"","Div","Date","HomeTeam","AwayTeam","FTHG","FTAG","FTR","HTHG","HTAG","HTR","PSH","PSD","PSA","HTCS","CS","HS","HST","AS","AST","HY","AY","HR","AR","HCO","ACO","HF","AF","TG","TC","TF","COSC","OV15","OV25","OV35","TY","TR","all_matchday"
"3294","B1",2023-07-28,"St. Gilloise","Anderlecht",2,0,"H",1,0,"H",2.22,3.63,3.24,"1-0","2-0",10,3,5,2,5,3,0,0,3,3,16,13,2,6,29,"3-3","Y","N","N",8,0,1
"3295","B1",2023-07-29,"Eupen","Westerlo",2,2,"D",1,0,"H",3.56,3.56,2.12,"1-0","2-2",13,6,22,5,1,0,0,0,1,4,14,7,4,5,21,"1-4","Y","Y","Y",1,0,1
"3296","B1",2023-07-29,"Charleroi","Oud-Heverlee Leuven",1,1,"D",1,0,"H",2.03,3.73,3.65,"1-0","1-1",4,2,19,5,3,1,1,0,2,6,7,12,2,8,19,"2-6","Y","N","N",4,1,1
"3297","B1",2023-07-29,"RWD Molenbeek","Genk",0,4,"A",0,3,"A",3.67,3.9,1.98,"0-3","0-4",10,4,28,10,1,0,0,0,2,6,11,11,4,8,22,"2-6","Y","Y","Y",1,0,1
"3298","B1",2023-07-30,"Antwerp","Cercle Brugge",1,0,"H",1,0,"H",1.85,3.6,4.36,"1-0","1-0",15,4,8,1,0,2,0,0,7,7,15,13,1,14,28,"7-7","N","N","N",2,0,1
"3299","B1",2023-07-30,"Gent","Kortrijk",3,2,"H",2,1,"H",1.33,5.51,8.63,"2-1","3-2",17,4,10,3,1,4,0,0,7,5,5,9,5,12,14,"7-5","Y","Y","Y",5,0,1
"3300","B1",2023-07-30,"Club Brugge","Mechelen",1,1,"D",0,1,"A",1.47,4.68,6.33,"0-1","1-1",21,5,9,2,2,2,1,0,4,3,8,9,2,7,17,"4-3","Y","N","N",4,1,1
"3301","B1",2023-07-30,"St Truiden","Standard",1,0,"H",0,0,"D",2.71,3.27,2.71,"0-0","1-0",11,3,7,3,1,1,0,0,3,2,13,11,1,5,24,"3-2","N","N","N",2,0,1
"3302","B1",2023-08-04,"Standard","St. Gilloise",0,1,"A",0,1,"A",3.87,3.67,1.98,"0-1","0-1",8,3,24,8,4,1,1,0,2,13,9,12,1,15,21,"2-13","N","N","N",5,1,2
"3303","B1",2023-08-05,"Genk","Eupen",0,1,"A",0,1,"A",1.29,6.28,9.53,"0-1","0-1",28,3,5,2,1,2,0,0,7,2,11,11,1,9,22,"7-2","N","N","N",3,0,2
"3304","B1",2023-08-05,"Cercle Brugge","Charleroi",2,0,"H",2,0,"H",1.92,3.8,3.98,"2-0","2-0",19,3,8,3,0,3,0,0,4,5,11,13,2,9,24,"4-5","Y","N","N",3,0,2
"3305","B1",2023-08-05,"Oud-Heverlee Leuven","RWD Molenbeek",1,2,"A",1,1,"D",1.82,4.01,4.23,"1-1","1-2",18,5,15,4,4,1,0,0,15,6,14,18,3,21,32,"15-6","Y","Y","N",5,0,2
"3306","B1",2023-08-06,"Anderlecht","Antwerp",1,0,"H",1,0,"H",2.65,3.7,2.55,"1-0","1-0",9,2,5,3,1,1,0,0,3,6,9,19,1,9,28,"3-6","N","N","N",2,0,2
"3307","B1",2023-08-06,"Mechelen","Gent",0,1,"A",0,0,"D",3.78,4.04,1.87,"0-0","0-1",14,2,12,3,2,3,0,0,7,3,14,14,1,10,28,"7-3","N","N","N",5,0,2
"3308","B1",2023-08-06,"Westerlo","Club Brugge",0,1,"A",0,1,"A",3.69,3.7,1.98,"0-1","0-1",11,3,20,8,1,0,0,0,4,5,7,9,1,9,16,"4-5","N","N","N",1,0,2
"3309","B1",2023-08-06,"Kortrijk","St Truiden",0,1,"A",0,0,"D",2.85,3.35,2.53,"0-0","0-1",8,1,14,4,1,2,0,0,0,14,10,12,1,14,22,"0-14","N","N","N",3,0,2
"3310","B1",2023-08-11,"Antwerp","Kortrijk",6,0,"H",4,0,"H",1.26,6.31,11.17,"4-0","6-0",25,9,4,1,0,2,0,0,4,1,8,11,6,5,19,"4-1","Y","Y","Y",2,0,3
"3311","B1",2023-08-12,"RWD Molenbeek","Mechelen",1,0,"H",0,0,"D",2.25,3.89,3.01,"0-0","1-0",18,8,9,4,3,1,0,0,7,4,12,11,1,11,23,"7-4","N","N","N",4,0,3
"3312","B1",2023-08-12,"St. Gilloise","Oud-Heverlee Leuven",5,1,"H",2,1,"H",1.51,4.42,6.74,"2-1","5-1",16,9,4,1,1,4,0,0,0,3,10,15,6,3,25,"0-3","Y","Y","Y",5,0,3
"3313","B1",2023-08-13,"St Truiden","Anderlecht",0,1,"A",0,0,"D",3.46,3.45,2.15,"0-0","0-1",14,5,9,3,4,5,0,1,6,1,13,15,1,7,28,"6-1","N","N","N",9,1,3
"3314","B1",2023-08-13,"Cercle Brugge","Genk",0,1,"A",0,0,"D",2.72,3.73,2.45,"0-0","0-1",13,2,10,3,2,3,0,0,5,3,8,20,1,8,28,"5-3","N","N","N",5,0,3
"3315","B1",2023-08-13,"Eupen","Club Brugge",0,5,"A",0,3,"A",5.62,4.33,1.56,"0-3","0-5",9,1,13,7,0,2,0,0,4,6,9,13,5,10,22,"4-6","Y","Y","Y",2,0,3
"3316","B1",2023-08-13,"Charleroi","Standard",1,1,"D",0,1,"A",2.07,3.64,3.47,"0-1","1-1",18,3,7,2,3,2,1,1,13,2,11,12,2,15,23,"13-2","Y","N","N",5,2,3
"3317","B1",2023-08-13,"Westerlo","Gent",1,3,"A",1,1,"D",3.56,3.96,1.95,"1-1","1-3",14,4,18,9,1,1,0,0,4,10,10,14,4,14,24,"4-10","Y","Y","Y",2,0,3
"3318","B1",2023-08-18,"Oud-Heverlee Leuven","Antwerp",1,1,"D",0,1,"A",4.93,4.24,1.67,"0-1","1-1",10,2,13,4,4,2,1,0,7,7,16,10,2,14,26,"7-7","Y","N","N",6,1,4
"3319","B1",2023-08-19,"Standard","Cercle Brugge",0,1,"A",0,0,"D",2.94,3.55,2.43,"0-0","0-1",7,3,16,4,2,2,0,0,3,2,10,11,1,5,21,"3-2","N","N","N",4,0,4
"3320","B1",2023-08-19,"Mechelen","St. Gilloise",4,0,"H",1,0,"H",4.29,4.01,1.81,"1-0","4-0",10,7,14,1,0,2,0,0,4,6,9,10,4,10,19,"4-6","Y","Y","Y",2,0,4
"3321","B1",2023-08-20,"Anderlecht","Westerlo",2,1,"H",1,0,"H",1.92,3.59,4.13,"1-0","2-1",24,7,18,3,1,3,0,0,6,2,7,13,3,8,20,"6-2","Y","Y","N",4,0,4
"3322","B1",2023-08-20,"Genk","Charleroi",0,0,"D",0,0,"D",1.59,4.53,5.02,"0-0","0-0",23,7,7,3,0,0,0,0,11,4,11,13,0,15,24,"11-4","N","N","N",0,0,4
"3323","B1",2023-08-20,"Gent","St Truiden",2,2,"D",1,2,"A",1.44,4.89,6.52,"1-2","2-2",19,5,14,3,2,2,0,0,7,2,11,9,4,9,20,"7-2","Y","Y","Y",4,0,4
"3324","B1",2023-08-20,"Club Brugge","RWD Molenbeek",7,1,"H",2,1,"H",1.29,5.77,9.29,"2-1","7-1",23,9,9,3,0,1,0,0,8,3,10,12,8,11,22,"8-3","Y","Y","Y",1,0,4
"3325","B1",2023-08-20,"Kortrijk","Eupen",1,3,"A",0,0,"D",2.33,3.77,2.85,"0-0","1-3",13,4,15,8,5,4,1,0,5,9,15,15,4,14,30,"5-9","Y","Y","Y",9,1,4
"3326","B1",2023-08-26,"Westerlo","Mechelen",2,3,"A",2,0,"H",2.25,3.83,3.04,"2-0","2-3",11,4,17,5,0,3,0,0,5,4,8,9,5,9,17,"5-4","Y","Y","Y",3,0,5
"3327","B1",2023-08-26,"Eupen","Oud-Heverlee Leuven",3,1,"H",1,0,"H",3.02,3.81,2.27,"1-0","3-1",17,4,22,5,1,2,0,0,3,5,15,9,4,8,24,"3-5","Y","Y","Y",3,0,5
"3328","B1",2023-08-26,"Kortrijk","Standard",1,1,"D",1,0,"H",3,3.65,2.35,"1-0","1-1",19,6,23,6,0,2,0,0,7,10,7,12,2,17,19,"7-10","Y","N","N",2,0,5
"3329","B1",2023-08-27,"St Truiden","Cercle Brugge",0,2,"A",0,0,"D",3.19,3.38,2.3,"0-0","0-2",20,4,25,8,1,1,0,0,8,8,8,18,2,16,26,"8-8","Y","N","N",2,0,5
"3330","B1",2023-08-27,"Anderlecht","Charleroi",2,1,"H",1,0,"H",1.72,4.11,4.43,"1-0","2-1",15,8,18,5,0,2,0,0,4,7,12,16,3,11,28,"4-7","Y","Y","N",2,0,5
"3331","B1",2023-09-01,"Oud-Heverlee Leuven","Kortrijk",3,0,"H",1,0,"H",1.63,4.61,4.83,"1-0","3-0",20,9,13,7,1,3,0,0,4,1,10,14,3,5,24,"4-1","Y","Y","N",4,0,5
"3332","B1",2023-09-02,"Cercle Brugge","Westerlo",2,1,"H",1,0,"H",1.58,4.43,5.54,"1-0","2-1",21,6,7,1,0,1,0,0,14,1,16,16,3,15,32,"14-1","Y","Y","N",1,0,5
"3333","B1",2023-09-02,"Mechelen","Eupen",1,0,"H",0,0,"D",1.78,4.13,4.21,"0-0","1-0",22,6,9,1,0,1,0,0,6,4,10,13,1,10,23,"6-4","N","N","N",1,0,5
"3334","B1",2023-09-02,"Standard","RWD Molenbeek",1,1,"D",1,1,"D",2.07,3.56,3.7,"1-1","1-1",11,4,8,3,1,3,0,0,5,0,9,22,2,5,31,"5-0","Y","N","N",4,0,6
"3335","B1",2023-09-03,"Gent","Club Brugge",2,1,"H",1,1,"D",2.41,3.77,2.79,"1-1","2-1",14,4,14,7,2,0,1,0,5,6,14,12,3,11,26,"5-6","Y","Y","N",2,1,6
"3336","B1",2023-09-03,"St. Gilloise","Antwerp",2,2,"D",1,2,"A",2.34,3.22,3.27,"1-2","2-2",24,7,8,5,1,2,0,0,8,4,9,12,4,12,21,"8-4","Y","Y","Y",3,0,6
"3337","B1",2023-09-03,"Genk","Anderlecht",1,1,"D",0,0,"D",1.97,3.56,3.87,"0-0","1-1",12,4,8,4,5,6,1,0,7,7,6,15,2,14,21,"7-7","Y","N","N",11,1,6
"3338","B1",2023-09-03,"Charleroi","St Truiden",1,1,"D",0,0,"D",2.23,3.43,3.28,"0-0","1-1",18,5,8,5,2,0,0,1,3,5,12,6,2,8,18,"3-5","Y","N","N",2,1,6
"3339","B1",2023-09-15,"Westerlo","Antwerp",0,3,"A",0,1,"A",5.39,4.45,1.6,"0-1","0-3",9,2,15,4,3,0,0,0,4,5,13,9,3,9,22,"4-5","Y","Y","N",3,0,6
"3340","B1",2023-09-16,"RWD Molenbeek","Cercle Brugge",2,1,"H",1,1,"D",4.18,4.22,1.79,"1-1","2-1",10,5,15,4,3,3,0,0,5,4,18,12,3,9,30,"5-4","Y","Y","N",6,0,6
"3341","B1",2023-09-16,"St. Gilloise","Genk",0,2,"A",0,1,"A",2,3.85,3.63,"0-1","0-2",25,4,7,2,1,6,0,0,7,3,15,15,2,10,30,"7-3","Y","N","N",7,0,6
"3342","B1",2023-09-16,"Club Brugge","Charleroi",4,2,"H",2,2,"D",1.41,5.26,7.15,"2-2","4-2",25,10,14,8,2,3,0,0,5,5,8,6,6,10,14,"5-5","Y","Y","Y",5,0,7
"3343","B1",2023-09-17,"Eupen","Standard",1,3,"A",0,2,"A",3.08,3.37,2.36,"0-2","1-3",13,3,16,6,1,4,0,1,6,6,5,12,4,12,17,"6-6","Y","Y","Y",5,1,7
"3344","B1",2023-09-17,"Kortrijk","Anderlecht",2,2,"D",1,1,"D",4.66,4.22,1.68,"1-1","2-2",9,4,18,6,5,1,1,1,3,11,13,6,4,14,19,"3-11","Y","Y","Y",6,2,7
"3345","B1",2023-09-17,"Oud-Heverlee Leuven","Gent",1,1,"D",1,1,"D",4.4,4.13,1.73,"1-1","1-1",9,2,22,4,4,3,0,0,3,16,7,11,2,19,18,"3-16","Y","N","N",7,0,7
"3346","B1",2023-09-17,"St Truiden","Mechelen",2,0,"H",1,0,"H",2.45,3.44,2.9,"1-0","2-0",16,4,13,7,1,2,0,0,1,7,8,12,2,8,20,"1-7","Y","N","N",3,0,7
"3347","B1",2023-09-22,"Standard","Westerlo",0,0,"D",0,0,"D",1.83,4.25,3.92,"0-0","0-0",14,5,3,2,0,3,0,0,5,2,6,23,0,7,29,"5-2","N","N","N",3,0,7
"3348","B1",2023-09-23,"Charleroi","Kortrijk",1,0,"H",1,0,"H",1.65,4.34,5.05,"1-0","1-0",14,5,13,3,2,1,0,0,8,7,16,13,1,15,29,"8-7","N","N","N",3,0,7
"3349","B1",2023-09-23,"Mechelen","Oud-Heverlee Leuven",1,2,"A",0,2,"A",1.93,3.81,3.9,"0-2","1-2",16,4,15,8,5,3,0,0,6,6,12,7,3,12,19,"6-6","Y","Y","N",8,0,7
"3350","B1",2023-09-23,"Antwerp","RWD Molenbeek",0,0,"D",0,0,"D",1.33,5.63,8.62,"0-0","0-0",14,3,5,1,0,1,0,0,9,1,4,14,0,10,18,"9-1","N","N","N",1,0,8
"3351","B1",2023-09-24,"Genk","St Truiden",3,3,"D",0,3,"A",1.58,4.34,5.35,"0-3","3-3",20,7,16,6,2,4,0,0,5,1,17,11,6,6,28,"5-1","Y","Y","Y",6,0,8
"3352","B1",2023-09-24,"Cercle Brugge","St. Gilloise",0,2,"A",0,1,"A",2.88,3.53,2.42,"0-1","0-2",6,1,15,7,3,3,1,0,3,2,8,17,2,5,25,"3-2","Y","N","N",6,1,8
"3353","B1",2023-09-24,"Anderlecht","Club Brugge",1,1,"D",1,0,"H",2.91,3.74,2.31,"1-0","1-1",8,1,9,3,1,1,0,0,3,3,12,11,2,6,23,"3-3","Y","N","N",2,0,8
"3354","B1",2023-09-24,"Gent","Eupen",2,1,"H",0,1,"A",1.28,5.94,9.23,"0-1","2-1",13,6,14,3,1,4,1,0,3,7,9,16,3,10,25,"3-7","Y","Y","N",5,1,8
"3355","B1",2023-09-27,"Antwerp","Gent",0,0,"D",0,0,"D",2.12,3.7,3.42,"0-0","0-0",14,4,6,2,3,1,0,0,6,0,10,4,0,6,14,"6-0","N","N","N",4,0,8
"3356","B1",2023-09-28,"RWD Molenbeek","St. Gilloise",2,3,"A",2,2,"D",4.79,4.22,1.66,"2-2","2-3",10,7,16,8,2,3,0,0,3,8,8,14,5,11,22,"3-8","Y","Y","Y",5,0,8
"3357","B1",2023-09-28,"Club Brugge","Genk",1,1,"D",0,1,"A",1.79,4.03,4.16,"0-1","1-1",18,3,15,5,4,1,0,0,10,3,16,7,2,13,23,"10-3","Y","N","N",5,0,8
"3358","B1",2023-09-29,"Kortrijk","Cercle Brugge",2,1,"H",0,0,"D",4.68,4.39,1.68,"0-0","2-1",10,4,10,2,3,1,0,0,3,7,13,19,3,10,32,"3-7","Y","Y","N",4,0,9
"3359","B1",2023-09-30,"Eupen","Anderlecht",1,3,"A",1,1,"D",4.48,3.99,1.78,"1-1","1-3",9,3,20,6,1,0,0,0,2,4,11,15,4,6,26,"2-4","Y","Y","Y",1,0,9
"3360","B1",2023-09-30,"Oud-Heverlee Leuven","Standard",1,2,"A",0,1,"A",2.38,3.69,2.92,"0-1","1-2",11,5,14,3,2,1,0,0,6,3,10,11,3,9,21,"6-3","Y","Y","N",3,0,9
"3361","B1",2023-09-30,"Mechelen","Antwerp",0,0,"D",0,0,"D",3.93,3.8,1.93,"0-0","0-0",14,3,22,4,0,1,0,0,5,13,3,5,0,18,8,"5-13","N","N","N",1,0,9
"3362","B1",2023-10-01,"St. Gilloise","Charleroi",3,1,"H",3,1,"H",1.57,4.43,5.34,"3-1","3-1",17,7,4,3,1,2,0,0,8,7,13,13,4,15,26,"8-7","Y","Y","Y",3,0,9
"3363","B1",2023-10-01,"Genk","Westerlo",3,3,"D",2,1,"H",1.45,4.87,6.35,"2-1","3-3",18,6,10,7,2,2,1,0,4,7,7,12,6,11,19,"4-7","Y","Y","Y",4,1,9
"3364","B1",2023-10-01,"Club Brugge","St Truiden",1,1,"D",0,0,"D",1.38,5.12,7.61,"0-0","1-1",20,7,12,3,3,1,0,0,11,4,12,8,2,15,20,"11-4","Y","N","N",4,0,9
"3365","B1",2023-10-01,"RWD Molenbeek","Gent",1,1,"D",1,1,"D",4.5,4.23,1.69,"1-1","1-1",9,3,19,9,3,1,0,0,4,4,9,10,2,8,19,"4-4","Y","N","N",4,0,9
"3366","B1",2023-10-06,"Charleroi","RWD Molenbeek",2,1,"H",0,0,"D",1.91,3.88,3.95,"0-0","2-1",22,7,6,3,1,3,0,1,14,2,9,7,3,16,16,"14-2","Y","Y","N",4,1,10
"3367","B1",2023-10-07,"Cercle Brugge","Oud-Heverlee Leuven",3,2,"H",2,2,"D",1.62,4.4,5.2,"2-2","3-2",18,7,13,5,2,3,0,0,6,6,9,9,5,12,18,"6-6","Y","Y","Y",5,0,10
"3368","B1",2023-10-07,"Westerlo","Kortrijk",1,0,"H",1,0,"H",1.85,4.29,3.79,"1-0","1-0",13,4,13,3,2,4,0,0,1,10,15,10,1,11,25,"1-10","N","N","N",6,0,10
"3369","B1",2023-10-07,"Anderlecht","Mechelen",3,1,"H",1,0,"H",1.75,4.05,4.58,"1-0","3-1",19,9,13,3,2,3,0,0,8,1,14,10,4,9,24,"8-1","Y","Y","Y",5,0,10
"3370","B1",2023-10-08,"Standard","Club Brugge",2,1,"H",1,0,"H",4.92,4.2,1.66,"1-0","2-1",7,5,16,7,4,1,0,0,1,6,13,14,3,7,27,"1-6","Y","Y","N",5,0,10
"3371","B1",2023-10-08,"Antwerp","Eupen",4,1,"H",2,1,"H",1.23,6.64,10.66,"2-1","4-1",27,12,5,2,0,2,0,0,8,2,8,10,5,10,18,"8-2","Y","Y","Y",2,0,10
"3372","B1",2023-10-08,"Gent","Genk",1,1,"D",0,0,"D",2.05,3.76,3.42,"0-0","1-1",18,9,20,6,1,3,0,0,4,9,9,14,2,13,23,"4-9","Y","N","N",4,0,10
"3373","B1",2023-10-08,"St Truiden","St. Gilloise",0,4,"A",0,2,"A",4.22,3.82,1.82,"0-2","0-4",9,1,12,7,1,4,0,0,3,5,3,15,4,8,18,"3-5","Y","Y","Y",5,0,10
"3374","B1",2023-10-20,"St. Gilloise","Eupen",4,1,"H",2,0,"H",1.2,7.49,13.66,"2-0","4-1",21,11,6,1,0,3,0,1,3,1,14,14,5,4,28,"3-1","Y","Y","Y",3,1,11
"3375","B1",2023-10-21,"Kortrijk","Club Brugge",1,0,"H",1,0,"H",7.22,5.36,1.4,"1-0","1-0",6,2,18,4,4,2,0,0,1,9,14,9,1,10,23,"1-9","N","N","N",6,0,11
"3376","B1",2023-10-21,"RWD Molenbeek","Westerlo",1,1,"D",0,0,"D",2.39,3.67,2.92,"0-0","1-1",12,6,9,5,2,2,0,0,7,4,10,8,2,11,18,"7-4","Y","N","N",4,0,11
"3377","B1",2023-10-21,"Charleroi","Antwerp",3,2,"H",0,0,"D",3.43,3.57,2.16,"0-0","3-2",10,5,11,5,2,2,0,0,5,2,6,12,5,7,18,"5-2","Y","Y","Y",4,0,11
"3378","B1",2023-10-22,"Genk","Mechelen",4,0,"H",2,0,"H",1.54,4.67,5.72,"2-0","4-0",19,9,10,3,1,2,0,0,4,3,6,10,4,7,16,"4-3","Y","Y","Y",3,0,11
"3379","B1",2023-10-22,"Cercle Brugge","Gent",2,0,"H",0,0,"D",2.65,3.71,2.52,"0-0","2-0",16,5,10,4,3,2,0,1,6,7,17,15,2,13,32,"6-7","Y","N","N",5,1,11
"3380","B1",2023-10-22,"Standard","Anderlecht",3,2,"H",0,2,"A",3.14,3.47,2.29,"0-2","3-2",15,8,13,7,2,3,0,0,3,8,12,14,5,11,26,"3-8","Y","Y","Y",5,0,11
"3381","B1",2023-10-22,"Oud-Heverlee Leuven","St Truiden",4,0,"H",2,0,"H",2.24,3.58,3.13,"2-0","4-0",11,4,18,3,1,3,0,0,3,7,9,12,4,10,21,"3-7","Y","Y","Y",4,0,11
"3382","B1",2023-10-27,"St Truiden","RWD Molenbeek",2,1,"H",0,0,"D",1.87,3.78,4.25,"0-0","2-1",9,5,10,3,0,0,0,0,4,0,9,7,3,4,16,"4-0","Y","Y","N",0,0,12
"3383","B1",2023-10-28,"Mechelen","Cercle Brugge",0,2,"A",0,0,"D",3.25,3.91,2.13,"0-0","0-2",11,7,22,4,1,3,0,0,8,3,13,15,2,11,28,"8-3","Y","N","N",4,0,12
"3384","B1",2023-10-28,"Eupen","Charleroi",2,0,"H",1,0,"H",3.54,3.77,2.06,"1-0","2-0",8,5,17,5,3,2,0,0,4,8,11,13,2,12,24,"4-8","Y","N","N",5,0,12
"3385","B1",2023-10-28,"Anderlecht","Oud-Heverlee Leuven",5,1,"H",2,1,"H",1.51,4.63,6.35,"2-1","5-1",18,9,13,7,1,1,0,0,5,1,13,13,6,6,26,"5-1","Y","Y","Y",2,0,12
"3386","B1",2023-10-29,"Club Brugge","Antwerp",2,1,"H",1,0,"H",1.98,3.77,3.63,"1-0","2-1",11,5,8,2,4,1,0,0,3,3,11,9,3,6,20,"3-3","Y","Y","N",5,0,12
"3387","B1",2023-10-29,"Westerlo","St. Gilloise",1,3,"A",1,1,"D",4.9,4.29,1.63,"1-1","1-3",12,4,22,7,1,1,0,0,5,8,11,10,4,13,21,"5-8","Y","Y","Y",2,0,12
"3388","B1",2023-10-29,"Gent","Standard",3,1,"H",3,0,"H",1.64,4.24,4.94,"3-0","3-1",18,9,12,7,2,2,0,0,4,4,16,15,4,8,31,"4-4","Y","Y","Y",4,0,12
"3389","B1",2023-10-29,"Kortrijk","Genk",0,3,"A",0,0,"D",5.98,4.69,1.49,"0-0","0-3",12,3,15,9,3,2,0,0,8,5,10,16,3,13,26,"8-5","Y","Y","N",5,0,12
"3390","B1",2023-11-03,"St Truiden","Eupen",1,1,"D",1,0,"H",1.65,4.2,5.18,"1-0","1-1",16,4,5,1,1,1,0,0,5,1,10,13,2,6,23,"5-1","Y","N","N",2,0,13
"3391","B1",2023-11-04,"RWD Molenbeek","Kortrijk",1,1,"D",1,1,"D",1.93,3.86,3.77,"1-1","1-1",9,5,5,2,3,1,0,0,4,2,14,7,2,6,21,"4-2","Y","N","N",4,0,13
"3392","B1",2023-11-04,"Oud-Heverlee Leuven","Westerlo",0,2,"A",0,0,"D",2.1,3.81,3.3,"0-0","0-2",10,2,10,6,3,7,0,0,7,7,11,13,2,14,24,"7-7","Y","N","N",10,0,13
"3393","B1",2023-11-04,"Antwerp","Genk",3,2,"H",3,1,"H",2.19,3.77,3.2,"3-1","3-2",14,5,17,8,3,4,0,0,5,5,13,12,5,10,25,"5-5","Y","Y","Y",7,0,13
"3394","B1",2023-11-05,"Cercle Brugge","Anderlecht",0,3,"A",0,2,"A",2.52,3.63,2.77,"0-2","0-3",16,2,7,5,2,3,0,0,7,1,14,13,3,8,27,"7-1","Y","Y","N",5,0,13
"3395","B1",2023-11-05,"Standard","Mechelen",1,1,"D",1,0,"H",1.69,4.08,4.71,"1-0","1-1",10,4,11,4,1,4,0,0,10,1,10,19,2,11,29,"10-1","Y","N","N",5,0,13
"3396","B1",2023-11-05,"St. Gilloise","Club Brugge",2,1,"H",1,0,"H",2.31,3.7,2.93,"1-0","2-1",19,6,5,2,3,4,0,0,9,4,11,6,3,13,17,"9-4","Y","Y","N",7,0,13
"3397","B1",2023-11-05,"Charleroi","Gent",1,3,"A",0,1,"A",3.39,3.68,2.09,"0-1","1-3",11,3,17,9,3,0,0,0,0,6,5,4,4,6,9,"0-6","Y","Y","Y",3,0,13
"3398","B1",2023-11-10,"Westerlo","St Truiden",3,3,"D",2,1,"H",2.65,3.52,2.69,"2-1","3-3",17,4,10,7,3,2,0,0,9,3,11,13,6,12,24,"9-3","Y","Y","Y",5,0,14
"3399","B1",2023-11-11,"Antwerp","Standard",6,0,"H",4,0,"H",1.63,4.28,5.29,"4-0","6-0",15,9,2,0,2,2,0,0,6,2,13,10,6,8,23,"6-2","Y","Y","Y",4,0,14
"3400","B1",2023-11-11,"Eupen","RWD Molenbeek",1,3,"A",1,1,"D",2.6,3.62,2.68,"1-1","1-3",11,4,20,10,1,4,0,0,8,5,12,14,4,13,26,"8-5","Y","Y","Y",5,0,14
"3401","B1",2023-11-11,"Mechelen","Charleroi",1,0,"H",0,0,"D",2.71,3.65,2.56,"0-0","1-0",19,7,6,3,2,1,0,1,8,2,11,10,1,10,21,"8-2","N","N","N",3,1,14
"3402","B1",2023-11-12,"Club Brugge","Cercle Brugge",0,0,"D",0,0,"D",1.72,4.09,4.47,"0-0","0-0",14,7,20,3,2,5,0,0,10,3,11,12,0,13,23,"10-3","N","N","N",7,0,14
"3403","B1",2023-11-12,"Genk","Oud-Heverlee Leuven",3,1,"H",1,0,"H",1.39,5.53,6.66,"1-0","3-1",18,6,6,3,2,4,0,0,3,2,14,19,4,5,33,"3-2","Y","Y","Y",6,0,14
"3404","B1",2023-11-12,"Gent","Anderlecht",1,1,"D",1,1,"D",2.19,3.63,3.2,"1-1","1-1",10,5,7,2,1,2,0,0,8,3,12,10,2,11,22,"8-3","Y","N","N",3,0,14
"3405","B1",2023-11-12,"St. Gilloise","Kortrijk",3,0,"H",2,0,"H",1.2,7.29,12.28,"2-0","3-0",18,8,11,1,2,1,0,0,6,6,10,9,3,12,19,"6-6","Y","Y","N",3,0,14
"3406","B1",2023-11-24,"St Truiden","Antwerp",1,1,"D",1,0,"H",4.1,3.67,1.93,"1-0","1-1",11,5,12,1,2,2,0,0,4,7,8,11,2,11,19,"4-7","Y","N","N",4,0,15
"3407","B1",2023-11-25,"Cercle Brugge","Eupen",2,0,"H",0,0,"D",1.38,5.15,7.14,"0-0","2-0",30,10,6,4,4,3,0,0,5,3,12,13,2,8,25,"5-3","Y","N","N",7,0,15
"3408","B1",2023-11-25,"Charleroi","Westerlo",3,2,"H",0,1,"A",1.85,3.79,4.12,"0-1","3-2",14,4,11,4,3,2,0,0,5,4,15,11,5,9,26,"5-4","Y","Y","Y",5,0,15
"3409","B1",2023-11-25,"Standard","Genk",1,0,"H",0,0,"D",3.7,3.89,1.93,"0-0","1-0",13,4,11,2,2,2,0,0,5,5,20,12,1,10,32,"5-5","N","N","N",4,0,15
"3410","B1",2023-11-26,"Gent","St. Gilloise",1,1,"D",1,0,"H",2.59,3.6,2.55,"1-0","1-1",11,3,12,4,2,3,0,0,5,8,8,14,2,13,22,"5-8","Y","N","N",5,0,15
"3411","B1",2023-11-26,"Oud-Heverlee Leuven","Club Brugge",0,1,"A",0,1,"A",4.37,4.2,1.68,"0-1","0-1",10,3,14,6,4,2,0,0,7,6,19,13,1,13,32,"7-6","N","N","N",6,0,15
"3412","B1",2023-11-26,"Anderlecht","RWD Molenbeek",2,1,"H",0,1,"A",1.39,4.87,7.22,"0-1","2-1",25,8,7,2,1,4,0,1,10,1,6,12,3,11,18,"10-1","Y","Y","N",5,1,15
"3413","B1",2023-11-26,"Kortrijk","Mechelen",0,3,"A",0,2,"A",3.01,3.4,2.34,"0-2","0-3",15,3,10,5,2,2,0,0,4,3,12,12,3,7,24,"4-3","Y","Y","N",4,0,15
"3414","B1",2023-12-01,"Westerlo","Anderlecht",1,3,"A",0,1,"A",5.13,3.88,1.71,"0-1","1-3",23,7,26,10,0,0,0,0,7,2,3,11,4,9,14,"7-2","Y","Y","Y",0,0,16
"3415","B1",2023-12-02,"RWD Molenbeek","Charleroi",0,0,"D",0,0,"D",2.88,3.4,2.55,"0-0","0-0",10,4,18,8,0,2,0,0,3,10,4,8,0,13,12,"3-10","N","N","N",2,0,16
"3416","B1",2023-12-02,"Eupen","Kortrijk",1,1,"D",0,0,"D",2.28,3.67,3.09,"0-0","1-1",14,3,14,3,1,1,0,0,7,11,14,10,2,18,24,"7-11","Y","N","N",2,0,16
"3417","B1",2023-12-02,"Antwerp","Oud-Heverlee Leuven",1,0,"H",1,0,"H",1.34,5.81,8.32,"1-0","1-0",18,5,10,4,0,3,0,0,7,6,6,9,1,13,15,"7-6","N","N","N",3,0,16
"3418","B1",2023-12-03,"Genk","Gent",2,2,"D",1,1,"D",2.21,3.75,3.19,"1-1","2-2",13,6,17,6,2,2,0,0,1,9,15,12,4,10,27,"1-9","Y","Y","Y",4,0,16
"3419","B1",2023-12-03,"Mechelen","St Truiden",0,2,"A",0,2,"A",2.22,3.38,3.36,"0-2","0-2",6,5,13,5,1,2,0,0,1,5,10,8,2,6,18,"1-5","Y","N","N",3,0,16
"3420","B1",2023-12-03,"Club Brugge","Standard",2,0,"H",1,0,"H",1.45,4.97,6.21,"1-0","2-0",13,5,7,2,2,2,0,0,4,3,13,10,2,7,23,"4-3","Y","N","N",4,0,16
"3421","B1",2023-12-03,"St. Gilloise","Cercle Brugge",2,1,"H",2,1,"H",1.65,4.06,5.14,"2-1","2-1",12,6,13,6,1,3,0,0,5,4,13,15,3,9,28,"5-4","Y","Y","N",4,0,16
"3422","B1",2023-12-08,"Kortrijk","Westerlo",1,2,"A",0,1,"A",2.87,3.38,2.57,"0-1","1-2",16,6,8,3,1,3,0,0,5,1,8,13,3,6,21,"5-1","Y","Y","N",4,0,17
"3423","B1",2023-12-09,"Cercle Brugge","Antwerp",1,3,"A",0,1,"A",2.79,3.44,2.61,"0-1","1-3",15,2,14,8,4,1,0,0,6,2,13,6,4,8,19,"6-2","Y","Y","Y",5,0,17
"3424","B1",2023-12-09,"St Truiden","Oud-Heverlee Leuven",1,1,"D",1,1,"D",1.83,4.11,4.09,"1-1","1-1",26,13,4,3,0,2,0,1,15,2,5,10,2,17,15,"15-2","Y","N","N",2,1,17
"3425","B1",2023-12-09,"Gent","RWD Molenbeek",4,0,"H",2,0,"H",1.33,6.02,8.28,"2-0","4-0",22,10,3,1,0,5,0,0,9,1,11,14,4,10,25,"9-1","Y","Y","Y",5,0,17
"3426","B1",2023-12-10,"Mechelen","Club Brugge",0,0,"D",0,0,"D",5.18,4.23,1.61,"0-0","0-0",9,4,13,2,3,5,0,0,2,9,11,9,0,11,20,"2-9","N","N","N",8,0,17
"3427","B1",2023-12-10,"Eupen","Genk",1,3,"A",0,1,"A",7.43,5.43,1.36,"0-1","1-3",11,4,18,10,0,2,0,0,8,8,12,8,4,16,20,"8-8","Y","Y","Y",2,0,17
"3428","B1",2023-12-10,"Anderlecht","Standard",2,2,"D",1,1,"D",1.56,4.28,5.79,"1-1","2-2",12,4,13,4,2,3,0,0,1,1,8,14,4,2,22,"1-1","Y","Y","Y",5,0,17
"3429","B1",2023-12-10,"Charleroi","St. Gilloise",1,3,"A",0,1,"A",5.36,4.07,1.62,"0-1","1-3",9,3,17,9,3,2,0,0,6,7,7,12,4,13,19,"6-7","Y","Y","Y",5,0,17
"3430","B1",2023-12-15,"Westerlo","Eupen",2,0,"H",0,0,"D",1.8,3.84,4.54,"0-0","2-0",20,4,15,7,3,1,0,0,4,4,15,8,2,8,23,"4-4","Y","N","N",4,0,18
"3431","B1",2023-12-16,"Oud-Heverlee Leuven","Cercle Brugge",1,2,"A",1,0,"H",4.09,4.27,1.79,"1-0","1-2",9,3,12,5,4,3,0,0,4,6,12,14,3,10,26,"4-6","Y","Y","N",7,0,18
"3432","B1",2023-12-16,"RWD Molenbeek","St Truiden",3,0,"H",1,0,"H",3.42,3.43,2.22,"1-0","3-0",7,6,12,1,3,2,0,0,4,4,14,8,3,8,22,"4-4","Y","Y","N",5,0,18
"3433","B1",2023-12-16,"Standard","Charleroi",0,0,"D",0,0,"D",2.16,3.52,3.48,"0-0","0-0",6,1,7,2,1,1,0,0,4,2,11,21,0,6,32,"4-2","N","N","N",2,0,18
"3434","B1",2023-12-17,"Club Brugge","Gent",2,0,"H",2,0,"H",1.68,4.2,4.89,"2-0","2-0",13,4,8,2,0,0,0,1,4,5,10,11,2,9,21,"4-5","Y","N","N",0,1,18
"3435","B1",2023-12-17,"St. Gilloise","Mechelen",1,0,"H",0,0,"D",1.33,5.4,8.6,"0-0","1-0",24,8,15,8,2,1,0,0,8,5,14,10,1,13,24,"8-5","N","N","N",3,0,18
"3436","B1",2023-12-17,"Antwerp","Anderlecht",1,1,"D",0,1,"A",1.99,3.57,3.8,"0-1","1-1",19,5,10,4,2,4,0,0,7,2,9,13,2,9,22,"7-2","Y","N","N",6,0,18
"3437","B1",2023-12-17,"Genk","Kortrijk",4,0,"H",1,0,"H",1.23,6.73,10.54,"1-0","4-0",27,9,5,1,0,2,0,0,7,2,7,12,4,9,19,"7-2","Y","Y","Y",2,0,18
"3438","B1",2023-12-20,"Cercle Brugge","Kortrijk",3,0,"H",1,0,"H",1.35,5.53,8.71,"1-0","3-0",24,13,6,1,2,3,0,0,7,5,8,14,3,12,22,"7-5","Y","Y","N",5,0,19
"3439","B1",2023-12-20,"Mechelen","Standard",3,0,"H",1,0,"H",2.57,3.36,2.89,"1-0","3-0",28,8,14,3,2,0,0,1,5,3,8,8,3,8,16,"5-3","Y","Y","N",2,1,19
"3440","B1",2023-12-21,"Gent","Oud-Heverlee Leuven",4,0,"H",1,0,"H",1.29,6.02,8.57,"1-0","4-0",21,6,9,2,0,1,0,0,8,3,6,12,4,11,18,"8-3","Y","Y","Y",1,0,19
"3441","B1",2023-12-22,"RWD Molenbeek","Club Brugge",1,6,"A",0,3,"A",8.5,5.2,1.37,"0-3","1-6",10,3,15,10,1,2,0,0,2,8,9,8,7,10,17,"2-8","Y","Y","Y",3,0,19
"3442","B1",2023-12-23,"Eupen","St. Gilloise",1,2,"A",0,2,"A",11.63,6.62,1.24,"0-2","1-2",1,1,20,8,5,1,0,0,3,14,15,8,3,17,23,"3-14","Y","Y","N",6,0,19
"3443","B1",2023-12-23,"Antwerp","Westerlo",2,2,"D",1,0,"H",1.37,5.38,8,"1-0","2-2",15,6,12,6,2,1,0,0,8,2,5,7,4,10,12,"8-2","Y","Y","Y",3,0,19
"3444","B1",2023-12-23,"St Truiden","Charleroi",1,0,"H",0,0,"D",2.32,3.34,3.3,"0-0","1-0",16,7,4,0,0,0,0,0,6,3,4,17,1,9,21,"6-3","N","N","N",0,0,19
"3445","B1",2023-12-23,"Anderlecht","Genk",2,1,"H",0,0,"D",2.35,3.58,3.04,"0-0","2-1",9,3,20,7,1,2,0,0,1,8,7,15,3,9,22,"1-8","Y","Y","N",3,0,19
"3446","B1",2023-12-26,"Genk","Antwerp",3,0,"H",1,0,"H",2.18,3.81,3.2,"1-0","3-0",16,8,3,1,1,3,0,0,3,3,8,9,3,6,17,"3-3","Y","Y","N",4,0,20
"3447","B1",2023-12-26,"Kortrijk","Gent",0,2,"A",0,1,"A",8.48,5.57,1.35,"0-1","0-2",7,3,20,9,1,1,0,0,4,5,9,10,2,9,19,"4-5","Y","N","N",2,0,20
"3448","B1",2023-12-26,"Oud-Heverlee Leuven","Eupen",3,0,"H",2,0,"H",1.85,3.99,4.09,"2-0","3-0",18,7,14,6,2,2,0,0,7,3,6,15,3,10,21,"7-3","Y","Y","N",4,0,20
"3449","B1",2023-12-26,"Westerlo","RWD Molenbeek",3,0,"H",1,0,"H",1.88,3.83,4.15,"1-0","3-0",13,3,11,4,0,0,0,1,6,0,7,12,3,6,19,"6-0","Y","Y","N",0,1,20
"3450","B1",2023-12-26,"Club Brugge","St. Gilloise",1,1,"D",0,1,"A",2.34,3.45,3.06,"0-1","1-1",9,2,7,3,1,5,0,1,6,0,15,14,2,6,29,"6-0","Y","N","N",6,1,20
"3451","B1",2023-12-27,"Standard","St Truiden",1,1,"D",0,0,"D",2.37,3.34,3.1,"0-0","1-1",11,2,18,8,1,3,0,0,4,4,14,14,2,8,28,"4-4","Y","N","N",4,0,20
"3452","B1",2023-12-27,"Anderlecht","Cercle Brugge",2,0,"H",1,0,"H",1.89,3.96,3.77,"1-0","2-0",7,4,19,7,1,1,0,0,2,12,9,13,2,14,22,"2-12","Y","N","N",2,0,20
"3453","B1",2023-12-27,"Charleroi","Mechelen",3,1,"H",2,0,"H",2.19,3.36,3.44,"2-0","3-1",16,6,11,5,2,1,0,0,5,7,10,9,4,12,19,"5-7","Y","Y","Y",3,0,20
"1922","D1",2023-08-18,"Werder Bremen","Bayern Munich",0,4,"A",0,1,"A",8.59,6.36,1.33,"0-1","0-4",6,1,25,10,2,1,0,0,0,6,16,11,4,6,27,"0-6","Y","Y","Y",3,0,1
"1923","D1",2023-08-19,"Augsburg","Mgladbach",4,4,"D",3,3,"D",2.74,3.78,2.51,"3-3","4-4",20,8,9,6,1,2,0,0,8,7,9,14,8,15,23,"8-7","Y","Y","Y",3,0,1
"1924","D1",2023-08-19,"Hoffenheim","Freiburg",1,2,"A",0,2,"A",2.43,3.67,2.92,"0-2","1-2",24,5,17,8,0,1,0,0,4,2,9,9,3,6,18,"4-2","Y","Y","N",1,0,1
"1925","D1",2023-08-19,"Leverkusen","RB Leipzig",3,2,"H",2,1,"H",2.5,3.61,2.85,"2-1","3-2",11,7,13,6,1,2,0,0,4,5,13,10,5,9,23,"4-5","Y","Y","Y",3,0,1
"1926","D1",2023-08-19,"Stuttgart","Bochum",5,0,"H",2,0,"H",1.7,4.25,4.78,"2-0","5-0",19,9,4,1,1,1,0,0,7,0,5,12,5,7,17,"7-0","Y","Y","Y",2,0,1
"1927","D1",2023-08-19,"Wolfsburg","Heidenheim",2,0,"H",2,0,"H",1.62,4.49,5.24,"2-0","2-0",18,8,13,1,3,0,0,0,1,7,10,9,2,8,19,"1-7","Y","N","N",3,0,1
"1928","D1",2023-08-19,"Dortmund","FC Koln",1,0,"H",0,0,"D",1.41,5.42,7.25,"0-0","1-0",12,2,11,4,1,0,0,0,6,3,13,11,1,9,24,"6-3","N","N","N",1,0,1
"1929","D1",2023-08-20,"Union Berlin","Mainz",4,1,"H",2,0,"H",2.02,3.5,4.02,"2-0","4-1",12,7,9,3,1,5,0,0,3,1,15,16,5,4,31,"3-1","Y","Y","Y",6,0,1
"1930","D1",2023-08-20,"Ein Frankfurt","Darmstadt",1,0,"H",1,0,"H",1.4,5.42,7.44,"1-0","1-0",10,4,11,2,2,3,0,0,7,3,9,14,1,10,23,"7-3","N","N","N",5,0,1
"1931","D1",2023-08-25,"RB Leipzig","Stuttgart",5,1,"H",0,1,"A",1.53,4.69,6.14,"0-1","5-1",20,11,8,3,1,1,0,0,4,4,12,10,6,8,22,"4-4","Y","Y","Y",2,0,2
"1932","D1",2023-08-26,"Bochum","Dortmund",1,1,"D",1,0,"H",6.63,5.36,1.44,"1-0","1-1",17,6,13,3,2,1,0,0,5,4,21,7,2,9,28,"5-4","Y","N","N",3,0,2
"1933","D1",2023-08-26,"Darmstadt","Union Berlin",1,4,"A",1,3,"A",3.94,3.42,2.08,"1-3","1-4",18,6,12,6,2,2,0,1,3,5,15,12,5,8,27,"3-5","Y","Y","Y",4,1,2
"1934","D1",2023-08-26,"FC Koln","Wolfsburg",1,2,"A",0,0,"D",2.41,3.53,3.04,"0-0","1-2",14,2,9,6,1,5,0,0,6,1,6,10,3,7,16,"6-1","Y","Y","N",6,0,2
"1935","D1",2023-08-26,"Freiburg","Werder Bremen",1,0,"H",0,0,"D",1.72,4.15,4.76,"0-0","1-0",23,6,16,2,2,2,0,0,5,5,9,8,1,10,17,"5-5","N","N","N",4,0,2
"1936","D1",2023-08-26,"Heidenheim","Hoffenheim",2,3,"A",1,0,"H",2.96,3.81,2.34,"1-0","2-3",19,9,16,6,1,5,0,0,10,6,13,9,5,16,22,"10-6","Y","Y","Y",6,0,2
"1937","D1",2023-08-26,"Mgladbach","Leverkusen",0,3,"A",0,2,"A",3.73,4.2,1.91,"0-2","0-3",13,2,24,10,2,3,0,0,5,8,7,8,3,13,15,"5-8","Y","Y","N",5,0,2
"1938","D1",2023-08-27,"Mainz","Ein Frankfurt",1,1,"D",1,0,"H",2.39,3.74,2.92,"1-0","1-1",13,7,8,2,3,4,0,1,5,4,23,12,2,9,35,"5-4","Y","N","N",7,1,2
"1939","D1",2023-08-27,"Bayern Munich","Augsburg",3,1,"H",2,0,"H",1.09,14.24,22.48,"2-0","3-1",19,6,11,2,1,2,0,0,10,4,13,8,4,14,21,"10-4","Y","Y","Y",3,0,2
"1940","D1",2023-09-01,"Dortmund","Heidenheim",2,2,"D",2,0,"H",1.26,7.07,10.23,"2-0","2-2",20,9,15,6,3,3,0,0,3,6,9,22,4,9,31,"3-6","Y","Y","Y",6,0,3
"1941","D1",2023-09-02,"Augsburg","Bochum",2,2,"D",1,1,"D",2.09,3.67,3.61,"1-1","2-2",11,3,22,9,2,2,0,0,3,5,15,13,4,8,28,"3-5","Y","Y","Y",4,0,3
"1942","D1",2023-09-02,"Hoffenheim","Wolfsburg",3,1,"H",1,1,"D",2.48,3.86,2.73,"1-1","3-1",11,5,14,7,2,2,0,0,3,3,12,15,4,6,27,"3-3","Y","Y","Y",4,0,3
"1943","D1",2023-09-02,"Leverkusen","Darmstadt",5,1,"H",1,1,"D",1.2,7.79,13.72,"1-1","5-1",24,13,5,1,3,2,0,0,4,2,8,11,6,6,19,"4-2","Y","Y","Y",5,0,3
"1944","D1",2023-09-02,"Stuttgart","Freiburg",5,0,"H",3,0,"H",2.18,3.79,3.28,"3-0","5-0",13,6,11,5,1,1,0,0,2,4,9,10,5,6,19,"2-4","Y","Y","Y",2,0,3
"1945","D1",2023-09-02,"Werder Bremen","Mainz",4,0,"H",1,0,"H",2.76,3.55,2.61,"1-0","4-0",12,6,12,3,2,2,0,0,1,7,18,14,4,8,32,"1-7","Y","Y","Y",4,0,3
"1946","D1",2023-09-02,"Mgladbach","Bayern Munich",1,2,"A",1,0,"H",7.93,6.61,1.31,"1-0","1-2",8,3,25,9,0,2,0,0,1,15,5,20,3,16,25,"1-15","Y","Y","N",2,0,3
"1947","D1",2023-09-03,"Ein Frankfurt","FC Koln",1,1,"D",0,1,"A",2.18,3.49,3.54,"0-1","1-1",12,4,6,2,1,3,0,0,8,1,10,10,2,9,20,"8-1","Y","N","N",4,0,3
"1948","D1",2023-09-03,"Union Berlin","RB Leipzig",0,3,"A",0,0,"D",3.24,3.48,2.31,"0-0","0-3",4,1,15,8,3,1,1,0,3,7,16,9,3,10,25,"3-7","Y","Y","N",4,1,3
"1949","D1",2023-09-15,"Bayern Munich","Leverkusen",2,2,"D",1,1,"D",1.65,4.7,4.78,"1-1","2-2",15,9,12,5,0,3,0,0,7,4,6,6,4,11,12,"7-4","Y","Y","Y",3,0,4
"1950","D1",2023-09-16,"FC Koln","Hoffenheim",1,3,"A",0,2,"A",2.26,3.87,3.06,"0-2","1-3",17,7,17,5,4,4,1,0,13,4,15,14,4,17,29,"13-4","Y","Y","Y",8,1,4
"1951","D1",2023-09-16,"Freiburg","Dortmund",2,4,"A",2,1,"H",3.16,3.86,2.21,"2-1","2-4",14,4,14,6,2,3,1,0,6,8,12,16,6,14,28,"6-8","Y","Y","Y",5,1,4
"1952","D1",2023-09-16,"Mainz","Stuttgart",1,3,"A",0,0,"D",2.57,3.71,2.71,"0-0","1-3",15,3,16,6,1,2,0,0,6,4,12,9,4,10,21,"6-4","Y","Y","Y",3,0,4
"1953","D1",2023-09-16,"RB Leipzig","Augsburg",3,0,"H",3,0,"H",1.24,7.19,11.19,"3-0","3-0",9,6,16,4,0,0,0,0,1,6,16,12,3,7,28,"1-6","Y","Y","N",0,0,4
"1954","D1",2023-09-16,"Wolfsburg","Union Berlin",2,1,"H",2,1,"H",2.27,3.55,3.27,"2-1","2-1",8,3,17,5,1,0,0,0,3,7,6,8,3,10,14,"3-7","Y","Y","N",1,0,4
"1955","D1",2023-09-16,"Bochum","Ein Frankfurt",1,1,"D",0,0,"D",2.95,3.63,2.42,"0-0","1-1",24,10,8,6,3,2,0,0,8,2,13,14,2,10,27,"8-2","Y","N","N",5,0,4
"1956","D1",2023-09-17,"Heidenheim","Werder Bremen",4,2,"H",2,0,"H",2.39,3.88,2.85,"2-0","4-2",19,4,11,4,1,1,0,0,10,1,21,9,6,11,30,"10-1","Y","Y","Y",2,0,4
"1957","D1",2023-09-17,"Darmstadt","Mgladbach",3,3,"D",3,0,"H",3.01,3.74,2.34,"3-0","3-3",15,8,21,10,1,1,1,0,6,6,12,8,6,12,20,"6-6","Y","Y","Y",2,1,4
"1958","D1",2023-09-22,"Stuttgart","Darmstadt",3,1,"H",2,1,"H",1.4,5.24,8.18,"2-1","3-1",18,11,3,0,1,6,0,0,5,4,7,12,4,9,19,"5-4","Y","Y","Y",7,0,5
"1959","D1",2023-09-23,"Augsburg","Mainz",2,1,"H",2,1,"H",2.61,3.7,2.68,"2-1","2-1",6,3,13,3,2,3,1,0,3,4,16,14,3,7,30,"3-4","Y","Y","N",5,1,5
"1960","D1",2023-09-23,"Bayern Munich","Bochum",7,0,"H",4,0,"H",1.1,12.85,20.11,"4-0","7-0",26,16,4,1,0,1,0,0,8,1,8,10,7,9,18,"8-1","Y","Y","Y",1,0,5
"1961","D1",2023-09-23,"Dortmund","Wolfsburg",1,0,"H",0,0,"D",1.71,4.47,4.48,"0-0","1-0",18,4,8,2,0,1,0,0,5,3,9,14,1,8,23,"5-3","N","N","N",1,0,5
"1962","D1",2023-09-23,"Mgladbach","RB Leipzig",0,1,"A",0,0,"D",5.26,4.74,1.59,"0-0","0-1",13,1,8,4,1,1,0,0,11,6,14,7,1,17,21,"11-6","N","N","N",2,0,5
"1963","D1",2023-09-23,"Union Berlin","Hoffenheim",0,2,"A",0,2,"A",2.15,3.72,3.39,"0-2","0-2",22,6,11,4,1,3,0,0,11,6,11,13,2,17,24,"11-6","Y","N","N",4,0,5
"1964","D1",2023-09-23,"Werder Bremen","FC Koln",2,1,"H",1,1,"D",2.56,3.69,2.74,"1-1","2-1",17,6,13,5,2,1,0,0,9,8,18,16,3,17,34,"9-8","Y","Y","N",3,0,5
"1965","D1",2023-09-24,"Leverkusen","Heidenheim",4,1,"H",1,0,"H",1.23,7.35,11.42,"1-0","4-1",20,10,1,1,1,1,0,0,7,2,9,10,5,9,19,"7-2","Y","Y","Y",2,0,5
"1966","D1",2023-09-24,"Ein Frankfurt","Freiburg",0,0,"D",0,0,"D",2.16,3.66,3.42,"0-0","0-0",13,5,9,2,4,2,0,0,7,3,12,5,0,10,17,"7-3","N","N","N",6,0,5
"1967","D1",2023-09-29,"Hoffenheim","Dortmund",1,3,"A",1,2,"A",3.15,4.16,2.12,"1-2","1-3",15,5,6,5,3,4,0,1,4,3,14,16,4,7,30,"4-3","Y","Y","Y",7,1,6
"1968","D1",2023-09-30,"Bochum","Mgladbach",1,3,"A",0,3,"A",2.32,3.88,2.96,"0-3","1-3",23,5,25,9,2,3,0,0,5,10,12,12,4,15,24,"5-10","Y","Y","Y",5,0,6
"1969","D1",2023-09-30,"FC Koln","Stuttgart",0,2,"A",0,0,"D",2.89,3.64,2.46,"0-0","0-2",14,5,18,4,2,1,0,0,8,4,16,8,2,12,24,"8-4","Y","N","N",3,0,6
"1970","D1",2023-09-30,"Heidenheim","Union Berlin",1,0,"H",0,0,"D",3.05,3.72,2.32,"0-0","1-0",9,4,19,8,1,2,0,0,5,7,11,14,1,12,25,"5-7","N","N","N",3,0,6
"1971","D1",2023-09-30,"Mainz","Leverkusen",0,3,"A",0,1,"A",5.85,4.72,1.54,"0-1","0-3",10,3,6,3,4,1,0,0,3,1,13,11,3,4,24,"3-1","Y","Y","N",5,0,6
"1972","D1",2023-09-30,"Wolfsburg","Ein Frankfurt",2,0,"H",1,0,"H",2.11,3.53,3.68,"1-0","2-0",19,7,7,3,1,6,0,1,7,4,11,18,2,11,29,"7-4","Y","N","N",7,1,6
"1973","D1",2023-09-30,"RB Leipzig","Bayern Munich",2,2,"D",2,0,"H",3.73,4.2,1.91,"2-0","2-2",7,2,11,5,2,5,0,0,5,1,10,11,4,6,21,"5-1","Y","Y","Y",7,0,6
"1974","D1",2023-10-01,"Darmstadt","Werder Bremen",4,2,"H",2,0,"H",2.82,3.74,2.47,"2-0","4-2",14,5,10,7,3,2,0,0,2,4,19,19,6,6,38,"2-4","Y","Y","Y",5,0,6
"1975","D1",2023-10-01,"Freiburg","Augsburg",2,0,"H",1,0,"H",1.73,4.19,4.68,"1-0","2-0",7,3,13,4,2,2,0,0,2,3,13,17,2,5,30,"2-3","Y","N","N",4,0,6
"1976","D1",2023-10-06,"Mgladbach","Mainz",2,2,"D",1,1,"D",2.08,3.93,3.48,"1-1","2-2",20,9,13,7,3,1,0,0,10,3,9,9,4,13,18,"10-3","Y","Y","Y",4,0,7
"1977","D1",2023-10-07,"Augsburg","Darmstadt",1,2,"A",0,0,"D",1.92,3.9,3.98,"0-0","1-2",17,3,17,5,4,2,0,0,4,4,13,12,3,8,25,"4-4","Y","Y","N",6,0,7
"1978","D1",2023-10-07,"Dortmund","Union Berlin",4,2,"H",1,2,"A",1.61,4.51,5.28,"1-2","4-2",12,7,12,6,1,1,0,0,4,6,7,15,6,10,22,"4-6","Y","Y","Y",2,0,7
"1979","D1",2023-10-07,"RB Leipzig","Bochum",0,0,"D",0,0,"D",1.25,6.87,10.85,"0-0","0-0",18,5,9,2,2,4,0,0,9,1,10,13,0,10,23,"9-1","N","N","N",6,0,7
"1980","D1",2023-10-07,"Stuttgart","Wolfsburg",3,1,"H",0,1,"A",2.01,3.8,3.73,"0-1","3-1",13,7,12,5,1,3,0,0,5,6,13,14,4,11,27,"5-6","Y","Y","Y",4,0,7
"1981","D1",2023-10-07,"Werder Bremen","Hoffenheim",2,3,"A",1,2,"A",2.75,3.92,2.44,"1-2","2-3",13,3,11,4,5,4,0,0,4,4,15,6,5,8,21,"4-4","Y","Y","Y",9,0,7
"1982","D1",2023-10-08,"Leverkusen","FC Koln",3,0,"H",2,0,"H",1.34,5.68,9.07,"2-0","3-0",21,10,7,3,3,0,0,0,11,4,9,7,3,15,16,"11-4","Y","Y","N",3,0,7
"1983","D1",2023-10-08,"Bayern Munich","Freiburg",3,0,"H",2,0,"H",1.16,9.23,14.64,"2-0","3-0",21,5,2,0,1,0,0,0,7,1,7,8,3,8,15,"7-1","Y","Y","N",1,0,7
"1984","D1",2023-10-08,"Ein Frankfurt","Heidenheim",2,0,"H",1,0,"H",1.74,4.12,4.7,"1-0","2-0",12,6,7,2,2,3,0,0,3,6,14,10,2,9,24,"3-6","Y","N","N",5,0,7
"1985","D1",2023-10-20,"Dortmund","Werder Bremen",1,0,"H",0,0,"D",1.3,6.69,8.63,"0-0","1-0",22,5,6,1,1,5,0,0,10,4,5,10,1,14,15,"10-4","N","N","N",6,0,8
"1986","D1",2023-10-21,"Darmstadt","RB Leipzig",1,3,"A",1,2,"A",6.38,5.09,1.47,"1-2","1-3",16,3,10,7,6,3,0,0,6,0,16,12,4,6,28,"6-0","Y","Y","Y",9,0,8
"1987","D1",2023-10-21,"Freiburg","Bochum",2,1,"H",2,1,"H",1.76,4.02,4.73,"2-1","2-1",15,5,13,5,3,4,0,0,5,2,11,16,3,7,27,"5-2","Y","Y","N",7,0,8
"1988","D1",2023-10-21,"Hoffenheim","Ein Frankfurt",1,3,"A",1,3,"A",2.15,3.72,3.4,"1-3","1-3",14,5,13,5,3,0,0,0,6,3,7,7,4,9,14,"6-3","Y","Y","Y",3,0,8
"1989","D1",2023-10-21,"Union Berlin","Stuttgart",0,3,"A",0,1,"A",2.56,3.58,2.79,"0-1","0-3",10,2,10,5,2,1,0,0,4,2,12,12,3,6,24,"4-2","Y","Y","N",3,0,8
"1990","D1",2023-10-21,"Wolfsburg","Leverkusen",1,2,"A",1,1,"D",4.52,4.2,1.75,"1-1","1-2",18,7,13,6,3,5,0,0,4,3,15,14,3,7,29,"4-3","Y","Y","N",8,0,8
"1991","D1",2023-10-21,"Mainz","Bayern Munich",1,3,"A",1,2,"A",9.99,6.69,1.27,"1-2","1-3",14,3,12,5,3,2,0,0,2,7,12,10,4,9,22,"2-7","Y","Y","Y",5,0,8
"1992","D1",2023-10-22,"FC Koln","Mgladbach",3,1,"H",1,0,"H",2.37,3.77,2.93,"1-0","3-1",21,8,5,2,0,2,0,1,8,3,13,10,4,11,23,"8-3","Y","Y","Y",2,1,8
"1993","D1",2023-10-22,"Heidenheim","Augsburg",2,5,"A",2,3,"A",2.42,3.69,2.91,"2-3","2-5",16,5,9,6,3,2,0,0,6,5,11,11,7,11,22,"6-5","Y","Y","Y",5,0,8
"1994","D1",2023-10-27,"Bochum","Mainz",2,2,"D",1,0,"H",2.78,3.57,2.57,"1-0","2-2",10,4,10,4,3,3,0,0,5,4,14,21,4,9,35,"5-4","Y","Y","Y",6,0,9
"1995","D1",2023-10-28,"Augsburg","Wolfsburg",3,2,"H",1,2,"A",2.91,3.67,2.4,"1-2","3-2",9,5,13,6,6,4,1,0,5,5,19,14,5,10,33,"5-5","Y","Y","Y",10,1,9
"1996","D1",2023-10-28,"Bayern Munich","Darmstadt",8,0,"H",0,0,"D",1.07,16.22,27.11,"0-0","8-0",28,16,10,4,1,2,1,2,7,1,15,13,8,8,28,"7-1","Y","Y","Y",3,3,9
"1997","D1",2023-10-28,"Mgladbach","Heidenheim",2,1,"H",1,1,"D",1.8,4.26,4.16,"1-1","2-1",11,6,8,3,0,3,0,0,6,4,5,18,3,10,23,"6-4","Y","Y","N",3,0,9
"1998","D1",2023-10-28,"Stuttgart","Hoffenheim",2,3,"A",0,2,"A",1.88,4.15,3.82,"0-2","2-3",23,10,7,5,2,1,0,0,6,0,13,11,5,6,24,"6-0","Y","Y","Y",3,0,9
"1999","D1",2023-10-28,"Werder Bremen","Union Berlin",2,0,"H",1,0,"H",2.73,3.61,2.6,"1-0","2-0",9,3,7,2,1,4,0,1,3,3,12,14,2,6,26,"3-3","Y","N","N",5,1,9
"2000","D1",2023-10-28,"RB Leipzig","FC Koln",6,0,"H",4,0,"H",1.44,5.05,7.18,"4-0","6-0",24,13,6,1,2,4,0,1,11,1,8,13,6,12,21,"11-1","Y","Y","Y",6,1,9
"2001","D1",2023-10-29,"Ein Frankfurt","Dortmund",3,3,"D",2,1,"H",3.31,3.73,2.18,"2-1","3-3",11,7,14,4,3,2,0,0,0,4,11,10,6,4,21,"0-4","Y","Y","Y",5,0,9
"2002","D1",2023-10-29,"Leverkusen","Freiburg",2,1,"H",1,0,"H",1.29,6.08,10.27,"1-0","2-1",19,4,10,4,0,2,0,0,11,4,9,10,3,15,19,"11-4","Y","Y","N",2,0,9
"2003","D1",2023-11-03,"Darmstadt","Bochum",1,2,"A",1,1,"D",2.41,3.61,2.98,"1-1","1-2",15,4,9,4,2,5,1,0,11,2,7,16,3,13,23,"11-2","Y","Y","N",7,1,10
"2004","D1",2023-11-04,"FC Koln","Augsburg",1,1,"D",1,1,"D",2.32,3.75,2.97,"1-1","1-1",28,12,18,3,1,4,0,0,10,2,10,10,2,12,20,"10-2","Y","N","N",5,0,10
"2005","D1",2023-11-04,"Freiburg","Mgladbach",3,3,"D",1,3,"A",2.08,4,3.31,"1-3","3-3",15,8,10,5,2,2,0,0,8,2,7,10,6,10,17,"8-2","Y","Y","Y",4,0,10
"2006","D1",2023-11-04,"Hoffenheim","Leverkusen",2,3,"A",0,2,"A",4.92,4.9,1.59,"0-2","2-3",12,7,10,4,3,2,0,0,4,3,6,10,5,7,16,"4-3","Y","Y","Y",5,0,10
"2007","D1",2023-11-04,"Mainz","RB Leipzig",2,0,"H",0,0,"D",5.42,4.56,1.58,"0-0","2-0",10,3,10,2,3,1,0,0,2,7,13,9,2,9,22,"2-7","Y","N","N",4,0,10
"2008","D1",2023-11-04,"Union Berlin","Ein Frankfurt",0,3,"A",0,2,"A",2.57,3.21,3.01,"0-2","0-3",10,3,4,3,0,1,0,0,9,1,13,8,3,10,21,"9-1","Y","Y","N",1,0,10
"2009","D1",2023-11-04,"Dortmund","Bayern Munich",0,4,"A",0,2,"A",3.77,4.42,1.84,"0-2","0-4",15,1,14,8,3,2,0,0,3,2,14,6,4,5,20,"3-2","Y","Y","Y",5,0,10
"2010","D1",2023-11-05,"Wolfsburg","Werder Bremen",2,2,"D",1,1,"D",1.74,4.29,4.37,"1-1","2-2",15,5,13,4,4,1,1,0,5,2,14,17,4,7,31,"5-2","Y","Y","Y",5,1,10
"2011","D1",2023-11-05,"Heidenheim","Stuttgart",2,0,"H",0,0,"D",4.59,4.39,1.69,"0-0","2-0",19,2,14,2,2,2,0,0,9,6,7,13,2,15,20,"9-6","Y","N","N",4,0,10
"2012","D1",2023-11-10,"Mgladbach","Wolfsburg",4,0,"H",2,0,"H",2.41,3.75,2.89,"2-0","4-0",16,8,12,4,1,3,0,0,8,5,7,12,4,13,19,"8-5","Y","Y","Y",4,0,11
"2013","D1",2023-11-11,"Augsburg","Hoffenheim",1,1,"D",0,1,"A",2.62,3.92,2.52,"0-1","1-1",11,6,12,6,1,2,0,0,3,5,9,11,2,8,20,"3-5","Y","N","N",3,0,11
"2014","D1",2023-11-11,"Bayern Munich","Heidenheim",4,2,"H",2,0,"H",1.06,18.13,28.2,"2-0","4-2",18,8,7,2,1,0,0,0,7,2,8,8,6,9,16,"7-2","Y","Y","Y",1,0,11
"2015","D1",2023-11-11,"Darmstadt","Mainz",0,0,"D",0,0,"D",3.04,3.72,2.3,"0-0","0-0",9,3,9,0,3,3,0,0,0,5,20,15,0,5,35,"0-5","N","N","N",6,0,11
"2016","D1",2023-11-11,"Stuttgart","Dortmund",2,1,"H",1,1,"D",2.61,3.85,2.56,"1-1","2-1",22,10,5,1,2,3,0,0,6,1,13,16,3,7,29,"6-1","Y","Y","N",5,0,11
"2017","D1",2023-11-11,"Bochum","FC Koln",1,1,"D",1,0,"H",2.46,3.7,2.81,"1-0","1-1",25,9,10,6,4,1,0,0,3,3,14,19,2,6,33,"3-3","Y","N","N",5,0,11
"2018","D1",2023-11-12,"Leverkusen","Union Berlin",4,0,"H",1,0,"H",1.29,6.09,10.4,"1-0","4-0",19,10,2,2,0,1,0,0,10,1,8,5,4,11,13,"10-1","Y","Y","Y",1,0,11
"2019","D1",2023-11-12,"Werder Bremen","Ein Frankfurt",2,2,"D",1,0,"H",3.01,3.6,2.36,"1-0","2-2",14,5,14,3,1,3,0,0,3,7,3,10,4,10,13,"3-7","Y","Y","Y",4,0,11
"2020","D1",2023-11-12,"RB Leipzig","Freiburg",3,1,"H",1,1,"D",1.46,4.96,6.59,"1-1","3-1",15,6,9,3,2,0,0,0,7,3,10,12,4,10,22,"7-3","Y","Y","Y",2,0,11
"2021","D1",2023-11-24,"FC Koln","Bayern Munich",0,1,"A",0,1,"A",10.64,6.78,1.25,"0-1","0-1",6,2,19,5,0,1,0,0,3,12,6,4,1,15,10,"3-12","N","N","N",1,0,12
"2022","D1",2023-11-25,"Dortmund","Mgladbach",4,2,"H",3,2,"H",1.48,5.38,5.62,"3-2","4-2",20,13,10,3,1,2,0,0,5,4,11,11,6,9,22,"5-4","Y","Y","Y",3,0,12
"2023","D1",2023-11-25,"Freiburg","Darmstadt",1,1,"D",1,1,"D",1.57,4.42,5.65,"1-1","1-1",16,3,7,1,2,0,0,0,11,2,15,15,2,13,30,"11-2","Y","N","N",2,0,12
"2024","D1",2023-11-25,"Union Berlin","Augsburg",1,1,"D",0,1,"A",2.01,3.65,3.79,"0-1","1-1",16,6,11,2,2,2,0,0,3,4,10,15,2,7,25,"3-4","Y","N","N",4,0,12
"2025","D1",2023-11-25,"Werder Bremen","Leverkusen",0,3,"A",0,2,"A",6.3,5.25,1.45,"0-2","0-3",2,1,13,4,3,1,0,0,1,6,15,4,3,7,19,"1-6","Y","Y","N",4,0,12
"2026","D1",2023-11-25,"Wolfsburg","RB Leipzig",2,1,"H",1,0,"H",3.79,3.97,1.93,"1-0","2-1",10,4,26,10,4,2,0,0,1,12,18,11,3,13,29,"1-12","Y","Y","N",6,0,12
"2027","D1",2023-11-25,"Ein Frankfurt","Stuttgart",1,2,"A",1,2,"A",2.65,3.7,2.6,"1-2","1-2",14,1,11,5,0,1,0,0,4,2,14,8,3,6,22,"4-2","Y","Y","N",1,0,12
"2028","D1",2023-11-26,"Heidenheim","Bochum",0,0,"D",0,0,"D",2.23,3.81,3.09,"0-0","0-0",9,3,9,2,4,3,0,0,6,5,14,7,0,11,21,"6-5","N","N","N",7,0,12
"2029","D1",2023-11-26,"Hoffenheim","Mainz",1,1,"D",0,1,"A",1.85,4.08,4.01,"0-1","1-1",15,6,15,6,4,4,0,0,4,5,9,14,2,9,23,"4-5","Y","N","N",8,0,12
"2030","D1",2023-12-01,"Darmstadt","FC Koln",0,1,"A",0,0,"D",2.66,3.54,2.71,"0-0","0-1",11,1,11,6,1,3,0,0,1,6,12,12,1,7,24,"1-6","N","N","N",4,0,13
"2031","D1",2023-12-02,"Bochum","Wolfsburg",3,1,"H",2,1,"H",2.67,3.6,2.62,"2-1","3-1",19,9,15,6,6,2,0,0,6,6,14,13,4,12,27,"6-6","Y","Y","Y",8,0,13
"2032","D1",2023-12-02,"Mgladbach","Hoffenheim",2,1,"H",0,0,"D",2.26,4.13,2.87,"0-0","2-1",9,3,17,5,2,2,0,0,6,3,12,14,3,9,26,"6-3","Y","Y","N",4,0,13
"2033","D1",2023-12-02,"RB Leipzig","Heidenheim",2,1,"H",2,1,"H",1.24,7.2,10.19,"2-1","2-1",23,8,7,1,2,2,0,0,5,3,13,16,3,8,29,"5-3","Y","Y","N",4,0,13
"2034","D1",2023-12-02,"Stuttgart","Werder Bremen",2,0,"H",1,0,"H",1.4,5.24,7.66,"1-0","2-0",17,6,11,3,1,0,0,0,6,7,7,9,2,13,16,"6-7","Y","N","N",1,0,13
"2035","D1",2023-12-03,"Mainz","Freiburg",0,1,"A",0,0,"D",2.29,3.56,3.16,"0-0","0-1",19,6,13,5,1,1,0,0,14,3,16,11,1,17,27,"14-3","N","N","N",2,0,13
"2036","D1",2023-12-03,"Leverkusen","Dortmund",1,1,"D",0,1,"A",1.68,4.46,4.59,"0-1","1-1",22,6,6,2,3,2,0,0,16,1,12,12,2,17,24,"16-1","Y","N","N",5,0,13
"2037","D1",2023-12-03,"Augsburg","Ein Frankfurt",2,1,"H",1,0,"H",2.69,3.6,2.61,"1-0","2-1",9,4,12,6,1,1,0,0,2,4,9,10,3,6,19,"2-4","Y","Y","N",2,0,13
"2038","D1",2023-12-08,"Hoffenheim","Bochum",3,1,"H",2,0,"H",1.73,4.32,4.52,"2-0","3-1",18,7,22,5,3,2,0,0,4,5,18,11,4,9,29,"4-5","Y","Y","Y",5,0,13
"2039","D1",2023-12-09,"Ein Frankfurt","Bayern Munich",5,1,"H",3,1,"H",8.96,6.05,1.31,"3-1","5-1",14,6,17,6,1,2,0,0,1,9,8,7,6,10,15,"1-9","Y","Y","Y",3,0,14
"2040","D1",2023-12-09,"Heidenheim","Darmstadt",3,2,"H",1,0,"H",2.07,3.73,3.53,"1-0","3-2",16,7,20,7,2,2,0,0,8,3,17,13,5,11,30,"8-3","Y","Y","Y",4,0,14
"2041","D1",2023-12-09,"Union Berlin","Mgladbach",3,1,"H",1,0,"H",2.18,3.68,3.29,"1-0","3-1",16,6,13,4,1,3,0,0,6,7,9,8,4,13,17,"6-7","Y","Y","Y",4,0,14
"2042","D1",2023-12-09,"Werder Bremen","Augsburg",2,0,"H",1,0,"H",2.45,3.71,2.81,"1-0","2-0",12,5,11,1,1,2,0,0,5,2,13,9,2,7,22,"5-2","Y","N","N",3,0,14
"2043","D1",2023-12-09,"Wolfsburg","Freiburg",0,1,"A",0,0,"D",2.29,3.78,3,"0-0","0-1",10,3,4,1,1,4,0,0,5,3,11,16,1,8,27,"5-3","N","N","N",5,0,14
"2044","D1",2023-12-09,"Dortmund","RB Leipzig",2,3,"A",1,1,"D",2.59,3.87,2.57,"1-1","2-3",18,6,24,8,1,3,1,0,6,6,6,11,5,12,17,"6-6","Y","Y","Y",4,1,14
"2045","D1",2023-12-10,"Stuttgart","Leverkusen",1,1,"D",1,0,"H",2.84,3.82,2.38,"1-0","1-1",22,12,20,6,1,1,0,0,8,8,8,7,2,16,15,"8-8","Y","N","N",2,0,14
"2046","D1",2023-12-10,"FC Koln","Mainz",0,0,"D",0,0,"D",2.48,3.44,2.95,"0-0","0-0",7,3,13,5,2,4,0,0,1,7,10,10,0,8,20,"1-7","N","N","N",6,0,14
"2047","D1",2023-12-15,"Mgladbach","Werder Bremen",2,2,"D",1,1,"D",2.01,4.02,3.54,"1-1","2-2",15,4,10,5,4,2,0,0,4,3,10,12,4,7,22,"4-3","Y","Y","Y",6,0,14
"2048","D1",2023-12-16,"Augsburg","Dortmund",1,1,"D",1,1,"D",3.64,4.24,1.91,"1-1","1-1",20,4,24,6,2,1,0,0,4,7,13,4,2,11,17,"4-7","Y","N","N",3,0,15
"2049","D1",2023-12-16,"Bochum","Union Berlin",3,0,"H",1,0,"H",2.68,3.48,2.68,"1-0","3-0",21,7,10,2,2,2,0,0,6,4,12,13,3,10,25,"6-4","Y","Y","N",4,0,15
"2050","D1",2023-12-16,"Darmstadt","Wolfsburg",0,1,"A",0,0,"D",3.29,3.61,2.21,"0-0","0-1",14,4,11,3,2,0,0,1,7,7,16,10,1,14,26,"7-7","N","N","N",2,1,15
"2051","D1",2023-12-16,"Mainz","Heidenheim",0,1,"A",0,1,"A",1.67,4.23,4.93,"0-1","0-1",16,4,5,2,3,3,0,0,8,1,9,20,1,9,29,"8-1","N","N","N",6,0,15
"2052","D1",2023-12-16,"RB Leipzig","Hoffenheim",3,1,"H",1,1,"D",1.45,5.3,6.22,"1-1","3-1",23,11,10,4,3,2,0,0,9,2,11,9,4,11,20,"9-2","Y","Y","Y",5,0,15
"2053","D1",2023-12-17,"Freiburg","FC Koln",2,0,"H",0,0,"D",1.82,3.75,4.57,"0-0","2-0",23,7,7,1,1,4,0,1,5,2,13,10,2,7,23,"5-2","Y","N","N",5,1,15
"2054","D1",2023-12-17,"Leverkusen","Ein Frankfurt",3,0,"H",1,0,"H",1.36,5.67,7.93,"1-0","3-0",14,6,4,2,1,1,0,0,5,5,4,13,3,10,17,"5-5","Y","Y","N",2,0,15
"2055","D1",2023-12-17,"Bayern Munich","Stuttgart",3,0,"H",1,0,"H",1.44,5.56,6.06,"1-0","3-0",17,8,5,2,0,3,0,0,6,2,7,8,3,8,15,"6-2","Y","Y","N",3,0,15
"2056","D1",2023-12-19,"Werder Bremen","RB Leipzig",1,1,"D",0,0,"D",5.13,4.76,1.6,"0-0","1-1",11,3,18,9,4,2,0,0,1,4,15,9,2,5,24,"1-4","Y","N","N",6,0,15
"2057","D1",2023-12-19,"Dortmund","Mainz",1,1,"D",1,1,"D",1.57,4.84,5.33,"1-1","1-1",21,8,11,6,0,4,0,0,6,1,11,14,2,7,25,"6-1","Y","N","N",4,0,16
"2058","D1",2023-12-19,"Hoffenheim","Darmstadt",3,3,"D",2,1,"H",1.45,5.14,6.78,"2-1","3-3",13,4,14,3,2,4,0,0,8,3,9,15,6,11,24,"8-3","Y","Y","Y",6,0,16
"2059","D1",2023-12-20,"Union Berlin","FC Koln",2,0,"H",0,0,"D",1.95,3.59,4.09,"0-0","2-0",12,8,15,7,0,0,0,0,4,5,10,7,2,9,17,"4-5","Y","N","N",0,0,16
"2060","D1",2023-12-20,"Ein Frankfurt","Mgladbach",2,1,"H",0,1,"A",1.88,3.98,4,"0-1","2-1",15,7,7,2,1,6,0,1,8,2,11,14,3,10,25,"8-2","Y","Y","N",7,1,16
"2061","D1",2023-12-20,"Heidenheim","Freiburg",3,2,"H",0,1,"A",2.9,3.58,2.44,"0-1","3-2",14,3,10,4,3,4,0,0,7,4,20,12,5,11,32,"7-4","Y","Y","Y",7,0,16
"2062","D1",2023-12-20,"Leverkusen","Bochum",4,0,"H",3,0,"H",1.18,8.42,13.23,"3-0","4-0",15,8,6,1,0,2,0,0,4,3,7,12,4,7,19,"4-3","Y","Y","Y",2,0,16
"2063","D1",2023-12-20,"Stuttgart","Augsburg",3,0,"H",2,0,"H",1.37,5.46,7.98,"2-0","3-0",17,7,6,5,0,4,0,0,4,4,8,14,3,8,22,"4-4","Y","Y","N",4,0,16
"2064","D1",2023-12-20,"Wolfsburg","Bayern Munich",1,2,"A",1,2,"A",7.64,5.7,1.37,"1-2","1-2",5,4,20,7,4,2,0,0,0,6,14,12,3,6,26,"0-6","Y","Y","N",6,0,16
"2065","D1",2024-01-12,"Bayern Munich","Hoffenheim",3,0,"H",1,0,"H",1.15,9.94,16.13,"1-0","3-0",27,12,12,4,1,3,0,1,11,2,8,6,3,13,14,"11-2","Y","Y","N",4,1,16
"2066","D1",2024-01-13,"Augsburg","Leverkusen",0,1,"A",0,0,"D",5.74,4.65,1.54,"0-0","0-1",2,0,25,6,3,1,0,0,0,12,11,4,1,12,15,"0-12","N","N","N",4,0,17
"2067","D1",2024-01-13,"FC Koln","Heidenheim",1,1,"D",1,0,"H",2.1,3.67,3.51,"1-0","1-1",13,6,10,2,2,1,0,0,9,6,12,11,2,15,23,"9-6","Y","N","N",3,0,17
"2068","D1",2024-01-13,"Freiburg","Union Berlin",0,0,"D",0,0,"D",2.1,3.62,3.54,"0-0","0-0",14,4,8,4,0,2,0,0,4,3,7,9,0,7,16,"4-3","N","N","N",2,0,17
"2069","D1",2024-01-13,"Mainz","Wolfsburg",1,1,"D",0,1,"A",2.25,3.47,3.33,"0-1","1-1",12,4,9,4,3,4,0,0,7,3,21,16,2,10,37,"7-3","Y","N","N",7,0,17
"2070","D1",2024-01-13,"RB Leipzig","Ein Frankfurt",0,1,"A",0,1,"A",1.45,4.99,6.78,"0-1","0-1",26,7,5,1,0,2,0,0,15,4,7,16,1,19,23,"15-4","N","N","N",2,0,17
"2071","D1",2024-01-13,"Darmstadt","Dortmund",0,3,"A",0,1,"A",5.5,4.91,1.53,"0-1","0-3",10,2,17,8,1,3,0,0,3,4,10,13,3,7,23,"3-4","Y","Y","N",4,0,17
"2072","D1",2024-01-14,"Bochum","Werder Bremen",1,1,"D",0,0,"D",2.21,3.78,3.16,"0-0","1-1",13,4,15,4,6,5,0,0,3,4,14,14,2,7,28,"3-4","Y","N","N",11,0,17
"2073","D1",2024-01-14,"Mgladbach","Stuttgart",3,1,"H",2,0,"H",3.67,4.14,1.92,"2-0","3-1",8,4,14,2,3,3,0,0,0,3,7,11,4,3,18,"0-3","Y","Y","Y",6,0,17
"2074","D2",2023-07-28,"Hamburg","Schalke 04",5,3,"H",1,2,"A",2.43,3.81,2.83,"1-2","5-3",31,14,11,6,3,3,0,1,9,3,10,13,8,12,23,"9-3","Y","Y","Y",6,1,1
"2075","D2",2023-07-29,"Hannover","Elversberg",2,2,"D",1,2,"A",2.12,3.88,3.34,"1-2","2-2",10,4,23,9,3,4,0,0,3,6,5,18,4,9,23,"3-6","Y","Y","Y",7,0,1
"2076","D2",2023-07-29,"Kaiserslautern","St Pauli",1,2,"A",0,0,"D",3.19,3.5,2.33,"0-0","1-2",10,3,14,5,2,1,0,0,3,5,11,10,3,8,21,"3-5","Y","Y","N",3,0,1
"2077","D2",2023-07-29,"Osnabruck","Karlsruhe",2,3,"A",1,2,"A",2.94,3.75,2.38,"1-2","2-3",18,7,14,8,3,2,1,0,4,9,11,9,5,13,20,"4-9","Y","Y","Y",5,1,1
"2078","D2",2023-07-29,"Wehen","Magdeburg",1,1,"D",0,1,"A",2.91,3.8,2.37,"0-1","1-1",9,1,11,3,2,3,1,0,3,2,10,18,2,5,28,"3-2","Y","N","N",5,1,1
"2079","D2",2023-07-29,"Fortuna Dusseldorf","Hertha",1,0,"H",0,0,"D",2.32,3.59,3.13,"0-0","1-0",9,2,12,4,3,2,0,0,7,8,13,11,1,15,24,"7-8","N","N","N",5,0,1
"2080","D2",2023-07-30,"Braunschweig","Holstein Kiel",0,1,"A",0,0,"D",2.66,3.83,2.56,"0-0","0-1",9,2,15,4,3,1,1,0,4,10,10,13,1,14,23,"4-10","N","N","N",4,1,1
"2081","D2",2023-07-30,"Greuther Furth","Paderborn",5,0,"H",3,0,"H",2.46,3.71,2.85,"3-0","5-0",24,11,7,0,1,1,0,1,5,2,9,5,5,7,14,"5-2","Y","Y","Y",2,1,1
"2082","D2",2023-07-30,"Hansa Rostock","Nurnberg",2,0,"H",1,0,"H",2.62,3.23,2.97,"1-0","2-0",14,4,18,7,3,4,0,0,6,6,15,13,2,12,28,"6-6","Y","N","N",7,0,1
"2083","D2",2023-08-04,"Hertha","Wehen",0,1,"A",0,0,"D",1.57,4.43,5.89,"0-0","0-1",21,8,12,5,2,3,0,0,6,4,9,9,1,10,18,"6-4","N","N","N",5,0,2
"2084","D2",2023-08-04,"Paderborn","Osnabruck",1,1,"D",0,0,"D",1.6,4.38,5.68,"0-0","1-1",15,5,15,5,1,0,0,0,7,7,11,12,2,14,23,"7-7","Y","N","N",1,0,2
"2085","D2",2023-08-05,"Elversberg","Hansa Rostock",1,2,"A",0,0,"D",2.15,3.72,3.4,"0-0","1-2",13,4,17,5,3,4,0,0,7,2,12,15,3,9,27,"7-2","Y","Y","N",7,0,2
"2086","D2",2023-08-05,"Holstein Kiel","Greuther Furth",2,1,"H",0,0,"D",2.47,3.85,2.75,"0-0","2-1",9,4,15,2,2,2,0,0,8,5,14,16,3,13,30,"8-5","Y","Y","N",4,0,2
"2087","D2",2023-08-05,"St Pauli","Fortuna Dusseldorf",0,0,"D",0,0,"D",1.97,3.73,3.96,"0-0","0-0",13,5,10,3,2,1,1,0,4,8,11,8,0,12,19,"4-8","N","N","N",3,1,2
"2088","D2",2023-08-05,"Schalke 04","Kaiserslautern",3,0,"H",1,0,"H",1.69,4.07,5.12,"1-0","3-0",16,8,10,4,1,3,0,2,8,7,14,12,3,15,26,"8-7","Y","Y","N",4,2,2
"2089","D2",2023-08-06,"Karlsruhe","Hamburg",2,2,"D",1,0,"H",2.87,4.16,2.28,"1-0","2-2",17,4,13,7,3,2,0,0,7,3,6,14,4,10,20,"7-3","Y","Y","Y",5,0,2
"2090","D2",2023-08-06,"Magdeburg","Braunschweig",2,1,"H",2,0,"H",1.81,4.06,4.35,"2-0","2-1",14,5,9,4,1,3,0,0,1,5,7,20,3,6,27,"1-5","Y","Y","N",4,0,2
"2091","D2",2023-08-06,"Nurnberg","Hannover",2,2,"D",0,2,"A",2.39,3.64,2.99,"0-2","2-2",8,3,19,6,6,2,0,0,5,7,20,14,4,12,34,"5-7","Y","Y","Y",8,0,2
"2092","D2",2023-08-18,"Kaiserslautern","Elversberg",3,2,"H",1,0,"H",2.32,3.65,3.09,"1-0","3-2",20,8,21,9,3,1,0,0,4,6,11,12,5,10,23,"4-6","Y","Y","Y",4,0,3
"2093","D2",2023-08-18,"Wehen","Karlsruhe",1,0,"H",1,0,"H",3.07,3.82,2.27,"1-0","1-0",11,4,15,7,3,1,0,0,2,7,14,2,1,9,16,"2-7","N","N","N",4,0,3
"2094","D2",2023-08-19,"Fortuna Dusseldorf","Paderborn",1,2,"A",0,1,"A",2.11,3.94,3.32,"0-1","1-2",26,6,10,6,0,3,0,0,12,1,6,20,3,13,26,"12-1","Y","Y","N",3,0,3
"2095","D2",2023-08-19,"Greuther Furth","St Pauli",0,0,"D",0,0,"D",2.66,3.59,2.68,"0-0","0-0",16,2,6,1,1,5,0,0,2,1,11,17,0,3,28,"2-1","N","N","N",6,0,3
"2096","D2",2023-08-19,"Hansa Rostock","Hannover",1,2,"A",0,1,"A",2.63,3.63,2.69,"0-1","1-2",10,2,8,2,3,1,0,0,4,5,13,11,3,9,24,"4-5","Y","Y","N",4,0,3
"2097","D2",2023-08-19,"Hamburg","Hertha",3,0,"H",2,0,"H",1.9,4.17,3.79,"2-0","3-0",27,7,11,2,2,2,0,0,4,2,10,7,3,6,17,"4-2","Y","Y","N",4,0,3
"2098","D2",2023-08-20,"Braunschweig","Schalke 04",1,0,"H",1,0,"H",3.61,3.87,2.03,"1-0","1-0",17,6,11,3,3,0,1,0,6,4,15,12,1,10,27,"6-4","N","N","N",3,1,3
"2099","D2",2023-08-20,"Holstein Kiel","Magdeburg",2,4,"A",1,2,"A",2.45,3.82,2.8,"1-2","2-4",17,8,18,10,1,2,0,0,6,3,23,12,6,9,35,"6-3","Y","Y","Y",3,0,3
"2100","D2",2023-08-20,"Osnabruck","Nurnberg",2,3,"A",0,1,"A",2.6,3.4,2.86,"0-1","2-3",15,3,20,7,2,2,0,0,3,12,13,8,5,15,21,"3-12","Y","Y","Y",4,0,3
"2101","D2",2023-08-25,"Paderborn","Kaiserslautern",1,2,"A",0,0,"D",2.21,3.84,3.17,"0-0","1-2",15,5,12,3,2,5,0,0,1,2,17,12,3,3,29,"1-2","Y","Y","N",7,0,4
"2102","D2",2023-08-25,"Schalke 04","Holstein Kiel",0,2,"A",0,1,"A",1.95,4.19,3.61,"0-1","0-2",13,4,14,5,1,1,1,0,3,7,11,13,2,10,24,"3-7","Y","N","N",2,1,4
"2103","D2",2023-08-26,"Elversberg","Fortuna Dusseldorf",0,5,"A",0,3,"A",2.86,3.87,2.38,"0-3","0-5",13,4,15,8,1,3,0,0,8,6,6,9,5,14,15,"8-6","Y","Y","Y",4,0,4
"2104","D2",2023-08-26,"Hansa Rostock","Osnabruck",2,1,"H",1,1,"D",2.12,3.7,3.49,"1-1","2-1",12,5,13,3,3,0,0,0,4,5,17,10,3,9,27,"4-5","Y","Y","N",3,0,4
"2105","D2",2023-08-26,"Hertha","Greuther Furth",5,0,"H",2,0,"H",2.55,3.71,2.73,"2-0","5-0",14,7,17,6,1,1,0,0,5,8,18,9,5,13,27,"5-8","Y","Y","Y",2,0,4
"2106","D2",2023-08-26,"Hannover","Hamburg",0,1,"A",0,0,"D",3.42,4.12,2.03,"0-0","0-1",19,5,11,4,1,4,0,1,3,3,13,13,1,6,26,"3-3","N","N","N",5,1,4
"2107","D2",2023-08-27,"Karlsruhe","Braunschweig",2,0,"H",1,0,"H",1.76,4.3,4.36,"1-0","2-0",22,9,9,0,1,1,0,1,6,4,11,4,2,10,15,"6-4","Y","N","N",2,1,4
"2108","D2",2023-08-27,"Nurnberg","Wehen",2,1,"H",0,0,"D",2.09,3.68,3.59,"0-0","2-1",13,4,15,2,2,6,1,2,10,6,12,17,3,16,29,"10-6","Y","Y","N",8,3,4
"2109","D2",2023-08-27,"St Pauli","Magdeburg",0,0,"D",0,0,"D",1.96,3.96,3.76,"0-0","0-0",26,12,5,2,2,3,0,0,11,3,9,9,0,14,18,"11-3","N","N","N",5,0,4
"2110","D2",2023-09-01,"Braunschweig","St Pauli",1,1,"D",0,0,"D",4.04,3.76,1.94,"0-0","1-1",9,1,19,5,2,3,0,0,3,5,11,11,2,8,22,"3-5","Y","N","N",5,0,5
"2111","D2",2023-09-01,"Fortuna Dusseldorf","Karlsruhe",3,1,"H",1,1,"D",2.25,3.89,3.06,"1-1","3-1",19,5,10,8,1,3,0,0,7,7,8,10,4,14,18,"7-7","Y","Y","Y",4,0,5
"2112","D2",2023-09-02,"Holstein Kiel","Paderborn",2,1,"H",1,1,"D",2.32,4.18,2.8,"1-1","2-1",19,6,13,2,3,3,0,0,6,8,9,9,3,14,18,"6-8","Y","Y","N",6,0,5
"2113","D2",2023-09-02,"Magdeburg","Hertha",6,4,"H",2,3,"A",2.31,4,2.9,"2-3","6-4",23,12,12,7,2,3,0,0,4,3,6,9,10,7,15,"4-3","Y","Y","Y",5,0,5
"2114","D2",2023-09-02,"Wehen","Schalke 04",1,1,"D",0,0,"D",3.32,3.88,2.13,"0-0","1-1",14,3,15,5,4,2,0,0,3,7,17,10,2,10,27,"3-7","Y","N","N",6,0,5
"2115","D2",2023-09-02,"Kaiserslautern","Nurnberg",3,1,"H",3,1,"H",2.24,3.73,3.19,"3-1","3-1",12,4,18,4,1,2,0,1,4,7,12,14,4,11,26,"4-7","Y","Y","Y",3,1,5
"2116","D2",2023-09-03,"Greuther Furth","Hannover",1,3,"A",0,2,"A",2.04,4.12,3.38,"0-2","1-3",19,5,6,5,1,2,0,0,9,2,11,11,4,11,22,"9-2","Y","Y","Y",3,0,5
"2117","D2",2023-09-03,"Hamburg","Hansa Rostock",2,0,"H",1,0,"H",1.52,4.94,5.86,"1-0","2-0",17,11,7,3,2,5,0,0,3,5,14,15,2,8,29,"3-5","Y","N","N",7,0,5
"2118","D2",2023-09-03,"Osnabruck","Elversberg",0,1,"A",0,0,"D",2.44,3.98,2.73,"0-0","0-1",9,4,10,2,1,2,0,0,6,2,16,13,1,8,29,"6-2","N","N","N",3,0,5
"2119","D2",2023-09-15,"Nurnberg","Greuther Furth",1,1,"D",1,1,"D",2.7,3.62,2.62,"1-1","1-1",18,4,9,2,2,3,0,0,6,5,14,17,2,11,31,"6-5","Y","N","N",5,0,6
"2120","D2",2023-09-15,"Paderborn","Wehen",2,1,"H",0,1,"A",1.77,4.21,4.39,"0-1","2-1",17,7,12,5,3,2,0,0,5,1,14,12,3,6,26,"5-1","Y","Y","N",5,0,6
"2121","D2",2023-09-16,"Elversberg","Hamburg",2,1,"H",1,0,"H",4.2,4.49,1.76,"1-0","2-1",16,7,13,6,3,2,0,0,7,6,12,9,3,13,21,"7-6","Y","Y","N",5,0,6
"2122","D2",2023-09-16,"Hansa Rostock","Fortuna Dusseldorf",1,3,"A",1,2,"A",3.36,3.51,2.25,"1-2","1-3",23,4,20,5,2,2,0,0,10,8,11,9,4,18,20,"10-8","Y","Y","Y",4,0,6
"2123","D2",2023-09-16,"Karlsruhe","Kaiserslautern",1,1,"D",1,1,"D",2.08,3.8,3.51,"1-1","1-1",19,6,14,7,0,1,0,0,9,3,10,14,2,12,24,"9-3","Y","N","N",1,0,6
"2124","D2",2023-09-16,"Schalke 04","Magdeburg",4,3,"H",1,2,"A",2.21,3.95,3.1,"1-2","4-3",19,9,12,6,4,4,0,1,9,4,22,12,7,13,34,"9-4","Y","Y","Y",8,1,6
"2125","D2",2023-09-17,"Hannover","Osnabruck",7,0,"H",2,0,"H",1.88,4.02,4.03,"2-0","7-0",24,15,6,3,0,2,0,1,5,3,13,9,7,8,22,"5-3","Y","Y","Y",2,1,6
"2126","D2",2023-09-17,"Hertha","Braunschweig",3,0,"H",2,0,"H",1.63,4.45,5.15,"2-0","3-0",15,8,14,4,2,0,0,0,4,9,11,11,3,13,22,"4-9","Y","Y","N",2,0,6
"2127","D2",2023-09-17,"St Pauli","Holstein Kiel",5,1,"H",3,0,"H",1.89,3.91,4.08,"3-0","5-1",18,7,13,4,3,3,0,0,3,1,13,16,6,4,29,"3-1","Y","Y","Y",6,0,6
"2128","D2",2023-09-22,"Magdeburg","Paderborn",1,1,"D",0,1,"A",2.21,4.05,3.04,"0-1","1-1",11,3,14,4,4,1,0,0,2,6,14,12,2,8,26,"2-6","Y","N","N",5,0,7
"2129","D2",2023-09-22,"Osnabruck","Hamburg",2,1,"H",2,1,"H",4.5,4.74,1.67,"2-1","2-1",18,9,8,3,5,6,0,0,13,7,10,15,3,20,25,"13-7","Y","Y","N",11,0,7
"2130","D2",2023-09-23,"Braunschweig","Nurnberg",2,2,"D",1,2,"A",2.94,3.68,2.41,"1-2","2-2",14,5,11,5,2,2,0,0,2,3,17,15,4,5,32,"2-3","Y","Y","Y",4,0,7
"2131","D2",2023-09-23,"Greuther Furth","Karlsruhe",4,3,"H",3,3,"D",2.27,3.89,3.03,"3-3","4-3",9,6,17,5,3,5,1,0,9,4,10,12,7,13,22,"9-4","Y","Y","Y",8,1,7
"2132","D2",2023-09-23,"Wehen","Elversberg",0,2,"A",0,1,"A",2.67,3.82,2.55,"0-1","0-2",16,3,13,5,4,4,0,0,7,3,13,17,2,10,30,"7-3","Y","N","N",8,0,7
"2133","D2",2023-09-23,"St Pauli","Schalke 04",3,1,"H",1,1,"D",1.89,3.73,4.28,"1-1","3-1",19,8,10,3,1,4,0,0,4,2,3,19,4,6,22,"4-2","Y","Y","Y",5,0,7
"2134","D2",2023-09-24,"Fortuna Dusseldorf","Hannover",1,1,"D",0,1,"A",1.93,4.12,3.7,"0-1","1-1",17,5,6,2,2,3,0,0,5,2,7,10,2,7,17,"5-2","Y","N","N",5,0,7
"2135","D2",2023-09-24,"Holstein Kiel","Hertha",2,3,"A",0,2,"A",2.75,3.68,2.55,"0-2","2-3",16,5,11,7,4,3,1,0,2,4,19,13,5,6,32,"2-4","Y","Y","Y",7,1,7
"2136","D2",2023-09-24,"Kaiserslautern","Hansa Rostock",3,1,"H",2,1,"H",2.11,3.39,3.83,"2-1","3-1",22,11,18,2,2,2,0,0,6,10,9,15,4,16,24,"6-10","Y","Y","Y",4,0,7
"2137","D2",2023-09-29,"Hamburg","Fortuna Dusseldorf",1,0,"H",0,0,"D",2.11,4.16,3.18,"0-0","1-0",10,4,8,2,3,6,0,1,8,3,10,14,1,11,24,"8-3","N","N","N",9,1,8
"2138","D2",2023-09-29,"Paderborn","Schalke 04",3,1,"H",1,0,"H",2.28,3.85,3.04,"1-0","3-1",11,6,13,2,1,3,0,0,2,10,10,9,4,12,19,"2-10","Y","Y","Y",4,0,8
"2139","D2",2023-09-30,"Hannover","Wehen",2,0,"H",1,0,"H",1.71,4.35,4.6,"1-0","2-0",17,5,12,3,0,2,0,0,4,6,13,15,2,10,28,"4-6","Y","N","N",2,0,8
"2140","D2",2023-09-30,"Hansa Rostock","Braunschweig",1,0,"H",0,0,"D",2.03,3.73,3.75,"0-0","1-0",19,6,20,0,3,1,0,0,7,5,20,10,1,12,30,"7-5","N","N","N",4,0,8
"2141","D2",2023-09-30,"Karlsruhe","Holstein Kiel",0,2,"A",0,2,"A",2.1,4.04,3.29,"0-2","0-2",14,4,12,5,0,4,0,0,7,9,4,16,2,16,20,"7-9","Y","N","N",4,0,8
"2142","D2",2023-09-30,"Hertha","St Pauli",1,2,"A",0,1,"A",2.71,3.68,2.59,"0-1","1-2",8,3,24,5,2,0,0,0,7,3,11,5,3,10,16,"7-3","Y","Y","N",2,0,8
"2143","D2",2023-10-01,"Elversberg","Greuther Furth",1,1,"D",1,1,"D",2.48,3.94,2.7,"1-1","1-1",11,4,15,5,1,1,0,0,2,8,13,19,2,10,32,"2-8","Y","N","N",2,0,8
"2144","D2",2023-10-01,"Nurnberg","Magdeburg",1,0,"H",0,0,"D",2.67,3.78,2.57,"0-0","1-0",16,6,13,1,6,5,0,0,7,3,14,21,1,10,35,"7-3","N","N","N",11,0,8
"2145","D2",2023-10-01,"Osnabruck","Kaiserslautern",2,2,"D",2,1,"H",2.77,3.67,2.54,"2-1","2-2",9,4,32,13,4,3,0,0,4,13,15,13,4,17,28,"4-13","Y","Y","Y",7,0,8
"2146","D2",2023-10-06,"Fortuna Dusseldorf","Osnabruck",1,1,"D",0,0,"D",1.59,4.64,5.36,"0-0","1-1",19,4,9,3,5,3,0,0,8,1,13,11,2,9,24,"8-1","Y","N","N",8,0,9
"2147","D2",2023-10-06,"Kaiserslautern","Hannover",3,1,"H",1,1,"D",2.34,3.62,3.08,"1-1","3-1",16,11,11,4,4,2,0,1,5,2,13,17,4,7,30,"5-2","Y","Y","Y",6,1,9
"2148","D2",2023-10-07,"Greuther Furth","Hansa Rostock",1,0,"H",1,0,"H",1.8,3.89,4.6,"1-0","1-0",9,4,8,2,1,7,0,0,8,2,11,16,1,10,27,"8-2","N","N","N",8,0,9
"2149","D2",2023-10-07,"Magdeburg","Karlsruhe",1,1,"D",0,1,"A",2.3,4.05,2.89,"0-1","1-1",19,5,2,2,3,2,0,0,7,1,4,12,2,8,16,"7-1","Y","N","N",5,0,9
"2150","D2",2023-10-07,"Wehen","Hamburg",1,1,"D",0,0,"D",4.61,4.6,1.68,"0-0","1-1",6,2,23,5,2,2,0,0,4,13,11,3,2,17,14,"4-13","Y","N","N",4,0,9
"2151","D2",2023-10-07,"St Pauli","Nurnberg",5,1,"H",1,1,"D",1.61,4.32,5.6,"1-1","5-1",20,7,7,3,4,1,0,0,8,4,7,11,6,12,18,"8-4","Y","Y","Y",5,0,9
"2152","D2",2023-10-08,"Braunschweig","Paderborn",1,3,"A",1,2,"A",3.13,3.86,2.22,"1-2","1-3",24,4,11,6,3,0,0,0,13,4,9,9,4,17,18,"13-4","Y","Y","Y",3,0,9
"2153","D2",2023-10-08,"Holstein Kiel","Elversberg",1,1,"D",1,0,"H",2.15,4.11,3.13,"1-0","1-1",23,7,9,4,1,1,0,0,11,2,13,16,2,13,29,"11-2","Y","N","N",2,0,9
"2154","D2",2023-10-08,"Schalke 04","Hertha",1,2,"A",0,1,"A",2.3,4.04,2.89,"0-1","1-2",16,6,16,4,2,3,1,0,11,5,15,14,3,16,29,"11-5","Y","Y","N",5,1,9
"2155","D2",2023-10-20,"Elversberg","Braunschweig",3,0,"H",2,0,"H",1.9,4.14,3.84,"2-0","3-0",13,7,7,4,0,1,0,0,6,1,12,9,3,7,21,"6-1","Y","Y","N",1,0,10
"2156","D2",2023-10-20,"Hannover","Magdeburg",2,1,"H",1,0,"H",2.16,3.95,3.21,"1-0","2-1",14,4,13,8,2,3,0,0,6,9,9,14,3,15,23,"6-9","Y","Y","N",5,0,10
"2157","D2",2023-10-21,"Hamburg","Greuther Furth",2,0,"H",2,0,"H",1.68,4.52,4.68,"2-0","2-0",17,4,14,3,2,4,0,0,6,7,12,12,2,13,24,"6-7","Y","N","N",6,0,10
"2158","D2",2023-10-21,"Osnabruck","Wehen",0,2,"A",0,1,"A",2.31,3.64,3.13,"0-1","0-2",19,5,14,5,3,1,0,0,2,3,14,17,2,5,31,"2-3","Y","N","N",4,0,10
"2159","D2",2023-10-21,"Paderborn","St Pauli",2,2,"D",1,0,"H",3.21,3.95,2.16,"1-0","2-2",6,3,17,3,0,1,0,0,3,6,7,11,4,9,18,"3-6","Y","Y","Y",1,0,10
"2160","D2",2023-10-21,"Fortuna Dusseldorf","Kaiserslautern",4,3,"H",1,3,"A",1.91,3.91,4,"1-3","4-3",20,5,16,8,4,1,0,0,6,5,12,8,7,11,20,"6-5","Y","Y","Y",5,0,10
"2161","D2",2023-10-22,"Hansa Rostock","Holstein Kiel",1,3,"A",1,1,"D",2.83,3.59,2.53,"1-1","1-3",22,9,10,5,1,4,0,1,9,2,13,14,4,11,27,"9-2","Y","Y","Y",5,1,10
"2162","D2",2023-10-22,"Karlsruhe","Schalke 04",3,0,"H",2,0,"H",2.4,3.79,2.88,"2-0","3-0",12,5,9,3,1,1,0,0,7,5,13,13,3,12,26,"7-5","Y","Y","N",2,0,10
"2163","D2",2023-10-22,"Nurnberg","Hertha",3,1,"H",0,1,"A",2.77,3.77,2.49,"0-1","3-1",18,7,14,6,3,2,1,1,11,5,13,11,4,16,24,"11-5","Y","Y","Y",5,2,10
"2164","D2",2023-10-27,"Braunschweig","Fortuna Dusseldorf",1,4,"A",0,2,"A",4.01,3.97,1.89,"0-2","1-4",16,5,12,6,2,1,0,0,8,4,12,6,5,12,18,"8-4","Y","Y","Y",3,0,11
"2165","D2",2023-10-27,"Greuther Furth","Osnabruck",4,0,"H",1,0,"H",1.76,4.32,4.32,"1-0","4-0",13,6,5,2,0,3,0,0,10,1,15,15,4,11,30,"10-1","Y","Y","Y",3,0,11
"2166","D2",2023-10-28,"Hertha","Paderborn",3,1,"H",2,0,"H",2.25,3.95,3.02,"2-0","3-1",11,5,16,6,5,1,1,0,3,9,13,14,4,12,27,"3-9","Y","Y","Y",6,1,11
"2167","D2",2023-10-28,"Schalke 04","Hannover",3,2,"H",1,0,"H",2.34,4.06,2.82,"1-0","3-2",11,6,14,3,4,1,0,0,4,5,15,15,5,9,30,"4-5","Y","Y","Y",5,0,11
"2168","D2",2023-10-28,"St Pauli","Karlsruhe",2,1,"H",0,1,"A",1.66,4.36,5.01,"0-1","2-1",20,9,6,3,1,2,0,0,7,3,10,10,3,10,20,"7-3","Y","Y","N",3,0,11
"2169","D2",2023-10-28,"Kaiserslautern","Hamburg",3,3,"D",2,1,"H",3.07,3.96,2.23,"2-1","3-3",13,5,20,9,1,4,0,0,3,4,8,15,6,7,23,"3-4","Y","Y","Y",5,0,11
"2170","D2",2023-10-29,"Holstein Kiel","Nurnberg",0,2,"A",0,0,"D",2.11,3.89,3.37,"0-0","0-2",14,1,21,5,2,4,0,0,7,3,12,8,2,10,20,"7-3","Y","N","N",6,0,11
"2171","D2",2023-10-29,"Magdeburg","Elversberg",1,2,"A",0,2,"A",2.13,3.92,3.29,"0-2","1-2",18,5,8,4,2,2,0,0,5,3,12,14,3,8,26,"5-3","Y","Y","N",4,0,11
"2172","D2",2023-10-29,"Wehen","Hansa Rostock",1,0,"H",0,0,"D",2.33,3.51,3.19,"0-0","1-0",16,6,16,4,1,0,0,0,9,11,7,9,1,20,16,"9-11","N","N","N",1,0,11
"2173","D2",2023-11-03,"Elversberg","St Pauli",0,2,"A",0,2,"A",3.65,3.88,2.01,"0-2","0-2",7,2,10,4,2,1,0,0,6,3,10,7,2,9,17,"6-3","Y","N","N",3,0,12
"2174","D2",2023-11-03,"Fortuna Dusseldorf","Wehen",1,3,"A",0,3,"A",1.58,4.67,5.46,"0-3","1-3",25,7,11,5,4,5,0,0,6,6,14,6,4,12,20,"6-6","Y","Y","Y",9,0,12
"2175","D2",2023-11-04,"Kaiserslautern","Greuther Furth",0,2,"A",0,1,"A",2.15,3.72,3.4,"0-1","0-2",18,2,13,6,3,2,1,0,9,3,8,13,2,12,21,"9-3","Y","N","N",5,1,12
"2176","D2",2023-11-04,"Nurnberg","Schalke 04",1,2,"A",0,1,"A",2.25,3.84,3.09,"0-1","1-2",15,4,11,4,4,2,0,0,4,7,9,18,3,11,27,"4-7","Y","Y","N",6,0,12
"2177","D2",2023-11-04,"Osnabruck","Holstein Kiel",1,1,"D",0,0,"D",2.91,3.88,2.35,"0-0","1-1",14,4,16,9,1,3,0,0,6,5,19,15,2,11,34,"6-5","Y","N","N",4,0,12
"2178","D2",2023-11-04,"Hamburg","Magdeburg",2,0,"H",1,0,"H",1.57,5.02,5.15,"1-0","2-0",16,7,13,4,1,2,0,1,4,6,18,10,2,10,28,"4-6","Y","N","N",3,1,12
"2179","D2",2023-11-05,"Hannover","Braunschweig",2,0,"H",2,0,"H",1.59,4.51,5.56,"2-0","2-0",12,6,0,0,2,7,0,1,2,5,10,13,2,7,23,"2-5","Y","N","N",9,1,12
"2180","D2",2023-11-05,"Hansa Rostock","Hertha",0,0,"D",0,0,"D",3.06,3.68,2.33,"0-0","0-0",8,2,16,2,2,2,0,0,7,5,17,11,0,12,28,"7-5","N","N","N",4,0,12
"2181","D2",2023-11-05,"Karlsruhe","Paderborn",0,3,"A",0,1,"A",2.19,3.77,3.27,"0-1","0-3",16,7,11,5,4,1,0,0,2,3,10,10,3,5,20,"2-3","Y","Y","N",5,0,12
"2182","D2",2023-11-10,"Schalke 04","Elversberg",1,2,"A",1,2,"A",2.14,3.86,3.3,"1-2","1-2",22,3,13,5,3,2,0,0,8,2,11,11,3,10,22,"8-2","Y","Y","N",5,0,13
"2183","D2",2023-11-10,"St Pauli","Hannover",0,0,"D",0,0,"D",1.66,4.14,5.31,"0-0","0-0",13,2,2,0,2,4,0,0,7,1,12,15,0,8,27,"7-1","N","N","N",6,0,13
"2184","D2",2023-11-11,"Braunschweig","Osnabruck",3,2,"H",1,1,"D",2.32,3.56,3.16,"1-1","3-2",16,8,6,3,3,5,0,1,4,4,18,12,5,8,30,"4-4","Y","Y","Y",8,1,13
"2185","D2",2023-11-11,"Holstein Kiel","Hamburg",4,2,"H",1,0,"H",3.43,4.03,2.05,"1-0","4-2",16,8,15,7,2,2,0,0,7,6,13,13,6,13,26,"7-6","Y","Y","Y",4,0,13
"2186","D2",2023-11-11,"Paderborn","Nurnberg",1,3,"A",0,3,"A",2.13,3.87,3.33,"0-3","1-3",24,9,12,8,2,1,0,1,12,2,17,8,4,14,25,"12-2","Y","Y","Y",3,1,13
"2187","D2",2023-11-11,"Hertha","Karlsruhe",2,2,"D",2,1,"H",2,4.01,3.57,"2-1","2-2",10,3,12,4,0,2,0,0,6,9,17,13,4,15,30,"6-9","Y","Y","Y",2,0,13
"2188","D2",2023-11-12,"Greuther Furth","Fortuna Dusseldorf",1,0,"H",0,0,"D",2.3,3.64,3.15,"0-0","1-0",9,4,12,3,4,3,0,0,3,7,16,13,1,10,29,"3-7","N","N","N",7,0,13
"2189","D2",2023-11-12,"Magdeburg","Hansa Rostock",1,2,"A",1,0,"H",1.81,4.07,4.32,"1-0","1-2",16,8,16,5,3,2,0,0,13,2,6,15,3,15,21,"13-2","Y","Y","N",5,0,13
"2190","D2",2023-11-12,"Wehen","Kaiserslautern",2,1,"H",0,1,"A",2.93,3.78,2.37,"0-1","2-1",12,6,5,1,0,2,0,0,5,2,16,14,3,7,30,"5-2","Y","Y","N",2,0,13
"2191","D2",2023-11-24,"Hamburg","Braunschweig",2,1,"H",2,0,"H",1.31,6.18,9.49,"2-0","2-1",16,5,14,3,1,2,0,0,7,4,11,10,3,11,21,"7-4","Y","Y","N",3,0,14
"2192","D2",2023-11-24,"Hannover","Hertha",2,2,"D",0,2,"A",2.28,3.61,3.21,"0-2","2-2",18,6,8,4,0,1,0,0,9,1,10,16,4,10,26,"9-1","Y","Y","Y",1,0,14
"2193","D2",2023-11-25,"Elversberg","Paderborn",4,1,"H",1,1,"D",2.48,3.88,2.72,"1-1","4-1",15,9,9,4,2,3,0,0,4,3,10,13,5,7,23,"4-3","Y","Y","Y",5,0,14
"2194","D2",2023-11-25,"Hansa Rostock","St Pauli",2,3,"A",1,3,"A",5,4.08,1.71,"1-3","2-3",16,4,18,9,2,1,0,0,2,1,19,10,5,3,29,"2-1","Y","Y","Y",3,0,14
"2195","D2",2023-11-25,"Osnabruck","Magdeburg",0,2,"A",0,0,"D",3.16,3.83,2.22,"0-0","0-2",12,3,13,6,2,2,0,0,5,8,10,13,2,13,23,"5-8","Y","N","N",4,0,14
"2196","D2",2023-11-25,"Fortuna Dusseldorf","Schalke 04",5,3,"H",3,0,"H",1.88,4,4.03,"3-0","5-3",13,9,11,7,1,2,0,0,6,8,8,9,8,14,17,"6-8","Y","Y","Y",3,0,14
"2197","D2",2023-11-26,"Greuther Furth","Wehen",2,0,"H",1,0,"H",1.75,4.14,4.58,"1-0","2-0",23,7,14,6,3,5,0,0,7,6,7,18,2,13,25,"7-6","Y","N","N",8,0,14
"2198","D2",2023-11-26,"Kaiserslautern","Holstein Kiel",0,3,"A",0,2,"A",2.2,3.85,3.18,"0-2","0-3",13,5,11,6,1,1,0,0,6,10,9,11,3,16,20,"6-10","Y","Y","N",2,0,14
"2199","D2",2023-11-26,"Karlsruhe","Nurnberg",4,1,"H",1,0,"H",2.29,3.88,3,"1-0","4-1",19,8,12,3,2,3,0,0,6,8,10,9,5,14,19,"6-8","Y","Y","Y",5,0,14
"2200","D2",2023-12-01,"Schalke 04","Osnabruck",4,0,"H",1,0,"H",1.56,4.52,5.91,"1-0","4-0",14,5,8,2,2,2,0,0,3,0,15,11,4,3,26,"3-0","Y","Y","Y",4,0,15
"2201","D2",2023-12-01,"St Pauli","Hamburg",2,2,"D",2,0,"H",1.91,3.92,4,"2-0","2-2",16,5,6,3,1,3,0,0,9,3,5,13,4,12,18,"9-3","Y","Y","Y",4,0,15
"2202","D2",2023-12-02,"Braunschweig","Greuther Furth",0,1,"A",0,1,"A",3.76,3.66,2.04,"0-1","0-1",13,6,7,1,4,3,0,0,2,5,7,16,1,7,23,"2-5","N","N","N",7,0,15
"2203","D2",2023-12-02,"Holstein Kiel","Wehen",3,2,"H",2,0,"H",1.85,4.19,4,"2-0","3-2",23,9,13,4,1,2,0,0,11,3,7,10,5,14,17,"11-3","Y","Y","Y",3,0,15
"2204","D2",2023-12-02,"Nurnberg","Fortuna Dusseldorf",0,5,"A",0,3,"A",2.81,3.7,2.49,"0-3","0-5",4,1,14,7,2,3,0,0,2,5,10,6,5,7,16,"2-5","Y","Y","Y",5,0,15
"2205","D2",2023-12-02,"Magdeburg","Kaiserslautern",4,1,"H",1,1,"D",2.09,3.94,3.38,"1-1","4-1",18,11,19,5,3,1,0,0,6,2,9,14,5,8,23,"6-2","Y","Y","Y",4,0,15
"2206","D2",2023-12-03,"Hertha","Elversberg",5,1,"H",2,1,"H",1.96,4.04,3.67,"2-1","5-1",14,6,15,5,0,2,0,0,3,4,7,8,6,7,15,"3-4","Y","Y","Y",2,0,15
"2207","D2",2023-12-03,"Karlsruhe","Hansa Rostock",2,2,"D",1,2,"A",1.77,3.94,4.74,"1-2","2-2",17,7,17,7,2,1,0,0,8,5,6,11,4,13,17,"8-5","Y","Y","Y",3,0,15
"2208","D2",2023-12-03,"Paderborn","Hannover",1,0,"H",0,0,"D",2.41,3.71,2.92,"0-0","1-0",21,6,8,1,1,2,0,1,6,5,18,13,1,11,31,"6-5","N","N","N",3,1,15
"2209","D2",2023-12-08,"Hannover","Karlsruhe",2,2,"D",0,1,"A",2.06,3.68,3.67,"0-1","2-2",18,7,15,7,1,0,0,0,5,4,10,13,4,9,23,"5-4","Y","Y","Y",1,0,16
"2210","D2",2023-12-08,"Wehen","Braunschweig",1,3,"A",1,0,"H",1.93,3.85,3.98,"1-0","1-3",10,2,13,8,2,1,0,0,4,7,10,7,4,11,17,"4-7","Y","Y","Y",3,0,16
"2211","D2",2023-12-09,"Greuther Furth","Magdeburg",1,1,"D",0,0,"D",1.95,3.94,3.81,"0-0","1-1",16,6,11,8,1,4,0,0,7,3,20,17,2,10,37,"7-3","Y","N","N",5,0,16
"2212","D2",2023-12-09,"Hamburg","Paderborn",1,2,"A",1,1,"D",1.64,4.77,4.77,"1-1","1-2",18,6,11,4,2,1,1,1,8,4,16,8,3,12,24,"8-4","Y","Y","N",3,2,16
"2213","D2",2023-12-09,"Kaiserslautern","Hertha",1,2,"A",1,0,"H",2.39,3.84,2.87,"1-0","1-2",12,4,10,5,1,3,1,0,9,6,8,21,3,15,29,"9-6","Y","Y","N",4,1,16
"2214","D2",2023-12-09,"Osnabruck","St Pauli",1,1,"D",0,1,"A",6.7,4.42,1.52,"0-1","1-1",9,3,19,4,4,0,1,0,9,10,11,10,2,19,21,"9-10","Y","N","N",4,1,16
"2215","D2",2023-12-10,"Elversberg","Nurnberg",0,1,"A",0,0,"D",2,3.99,3.6,"0-0","0-1",19,3,10,3,3,4,0,0,9,4,11,13,1,13,24,"9-4","N","N","N",7,0,16
"2216","D2",2023-12-10,"Fortuna Dusseldorf","Holstein Kiel",0,1,"A",0,1,"A",1.99,4.05,3.59,"0-1","0-1",15,2,12,6,2,0,0,0,9,3,11,10,1,12,21,"9-3","N","N","N",2,0,16
"2217","D2",2023-12-10,"Hansa Rostock","Schalke 04",0,2,"A",0,0,"D",2.83,3.72,2.47,"0-0","0-2",3,0,18,3,1,2,1,0,3,4,16,13,2,7,29,"3-4","Y","N","N",3,1,16
"2218","D2",2023-12-15,"Paderborn","Hansa Rostock",3,0,"H",1,0,"H",1.64,4.28,5.36,"1-0","3-0",24,11,8,1,4,3,0,1,12,2,7,13,3,14,20,"12-2","Y","Y","N",7,1,17
"2219","D2",2023-12-15,"Schalke 04","Greuther Furth",2,2,"D",1,0,"H",2.24,3.63,3.28,"1-0","2-2",12,8,11,8,4,1,1,0,2,3,14,14,4,5,28,"2-3","Y","Y","Y",5,1,17
"2220","D2",2023-12-16,"Hertha","Osnabruck",0,0,"D",0,0,"D",1.45,4.97,7.01,"0-0","0-0",12,6,8,2,3,3,1,0,4,7,18,16,0,11,34,"4-7","N","N","N",6,1,17
"2221","D2",2023-12-16,"Magdeburg","Fortuna Dusseldorf",2,3,"A",2,0,"H",2.5,3.87,2.71,"2-0","2-3",19,6,12,5,2,3,0,0,7,2,9,17,5,9,26,"7-2","Y","Y","Y",5,0,17
"2222","D2",2023-12-16,"Nurnberg","Hamburg",0,2,"A",0,0,"D",3.14,4.29,2.09,"0-0","0-2",12,2,14,4,1,5,0,0,4,6,9,18,2,10,27,"4-6","Y","N","N",6,0,17
"2223","D2",2023-12-16,"Holstein Kiel","Hannover",3,0,"H",3,0,"H",2.33,3.85,2.96,"3-0","3-0",11,6,11,1,2,2,0,1,2,4,11,12,3,6,23,"2-4","Y","Y","N",4,1,17
"2224","D2",2023-12-17,"Braunschweig","Kaiserslautern",2,1,"H",1,1,"D",2.84,3.62,2.5,"1-1","2-1",17,6,11,0,1,3,0,0,4,6,7,11,3,10,18,"4-6","Y","Y","N",4,0,17
"2225","D2",2023-12-17,"Karlsruhe","Elversberg",3,2,"H",2,1,"H",2.22,3.9,3.12,"2-1","3-2",17,7,11,5,2,2,0,0,5,1,9,14,5,6,23,"5-1","Y","Y","Y",4,0,17
"2226","D2",2023-12-17,"St Pauli","Wehen",1,1,"D",0,0,"D",1.35,5.59,8.99,"0-0","1-1",28,5,5,2,2,3,0,0,12,2,8,9,2,14,17,"12-2","Y","N","N",5,0,17
"1","E0",2023-08-11,"Burnley","Man City",0,3,"A",0,2,"A",8.58,5.51,1.37,"0-2","0-3",6,1,17,8,0,0,1,0,6,5,11,8,3,11,19,"6-5","Y","Y","N",0,1,1
"2","E0",2023-08-12,"Arsenal","Nottm Forest",2,1,"H",2,0,"H",1.18,7.86,15.67,"2-0","2-1",15,7,6,2,2,2,0,0,8,3,12,12,3,11,24,"8-3","Y","Y","N",4,0,1
"3","E0",2023-08-12,"Bournemouth","West Ham",1,1,"D",0,0,"D",2.7,3.47,2.71,"0-0","1-1",14,5,16,3,1,4,0,0,10,4,9,14,2,14,23,"10-4","Y","N","N",5,0,1
"4","E0",2023-08-12,"Brighton","Luton",4,1,"H",1,0,"H",1.33,5.65,9.61,"1-0","4-1",27,12,9,3,2,2,0,0,6,7,11,12,5,13,23,"6-7","Y","Y","Y",4,0,1
"5","E0",2023-08-12,"Everton","Fulham",0,1,"A",0,0,"D",2.27,3.45,3.35,"0-0","0-1",19,9,9,2,0,2,0,0,10,4,12,6,1,14,18,"10-4","N","N","N",2,0,1
"6","E0",2023-08-12,"Sheffield United","Crystal Palace",0,1,"A",0,0,"D",3.28,3.22,2.43,"0-0","0-1",8,1,24,8,3,0,0,0,5,5,18,11,1,10,29,"5-5","N","N","N",3,0,1
"7","E0",2023-08-12,"Newcastle","Aston Villa",5,1,"H",2,1,"H",1.77,3.92,4.77,"2-1","5-1",17,13,16,6,4,4,0,0,6,5,12,17,6,11,29,"6-5","Y","Y","Y",8,0,1
"8","E0",2023-08-13,"Brentford","Tottenham",2,2,"D",2,2,"D",2.76,3.65,2.55,"2-2","2-2",11,6,18,6,1,4,0,0,3,6,12,13,4,9,25,"3-6","Y","Y","Y",5,0,1
"9","E0",2023-08-13,"Chelsea","Liverpool",1,1,"D",1,1,"D",2.97,3.64,2.4,"1-1","1-1",10,4,13,1,3,3,0,0,4,4,5,12,2,8,17,"4-4","Y","N","N",6,0,1
"10","E0",2023-08-14,"Man United","Wolves",1,0,"H",0,0,"D",1.32,5.79,9.66,"0-0","1-0",15,3,23,6,2,3,0,0,8,7,14,10,1,15,24,"8-7","N","N","N",5,0,1
"11","E0",2023-08-18,"Nottm Forest","Sheffield United",2,1,"H",1,0,"H",1.97,3.48,4.37,"1-0","2-1",16,4,7,3,2,3,0,0,6,7,5,9,3,13,14,"6-7","Y","Y","N",5,0,2
"12","E0",2023-08-19,"Fulham","Brentford",0,3,"A",0,1,"A",2.76,3.43,2.67,"0-1","0-3",10,2,17,8,2,2,1,0,5,5,13,12,3,10,25,"5-5","Y","Y","N",4,1,2
"13","E0",2023-08-19,"Liverpool","Bournemouth",3,1,"H",2,1,"H",1.23,7.14,11.46,"2-1","3-1",26,10,13,5,1,3,1,0,10,2,11,13,4,12,24,"10-2","Y","Y","Y",4,1,2
"14","E0",2023-08-19,"Wolves","Brighton",1,4,"A",0,1,"A",4.12,3.92,1.88,"0-1","1-4",16,5,16,8,3,6,1,0,5,3,14,11,5,8,25,"5-3","Y","Y","Y",9,1,2
"15","E0",2023-08-19,"Tottenham","Man United",2,0,"H",0,0,"D",2.85,3.82,2.41,"0-0","2-0",17,6,22,6,1,3,0,0,5,6,9,8,2,11,17,"5-6","Y","N","N",4,0,2
"16","E0",2023-08-19,"Man City","Newcastle",1,0,"H",1,0,"H",1.73,4.1,4.8,"1-0","1-0",14,4,7,1,1,5,0,0,3,0,12,11,1,3,23,"3-0","N","N","N",6,0,2
"17","E0",2023-08-20,"Aston Villa","Everton",4,0,"H",2,0,"H",1.72,3.99,5.06,"2-0","4-0",13,7,9,2,3,4,0,0,7,6,8,12,4,13,20,"7-6","Y","Y","Y",7,0,2
"18","E0",2023-08-20,"West Ham","Chelsea",3,1,"H",1,1,"D",3.68,3.57,2.1,"1-1","3-1",12,6,17,4,2,3,1,0,3,9,12,9,4,12,21,"3-9","Y","Y","Y",5,1,2
"19","E0",2023-08-21,"Crystal Palace","Arsenal",0,1,"A",0,0,"D",5.73,4.12,1.63,"0-0","0-1",14,2,14,3,2,1,0,1,1,8,14,10,1,9,24,"1-8","N","N","N",3,1,2
"20","E0",2023-08-25,"Chelsea","Luton",3,0,"H",1,0,"H",1.3,6.08,10.68,"1-0","3-0",19,8,11,1,2,3,0,0,6,4,15,12,3,10,27,"6-4","Y","Y","N",5,0,2
"21","E0",2023-08-26,"Bournemouth","Tottenham",0,2,"A",0,1,"A",3.72,4.04,1.95,"0-1","0-2",11,3,17,6,1,3,0,0,6,2,18,11,2,8,29,"6-2","Y","N","N",4,0,3
"22","E0",2023-08-26,"Arsenal","Fulham",2,2,"D",0,1,"A",1.24,6.07,15.25,"0-1","2-2",19,11,8,3,0,3,0,1,8,3,6,5,4,11,11,"8-3","Y","Y","Y",3,1,3
"23","E0",2023-08-26,"Brentford","Crystal Palace",1,1,"D",1,0,"H",2.17,3.43,3.62,"1-0","1-1",12,1,15,5,0,0,0,0,8,6,9,15,2,14,24,"8-6","Y","N","N",0,0,3
"24","E0",2023-08-26,"Everton","Wolves",0,1,"A",0,0,"D",2.34,3.32,3.34,"0-0","0-1",15,7,11,2,3,4,0,0,7,0,10,14,1,7,24,"7-0","N","N","N",7,0,3
"25","E0",2023-08-26,"Man United","Nottm Forest",3,2,"H",1,2,"A",1.32,5.98,9.11,"1-2","3-2",18,9,9,4,4,4,0,1,11,3,13,11,5,14,24,"11-3","Y","Y","Y",8,1,3
"26","E0",2023-08-26,"Brighton","West Ham",1,3,"A",0,1,"A",1.54,4.74,5.81,"0-1","1-3",25,10,12,3,1,3,0,0,17,4,10,9,4,21,19,"17-4","Y","Y","Y",4,0,3
"27","E0",2023-08-27,"Burnley","Aston Villa",1,3,"A",0,2,"A",3.39,3.65,2.18,"0-2","1-3",9,2,16,6,2,0,0,0,4,6,12,11,4,10,23,"4-6","Y","Y","Y",2,0,3
"28","E0",2023-08-27,"Sheffield United","Man City",1,2,"A",0,0,"D",16.72,7.73,1.18,"0-0","1-2",6,2,30,9,3,0,0,0,1,12,11,2,3,13,13,"1-12","Y","Y","N",3,0,3
"29","E0",2023-08-27,"Newcastle","Liverpool",1,2,"A",1,0,"H",2.2,3.95,3.13,"1-0","1-2",23,8,9,4,1,2,0,1,5,9,16,10,3,14,26,"5-9","Y","Y","N",3,1,3
"30","E0",2023-09-01,"Luton","West Ham",1,2,"A",0,1,"A",4.82,4.04,1.75,"0-1","1-2",16,1,9,3,1,1,0,0,9,6,8,13,3,15,21,"9-6","Y","Y","N",2,0,3
"31","E0",2023-09-02,"Sheffield United","Everton",2,2,"D",2,1,"H",3.06,3.27,2.53,"2-1","2-2",13,8,16,6,1,2,0,0,4,6,11,13,4,10,24,"4-6","Y","Y","Y",3,0,4
"32","E0",2023-09-02,"Brentford","Bournemouth",2,2,"D",1,1,"D",1.75,4.14,4.62,"1-1","2-2",21,7,12,5,1,2,0,0,5,2,6,13,4,7,19,"5-2","Y","Y","Y",3,0,4
"33","E0",2023-09-02,"Burnley","Tottenham",2,5,"A",1,2,"A",3.97,4.04,1.88,"1-2","2-5",16,4,20,10,4,3,0,0,7,4,15,9,7,11,24,"7-4","Y","Y","Y",7,0,4
"34","E0",2023-09-02,"Chelsea","Nottm Forest",0,1,"A",0,0,"D",1.39,5.1,8.62,"0-0","0-1",21,2,7,3,3,4,0,0,8,0,10,9,1,8,19,"8-0","N","N","N",7,0,4
"35","E0",2023-09-02,"Man City","Fulham",5,1,"H",2,1,"H",1.15,8.93,18.11,"2-1","5-1",7,5,6,4,2,4,0,0,4,5,12,12,6,9,24,"4-5","Y","Y","Y",6,0,4
"36","E0",2023-09-02,"Brighton","Newcastle",3,1,"H",1,0,"H",2.59,3.94,2.58,"1-0","3-1",15,6,9,2,4,4,0,0,5,3,14,17,4,8,31,"5-3","Y","Y","Y",8,0,4
"37","E0",2023-09-03,"Crystal Palace","Wolves",3,2,"H",0,0,"D",1.97,3.5,4.25,"0-0","3-2",16,11,12,4,1,3,0,0,4,2,12,12,5,6,24,"4-2","Y","Y","Y",4,0,4
"38","E0",2023-09-03,"Liverpool","Aston Villa",3,0,"H",2,0,"H",1.68,4.61,4.6,"2-0","3-0",17,4,9,3,0,1,0,0,7,3,12,7,3,10,19,"7-3","Y","Y","N",1,0,4
"39","E0",2023-09-03,"Arsenal","Man United",3,1,"H",1,1,"D",1.77,4.08,4.55,"1-1","3-1",17,5,10,2,2,3,0,0,12,3,8,7,4,15,15,"12-3","Y","Y","Y",5,0,4
"40","E0",2023-09-16,"Wolves","Liverpool",1,3,"A",1,0,"H",6.66,4.98,1.47,"1-0","1-3",11,2,16,6,1,3,0,0,4,4,10,4,4,8,14,"4-4","Y","Y","Y",4,0,4
"41","E0",2023-09-16,"Aston Villa","Crystal Palace",3,1,"H",0,0,"D",1.93,3.76,4.1,"0-0","3-1",16,5,6,3,5,3,0,0,4,2,13,9,4,6,22,"4-2","Y","Y","Y",8,0,5
"42","E0",2023-09-16,"Fulham","Luton",1,0,"H",0,0,"D",1.68,4.03,5.31,"0-0","1-0",13,2,7,2,2,2,0,0,6,2,6,14,1,8,20,"6-2","N","N","N",4,0,5
"43","E0",2023-09-16,"Man United","Brighton",1,3,"A",0,1,"A",2.25,4.02,2.99,"0-1","1-3",14,4,10,8,2,2,0,0,8,1,8,9,4,9,17,"8-1","Y","Y","Y",4,0,5
"44","E0",2023-09-16,"Tottenham","Sheffield United",2,1,"H",0,0,"D",1.29,6.08,10.21,"0-0","2-1",28,10,7,5,6,5,0,1,15,2,13,14,3,17,27,"15-2","Y","Y","N",11,1,5
"45","E0",2023-09-16,"West Ham","Man City",1,3,"A",1,0,"H",6.58,4.7,1.5,"1-0","1-3",6,3,29,15,3,2,0,0,4,11,7,11,4,15,18,"4-11","Y","Y","Y",5,0,5
"46","E0",2023-09-16,"Newcastle","Brentford",1,0,"H",0,0,"D",1.54,4.47,6.3,"0-0","1-0",9,2,11,2,3,5,0,0,8,3,8,12,1,11,20,"8-3","N","N","N",8,0,5
"47","E0",2023-09-17,"Bournemouth","Chelsea",0,0,"D",0,0,"D",4.39,4.05,1.8,"0-0","0-0",13,4,14,6,1,5,0,0,1,7,15,20,0,8,35,"1-7","N","N","N",6,0,5
"48","E0",2023-09-17,"Everton","Arsenal",0,1,"A",0,0,"D",6.3,4.54,1.53,"0-0","0-1",8,1,13,4,1,1,0,0,1,11,12,10,1,12,22,"1-11","N","N","N",2,0,5
"49","E0",2023-09-18,"Nottm Forest","Burnley",1,1,"D",0,1,"A",2.23,3.58,3.33,"0-1","1-1",14,4,10,3,2,3,0,1,5,4,16,10,2,9,26,"5-4","Y","N","N",5,1,5
"50","E0",2023-09-23,"Crystal Palace","Fulham",0,0,"D",0,0,"D",1.99,3.54,4.11,"0-0","0-0",7,3,10,5,3,2,0,0,3,2,10,15,0,5,25,"3-2","N","N","N",5,0,5
"51","E0",2023-09-23,"Luton","Wolves",1,1,"D",0,0,"D",3.26,3.47,2.31,"0-0","1-1",20,4,3,3,0,2,0,1,10,1,12,17,2,11,29,"10-1","Y","N","N",2,1,6
"52","E0",2023-09-23,"Man City","Nottm Forest",2,0,"H",2,0,"H",1.15,9.04,17.91,"2-0","2-0",7,4,10,3,3,7,1,0,6,6,5,17,2,12,22,"6-6","Y","N","N",10,1,6
"53","E0",2023-09-23,"Brentford","Everton",1,3,"A",1,1,"D",1.81,3.8,4.67,"1-1","1-3",12,2,18,6,2,2,0,0,1,4,9,12,4,5,21,"1-4","Y","Y","Y",4,0,6
"54","E0",2023-09-23,"Burnley","Man United",0,1,"A",0,1,"A",4.28,4.31,1.77,"0-1","0-1",12,4,11,4,1,2,0,0,9,5,6,12,1,14,18,"9-5","N","N","N",3,0,6
"55","E0",2023-09-24,"Arsenal","Tottenham",2,2,"D",1,1,"D",1.68,4.45,4.69,"1-1","2-2",13,6,13,5,3,4,0,0,11,4,12,19,4,15,31,"11-4","Y","Y","Y",7,0,6
"56","E0",2023-09-24,"Brighton","Bournemouth",3,1,"H",1,1,"D",1.41,5.08,7.9,"1-1","3-1",13,4,12,4,3,3,0,0,4,4,12,17,4,8,29,"4-4","Y","Y","Y",6,0,6
"57","E0",2023-09-24,"Chelsea","Aston Villa",0,1,"A",0,0,"D",1.93,3.9,3.93,"0-0","0-1",10,4,15,7,2,3,0,0,5,11,9,11,1,16,20,"5-11","N","N","N",5,0,6
"58","E0",2023-09-24,"Liverpool","West Ham",3,1,"H",1,1,"D",1.4,5.67,7.21,"1-1","3-1",22,7,11,4,0,2,0,0,7,4,12,13,4,11,25,"7-4","Y","Y","Y",2,0,6
"59","E0",2023-09-24,"Sheffield United","Newcastle",0,8,"A",0,3,"A",7.05,4.98,1.45,"0-3","0-8",9,1,22,15,3,0,0,0,2,6,12,8,8,8,20,"2-6","Y","Y","Y",3,0,6
"60","E0",2023-09-30,"Aston Villa","Brighton",6,1,"H",3,0,"H",2.58,3.96,2.58,"3-0","6-1",19,9,11,3,4,4,0,0,1,3,19,21,7,4,40,"1-3","Y","Y","Y",8,0,6
"61","E0",2023-09-30,"Bournemouth","Arsenal",0,4,"A",0,2,"A",5.59,4.77,1.56,"0-2","0-4",8,1,15,8,0,1,0,0,6,6,11,10,4,12,21,"6-6","Y","Y","Y",1,0,7
"62","E0",2023-09-30,"Everton","Luton",1,2,"A",1,2,"A",1.62,3.94,6.24,"1-2","1-2",23,5,9,2,0,1,0,0,3,6,8,10,3,9,18,"3-6","Y","Y","N",1,0,7
"63","E0",2023-09-30,"Man United","Crystal Palace",0,1,"A",0,1,"A",1.57,4.36,5.96,"0-1","0-1",19,4,8,2,3,2,0,0,10,4,10,8,1,14,18,"10-4","N","N","N",5,0,7
"64","E0",2023-09-30,"Newcastle","Burnley",2,0,"H",1,0,"H",1.34,5.67,9.15,"1-0","2-0",20,8,8,2,1,3,0,0,5,3,7,15,2,8,22,"5-3","Y","N","N",4,0,7
"65","E0",2023-09-30,"West Ham","Sheffield United",2,0,"H",2,0,"H",1.44,4.94,7.44,"2-0","2-0",20,9,16,2,1,1,0,0,7,4,6,9,2,11,15,"7-4","Y","N","N",2,0,7
"66","E0",2023-09-30,"Wolves","Man City",2,1,"H",1,0,"H",9.61,5.75,1.33,"1-0","2-1",3,1,23,8,5,4,0,0,0,6,18,12,3,6,30,"0-6","Y","Y","N",9,0,7
"67","E0",2023-09-30,"Tottenham","Liverpool",2,1,"H",1,1,"D",2.98,4.12,2.23,"1-1","2-1",24,8,12,4,5,4,0,2,12,5,11,17,3,17,28,"12-5","Y","Y","N",9,2,7
"68","E0",2023-10-01,"Nottm Forest","Brentford",1,1,"D",0,0,"D",2.84,3.29,2.69,"0-0","1-1",6,1,18,5,1,2,1,0,1,11,6,10,2,12,16,"1-11","Y","N","N",3,1,7
"69","E0",2023-10-02,"Fulham","Chelsea",0,2,"A",0,2,"A",3.93,3.45,2.06,"0-2","0-2",10,3,11,4,1,4,0,0,8,1,15,12,2,9,27,"8-1","Y","N","N",5,0,7
"70","E0",2023-10-03,"Luton","Burnley",1,2,"A",0,1,"A",2.94,3.23,2.65,"0-1","1-2",18,3,14,4,4,2,0,0,7,6,14,6,3,13,20,"7-6","Y","Y","N",6,0,7
"71","E0",2023-10-07,"Luton","Tottenham",0,1,"A",0,0,"D",6.91,4.98,1.46,"0-0","0-1",12,2,15,4,2,1,0,1,5,6,16,7,1,11,23,"5-6","N","N","N",3,1,8
"72","E0",2023-10-07,"Burnley","Chelsea",1,4,"A",1,1,"D",4.58,3.98,1.78,"1-1","1-4",10,3,9,5,2,4,0,0,7,3,11,8,5,10,19,"7-3","Y","Y","Y",6,0,8
"73","E0",2023-10-07,"Everton","Bournemouth",3,0,"H",2,0,"H",1.99,3.71,3.88,"2-0","3-0",25,8,11,4,1,2,0,0,8,7,14,15,3,15,29,"8-7","Y","Y","N",3,0,8
"74","E0",2023-10-07,"Fulham","Sheffield United",3,1,"H",0,0,"D",1.64,4,5.9,"0-0","3-1",20,6,5,2,1,2,0,0,9,4,8,10,4,13,18,"9-4","Y","Y","Y",3,0,8
"75","E0",2023-10-07,"Man United","Brentford",2,1,"H",0,1,"A",1.7,4.23,4.87,"0-1","2-1",21,8,11,3,0,5,0,0,7,5,10,17,3,12,27,"7-5","Y","Y","N",5,0,8
"76","E0",2023-10-07,"Crystal Palace","Nottm Forest",0,0,"D",0,0,"D",2.26,3.3,3.54,"0-0","0-0",8,2,16,5,0,1,0,0,3,7,7,12,0,10,19,"3-7","N","N","N",1,0,8
"77","E0",2023-10-08,"Brighton","Liverpool",2,2,"D",1,2,"A",3.14,4.02,2.17,"1-2","2-2",14,3,14,4,1,2,0,0,8,1,12,20,4,9,32,"8-1","Y","Y","Y",3,0,8
"78","E0",2023-10-08,"West Ham","Newcastle",2,2,"D",1,0,"H",3.41,3.79,2.12,"1-0","2-2",5,3,10,3,3,3,0,0,4,2,11,18,4,6,29,"4-2","Y","Y","Y",6,0,8
"79","E0",2023-10-08,"Wolves","Aston Villa",1,1,"D",0,0,"D",3.39,3.64,2.18,"0-0","1-1",8,3,18,4,2,2,1,0,2,10,19,9,2,12,28,"2-10","Y","N","N",4,1,8
"80","E0",2023-10-08,"Arsenal","Man City",1,0,"H",0,0,"D",2.99,3.49,2.46,"0-0","1-0",12,2,4,1,2,3,0,0,5,4,8,7,1,9,15,"5-4","N","N","N",5,0,8
"81","E0",2023-10-21,"Liverpool","Everton",2,0,"H",0,0,"D",1.37,5.77,7.65,"0-0","2-0",26,6,6,1,1,1,0,1,12,4,9,9,2,16,18,"12-4","Y","N","N",2,1,9
"82","E0",2023-10-21,"Bournemouth","Wolves",1,2,"A",1,0,"H",2.45,3.49,3.01,"1-0","1-2",7,4,20,7,2,6,1,0,3,12,15,10,3,15,25,"3-12","Y","Y","N",8,1,9
"83","E0",2023-10-21,"Brentford","Burnley",3,0,"H",1,0,"H",1.87,3.77,4.37,"1-0","3-0",23,10,6,1,5,2,0,1,5,5,14,12,3,10,26,"5-5","Y","Y","N",7,1,9
"84","E0",2023-10-21,"Man City","Brighton",2,1,"H",2,0,"H",1.42,5.45,6.93,"2-0","2-1",10,6,5,3,2,2,1,0,2,2,9,11,3,4,20,"2-2","Y","Y","N",4,1,9
"85","E0",2023-10-21,"Newcastle","Crystal Palace",4,0,"H",3,0,"H",1.46,4.63,7.7,"3-0","4-0",10,7,17,3,2,3,0,0,6,8,7,12,4,14,19,"6-8","Y","Y","Y",5,0,9
"86","E0",2023-10-21,"Nottm Forest","Luton",2,2,"D",0,0,"D",1.7,3.89,5.43,"0-0","2-2",19,8,13,4,3,0,0,0,4,2,12,11,4,6,23,"4-2","Y","Y","Y",3,0,9
"87","E0",2023-10-21,"Chelsea","Arsenal",2,2,"D",1,0,"H",3.33,3.5,2.26,"1-0","2-2",11,5,13,3,3,3,0,0,2,7,7,14,4,9,21,"2-7","Y","Y","Y",6,0,9
"88","E0",2023-10-21,"Sheffield United","Man United",1,2,"A",1,1,"D",7.57,5.24,1.41,"1-1","1-2",12,6,14,5,3,1,0,0,5,4,12,10,3,9,22,"5-4","Y","Y","N",4,0,9
"89","E0",2023-10-22,"Aston Villa","West Ham",4,1,"H",1,0,"H",1.9,3.93,4.01,"1-0","4-1",15,7,14,4,0,1,0,0,8,7,9,15,5,15,24,"8-7","Y","Y","Y",1,0,9
"90","E0",2023-10-23,"Tottenham","Fulham",2,0,"H",1,0,"H",1.51,4.85,6.06,"1-0","2-0",15,5,10,3,2,0,0,0,3,5,10,14,2,8,24,"3-5","Y","N","N",2,0,9
"91","E0",2023-10-27,"Crystal Palace","Tottenham",1,2,"A",0,0,"D",4.7,3.84,1.79,"0-0","1-2",13,3,10,1,2,1,0,0,11,2,19,11,3,13,30,"11-2","Y","Y","N",3,0,10
"92","E0",2023-10-28,"Chelsea","Brentford",0,2,"A",0,0,"D",1.66,4.15,5.32,"0-0","0-2",17,2,7,5,1,4,0,0,10,1,12,7,2,11,19,"10-1","Y","N","N",5,0,10
"93","E0",2023-10-28,"Arsenal","Sheffield United",5,0,"H",1,0,"H",1.13,10.16,21.31,"1-0","5-0",13,8,2,0,0,3,0,0,6,1,9,13,5,7,22,"6-1","Y","Y","Y",3,0,10
"94","E0",2023-10-28,"Bournemouth","Burnley",2,1,"H",1,1,"D",2.1,3.76,3.49,"1-1","2-1",13,6,6,3,2,3,0,0,10,5,9,12,3,15,21,"10-5","Y","Y","N",5,0,10
"95","E0",2023-10-28,"Wolves","Newcastle",2,2,"D",1,2,"A",4.22,3.99,1.84,"1-2","2-2",11,6,13,5,1,4,0,0,8,7,13,15,4,15,28,"8-7","Y","Y","Y",5,0,10
"96","E0",2023-10-29,"West Ham","Everton",0,1,"A",0,0,"D",2.18,3.62,3.41,"0-0","0-1",12,2,10,4,4,1,0,0,4,3,7,11,1,7,18,"4-3","N","N","N",5,0,10
"97","E0",2023-10-29,"Aston Villa","Luton",3,1,"H",1,0,"H",1.28,6.23,10.8,"1-0","3-1",17,6,7,1,3,2,0,0,6,4,11,10,4,10,21,"6-4","Y","Y","Y",5,0,10
"98","E0",2023-10-29,"Brighton","Fulham",1,1,"D",1,0,"H",1.59,4.65,5.36,"1-0","1-1",18,7,10,5,0,3,0,0,7,3,12,8,2,10,20,"7-3","Y","N","N",3,0,10
"99","E0",2023-10-29,"Liverpool","Nottm Forest",3,0,"H",2,0,"H",1.27,6.51,10.09,"2-0","3-0",21,8,9,1,2,3,0,0,8,3,9,13,3,11,22,"8-3","Y","Y","N",5,0,10
"100","E0",2023-10-29,"Man United","Man City",0,3,"A",0,1,"A",5.16,4.07,1.69,"0-1","0-3",7,3,21,10,4,1,0,0,7,12,9,4,3,19,13,"7-12","Y","Y","N",5,0,10
"101","E0",2023-11-04,"Fulham","Man United",0,1,"A",0,0,"D",3.22,3.68,2.22,"0-0","0-1",18,3,12,5,5,2,0,0,9,4,9,15,1,13,24,"9-4","N","N","N",7,0,11
"102","E0",2023-11-04,"Brentford","West Ham",3,2,"H",1,2,"A",2.07,3.74,3.52,"1-2","3-2",16,4,12,2,1,4,0,0,4,3,12,14,5,7,26,"4-3","Y","Y","Y",5,0,11
"103","E0",2023-11-04,"Burnley","Crystal Palace",0,2,"A",0,1,"A",2.89,3.24,2.65,"0-1","0-2",17,5,4,3,0,5,0,0,12,1,9,12,2,13,21,"12-1","Y","N","N",5,0,11
"104","E0",2023-11-04,"Everton","Brighton",1,1,"D",1,0,"H",3.1,3.87,2.21,"1-0","1-1",10,4,7,2,4,2,0,0,3,3,15,5,2,6,20,"3-3","Y","N","N",6,0,11
"105","E0",2023-11-04,"Man City","Bournemouth",6,1,"H",3,0,"H",1.08,12.84,29.22,"3-0","6-1",21,8,5,1,0,1,0,0,12,1,8,9,7,13,17,"12-1","Y","Y","Y",1,0,11
"106","E0",2023-11-04,"Sheffield United","Wolves",2,1,"H",0,0,"D",3.91,3.68,1.97,"0-0","2-1",11,2,10,3,2,3,0,0,4,4,13,10,3,8,23,"4-4","Y","Y","N",5,0,11
"107","E0",2023-11-04,"Newcastle","Arsenal",1,0,"H",0,0,"D",2.83,3.41,2.59,"0-0","1-0",9,2,14,1,5,1,0,0,0,11,14,9,1,11,23,"0-11","N","N","N",6,0,11
"108","E0",2023-11-05,"Nottm Forest","Aston Villa",2,0,"H",1,0,"H",4.17,3.76,1.89,"1-0","2-0",5,3,13,3,1,1,0,0,0,10,6,9,2,10,15,"0-10","Y","N","N",2,0,11
"109","E0",2023-11-05,"Luton","Liverpool",1,1,"D",0,0,"D",11.23,6.76,1.24,"0-0","1-1",8,5,24,6,1,1,0,0,4,7,7,13,2,11,20,"4-7","Y","N","N",2,0,11
"110","E0",2023-11-06,"Tottenham","Chelsea",1,4,"A",1,1,"D",2.14,3.73,3.34,"1-1","1-4",8,5,17,8,1,5,2,0,1,6,12,21,5,7,33,"1-6","Y","Y","Y",6,2,11
"111","E0",2023-11-11,"Wolves","Tottenham",2,1,"H",0,1,"A",3.11,3.78,2.23,"0-1","2-1",17,4,6,2,4,3,0,0,11,3,19,15,3,14,34,"11-3","Y","Y","N",7,0,12
"112","E0",2023-11-11,"Arsenal","Burnley",3,1,"H",1,0,"H",1.19,7.47,14.74,"1-0","3-1",16,6,8,5,0,1,1,0,3,3,8,9,4,6,17,"3-3","Y","Y","Y",1,1,12
"113","E0",2023-11-11,"Crystal Palace","Everton",2,3,"A",1,1,"D",2.45,3.2,3.19,"1-1","2-3",13,4,8,4,1,4,0,0,9,2,9,18,5,11,27,"9-2","Y","Y","Y",5,0,12
"114","E0",2023-11-11,"Man United","Luton",1,0,"H",0,0,"D",1.31,5.86,9.36,"0-0","1-0",15,4,10,4,0,2,0,0,11,3,9,11,1,14,20,"11-3","N","N","N",2,0,12
"115","E0",2023-11-11,"Bournemouth","Newcastle",2,0,"H",0,0,"D",4.52,4.06,1.76,"0-0","2-0",19,10,8,5,2,1,0,0,6,5,10,4,2,11,14,"6-5","Y","N","N",3,0,12
"116","E0",2023-11-12,"Aston Villa","Fulham",3,1,"H",2,0,"H",1.6,4.27,5.67,"2-0","3-1",12,6,9,5,2,5,0,0,2,2,4,17,4,4,21,"2-2","Y","Y","Y",7,0,12
"117","E0",2023-11-12,"Brighton","Sheffield United",1,1,"D",1,0,"H",1.24,6.8,11.28,"1-0","1-1",11,6,9,1,3,2,1,0,6,3,13,16,2,9,29,"6-3","Y","N","N",5,1,12
"118","E0",2023-11-12,"Liverpool","Brentford",3,0,"H",1,0,"H",1.41,5.26,7.17,"1-0","3-0",17,10,16,3,1,2,0,0,6,8,16,12,3,14,28,"6-8","Y","Y","N",3,0,12
"119","E0",2023-11-12,"West Ham","Nottm Forest",3,2,"H",1,1,"D",1.89,3.79,4.1,"1-1","3-2",16,6,10,5,2,2,0,0,9,4,9,12,5,13,21,"9-4","Y","Y","Y",4,0,12
"120","E0",2023-11-12,"Chelsea","Man City",4,4,"D",2,2,"D",4.92,3.8,1.75,"2-2","4-4",17,9,15,10,5,3,0,0,3,3,12,15,8,6,27,"3-3","Y","Y","Y",8,0,12
"121","E0",2023-11-25,"Man City","Liverpool",1,1,"D",1,0,"H",1.75,4.37,4.24,"1-0","1-1",16,5,8,3,1,3,0,0,9,6,9,11,2,15,20,"9-6","Y","N","N",4,0,13
"122","E0",2023-11-25,"Burnley","West Ham",1,2,"A",0,0,"D",3.58,3.54,2.12,"0-0","1-2",11,5,11,3,1,3,0,0,4,5,11,7,3,9,18,"4-5","Y","Y","N",4,0,13
"123","E0",2023-11-25,"Luton","Crystal Palace",2,1,"H",0,0,"D",3.7,3.41,2.13,"0-0","2-1",8,3,16,8,6,1,0,0,4,5,15,12,3,9,27,"4-5","Y","Y","N",7,0,13
"124","E0",2023-11-25,"Newcastle","Chelsea",4,1,"H",1,1,"D",2.65,3.46,2.73,"1-1","4-1",14,5,7,4,4,4,0,1,4,2,13,19,5,6,32,"4-2","Y","Y","Y",8,1,13
"125","E0",2023-11-25,"Nottm Forest","Brighton",2,3,"A",1,2,"A",3.32,3.63,2.19,"1-2","2-3",18,5,11,5,2,4,0,1,6,4,12,7,5,10,19,"6-4","Y","Y","Y",6,1,13
"126","E0",2023-11-25,"Sheffield United","Bournemouth",1,3,"A",0,2,"A",3.36,3.54,2.2,"0-2","1-3",10,2,23,11,4,1,0,0,4,7,6,8,4,11,14,"4-7","Y","Y","Y",5,0,13
"127","E0",2023-11-25,"Brentford","Arsenal",0,1,"A",0,0,"D",4.74,3.82,1.78,"0-0","0-1",9,3,15,4,1,1,0,0,1,8,9,7,1,9,16,"1-8","N","N","N",2,0,13
"128","E0",2023-11-26,"Tottenham","Aston Villa",1,2,"A",1,1,"D",2.36,3.93,2.82,"1-1","1-2",18,8,15,5,0,4,0,0,9,3,11,13,3,12,24,"9-3","Y","Y","N",4,0,13
"129","E0",2023-11-26,"Everton","Man United",0,3,"A",0,1,"A",2.75,3.51,2.6,"0-1","0-3",24,6,9,4,3,0,0,0,6,5,10,8,3,11,18,"6-5","Y","Y","N",3,0,13
"130","E0",2023-11-27,"Fulham","Wolves",3,2,"H",1,1,"D",2.45,3.37,3.05,"1-1","3-2",12,6,10,6,2,2,0,0,6,2,13,13,5,8,26,"6-2","Y","Y","Y",4,0,13
"131","E0",2023-12-02,"Arsenal","Wolves",2,1,"H",2,0,"H",1.29,5.9,10.82,"2-0","2-1",19,6,6,3,1,2,0,0,4,0,10,10,3,4,20,"4-0","Y","Y","N",3,0,14
"132","E0",2023-12-02,"Brentford","Luton",3,1,"H",0,0,"D",1.45,4.83,7.07,"0-0","3-1",27,6,7,1,1,2,0,0,7,5,10,8,4,12,18,"7-5","Y","Y","Y",3,0,14
"133","E0",2023-12-02,"Burnley","Sheffield United",5,0,"H",2,0,"H",1.83,3.63,4.65,"2-0","5-0",19,7,6,3,2,5,0,1,6,1,9,12,5,7,21,"6-1","Y","Y","Y",7,1,14
"134","E0",2023-12-02,"Nottm Forest","Everton",0,1,"A",0,0,"D",2.85,3.31,2.64,"0-0","0-1",13,2,12,3,1,0,0,0,4,3,15,14,1,7,29,"4-3","N","N","N",1,0,14
"135","E0",2023-12-02,"Newcastle","Man United",1,0,"H",0,0,"D",1.9,3.87,4,"0-0","1-0",22,4,8,1,1,2,0,0,7,3,6,13,1,10,19,"7-3","N","N","N",3,0,14
"136","E0",2023-12-03,"Bournemouth","Aston Villa",2,2,"D",1,1,"D",3.56,4.07,1.97,"1-1","2-2",15,7,11,3,5,3,0,0,7,7,16,12,4,14,28,"7-7","Y","Y","Y",8,0,14
"137","E0",2023-12-03,"Chelsea","Brighton",3,2,"H",2,1,"H",1.75,4.21,4.4,"2-1","3-2",8,5,18,9,3,5,1,0,5,8,16,12,5,13,28,"5-8","Y","Y","Y",8,1,14
"138","E0",2023-12-03,"Liverpool","Fulham",4,3,"H",2,2,"D",1.25,6.76,10.35,"2-2","4-3",26,12,9,5,0,0,0,0,3,4,6,7,7,7,13,"3-4","Y","Y","Y",0,0,14
"139","E0",2023-12-03,"West Ham","Crystal Palace",1,1,"D",1,0,"H",2.01,3.56,3.92,"1-0","1-1",9,3,9,2,2,0,0,0,2,3,17,7,2,5,24,"2-3","Y","N","N",2,0,14
"140","E0",2023-12-03,"Man City","Tottenham",3,3,"D",2,1,"H",1.27,6.42,9.75,"2-1","3-3",18,4,8,4,4,4,0,0,10,8,14,14,6,18,28,"10-8","Y","Y","Y",8,0,14
"141","E0",2023-12-05,"Wolves","Burnley",1,0,"H",1,0,"H",1.92,3.6,4.35,"1-0","1-0",7,4,12,3,2,4,0,0,6,8,11,15,1,14,26,"6-8","N","N","N",6,0,15
"142","E0",2023-12-05,"Luton","Arsenal",3,4,"A",1,2,"A",14.73,6.77,1.22,"1-2","3-4",6,4,23,9,2,1,0,0,3,8,14,7,7,11,21,"3-8","Y","Y","Y",3,0,15
"143","E0",2023-12-06,"Brighton","Brentford",2,1,"H",1,1,"D",1.94,3.89,3.79,"1-1","2-1",18,7,8,2,3,1,0,0,7,3,10,8,3,10,18,"7-3","Y","Y","N",4,0,15
"144","E0",2023-12-06,"Crystal Palace","Bournemouth",0,2,"A",0,1,"A",2.3,3.45,3.23,"0-1","0-2",16,3,11,4,1,3,0,0,3,9,10,17,2,12,27,"3-9","Y","N","N",4,0,15
"145","E0",2023-12-06,"Fulham","Nottm Forest",5,0,"H",2,0,"H",2.06,3.5,3.81,"2-0","5-0",14,6,4,1,0,1,0,0,6,1,7,10,5,7,17,"6-1","Y","Y","Y",1,0,15
"146","E0",2023-12-06,"Sheffield United","Liverpool",0,2,"A",0,1,"A",14.14,7.68,1.19,"0-1","0-2",6,1,15,8,2,3,0,0,2,12,12,8,2,14,20,"2-12","Y","N","N",5,0,15
"147","E0",2023-12-06,"Aston Villa","Man City",1,0,"H",0,0,"D",4.35,4.29,1.75,"0-0","1-0",22,7,2,2,2,2,0,0,6,0,13,13,1,6,26,"6-0","N","N","N",4,0,15
"148","E0",2023-12-06,"Man United","Chelsea",2,1,"H",1,1,"D",2.88,3.67,2.42,"1-1","2-1",28,9,13,3,4,0,0,0,12,4,12,12,3,16,24,"12-4","Y","Y","N",4,0,15
"149","E0",2023-12-07,"Everton","Newcastle",3,0,"H",0,0,"D",3.17,3.41,2.36,"0-0","3-0",21,6,13,3,3,0,0,0,5,2,18,8,3,7,26,"5-2","Y","Y","N",3,0,15
"150","E0",2023-12-07,"Tottenham","West Ham",1,2,"A",1,0,"H",1.8,4.31,4.04,"1-0","1-2",23,7,11,5,3,3,0,0,8,4,11,12,3,12,23,"8-4","Y","Y","N",6,0,15
"151","E0",2023-12-09,"Crystal Palace","Liverpool",1,2,"A",0,0,"D",6.3,4.59,1.51,"0-0","1-2",8,4,14,2,5,2,1,0,6,5,17,17,3,11,34,"6-5","Y","Y","N",7,1,16
"152","E0",2023-12-09,"Brighton","Burnley",1,1,"D",0,1,"A",1.5,4.69,6.31,"0-1","1-1",29,11,6,3,0,4,0,0,9,1,5,8,2,10,13,"9-1","Y","N","N",4,0,16
"153","E0",2023-12-09,"Man United","Bournemouth",0,3,"A",0,1,"A",1.55,4.7,5.52,"0-1","0-3",20,3,10,4,3,1,0,0,10,4,7,10,3,14,17,"10-4","Y","Y","N",4,0,16
"154","E0",2023-12-09,"Sheffield United","Brentford",1,0,"H",1,0,"H",4.47,3.84,1.81,"1-0","1-0",9,4,10,4,5,1,0,0,3,4,14,13,1,7,27,"3-4","N","N","N",6,0,16
"155","E0",2023-12-09,"Wolves","Nottm Forest",1,1,"D",1,1,"D",1.89,3.56,4.44,"1-1","1-1",10,4,8,2,0,1,0,0,4,3,9,11,2,7,20,"4-3","Y","N","N",1,0,16
"156","E0",2023-12-09,"Aston Villa","Arsenal",1,0,"H",1,0,"H",3.43,3.69,2.12,"1-0","1-0",10,3,12,5,4,2,0,0,3,3,16,11,1,6,27,"3-3","N","N","N",6,0,16
"157","E0",2023-12-10,"Everton","Chelsea",2,0,"H",0,0,"D",3.03,3.59,2.36,"0-0","2-0",9,5,16,4,2,2,0,0,4,8,12,12,2,12,24,"4-8","Y","N","N",4,0,16
"158","E0",2023-12-10,"Fulham","West Ham",5,0,"H",3,0,"H",2.44,3.4,3.03,"3-0","5-0",14,8,9,5,2,1,0,0,3,6,5,10,5,9,15,"3-6","Y","Y","Y",3,0,16
"159","E0",2023-12-10,"Luton","Man City",1,2,"A",1,0,"H",18.31,10.09,1.13,"1-0","1-2",4,2,18,6,2,1,0,0,6,3,16,6,3,9,22,"6-3","Y","Y","N",3,0,16
"160","E0",2023-12-10,"Tottenham","Newcastle",4,1,"H",2,0,"H",2.23,3.84,3.08,"2-0","4-1",23,12,9,3,1,3,0,0,3,6,10,12,5,9,22,"3-6","Y","Y","Y",4,0,16
"161","E0",2023-12-15,"Nottm Forest","Tottenham",0,2,"A",0,1,"A",4.51,4.14,1.76,"0-1","0-2",15,1,12,6,2,4,0,1,6,4,16,11,2,10,27,"6-4","Y","N","N",6,1,17
"162","E0",2023-12-16,"Chelsea","Sheffield United",2,0,"H",0,0,"D",1.24,6.69,11.68,"0-0","2-0",15,6,6,1,1,3,0,0,7,6,9,14,2,13,23,"7-6","Y","N","N",4,0,17
"163","E0",2023-12-16,"Man City","Crystal Palace",2,2,"D",1,0,"H",1.17,7.98,15.35,"1-0","2-2",19,9,5,2,1,1,0,0,6,1,12,9,4,7,21,"6-1","Y","Y","Y",2,0,17
"164","E0",2023-12-16,"Newcastle","Fulham",3,0,"H",0,0,"D",1.87,3.94,4.04,"0-0","3-0",27,10,6,4,0,2,0,1,5,1,7,12,3,6,19,"5-1","Y","Y","N",2,1,17
"165","E0",2023-12-16,"Burnley","Everton",0,2,"A",0,2,"A",3.66,3.44,2.13,"0-2","0-2",14,2,9,6,0,1,0,0,8,6,9,8,2,14,17,"8-6","Y","N","N",1,0,17
"166","E0",2023-12-17,"Arsenal","Brighton",2,0,"H",0,0,"D",1.48,4.76,6.67,"0-0","2-0",26,9,6,1,1,3,0,0,10,1,11,9,2,11,20,"10-1","Y","N","N",4,0,17
"167","E0",2023-12-17,"Brentford","Aston Villa",1,2,"A",1,0,"H",3.24,3.73,2.19,"1-0","1-2",4,3,15,5,6,4,1,1,7,12,19,6,3,19,25,"7-12","Y","Y","N",10,2,17
"168","E0",2023-12-17,"West Ham","Wolves",3,0,"H",2,0,"H",2.12,3.62,3.5,"2-0","3-0",13,4,14,3,3,1,0,0,6,6,12,15,3,12,27,"6-6","Y","Y","N",4,0,17
"169","E0",2023-12-17,"Liverpool","Man United",0,0,"D",0,0,"D",1.32,5.99,8.37,"0-0","0-0",34,8,6,1,2,4,0,1,12,0,13,8,0,12,21,"12-0","N","N","N",6,1,17
"170","E0",2023-12-21,"Crystal Palace","Brighton",1,1,"D",1,0,"H",3.4,3.47,2.22,"1-0","1-1",11,3,18,6,5,2,0,0,3,1,12,11,2,4,23,"3-1","Y","N","N",7,0,17
"171","E0",2023-12-22,"Aston Villa","Sheffield United",1,1,"D",0,0,"D",1.24,6.98,11.3,"0-0","1-1",12,4,5,2,3,3,0,0,9,1,11,16,2,10,27,"9-1","Y","N","N",6,0,18
"172","E0",2023-12-23,"West Ham","Man United",2,0,"H",0,0,"D",2.65,3.65,2.62,"0-0","2-0",12,5,11,3,2,3,0,0,4,4,13,15,2,8,28,"4-4","Y","N","N",5,0,18
"173","E0",2023-12-23,"Fulham","Burnley",0,2,"A",0,0,"D",1.7,3.96,5.12,"0-0","0-2",19,5,7,2,2,1,0,0,8,6,5,17,2,14,22,"8-6","Y","N","N",3,0,18
"174","E0",2023-12-23,"Luton","Newcastle",1,0,"H",1,0,"H",4.91,4.36,1.65,"1-0","1-0",16,5,15,2,2,1,0,0,6,7,11,5,1,13,16,"6-7","N","N","N",3,0,18
"175","E0",2023-12-23,"Nottm Forest","Bournemouth",2,3,"A",0,0,"D",2.74,3.52,2.61,"0-0","2-3",11,5,18,7,0,3,1,0,6,6,10,10,5,12,20,"6-6","Y","Y","Y",3,1,18
"176","E0",2023-12-23,"Tottenham","Everton",2,1,"H",2,0,"H",1.8,4.29,4.05,"2-0","2-1",13,6,18,8,1,4,0,0,3,8,6,18,3,11,24,"3-8","Y","Y","N",5,0,18
"177","E0",2023-12-23,"Liverpool","Arsenal",1,1,"D",1,1,"D",2.47,3.63,2.84,"1-1","1-1",13,3,13,2,2,5,0,0,4,5,13,14,2,9,27,"4-5","Y","N","N",7,0,18
"178","E0",2023-12-24,"Wolves","Chelsea",2,1,"H",0,0,"D",3.77,3.76,1.99,"0-0","2-1",14,6,16,5,3,5,0,0,10,6,11,9,3,16,20,"10-6","Y","Y","N",8,0,18
"179","E0",2023-12-26,"Newcastle","Nottm Forest",1,3,"A",1,1,"D",1.51,4.42,6.64,"1-1","1-3",19,7,15,6,3,3,0,0,10,2,10,11,4,12,21,"10-2","Y","Y","Y",6,0,18
"180","E0",2023-12-26,"Bournemouth","Fulham",3,0,"H",1,0,"H",2.22,3.69,3.2,"1-0","3-0",16,4,8,3,0,2,0,0,6,5,10,10,3,11,20,"6-5","Y","Y","N",2,0,18
"181","E0",2023-12-26,"Sheffield United","Luton",2,3,"A",0,1,"A",2.46,3.32,3.07,"0-1","2-3",21,6,12,4,5,0,0,0,9,4,13,13,5,13,26,"9-4","Y","Y","Y",5,0,19
"182","E0",2023-12-26,"Burnley","Liverpool",0,2,"A",0,1,"A",8.02,5.32,1.38,"0-1","0-2",9,0,19,10,2,1,0,0,4,4,7,10,2,8,17,"4-4","Y","N","N",3,0,19
"183","E0",2023-12-26,"Man United","Aston Villa",3,2,"H",0,2,"A",2.68,3.62,2.61,"0-2","3-2",13,7,10,4,1,3,0,0,3,6,10,10,5,9,20,"3-6","Y","Y","Y",4,0,19
"184","E0",2023-12-27,"Brentford","Wolves",1,4,"A",1,3,"A",1.94,3.66,4.07,"1-3","1-4",14,4,11,5,1,1,0,0,8,2,5,14,5,10,19,"8-2","Y","Y","Y",2,0,19
"185","E0",2023-12-27,"Chelsea","Crystal Palace",2,1,"H",1,1,"D",1.72,3.89,5.06,"1-1","2-1",9,4,13,5,3,2,0,0,4,3,13,16,3,7,29,"4-3","Y","Y","N",5,0,19
"186","E0",2023-12-27,"Everton","Man City",1,3,"A",1,0,"H",6.32,4.1,1.57,"1-0","1-3",7,2,23,9,4,2,0,0,8,4,13,5,4,12,18,"8-4","Y","Y","Y",6,0,19
"187","E0",2023-12-28,"Brighton","Tottenham",4,2,"H",2,0,"H",2.53,4.05,2.56,"2-0","4-2",15,9,19,3,3,2,0,0,7,6,18,6,6,13,24,"7-6","Y","Y","Y",5,0,19
"188","E0",2023-12-28,"Arsenal","West Ham",0,2,"A",0,1,"A",1.36,5.49,8.28,"0-1","0-2",30,8,6,3,2,0,0,0,10,3,8,8,2,13,16,"10-3","Y","N","N",2,0,19
"189","E0",2023-12-30,"Luton","Chelsea",2,3,"A",0,2,"A",6.05,4.65,1.52,"0-2","2-3",15,6,12,8,2,2,0,0,7,2,14,21,5,9,35,"7-2","Y","Y","Y",4,0,19
"190","E0",2023-12-30,"Aston Villa","Burnley",3,2,"H",2,1,"H",1.38,5.29,8.1,"2-1","3-2",19,7,9,5,4,1,0,1,6,2,9,14,5,8,23,"6-2","Y","Y","Y",5,1,19
"191","E0",2023-12-30,"Crystal Palace","Brentford",3,1,"H",2,1,"H",2.22,3.3,3.58,"2-1","3-1",13,6,9,4,0,1,0,0,7,4,14,10,4,11,24,"7-4","Y","Y","Y",1,0,20
"192","E0",2023-12-30,"Man City","Sheffield United",2,0,"H",1,0,"H",1.07,14.55,28.9,"1-0","2-0",18,4,4,2,1,1,0,0,12,2,5,6,2,14,11,"12-2","Y","N","N",2,0,20
"193","E0",2023-12-30,"Wolves","Everton",3,0,"H",1,0,"H",2.67,3.41,2.74,"1-0","3-0",12,6,10,0,2,3,0,0,5,2,9,14,3,7,23,"5-2","Y","Y","N",5,0,20
"194","E0",2023-12-30,"Nottm Forest","Man United",2,1,"H",0,0,"D",3.33,3.72,2.15,"0-0","2-1",8,2,10,5,2,4,0,0,4,5,9,11,3,9,20,"4-5","Y","Y","N",6,0,20
"195","E0",2023-12-31,"Fulham","Arsenal",2,1,"H",1,1,"D",5.94,4.29,1.57,"1-1","2-1",15,4,13,3,4,1,0,0,5,4,11,10,3,9,21,"5-4","Y","Y","N",5,0,20
"196","E0",2023-12-31,"Tottenham","Bournemouth",3,1,"H",1,0,"H",1.77,4.42,4.08,"1-0","3-1",12,6,24,4,3,3,0,0,4,13,9,18,4,17,27,"4-13","Y","Y","Y",6,0,20
"197","E0",2024-01-01,"Liverpool","Newcastle",4,2,"H",0,0,"D",1.45,4.96,6.69,"0-0","4-2",34,15,5,3,3,5,0,0,7,3,16,15,6,10,31,"7-3","Y","Y","Y",8,0,20
"198","E0",2024-01-02,"West Ham","Brighton",0,0,"D",0,0,"D",2.52,3.68,2.74,"0-0","0-0",6,2,22,8,1,0,0,0,2,0,4,6,0,2,10,"2-0","N","N","N",1,0,20
"199","E0",2024-01-12,"Burnley","Luton",1,1,"D",1,0,"H",2.06,3.58,3.8,"1-0","1-1",13,7,14,5,1,0,0,0,2,8,7,12,2,10,19,"2-8","Y","N","N",1,0,20
"200","E0",2024-01-13,"Chelsea","Fulham",1,0,"H",1,0,"H",1.65,4.22,5.13,"1-0","1-0",17,3,14,4,5,1,0,0,6,4,13,9,1,10,22,"6-4","N","N","N",6,0,20
"201","E0",2024-01-13,"Newcastle","Man City",2,3,"A",2,1,"H",5.63,4.53,1.56,"2-1","2-3",12,5,27,11,1,2,0,0,3,13,7,7,5,16,14,"3-13","Y","Y","Y",3,0,21
"202","E0",2024-01-14,"Everton","Aston Villa",0,0,"D",0,0,"D",2.81,3.62,2.49,"0-0","0-0",10,2,16,5,1,4,0,0,4,5,13,14,0,9,27,"4-5","N","N","N",5,0,21
"203","E0",2024-01-14,"Man United","Tottenham",2,2,"D",2,1,"H",2.22,3.97,3.01,"2-1","2-2",9,2,16,6,2,1,0,0,8,13,8,5,4,21,13,"8-13","Y","Y","Y",3,0,21
"204","E1",2023-08-04,"Sheffield Weds","Southampton",1,2,"A",0,1,"A",3.3,3.44,2.3,"0-1","1-2",8,1,23,7,4,4,0,0,3,6,12,10,3,9,22,"3-6","Y","Y","N",8,0,1
"205","E1",2023-08-05,"Blackburn","West Brom",2,1,"H",2,0,"H",2.92,3.24,2.65,"2-0","2-1",12,3,14,4,4,3,0,0,6,5,11,11,3,11,22,"6-5","Y","Y","N",7,0,1
"206","E1",2023-08-05,"Bristol City","Preston",1,1,"D",0,0,"D",2.13,3.45,3.72,"0-0","1-1",5,2,11,3,0,1,0,0,2,4,10,11,2,6,21,"2-4","Y","N","N",1,0,1
"207","E1",2023-08-05,"Middlesbrough","Millwall",0,1,"A",0,0,"D",2.05,3.48,3.96,"0-0","0-1",16,2,12,2,1,3,0,0,12,6,3,8,1,18,11,"12-6","N","N","N",4,0,1
"208","E1",2023-08-05,"Norwich","Hull",2,1,"H",1,1,"D",1.8,3.71,4.87,"1-1","2-1",28,5,8,3,2,5,0,0,9,4,14,12,3,13,26,"9-4","Y","Y","N",7,0,1
"209","E1",2023-08-05,"Plymouth","Huddersfield",3,1,"H",1,1,"D",2.19,3.46,3.55,"1-1","3-1",14,7,15,3,1,0,0,0,2,9,9,15,4,11,24,"2-9","Y","Y","Y",1,0,1
"210","E1",2023-08-05,"Stoke","Rotherham",4,1,"H",3,0,"H",1.65,4,5.74,"3-0","4-1",15,6,6,3,5,3,0,1,10,2,12,10,5,12,22,"10-2","Y","Y","Y",8,1,1
"211","E1",2023-08-05,"Swansea","Birmingham",1,1,"D",0,1,"A",1.9,3.65,4.37,"0-1","1-1",11,6,11,5,1,4,0,0,5,5,9,12,2,10,21,"5-5","Y","N","N",5,0,1
"212","E1",2023-08-05,"Watford","QPR",4,0,"H",4,0,"H",1.88,3.69,4.39,"4-0","4-0",23,12,4,1,1,2,0,0,8,2,8,15,4,10,23,"8-2","Y","Y","Y",3,0,1
"213","E1",2023-08-06,"Leicester","Coventry",2,1,"H",0,0,"D",1.6,4.24,5.9,"0-0","2-1",20,7,20,6,3,2,0,0,6,8,11,13,3,14,24,"6-8","Y","Y","N",5,0,1
"214","E1",2023-08-06,"Leeds","Cardiff",2,2,"D",0,2,"A",1.47,4.76,7.04,"0-2","2-2",25,6,7,2,2,1,0,0,10,0,8,10,4,10,18,"10-0","Y","Y","Y",3,0,1
"215","E1",2023-08-06,"Sunderland","Ipswich",1,2,"A",0,1,"A",2.53,3.36,2.99,"0-1","1-2",20,4,13,5,1,3,1,0,11,4,10,13,3,15,23,"11-4","Y","Y","N",4,1,1
"216","E1",2023-08-12,"Coventry","Middlesbrough",3,0,"H",1,0,"H",2.45,3.45,3.04,"1-0","3-0",12,5,14,2,1,1,0,0,7,7,5,8,3,14,13,"7-7","Y","Y","N",2,0,2
"217","E1",2023-08-12,"Birmingham","Leeds",1,0,"H",0,0,"D",3.43,3.59,2.19,"0-0","1-0",10,2,7,1,1,2,0,0,7,4,13,10,1,11,23,"7-4","N","N","N",3,0,2
"218","E1",2023-08-12,"Cardiff","QPR",1,2,"A",0,1,"A",2,3.58,4.01,"0-1","1-2",15,4,7,3,2,2,0,0,13,7,8,13,3,20,21,"13-7","Y","Y","N",4,0,2
"219","E1",2023-08-12,"Huddersfield","Leicester",0,1,"A",0,0,"D",4.66,3.93,1.78,"0-0","0-1",13,3,17,6,1,4,0,0,5,4,15,8,1,9,23,"5-4","N","N","N",5,0,2
"220","E1",2023-08-12,"Hull","Sheffield Weds",4,2,"H",1,1,"D",2.37,3.42,3.19,"1-1","4-2",16,7,6,2,1,3,0,0,9,1,7,22,6,10,29,"9-1","Y","Y","Y",4,0,2
"221","E1",2023-08-12,"Ipswich","Stoke",2,0,"H",1,0,"H",2.16,3.6,3.47,"1-0","2-0",22,10,9,2,3,1,0,0,7,3,12,17,2,10,29,"7-3","Y","N","N",4,0,2
"222","E1",2023-08-12,"Millwall","Bristol City",0,1,"A",0,0,"D",1.91,3.66,4.32,"0-0","0-1",10,2,13,1,1,3,0,0,1,5,13,11,1,6,24,"1-5","N","N","N",4,0,2
"223","E1",2023-08-12,"Preston","Sunderland",2,1,"H",1,1,"D",2.81,3.41,2.64,"1-1","2-1",11,2,13,4,3,1,0,0,5,12,17,8,3,17,25,"5-12","Y","Y","N",4,0,2
"224","E1",2023-08-12,"Rotherham","Blackburn",2,2,"D",1,0,"H",3.09,3.4,2.44,"1-0","2-2",9,3,21,6,3,1,1,0,5,9,9,8,4,14,17,"5-9","Y","Y","Y",4,1,2
"225","E1",2023-08-12,"Southampton","Norwich",4,4,"D",2,3,"A",1.87,3.77,4.35,"2-3","4-4",31,11,15,6,7,4,0,0,13,4,12,13,8,17,25,"13-4","Y","Y","Y",11,0,2
"226","E1",2023-08-12,"Watford","Plymouth",0,0,"D",0,0,"D",1.72,4.01,4.96,"0-0","0-0",20,3,13,5,0,2,0,0,12,3,16,10,0,15,26,"12-3","N","N","N",2,0,2
"227","E1",2023-08-12,"West Brom","Swansea",3,2,"H",1,0,"H",2.1,3.57,3.68,"1-0","3-2",11,3,13,4,3,4,0,0,4,8,10,10,5,12,20,"4-8","Y","Y","Y",7,0,2
"228","E1",2023-08-18,"Leeds","West Brom",1,1,"D",0,0,"D",2.16,3.56,3.52,"0-0","1-1",16,4,4,2,4,5,0,0,4,3,10,9,2,7,19,"4-3","Y","N","N",9,0,3
"229","E1",2023-08-19,"Plymouth","Southampton",1,2,"A",0,0,"D",3.88,3.98,1.93,"0-0","1-2",15,2,19,9,2,4,0,0,5,10,11,15,3,15,26,"5-10","Y","Y","N",6,0,3
"230","E1",2023-08-19,"Blackburn","Hull",1,2,"A",0,0,"D",1.93,3.77,4.04,"0-0","1-2",14,3,19,5,1,3,1,0,2,8,12,7,3,10,19,"2-8","Y","Y","N",4,1,3
"231","E1",2023-08-19,"Bristol City","Birmingham",0,2,"A",0,1,"A",2.29,3.27,3.5,"0-1","0-2",19,0,16,6,0,2,1,0,8,4,12,10,2,12,22,"8-4","Y","N","N",2,1,3
"232","E1",2023-08-19,"Leicester","Cardiff",2,1,"H",1,1,"D",1.54,4.49,6.29,"1-1","2-1",15,6,10,4,1,4,0,1,10,4,11,10,3,14,21,"10-4","Y","Y","N",5,1,3
"233","E1",2023-08-19,"Middlesbrough","Huddersfield",1,1,"D",0,0,"D",1.78,4.01,4.61,"0-0","1-1",17,7,16,2,1,3,0,0,7,8,10,10,2,15,20,"7-8","Y","N","N",4,0,3
"234","E1",2023-08-19,"QPR","Ipswich",0,1,"A",0,0,"D",4.51,3.63,1.88,"0-0","0-1",10,4,16,3,4,1,0,0,5,4,15,10,1,9,25,"5-4","N","N","N",5,0,3
"235","E1",2023-08-19,"Sheffield Weds","Preston",0,1,"A",0,0,"D",2.61,3.24,2.99,"0-0","0-1",8,3,5,2,1,1,0,0,0,4,14,16,1,4,30,"0-4","N","N","N",2,0,3
"236","E1",2023-08-19,"Stoke","Watford",1,0,"H",0,0,"D",2.25,3.53,3.34,"0-0","1-0",13,2,10,3,4,1,0,0,7,2,21,10,1,9,31,"7-2","N","N","N",5,0,3
"237","E1",2023-08-19,"Sunderland","Rotherham",2,1,"H",1,1,"D",1.66,4.18,5.32,"1-1","2-1",11,4,4,1,2,1,0,0,5,0,11,10,3,5,21,"5-0","Y","Y","N",3,0,3
"238","E1",2023-08-19,"Swansea","Coventry",1,1,"D",1,1,"D",2.43,3.53,3.01,"1-1","1-1",7,3,11,2,2,1,0,0,3,8,12,10,2,11,22,"3-8","Y","N","N",3,0,3
"239","E1",2023-08-20,"Norwich","Millwall",3,1,"H",1,0,"H",2.12,3.56,3.62,"1-0","3-1",20,5,10,2,2,1,0,0,6,3,3,13,4,9,16,"6-3","Y","Y","Y",3,0,3
"240","E1",2023-08-25,"Hull","Bristol City",1,1,"D",1,0,"H",2.41,3.41,3.13,"1-0","1-1",13,9,19,5,1,2,0,0,4,5,5,13,2,9,18,"4-5","Y","N","N",3,0,4
"241","E1",2023-08-26,"Birmingham","Plymouth",2,1,"H",1,0,"H",1.88,3.66,4.46,"1-0","2-1",13,4,16,8,2,1,0,0,10,10,17,5,3,20,22,"10-10","Y","Y","N",3,0,4
"242","E1",2023-08-26,"Cardiff","Sheffield Weds",2,1,"H",0,0,"D",2.13,3.44,3.74,"0-0","2-1",12,4,11,2,0,5,0,0,5,10,6,20,3,15,26,"5-10","Y","Y","N",5,0,4
"243","E1",2023-08-26,"Coventry","Sunderland",0,0,"D",0,0,"D",2.15,3.54,3.57,"0-0","0-0",17,6,15,2,1,4,0,0,4,7,11,7,0,11,18,"4-7","N","N","N",5,0,4
"244","E1",2023-08-26,"Huddersfield","Norwich",0,4,"A",0,2,"A",3.37,3.74,2.15,"0-2","0-4",18,5,9,5,3,1,0,0,5,3,10,8,4,8,18,"5-3","Y","Y","Y",4,0,4
"245","E1",2023-08-26,"Ipswich","Leeds",3,4,"A",2,3,"A",2.39,3.37,3.2,"2-3","3-4",21,6,14,9,3,2,0,0,8,4,12,8,7,12,20,"8-4","Y","Y","Y",5,0,4
"246","E1",2023-08-26,"Millwall","Stoke",1,0,"H",1,0,"H",2.43,3.27,3.22,"1-0","1-0",17,7,20,2,1,5,0,0,6,7,15,7,1,13,22,"6-7","N","N","N",6,0,4
"247","E1",2023-08-26,"Preston","Swansea",2,1,"H",0,1,"A",2.66,3.35,2.84,"0-1","2-1",11,3,10,1,2,1,0,0,6,4,12,7,3,10,19,"6-4","Y","Y","N",3,0,4
"248","E1",2023-08-26,"Rotherham","Leicester",1,2,"A",0,1,"A",5.53,4.21,1.63,"0-1","1-2",8,1,15,7,2,2,0,0,5,4,15,10,3,9,25,"5-4","Y","Y","N",4,0,4
"249","E1",2023-08-26,"Southampton","QPR",2,1,"H",1,1,"D",1.37,5.47,8.46,"1-1","2-1",7,3,11,5,4,2,0,0,4,3,8,14,3,7,22,"4-3","Y","Y","N",6,0,4
"250","E1",2023-08-26,"West Brom","Middlesbrough",4,2,"H",2,1,"H",2.3,3.52,3.24,"2-1","4-2",7,4,15,5,2,1,0,1,4,2,10,9,6,6,19,"4-2","Y","Y","Y",3,1,4
"251","E1",2023-08-27,"Watford","Blackburn",0,1,"A",0,0,"D",2.12,3.65,3.55,"0-0","0-1",24,4,5,3,3,2,0,0,8,4,8,5,1,12,13,"8-4","N","N","N",5,0,4
"252","E1",2023-09-02,"Birmingham","Millwall",1,1,"D",0,1,"A",2.46,3.21,3.23,"0-1","1-1",17,4,9,3,1,2,0,0,1,3,9,18,2,4,27,"1-3","Y","N","N",3,0,5
"253","E1",2023-09-02,"Sunderland","Southampton",5,0,"H",3,0,"H",2.84,3.65,2.49,"3-0","5-0",18,10,13,2,2,2,0,0,5,8,20,10,5,13,30,"5-8","Y","Y","Y",4,0,5
"254","E1",2023-09-02,"Swansea","Bristol City",1,2,"A",1,0,"H",2.17,3.64,3.42,"1-0","1-2",12,4,16,4,3,2,0,0,4,8,13,17,3,12,30,"4-8","Y","Y","N",5,0,5
"255","E1",2023-09-02,"Coventry","Watford",3,3,"D",1,1,"D",2.17,3.62,3.44,"1-1","3-3",16,7,14,5,3,3,0,0,9,6,10,16,6,15,26,"9-6","Y","Y","Y",6,0,5
"256","E1",2023-09-02,"Ipswich","Cardiff",3,2,"H",0,1,"A",1.67,4.16,5.25,"0-1","3-2",19,7,13,5,4,3,0,0,6,3,7,14,5,9,21,"6-3","Y","Y","Y",7,0,5
"257","E1",2023-09-02,"Leeds","Sheffield Weds",0,0,"D",0,0,"D",1.45,5.05,6.95,"0-0","0-0",16,4,10,5,1,2,0,0,5,3,8,9,0,8,17,"5-3","N","N","N",3,0,5
"258","E1",2023-09-02,"Leicester","Hull",0,1,"A",0,1,"A",1.54,4.67,5.95,"0-1","0-1",21,1,7,4,3,5,0,0,8,3,16,12,1,11,28,"8-3","N","N","N",8,0,5
"259","E1",2023-09-02,"Middlesbrough","QPR",0,2,"A",0,1,"A",1.6,4.43,5.61,"0-1","0-2",16,9,11,3,1,2,0,0,7,5,9,11,2,12,20,"7-5","Y","N","N",3,0,5
"260","E1",2023-09-02,"Plymouth","Blackburn",3,0,"H",1,0,"H",2.72,3.79,2.52,"1-0","3-0",23,9,20,4,2,1,0,0,9,9,5,6,3,18,11,"9-9","Y","Y","N",3,0,5
"261","E1",2023-09-02,"Rotherham","Norwich",2,1,"H",2,0,"H",4.85,4,1.74,"2-0","2-1",9,3,17,5,2,1,0,0,2,6,12,10,3,8,22,"2-6","Y","Y","N",3,0,5
"262","E1",2023-09-02,"Stoke","Preston",0,2,"A",0,0,"D",1.96,3.5,4.28,"0-0","0-2",18,1,7,3,3,4,0,0,9,0,15,17,2,9,32,"9-0","Y","N","N",7,0,5
"263","E1",2023-09-02,"West Brom","Huddersfield",1,2,"A",0,1,"A",1.72,4.08,4.89,"0-1","1-2",10,5,14,4,1,1,0,0,4,9,9,9,3,13,18,"4-9","Y","Y","N",2,0,5
"264","E1",2023-09-15,"Hull","Coventry",1,1,"D",0,1,"A",2.88,3.48,2.54,"0-1","1-1",18,4,8,2,2,5,0,0,9,3,7,21,2,12,28,"9-3","Y","N","N",7,0,6
"265","E1",2023-09-15,"Southampton","Leicester",1,4,"A",1,3,"A",2.52,3.6,2.83,"1-3","1-4",19,8,15,8,2,4,1,0,9,3,11,12,5,12,23,"9-3","Y","Y","Y",6,1,6
"266","E1",2023-09-16,"Blackburn","Middlesbrough",2,1,"H",1,0,"H",2.55,3.66,2.77,"1-0","2-1",15,8,21,6,1,2,0,0,5,9,11,10,3,14,21,"5-9","Y","Y","N",3,0,6
"267","E1",2023-09-16,"Bristol City","West Brom",0,0,"D",0,0,"D",2.47,3.43,3.01,"0-0","0-0",14,3,14,0,2,2,0,0,7,7,10,5,0,14,15,"7-7","N","N","N",4,0,6
"268","E1",2023-09-16,"Huddersfield","Rotherham",2,0,"H",1,0,"H",1.87,3.7,4.44,"1-0","2-0",15,5,7,3,1,1,0,0,2,5,10,17,2,7,27,"2-5","Y","N","N",2,0,6
"269","E1",2023-09-16,"Norwich","Stoke",1,0,"H",1,0,"H",1.92,3.83,4.04,"1-0","1-0",13,5,13,2,2,2,0,0,5,3,7,14,1,8,21,"5-3","N","N","N",4,0,6
"270","E1",2023-09-16,"Preston","Plymouth",2,1,"H",2,0,"H",2,3.71,3.84,"2-0","2-1",9,5,18,7,3,1,0,0,4,14,14,11,3,18,25,"4-14","Y","Y","N",4,0,6
"271","E1",2023-09-16,"QPR","Sunderland",1,3,"A",1,1,"D",3.33,3.56,2.24,"1-1","1-3",5,3,22,8,2,0,1,0,0,8,12,3,4,8,15,"0-8","Y","Y","Y",2,1,6
"272","E1",2023-09-16,"Sheffield Weds","Ipswich",0,1,"A",0,1,"A",3.89,3.53,2.05,"0-1","0-1",6,0,13,6,3,4,0,0,7,1,17,13,1,8,30,"7-1","N","N","N",7,0,6
"273","E1",2023-09-16,"Watford","Birmingham",2,0,"H",0,0,"D",2.04,3.48,3.98,"0-0","2-0",12,4,8,3,1,5,0,1,8,1,16,17,2,9,33,"8-1","Y","N","N",6,1,6
"274","E1",2023-09-16,"Cardiff","Swansea",2,0,"H",0,0,"D",2.63,3.39,2.85,"0-0","2-0",13,7,9,3,1,1,0,0,2,2,13,11,2,4,24,"2-2","Y","N","N",2,0,6
"275","E1",2023-09-17,"Millwall","Leeds",0,3,"A",0,1,"A",3.13,3.4,2.42,"0-1","0-3",12,3,14,3,0,0,0,0,8,9,13,9,3,17,22,"8-9","Y","Y","N",0,0,6
"276","E1",2023-09-19,"Bristol City","Plymouth",4,1,"H",3,1,"H",1.78,4.15,4.44,"3-1","4-1",17,6,6,2,3,0,0,0,7,1,9,13,5,8,22,"7-1","Y","Y","Y",3,0,7
"277","E1",2023-09-19,"Cardiff","Coventry",3,2,"H",1,1,"D",2.75,3.4,2.7,"1-1","3-2",8,3,7,3,2,3,0,0,3,5,7,8,5,8,15,"3-5","Y","Y","Y",5,0,7
"278","E1",2023-09-19,"Preston","Birmingham",2,1,"H",0,0,"D",2.4,3.2,3.35,"0-0","2-1",10,3,16,4,2,1,0,0,5,2,11,13,3,7,24,"5-2","Y","Y","N",3,0,7
"279","E1",2023-09-19,"QPR","Swansea",1,1,"D",0,1,"A",2.75,3.44,2.68,"0-1","1-1",11,3,8,3,1,1,0,1,4,6,12,17,2,10,29,"4-6","Y","N","N",2,1,7
"280","E1",2023-09-19,"Southampton","Ipswich",0,1,"A",0,1,"A",2.32,3.74,3.05,"0-1","0-1",13,3,11,3,2,2,0,0,9,3,9,13,1,12,22,"9-3","N","N","N",4,0,7
"281","E1",2023-09-19,"Sheffield Weds","Middlesbrough",1,1,"D",1,0,"H",3.46,3.6,2.17,"1-0","1-1",9,2,10,3,2,1,0,0,3,4,13,8,2,7,21,"3-4","Y","N","N",3,0,7
"282","E1",2023-09-20,"Blackburn","Sunderland",1,3,"A",1,2,"A",2.32,3.76,3.02,"1-2","1-3",22,6,13,4,5,3,0,0,8,4,14,11,4,12,25,"8-4","Y","Y","Y",8,0,7
"283","E1",2023-09-20,"Huddersfield","Stoke",2,2,"D",1,1,"D",2.83,3.45,2.6,"1-1","2-2",10,6,18,3,2,2,0,0,5,8,10,6,4,13,16,"5-8","Y","Y","Y",4,0,7
"284","E1",2023-09-20,"Hull","Leeds",0,0,"D",0,0,"D",3.9,3.73,1.98,"0-0","0-0",9,0,17,4,3,2,0,1,5,6,7,15,0,11,22,"5-6","N","N","N",5,1,7
"285","E1",2023-09-20,"Millwall","Rotherham",3,0,"H",1,0,"H",1.73,3.86,5.17,"1-0","3-0",20,8,5,1,1,1,0,0,6,1,12,16,3,7,28,"6-1","Y","Y","N",2,0,7
"286","E1",2023-09-20,"Watford","West Brom",2,2,"D",2,2,"D",2.22,3.49,3.45,"2-2","2-2",12,4,7,5,2,1,0,0,3,2,8,9,4,5,17,"3-2","Y","Y","Y",3,0,7
"287","E1",2023-09-20,"Norwich","Leicester",0,2,"A",0,1,"A",2.67,3.73,2.6,"0-1","0-2",15,2,10,3,3,4,0,0,10,1,14,15,2,11,29,"10-1","Y","N","N",7,0,7
"288","E1",2023-09-22,"Birmingham","QPR",0,0,"D",0,0,"D",1.86,3.61,4.65,"0-0","0-0",12,4,8,4,3,2,0,0,6,7,13,13,0,13,26,"6-7","N","N","N",5,0,8
"289","E1",2023-09-23,"Ipswich","Blackburn",4,3,"H",3,1,"H",1.7,4.26,4.77,"3-1","4-3",29,11,10,5,3,4,0,0,10,5,10,13,7,15,23,"10-5","Y","Y","Y",7,0,8
"290","E1",2023-09-23,"Leeds","Watford",3,0,"H",0,0,"D",1.75,4.09,4.64,"0-0","3-0",17,10,4,1,1,3,0,0,8,1,13,15,3,9,28,"8-1","Y","Y","N",4,0,8
"291","E1",2023-09-23,"Leicester","Bristol City",1,0,"H",0,0,"D",1.74,4.17,4.68,"0-0","1-0",19,7,6,1,1,2,0,0,9,0,11,10,1,9,21,"9-0","N","N","N",3,0,8
"292","E1",2023-09-23,"Middlesbrough","Southampton",2,1,"H",1,1,"D",2.5,3.62,2.85,"1-1","2-1",14,5,15,5,3,0,0,0,5,7,16,7,3,12,23,"5-7","Y","Y","N",3,0,8
"293","E1",2023-09-23,"Plymouth","Norwich",6,2,"H",4,0,"H",3.44,3.88,2.08,"4-0","6-2",16,10,11,6,1,0,0,0,3,6,9,6,8,9,15,"3-6","Y","Y","Y",1,0,8
"294","E1",2023-09-23,"Rotherham","Preston",1,1,"D",1,1,"D",3.44,3.28,2.31,"1-1","1-1",3,1,14,6,3,2,0,0,2,10,7,6,2,12,13,"2-10","Y","N","N",5,0,8
"295","E1",2023-09-23,"Swansea","Sheffield Weds",3,0,"H",1,0,"H",1.97,3.54,4.17,"1-0","3-0",12,4,10,1,2,2,0,0,2,5,12,16,3,7,28,"2-5","Y","Y","N",4,0,8
"296","E1",2023-09-23,"West Brom","Millwall",0,0,"D",0,0,"D",2.16,3.42,3.67,"0-0","0-0",16,3,7,2,0,2,0,0,6,8,8,12,0,14,20,"6-8","N","N","N",2,0,8
"297","E1",2023-09-24,"Stoke","Hull",1,3,"A",0,2,"A",1.95,3.78,3.97,"0-2","1-3",10,6,13,5,2,3,0,0,11,6,18,9,4,17,27,"11-6","Y","Y","Y",5,0,8
"298","E1",2023-09-24,"Sunderland","Cardiff",0,1,"A",0,0,"D",1.96,3.74,3.98,"0-0","0-1",16,6,7,2,2,2,0,0,4,4,6,14,1,8,20,"4-4","N","N","N",4,0,8
"299","E1",2023-09-25,"Coventry","Huddersfield",1,1,"D",1,0,"H",1.84,3.76,4.53,"1-0","1-1",11,3,10,4,2,3,0,0,10,4,12,14,2,14,26,"10-4","Y","N","N",5,0,8
"300","E1",2023-09-29,"Sheffield Weds","Sunderland",0,3,"A",0,3,"A",3.27,3.49,2.29,"0-3","0-3",8,2,12,6,2,0,0,0,2,5,14,5,3,7,19,"2-5","Y","Y","N",2,0,9
"301","E1",2023-09-30,"Southampton","Leeds",3,1,"H",3,0,"H",2.97,3.7,2.38,"3-0","3-1",10,5,15,5,4,1,0,0,5,6,14,13,4,11,27,"5-6","Y","Y","Y",5,0,9
"302","E1",2023-09-30,"Bristol City","Stoke",2,3,"A",2,1,"H",2.37,3.37,3.23,"2-1","2-3",13,5,6,4,1,1,0,0,11,3,9,13,5,14,22,"11-3","Y","Y","Y",2,0,9
"303","E1",2023-09-30,"Cardiff","Rotherham",2,0,"H",0,0,"D",1.71,3.94,5.2,"0-0","2-0",12,5,7,0,2,0,0,0,6,5,4,11,2,11,15,"6-5","Y","N","N",2,0,9
"304","E1",2023-09-30,"Huddersfield","Ipswich",1,1,"D",0,0,"D",3.88,3.89,1.94,"0-0","1-1",12,6,20,6,3,3,0,0,5,6,10,11,2,11,21,"5-6","Y","N","N",6,0,9
"305","E1",2023-09-30,"Hull","Plymouth",1,1,"D",1,1,"D",1.92,3.92,3.96,"1-1","1-1",21,5,11,5,2,2,0,0,12,4,9,10,2,16,19,"12-4","Y","N","N",4,0,9
"306","E1",2023-09-30,"Millwall","Swansea",0,3,"A",0,1,"A",2.1,3.43,3.85,"0-1","0-3",22,5,7,5,2,2,0,0,6,0,18,10,3,6,28,"6-0","Y","Y","N",4,0,9
"307","E1",2023-09-30,"Norwich","Birmingham",2,0,"H",0,0,"D",1.93,3.68,4.21,"0-0","2-0",16,4,12,2,1,1,0,0,4,4,9,10,2,8,19,"4-4","Y","N","N",2,0,9
"308","E1",2023-09-30,"Preston","West Brom",0,4,"A",0,2,"A",2.5,3.27,3.11,"0-2","0-4",5,1,19,6,3,1,0,0,2,6,12,5,4,8,17,"2-6","Y","Y","Y",4,0,9
"309","E1",2023-09-30,"QPR","Coventry",1,3,"A",0,0,"D",3.25,3.39,2.35,"0-0","1-3",12,3,15,6,4,2,0,0,4,5,11,14,4,9,25,"4-5","Y","Y","Y",6,0,9
"310","E1",2023-09-30,"Watford","Middlesbrough",2,3,"A",1,2,"A",2.46,3.53,2.96,"1-2","2-3",17,4,9,3,2,0,0,0,9,3,10,15,5,12,25,"9-3","Y","Y","Y",2,0,9
"311","E1",2023-10-01,"Blackburn","Leicester",1,4,"A",1,2,"A",3.53,3.82,2.07,"1-2","1-4",15,4,11,4,2,3,0,0,5,6,8,14,5,11,22,"5-6","Y","Y","Y",5,0,9
"312","E1",2023-10-03,"Birmingham","Huddersfield",4,1,"H",2,0,"H",2.3,3.34,3.4,"2-0","4-1",12,6,17,6,3,1,0,0,3,5,14,13,5,8,27,"3-5","Y","Y","Y",4,0,10
"313","E1",2023-10-03,"Ipswich","Hull",3,0,"H",2,0,"H",1.76,3.99,4.74,"2-0","3-0",14,6,13,6,0,0,0,0,6,5,16,11,3,11,27,"6-5","Y","Y","N",0,0,10
"314","E1",2023-10-03,"Middlesbrough","Cardiff",2,0,"H",0,0,"D",1.91,3.84,4.09,"0-0","2-0",11,6,6,3,1,3,0,0,8,2,10,10,2,10,20,"8-2","Y","N","N",4,0,10
"315","E1",2023-10-03,"Plymouth","Millwall",0,2,"A",0,0,"D",2.49,3.58,2.89,"0-0","0-2",22,6,9,3,2,6,0,0,8,1,5,14,2,9,19,"8-1","Y","N","N",8,0,10
"316","E1",2023-10-03,"Stoke","Southampton",0,1,"A",0,1,"A",2.78,3.46,2.64,"0-1","0-1",15,2,9,4,4,1,0,0,8,6,17,2,1,14,19,"8-6","N","N","N",5,0,10
"317","E1",2023-10-03,"West Brom","Sheffield Weds",1,0,"H",1,0,"H",1.61,3.94,6.36,"1-0","1-0",17,3,4,2,0,1,0,0,10,4,2,12,1,14,14,"10-4","N","N","N",1,0,10
"318","E1",2023-10-04,"Coventry","Blackburn",1,0,"H",0,0,"D",2.11,3.73,3.5,"0-0","1-0",14,3,14,4,2,1,0,0,7,8,18,13,1,15,31,"7-8","N","N","N",3,0,10
"319","E1",2023-10-04,"Leeds","QPR",1,0,"H",1,0,"H",1.36,5.53,8.65,"1-0","1-0",16,3,5,2,0,2,0,1,8,0,9,12,1,8,21,"8-0","N","N","N",2,1,10
"320","E1",2023-10-04,"Leicester","Preston",3,0,"H",0,0,"D",1.49,4.52,7.13,"0-0","3-0",9,4,6,1,0,2,0,0,4,4,3,8,3,8,11,"4-4","Y","Y","N",2,0,10
"321","E1",2023-10-04,"Sunderland","Watford",2,0,"H",1,0,"H",1.93,3.71,4.16,"1-0","2-0",9,4,11,4,1,5,0,1,5,2,9,19,2,7,28,"5-2","Y","N","N",6,1,10
"322","E1",2023-10-04,"Swansea","Norwich",2,1,"H",1,1,"D",2.94,3.47,2.51,"1-1","2-1",23,7,14,5,4,2,0,0,8,7,12,12,3,15,24,"8-7","Y","Y","N",6,0,10
"323","E1",2023-10-04,"Rotherham","Bristol City",1,2,"A",0,0,"D",4.01,3.37,2.07,"0-0","1-2",8,1,9,5,1,1,0,0,4,4,3,7,3,8,10,"4-4","Y","Y","N",2,0,10
"324","E1",2023-10-06,"Birmingham","West Brom",3,1,"H",2,1,"H",2.95,3.17,2.68,"2-1","3-1",11,3,10,3,2,1,0,0,6,8,16,6,4,14,22,"6-8","Y","Y","Y",3,0,11
"325","E1",2023-10-07,"Sunderland","Middlesbrough",0,4,"A",0,0,"D",2.4,3.53,3.05,"0-0","0-4",9,3,19,7,3,2,1,0,4,8,14,13,4,12,27,"4-8","Y","Y","Y",5,1,11
"326","E1",2023-10-07,"Cardiff","Watford",1,1,"D",1,0,"H",2.52,3.25,3.09,"1-0","1-1",8,2,8,1,0,2,0,0,2,1,9,10,2,3,19,"2-1","Y","N","N",2,0,11
"327","E1",2023-10-07,"Coventry","Norwich",1,1,"D",0,1,"A",2.57,3.41,2.9,"0-1","1-1",21,3,6,2,1,1,0,0,8,0,11,13,2,8,24,"8-0","Y","N","N",2,0,11
"328","E1",2023-10-07,"Ipswich","Preston",4,2,"H",3,1,"H",1.64,4.14,5.61,"3-1","4-2",16,10,8,2,0,3,0,0,7,0,10,11,6,7,21,"7-0","Y","Y","Y",3,0,11
"329","E1",2023-10-07,"Leeds","Bristol City",2,1,"H",1,1,"D",1.58,4.45,5.77,"1-1","2-1",21,8,9,2,1,2,0,0,8,6,10,8,3,14,18,"8-6","Y","Y","N",3,0,11
"330","E1",2023-10-07,"Leicester","Stoke",2,0,"H",1,0,"H",1.55,4.48,6.15,"1-0","2-0",14,7,3,1,1,1,0,0,4,4,6,5,2,8,11,"4-4","Y","N","N",2,0,11
"331","E1",2023-10-07,"Millwall","Hull",2,2,"D",1,2,"A",2.32,3.48,3.23,"1-2","2-2",13,4,8,3,4,2,0,0,5,1,18,7,4,6,25,"5-1","Y","Y","Y",6,0,11
"332","E1",2023-10-07,"Plymouth","Swansea",1,3,"A",1,0,"H",2.46,3.65,2.89,"1-0","1-3",16,7,14,6,2,0,0,0,12,7,11,5,4,19,16,"12-7","Y","Y","Y",2,0,11
"333","E1",2023-10-07,"QPR","Blackburn",0,4,"A",0,2,"A",3.02,3.65,2.36,"0-2","0-4",21,6,17,7,2,2,0,0,10,7,13,10,4,17,23,"10-7","Y","Y","Y",4,0,11
"334","E1",2023-10-07,"Sheffield Weds","Huddersfield",0,0,"D",0,0,"D",2.66,3.4,2.79,"0-0","0-0",6,1,7,0,1,1,0,0,5,4,16,13,0,9,29,"5-4","N","N","N",2,0,11
"335","E1",2023-10-07,"Southampton","Rotherham",1,1,"D",1,0,"H",1.35,5.51,9.29,"1-0","1-1",22,10,4,2,2,6,0,0,12,4,8,13,2,16,21,"12-4","Y","N","N",8,0,11
"336","E1",2023-10-21,"Preston","Millwall",1,1,"D",1,1,"D",2.52,3.18,3.17,"1-1","1-1",7,2,7,4,4,1,0,0,5,2,13,15,2,7,28,"5-2","Y","N","N",5,0,12
"337","E1",2023-10-21,"Blackburn","Cardiff",1,0,"H",0,0,"D",2.09,3.79,3.51,"0-0","1-0",9,1,11,2,2,1,0,0,4,6,8,8,1,10,16,"4-6","N","N","N",3,0,12
"338","E1",2023-10-21,"Bristol City","Coventry",1,0,"H",1,0,"H",2.47,3.49,2.97,"1-0","1-0",6,3,12,1,2,3,0,0,2,15,15,11,1,17,26,"2-15","N","N","N",5,0,12
"339","E1",2023-10-21,"Huddersfield","QPR",2,1,"H",2,1,"H",1.95,3.64,4.13,"2-1","2-1",6,4,14,2,2,2,0,0,2,9,9,12,3,11,21,"2-9","Y","Y","N",4,0,12
"340","E1",2023-10-21,"Hull","Southampton",1,2,"A",1,1,"D",2.97,3.58,2.43,"1-1","1-2",13,3,18,5,4,3,0,0,7,9,13,14,3,16,27,"7-9","Y","Y","N",7,0,12
"341","E1",2023-10-21,"Middlesbrough","Birmingham",1,0,"H",0,0,"D",1.79,3.89,4.64,"0-0","1-0",17,10,5,3,3,3,0,0,12,0,9,17,1,12,26,"12-0","N","N","N",6,0,12
"342","E1",2023-10-21,"Norwich","Leeds",2,3,"A",2,0,"H",3.21,3.72,2.23,"2-0","2-3",14,4,19,8,2,3,0,0,7,7,11,13,5,14,24,"7-7","Y","Y","Y",5,0,12
"343","E1",2023-10-21,"Stoke","Sunderland",2,1,"H",1,1,"D",2.55,3.56,2.82,"1-1","2-1",11,4,18,7,5,4,0,0,6,2,17,9,3,8,26,"6-2","Y","Y","N",9,0,12
"344","E1",2023-10-21,"Swansea","Leicester",1,3,"A",1,1,"D",4.59,3.97,1.78,"1-1","1-3",11,4,18,7,2,3,0,0,3,3,10,5,4,6,15,"3-3","Y","Y","Y",5,0,12
"345","E1",2023-10-21,"Watford","Sheffield Weds",1,0,"H",0,0,"D",1.72,3.78,5.34,"0-0","1-0",12,3,10,2,2,1,0,0,4,5,15,6,1,9,21,"4-5","N","N","N",3,0,12
"346","E1",2023-10-21,"West Brom","Plymouth",0,0,"D",0,0,"D",1.73,4.04,4.88,"0-0","0-0",14,2,5,2,2,7,0,0,10,5,4,14,0,15,18,"10-5","N","N","N",9,0,12
"347","E1",2023-10-24,"Huddersfield","Cardiff",0,4,"A",0,3,"A",2.41,3.29,3.23,"0-3","0-4",19,6,15,7,1,3,0,0,9,6,7,19,4,15,26,"9-6","Y","Y","Y",4,0,12
"348","E1",2023-10-24,"Millwall","Blackburn",1,2,"A",1,1,"D",2.52,3.54,2.87,"1-1","1-2",16,3,9,6,0,1,0,0,11,3,6,6,3,14,12,"11-3","Y","Y","N",1,0,13
"349","E1",2023-10-24,"Norwich","Middlesbrough",1,2,"A",0,0,"D",2.83,3.68,2.48,"0-0","1-2",13,2,19,8,2,2,0,0,4,7,13,10,3,11,23,"4-7","Y","Y","N",4,0,13
"350","E1",2023-10-24,"Swansea","Watford",0,1,"A",0,0,"D",2.41,3.36,3.17,"0-0","0-1",9,3,12,5,0,3,0,0,6,4,7,14,1,10,21,"6-4","N","N","N",3,0,13
"351","E1",2023-10-24,"Leicester","Sunderland",1,0,"H",1,0,"H",1.53,4.61,6.18,"1-0","1-0",8,5,13,3,4,3,0,0,5,5,13,10,1,10,23,"5-5","N","N","N",7,0,13
"352","E1",2023-10-24,"West Brom","QPR",2,0,"H",0,0,"D",1.63,4.08,5.78,"0-0","2-0",16,4,1,0,1,3,0,1,6,2,8,12,2,8,20,"6-2","Y","N","N",4,1,13
"353","E1",2023-10-25,"Birmingham","Hull",0,2,"A",0,1,"A",2.38,3.36,3.22,"0-1","0-2",14,4,17,8,2,1,0,0,6,5,18,8,2,11,26,"6-5","Y","N","N",3,0,13
"354","E1",2023-10-25,"Bristol City","Ipswich",0,1,"A",0,1,"A",3.55,3.73,2.09,"0-1","0-1",11,4,19,6,0,4,0,0,5,2,11,15,1,7,26,"5-2","N","N","N",4,0,13
"355","E1",2023-10-25,"Plymouth","Sheffield Weds",3,0,"H",2,0,"H",2.06,3.6,3.77,"2-0","3-0",13,6,13,2,2,1,0,0,1,7,10,8,3,8,18,"1-7","Y","Y","N",3,0,13
"356","E1",2023-10-25,"Preston","Southampton",2,2,"D",0,1,"A",3.54,3.59,2.14,"0-1","2-2",12,5,13,5,3,2,0,0,7,2,16,13,4,9,29,"7-2","Y","Y","Y",5,0,13
"357","E1",2023-10-25,"Rotherham","Coventry",2,0,"H",0,0,"D",4.2,3.66,1.93,"0-0","2-0",20,7,23,7,2,1,0,0,6,16,4,6,2,22,10,"6-16","Y","N","N",3,0,13
"358","E1",2023-10-25,"Stoke","Leeds",1,0,"H",0,0,"D",3.96,3.73,1.97,"0-0","1-0",12,4,16,3,1,3,0,0,5,3,16,11,1,8,27,"5-3","N","N","N",4,0,13
"359","E1",2023-10-28,"Leeds","Huddersfield",4,1,"H",4,0,"H",1.36,5.44,8.71,"4-0","4-1",20,5,5,2,0,4,0,0,4,2,7,11,5,6,18,"4-2","Y","Y","Y",4,0,13
"360","E1",2023-10-28,"Southampton","Birmingham",3,1,"H",2,0,"H",1.62,4.27,5.54,"2-0","3-1",11,5,10,2,0,4,0,0,4,4,8,12,4,8,20,"4-4","Y","Y","Y",4,0,14
"361","E1",2023-10-28,"Blackburn","Swansea",0,1,"A",0,1,"A",2.01,3.93,3.62,"0-1","0-1",20,6,16,4,5,3,0,0,6,5,15,7,1,11,22,"6-5","N","N","N",8,0,14
"362","E1",2023-10-28,"Cardiff","Bristol City",2,0,"H",1,0,"H",2.29,3.35,3.41,"1-0","2-0",9,7,8,1,1,2,0,0,4,3,9,9,2,7,18,"4-3","Y","N","N",3,0,14
"363","E1",2023-10-28,"Hull","Preston",1,0,"H",0,0,"D",2.09,3.45,3.83,"0-0","1-0",19,6,11,4,3,3,0,0,7,2,13,13,1,9,26,"7-2","N","N","N",6,0,14
"364","E1",2023-10-28,"Ipswich","Plymouth",3,2,"H",1,1,"D",1.4,5.41,7.45,"1-1","3-2",15,4,10,6,4,2,0,0,11,3,11,7,5,14,18,"11-3","Y","Y","Y",6,0,14
"365","E1",2023-10-28,"Middlesbrough","Stoke",0,2,"A",0,2,"A",1.81,3.9,4.56,"0-2","0-2",9,3,13,6,2,2,0,0,8,4,12,16,2,12,28,"8-4","Y","N","N",4,0,14
"366","E1",2023-10-28,"QPR","Leicester",1,2,"A",1,1,"D",8.06,5.21,1.4,"1-1","1-2",9,3,16,5,1,2,1,0,1,8,13,7,3,9,20,"1-8","Y","Y","N",3,1,14
"367","E1",2023-10-28,"Sunderland","Norwich",3,1,"H",2,1,"H",2.1,3.72,3.52,"2-1","3-1",17,8,9,2,4,4,0,0,7,1,12,17,4,8,29,"7-1","Y","Y","Y",8,0,14
"368","E1",2023-10-28,"Watford","Millwall",2,2,"D",1,1,"D",2.1,3.34,3.95,"1-1","2-2",19,6,11,4,3,3,0,0,7,2,13,13,4,9,26,"7-2","Y","Y","Y",6,0,14
"369","E1",2023-10-29,"Sheffield Weds","Rotherham",2,0,"H",2,0,"H",1.89,3.49,4.65,"2-0","2-0",14,5,6,0,2,3,0,0,4,3,9,16,2,7,25,"4-3","Y","N","N",5,0,14
"370","E1",2023-10-30,"Coventry","West Brom",0,2,"A",0,1,"A",2.33,3.33,3.28,"0-1","0-2",15,3,7,3,2,6,0,0,5,5,9,7,2,10,16,"5-5","Y","N","N",8,0,14
"371","E1",2023-11-03,"Leicester","Leeds",0,1,"A",0,0,"D",2.24,3.67,3.24,"0-0","0-1",10,1,11,6,1,2,0,0,7,6,6,8,1,13,14,"7-6","N","N","N",3,0,14
"372","E1",2023-11-04,"Birmingham","Ipswich",2,2,"D",1,0,"H",4.09,3.86,1.9,"1-0","2-2",13,3,17,7,3,1,0,0,7,8,9,11,4,15,20,"7-8","Y","Y","Y",4,0,15
"373","E1",2023-11-04,"Bristol City","Sheffield Weds",1,0,"H",0,0,"D",2.15,3.36,3.77,"0-0","1-0",17,7,6,2,3,1,0,1,8,7,10,14,1,15,24,"8-7","N","N","N",4,1,15
"374","E1",2023-11-04,"Huddersfield","Watford",0,0,"D",0,0,"D",3.27,3.45,2.31,"0-0","0-0",5,2,9,3,0,2,0,0,1,3,6,20,0,4,26,"1-3","N","N","N",2,0,15
"375","E1",2023-11-04,"Millwall","Southampton",0,1,"A",0,0,"D",3.55,3.68,2.11,"0-0","0-1",7,1,16,8,2,2,0,0,5,12,10,10,1,17,20,"5-12","N","N","N",4,0,15
"376","E1",2023-11-04,"Plymouth","Middlesbrough",3,3,"D",2,1,"H",3.8,3.98,1.94,"2-1","3-3",10,5,20,11,2,3,0,0,8,6,15,15,6,14,30,"8-6","Y","Y","Y",5,0,15
"377","E1",2023-11-04,"Preston","Coventry",3,2,"H",2,1,"H",2.92,3.2,2.69,"2-1","3-2",16,7,18,8,2,2,0,0,6,8,14,15,5,14,29,"6-8","Y","Y","Y",4,0,15
"378","E1",2023-11-04,"Rotherham","QPR",1,1,"D",0,0,"D",2.77,3.26,2.79,"0-0","1-1",8,3,11,4,2,1,0,0,6,6,10,14,2,12,24,"6-6","Y","N","N",3,0,15
"379","E1",2023-11-04,"Stoke","Cardiff",0,0,"D",0,0,"D",2.18,3.42,3.61,"0-0","0-0",7,1,11,3,1,0,0,0,1,7,16,6,0,8,22,"1-7","N","N","N",1,0,15
"380","E1",2023-11-04,"Swansea","Sunderland",0,0,"D",0,0,"D",2.8,3.49,2.61,"0-0","0-0",3,2,25,3,2,3,1,0,2,8,13,12,0,10,25,"2-8","N","N","N",5,1,15
"381","E1",2023-11-04,"West Brom","Hull",3,1,"H",1,1,"D",2.07,3.48,3.86,"1-1","3-1",10,5,9,4,1,1,0,0,1,2,10,12,4,3,22,"1-2","Y","Y","Y",2,0,15
"382","E1",2023-11-05,"Norwich","Blackburn",1,3,"A",0,2,"A",2.17,3.94,3.18,"0-2","1-3",21,8,10,4,3,2,0,1,8,2,11,4,4,10,15,"8-2","Y","Y","Y",5,1,15
"383","E1",2023-11-07,"Rotherham","Ipswich",2,2,"D",1,1,"D",6.51,4.47,1.53,"1-1","2-2",8,3,13,3,1,1,0,0,6,8,12,10,4,14,22,"6-8","Y","Y","Y",2,0,15
"384","E1",2023-11-10,"Blackburn","Preston",1,2,"A",0,1,"A",1.97,3.65,4.02,"0-1","1-2",22,5,9,4,0,1,0,0,7,2,9,13,3,9,22,"7-2","Y","Y","N",1,0,16
"385","E1",2023-11-11,"Sunderland","Birmingham",3,1,"H",1,1,"D",1.76,3.92,4.86,"1-1","3-1",22,6,16,7,2,2,0,0,10,5,5,13,4,15,18,"10-5","Y","Y","Y",4,0,16
"386","E1",2023-11-11,"Cardiff","Norwich",2,3,"A",2,1,"H",2.03,3.8,3.66,"2-1","2-3",13,6,20,8,2,2,0,0,2,9,10,6,5,11,16,"2-9","Y","Y","Y",4,0,16
"387","E1",2023-11-11,"Coventry","Stoke",0,0,"D",0,0,"D",2.32,3.4,3.3,"0-0","0-0",13,2,6,2,1,1,0,0,4,4,14,16,0,8,30,"4-4","N","N","N",2,0,16
"388","E1",2023-11-11,"Hull","Huddersfield",1,0,"H",0,0,"D",1.78,3.71,5.06,"0-0","1-0",20,5,2,1,2,3,0,0,9,1,10,10,1,10,20,"9-1","N","N","N",5,0,16
"389","E1",2023-11-11,"Ipswich","Swansea",3,2,"H",2,1,"H",1.61,4.43,5.46,"2-1","3-2",22,9,7,4,2,1,0,1,6,2,15,9,5,8,24,"6-2","Y","Y","Y",3,1,16
"390","E1",2023-11-11,"Leeds","Plymouth",2,1,"H",2,0,"H",1.27,6.68,10.06,"2-0","2-1",14,6,9,3,1,4,0,0,7,6,10,10,3,13,20,"7-6","Y","Y","N",5,0,16
"391","E1",2023-11-11,"Middlesbrough","Leicester",1,0,"H",0,0,"D",3.02,3.61,2.38,"0-0","1-0",9,6,12,4,4,3,0,0,3,4,18,15,1,7,33,"3-4","N","N","N",7,0,16
"392","E1",2023-11-11,"QPR","Bristol City",0,0,"D",0,0,"D",2.81,3.3,2.72,"0-0","0-0",7,0,7,2,2,2,0,0,5,2,12,16,0,7,28,"5-2","N","N","N",4,0,16
"393","E1",2023-11-11,"Sheffield Weds","Millwall",0,4,"A",0,2,"A",2.76,3.04,2.97,"0-2","0-4",12,2,13,6,2,2,0,0,8,4,13,8,4,12,21,"8-4","Y","Y","Y",4,0,16
"394","E1",2023-11-11,"Southampton","West Brom",2,1,"H",1,0,"H",1.88,3.76,4.31,"1-0","2-1",10,3,14,2,3,0,0,0,3,10,7,10,3,13,17,"3-10","Y","Y","N",3,0,16
"395","E1",2023-11-11,"Watford","Rotherham",5,0,"H",2,0,"H",1.49,4.43,7.55,"2-0","5-0",14,8,9,2,2,1,0,0,7,2,12,11,5,9,23,"7-2","Y","Y","Y",3,0,16
"396","E1",2023-11-24,"Rotherham","Leeds",1,1,"D",1,1,"D",9.25,5.33,1.36,"1-1","1-1",6,3,18,5,0,0,0,0,4,3,11,4,2,7,15,"4-3","Y","N","N",0,0,17
"397","E1",2023-11-25,"Birmingham","Sheffield Weds",2,1,"H",1,1,"D",2.19,3.26,3.79,"1-1","2-1",13,4,16,4,1,0,0,0,6,6,11,11,3,12,22,"6-6","Y","Y","N",1,0,17
"398","E1",2023-11-25,"Bristol City","Middlesbrough",3,2,"H",2,0,"H",3.59,3.49,2.16,"2-0","3-2",10,8,12,4,2,2,0,0,3,8,8,12,5,11,20,"3-8","Y","Y","Y",4,0,17
"399","E1",2023-11-25,"Huddersfield","Southampton",1,1,"D",0,1,"A",4.96,4.07,1.71,"0-1","1-1",10,2,16,4,4,1,0,0,2,7,5,11,2,9,16,"2-7","Y","N","N",5,0,17
"400","E1",2023-11-25,"Leicester","Watford",2,0,"H",0,0,"D",1.61,4.15,5.96,"0-0","2-0",23,8,9,1,2,5,0,1,6,2,5,14,2,8,19,"6-2","Y","N","N",7,1,17
"401","E1",2023-11-25,"Millwall","Coventry",0,3,"A",0,1,"A",2.76,3.27,2.78,"0-1","0-3",20,5,11,9,2,1,0,0,4,3,12,10,3,7,22,"4-3","Y","Y","N",3,0,17
"402","E1",2023-11-25,"Norwich","QPR",1,0,"H",1,0,"H",1.79,3.95,4.56,"1-0","1-0",7,1,9,3,4,4,0,0,4,7,18,12,1,11,30,"4-7","N","N","N",8,0,17
"403","E1",2023-11-25,"Plymouth","Sunderland",2,0,"H",2,0,"H",3.45,3.96,2.06,"2-0","2-0",10,2,24,5,4,1,0,0,4,14,12,5,2,18,17,"4-14","Y","N","N",5,0,17
"404","E1",2023-11-25,"Preston","Cardiff",1,2,"A",0,0,"D",2.47,3.21,3.2,"0-0","1-2",4,2,19,8,3,1,1,0,6,13,9,6,3,19,15,"6-13","Y","Y","N",4,1,17
"405","E1",2023-11-25,"Stoke","Blackburn",0,3,"A",0,1,"A",2.22,3.72,3.24,"0-1","0-3",12,1,7,4,2,1,0,0,7,1,11,9,3,8,20,"7-1","Y","Y","N",3,0,17
"406","E1",2023-11-25,"Swansea","Hull",2,2,"D",2,0,"H",2.63,3.33,2.88,"2-0","2-2",14,4,18,9,0,2,0,0,2,1,12,11,4,3,23,"2-1","Y","Y","Y",2,0,17
"407","E1",2023-11-25,"West Brom","Ipswich",2,0,"H",1,0,"H",2.72,3.55,2.64,"1-0","2-0",10,4,6,0,1,2,0,0,4,5,5,12,2,9,17,"4-5","Y","N","N",3,0,17
"408","E1",2023-11-28,"Cardiff","West Brom",0,1,"A",0,0,"D",3.03,3.2,2.6,"0-0","0-1",11,1,8,1,1,2,0,0,6,3,7,9,1,9,16,"6-3","N","N","N",3,0,18
"409","E1",2023-11-28,"Coventry","Plymouth",1,0,"H",0,0,"D",1.65,4.38,5.07,"0-0","1-0",13,3,13,3,1,3,0,0,7,6,10,11,1,13,21,"7-6","N","N","N",4,0,18
"410","E1",2023-11-28,"Hull","Rotherham",4,1,"H",3,0,"H",1.44,4.66,8,"3-0","4-1",22,12,9,3,1,2,0,0,8,4,5,8,5,12,13,"8-4","Y","Y","Y",3,0,18
"411","E1",2023-11-28,"Middlesbrough","Preston",4,0,"H",3,0,"H",1.69,3.89,5.42,"3-0","4-0",13,8,6,1,0,2,0,0,7,3,15,14,4,10,29,"7-3","Y","Y","Y",2,0,18
"412","E1",2023-11-28,"QPR","Stoke",4,2,"H",1,1,"D",3.29,3.27,2.39,"1-1","4-2",19,9,12,4,2,5,0,1,13,7,13,11,6,20,24,"13-7","Y","Y","Y",7,1,18
"413","E1",2023-11-28,"Watford","Norwich",3,2,"H",2,2,"D",2.19,3.57,3.44,"2-2","3-2",21,9,12,5,1,4,0,0,7,5,14,12,5,12,26,"7-5","Y","Y","Y",5,0,18
"414","E1",2023-11-29,"Blackburn","Birmingham",4,2,"H",0,0,"D",1.8,4.02,4.44,"0-0","4-2",11,6,26,6,4,2,0,0,8,9,12,6,6,17,18,"8-9","Y","Y","Y",6,0,18
"415","E1",2023-11-29,"Leeds","Swansea",3,1,"H",2,1,"H",1.37,5.52,8.43,"2-1","3-1",18,8,10,2,0,1,0,0,6,5,12,11,4,11,23,"6-5","Y","Y","Y",1,0,18
"416","E1",2023-11-29,"Sheffield Weds","Leicester",1,1,"D",0,1,"A",5.84,4.22,1.61,"0-1","1-1",14,7,12,3,2,1,0,0,5,4,10,7,2,9,17,"5-4","Y","N","N",3,0,18
"417","E1",2023-11-29,"Southampton","Bristol City",1,0,"H",0,0,"D",1.59,4.33,5.8,"0-0","1-0",14,5,8,1,3,1,0,0,6,3,11,14,1,9,25,"6-3","N","N","N",4,0,18
"418","E1",2023-11-29,"Sunderland","Huddersfield",1,2,"A",1,1,"D",1.54,4.44,6.29,"1-1","1-2",27,9,9,5,2,1,0,0,10,4,12,11,3,14,23,"10-4","Y","Y","N",3,0,18
"419","E1",2023-11-29,"Ipswich","Millwall",3,1,"H",3,0,"H",1.6,4.28,5.84,"3-0","3-1",19,7,5,3,2,3,0,0,4,2,9,13,4,6,22,"4-2","Y","Y","Y",5,0,18
"420","E1",2023-12-01,"Preston","QPR",0,2,"A",0,0,"D",2.25,3.22,3.67,"0-0","0-2",7,1,8,5,1,1,0,0,6,4,11,11,2,10,22,"6-4","Y","N","N",2,0,19
"421","E1",2023-12-02,"West Brom","Leicester",1,2,"A",0,0,"D",3.02,3.23,2.59,"0-0","1-2",9,3,9,3,2,1,0,0,4,6,10,11,3,10,21,"4-6","Y","Y","N",3,0,19
"422","E1",2023-12-02,"Birmingham","Rotherham",0,0,"D",0,0,"D",1.62,4.3,5.49,"0-0","0-0",12,4,12,4,1,3,0,0,4,6,11,17,0,10,28,"4-6","N","N","N",4,0,19
"423","E1",2023-12-02,"Hull","Watford",1,2,"A",1,1,"D",2.2,3.46,3.5,"1-1","1-2",23,7,10,4,1,2,0,0,8,2,7,12,3,10,19,"8-2","Y","Y","N",3,0,19
"424","E1",2023-12-02,"Ipswich","Coventry",2,1,"H",2,0,"H",1.81,4.08,4.3,"2-0","2-1",13,3,15,1,2,1,0,0,1,6,14,11,3,7,25,"1-6","Y","Y","N",3,0,19
"425","E1",2023-12-02,"Leeds","Middlesbrough",3,2,"H",3,2,"H",1.74,4.15,4.68,"3-2","3-2",20,9,11,5,2,5,0,1,6,3,12,15,5,9,27,"6-3","Y","Y","Y",7,1,19
"426","E1",2023-12-02,"Millwall","Sunderland",1,1,"D",1,0,"H",3.09,3.48,2.4,"1-0","1-1",7,4,10,3,5,3,0,0,4,4,14,12,2,8,26,"4-4","Y","N","N",8,0,19
"427","E1",2023-12-02,"Plymouth","Stoke",2,1,"H",1,1,"D",2.73,3.55,2.63,"1-1","2-1",16,8,9,4,1,2,0,0,7,8,3,15,3,15,18,"7-8","Y","Y","N",3,0,19
"428","E1",2023-12-02,"Sheffield Weds","Blackburn",3,1,"H",1,0,"H",2.93,3.65,2.42,"1-0","3-1",13,8,18,5,2,1,0,0,3,7,12,6,4,10,18,"3-7","Y","Y","Y",3,0,19
"429","E1",2023-12-02,"Southampton","Cardiff",2,0,"H",2,0,"H",1.67,4.11,5.28,"2-0","2-0",18,6,10,3,1,1,0,0,7,3,6,9,2,10,15,"7-3","Y","N","N",2,0,19
"430","E1",2023-12-02,"Swansea","Huddersfield",1,1,"D",0,1,"A",1.95,3.63,4.13,"0-1","1-1",22,5,5,3,1,2,0,0,19,1,11,9,2,20,20,"19-1","Y","N","N",3,0,19
"431","E1",2023-12-03,"Bristol City","Norwich",1,2,"A",1,0,"H",2.33,3.52,3.19,"1-0","1-2",15,6,12,3,1,1,0,0,6,6,5,7,3,12,12,"6-6","Y","Y","N",2,0,19
"432","E1",2023-12-08,"Coventry","Birmingham",2,0,"H",1,0,"H",1.75,3.86,5.01,"1-0","2-0",16,8,13,6,0,5,0,0,6,7,11,19,2,13,30,"6-7","Y","N","N",5,0,20
"433","E1",2023-12-09,"Blackburn","Leeds",0,2,"A",0,1,"A",4.33,4.26,1.77,"0-1","0-2",12,2,8,4,3,2,0,0,13,3,11,7,2,16,18,"13-3","Y","N","N",5,0,20
"434","E1",2023-12-09,"Sunderland","West Brom",2,1,"H",0,0,"D",2.28,3.47,3.33,"0-0","2-1",14,5,11,1,1,6,0,0,4,7,5,13,3,11,18,"4-7","Y","Y","N",7,0,20
"435","E1",2023-12-09,"Cardiff","Millwall",1,0,"H",0,0,"D",2.14,3.31,3.85,"0-0","1-0",7,3,10,3,1,2,0,0,4,2,11,14,1,6,25,"4-2","N","N","N",3,0,20
"436","E1",2023-12-09,"Huddersfield","Bristol City",1,1,"D",1,0,"H",3.24,3.16,2.49,"1-0","1-1",6,2,15,4,1,1,0,0,2,9,8,10,2,11,18,"2-9","Y","N","N",2,0,20
"437","E1",2023-12-09,"Leicester","Plymouth",4,0,"H",1,0,"H",1.28,6.38,9.88,"1-0","4-0",13,7,15,5,0,3,0,0,5,8,6,10,4,13,16,"5-8","Y","Y","Y",3,0,20
"438","E1",2023-12-09,"Middlesbrough","Ipswich",0,2,"A",0,1,"A",2.38,3.78,2.91,"0-1","0-2",7,1,9,3,1,3,0,0,5,3,15,14,2,8,29,"5-3","Y","N","N",4,0,20
"439","E1",2023-12-09,"Norwich","Preston",0,0,"D",0,0,"D",1.93,3.73,4.1,"0-0","0-0",18,4,6,1,0,2,0,0,10,1,8,10,0,11,18,"10-1","N","N","N",2,0,20
"440","E1",2023-12-09,"QPR","Hull",2,0,"H",1,0,"H",3.21,3.35,2.39,"1-0","2-0",13,4,15,6,1,3,0,0,4,4,10,7,2,8,17,"4-4","Y","N","N",4,0,20
"441","E1",2023-12-09,"Rotherham","Swansea",1,2,"A",0,1,"A",3.37,3.65,2.18,"0-1","1-2",7,3,19,9,2,3,1,0,6,11,9,9,3,17,18,"6-11","Y","Y","N",5,1,20
"442","E1",2023-12-09,"Stoke","Sheffield Weds",0,1,"A",0,0,"D",2.04,3.42,4.08,"0-0","0-1",13,4,6,2,3,4,0,0,4,5,7,11,1,9,18,"4-5","N","N","N",7,0,20
"443","E1",2023-12-09,"Watford","Southampton",1,1,"D",0,0,"D",3.22,3.52,2.31,"0-0","1-1",11,4,6,3,3,4,0,0,7,3,10,16,2,10,26,"7-3","Y","N","N",7,0,20
"444","E1",2023-12-12,"Blackburn","Bristol City",2,1,"H",1,0,"H",1.98,3.79,3.84,"1-0","2-1",13,3,11,5,4,1,0,0,3,4,6,7,3,7,13,"3-4","Y","Y","N",5,0,21
"445","E1",2023-12-12,"Huddersfield","Preston",1,3,"A",0,2,"A",2.78,2.99,3,"0-2","1-3",7,3,11,3,0,2,0,0,2,6,12,10,4,8,22,"2-6","Y","Y","Y",2,0,21
"446","E1",2023-12-12,"Rotherham","West Brom",0,2,"A",0,0,"D",5.51,3.76,1.71,"0-0","0-2",4,2,6,2,0,1,0,0,1,2,11,10,2,3,21,"1-2","Y","N","N",1,0,21
"447","E1",2023-12-12,"Stoke","Swansea",1,1,"D",0,0,"D",2.12,3.63,3.56,"0-0","1-1",16,4,8,2,3,2,0,0,6,3,11,14,2,9,25,"6-3","Y","N","N",5,0,21
"448","E1",2023-12-12,"Watford","Ipswich",1,2,"A",1,1,"D",3.03,3.49,2.43,"1-1","1-2",12,3,10,6,2,4,0,0,6,4,12,16,3,10,28,"6-4","Y","Y","N",6,0,21
"449","E1",2023-12-12,"Sunderland","Leeds",1,0,"H",0,0,"D",2.88,3.67,2.45,"0-0","1-0",11,3,12,4,1,3,0,0,6,3,12,8,1,9,20,"6-3","N","N","N",4,0,21
"450","E1",2023-12-13,"Cardiff","Birmingham",0,1,"A",0,1,"A",1.9,3.59,4.45,"0-1","0-1",11,4,11,5,1,2,0,0,4,3,11,18,1,7,29,"4-3","N","N","N",3,0,21
"451","E1",2023-12-13,"Coventry","Southampton",1,1,"D",0,0,"D",2.75,3.53,2.62,"0-0","1-1",11,4,12,3,0,3,0,0,3,9,9,12,2,12,21,"3-9","Y","N","N",3,0,21
"452","E1",2023-12-13,"Leicester","Millwall",3,2,"H",0,1,"A",1.35,5.31,9.9,"0-1","3-2",15,6,11,6,2,4,0,0,9,3,5,16,5,12,21,"9-3","Y","Y","Y",6,0,21
"453","E1",2023-12-13,"Norwich","Sheffield Weds",3,1,"H",1,1,"D",1.97,3.64,4.05,"1-1","3-1",12,5,21,4,1,1,0,0,3,7,6,10,4,10,16,"3-7","Y","Y","Y",2,0,21
"454","E1",2023-12-13,"QPR","Plymouth",0,0,"D",0,0,"D",2.04,3.72,3.7,"0-0","0-0",29,10,12,2,2,3,0,1,6,1,14,8,0,7,22,"6-1","N","N","N",5,1,21
"455","E1",2023-12-13,"Middlesbrough","Hull",1,2,"A",1,0,"H",1.89,3.88,4.1,"1-0","1-2",16,8,8,4,0,1,0,0,6,4,9,5,3,10,14,"6-4","Y","Y","N",1,0,21
"456","E1",2023-12-16,"Ipswich","Norwich",2,2,"D",1,1,"D",1.61,4.31,5.63,"1-1","2-2",18,5,11,3,2,0,0,0,6,3,11,8,4,9,19,"6-3","Y","Y","Y",2,0,22
"457","E1",2023-12-16,"Bristol City","Sunderland",1,0,"H",1,0,"H",3.14,3.48,2.37,"1-0","1-0",6,3,18,9,3,3,0,0,5,11,12,8,1,16,20,"5-11","N","N","N",6,0,22
"458","E1",2023-12-16,"Hull","Cardiff",3,0,"H",1,0,"H",1.91,3.6,4.4,"1-0","3-0",15,7,8,1,1,3,0,0,9,2,14,12,3,11,26,"9-2","Y","Y","N",4,0,22
"459","E1",2023-12-16,"Leeds","Coventry",1,1,"D",0,0,"D",1.55,4.52,6.07,"0-0","1-1",20,6,7,3,3,5,0,0,7,0,8,15,2,7,23,"7-0","Y","N","N",8,0,22
"460","E1",2023-12-16,"Millwall","Huddersfield",1,1,"D",0,0,"D",1.88,3.53,4.63,"0-0","1-1",12,7,10,2,0,2,0,0,0,6,16,8,2,6,24,"0-6","Y","N","N",2,0,22
"461","E1",2023-12-16,"Plymouth","Rotherham",3,2,"H",1,1,"D",1.67,4.16,5.26,"1-1","3-2",25,9,9,4,0,5,0,1,11,5,7,16,5,16,23,"11-5","Y","Y","Y",5,1,22
"462","E1",2023-12-16,"Preston","Watford",1,5,"A",1,1,"D",2.94,3.25,2.64,"1-1","1-5",20,10,15,7,3,1,0,0,10,5,14,9,6,15,23,"10-5","Y","Y","Y",4,0,22
"463","E1",2023-12-16,"Sheffield Weds","QPR",2,1,"H",0,1,"A",2.39,3.24,3.32,"0-1","2-1",8,3,5,2,5,4,0,0,8,3,12,13,3,11,25,"8-3","Y","Y","N",9,0,22
"464","E1",2023-12-16,"Southampton","Blackburn",4,0,"H",1,0,"H",1.7,4.07,5.1,"1-0","4-0",22,11,4,4,3,2,0,1,15,1,9,11,4,16,20,"15-1","Y","Y","Y",5,1,22
"465","E1",2023-12-16,"Swansea","Middlesbrough",1,2,"A",0,1,"A",3.24,3.73,2.22,"0-1","1-2",10,3,9,4,2,3,0,0,4,4,14,14,3,8,28,"4-4","Y","Y","N",5,0,22
"466","E1",2023-12-17,"West Brom","Stoke",1,1,"D",1,1,"D",1.8,3.72,4.88,"1-1","1-1",16,7,9,1,3,1,0,0,11,11,9,14,2,22,23,"11-11","Y","N","N",4,0,22
"467","E1",2023-12-18,"Birmingham","Leicester",2,3,"A",1,2,"A",5.68,4.16,1.61,"1-2","2-3",8,5,14,5,0,1,0,0,3,2,12,17,5,5,29,"3-2","Y","Y","Y",1,0,22
"468","E1",2023-12-22,"Bristol City","Hull",3,2,"H",1,2,"A",2.88,3.2,2.72,"1-2","3-2",21,5,16,4,2,3,0,0,7,6,9,11,5,13,20,"7-6","Y","Y","Y",5,0,23
"469","E1",2023-12-22,"Swansea","Preston",2,1,"H",0,0,"D",2.13,3.48,3.68,"0-0","2-1",10,4,9,4,4,2,0,0,4,3,10,8,3,7,18,"4-3","Y","Y","N",6,0,23
"470","E1",2023-12-23,"Leeds","Ipswich",4,0,"H",3,0,"H",1.81,4.24,4.13,"3-0","4-0",9,4,2,0,1,4,0,0,5,0,10,15,4,5,25,"5-0","Y","Y","Y",5,0,23
"471","E1",2023-12-23,"Blackburn","Watford",1,2,"A",1,0,"H",2.31,3.66,3.11,"1-0","1-2",11,5,18,6,2,3,0,0,7,5,12,8,3,12,20,"7-5","Y","Y","N",5,0,23
"472","E1",2023-12-23,"Leicester","Rotherham",3,0,"H",0,0,"D",1.16,8.62,18.49,"0-0","3-0",24,11,2,0,1,1,0,0,10,0,5,4,3,10,9,"10-0","Y","Y","N",2,0,23
"473","E1",2023-12-23,"Middlesbrough","West Brom",1,0,"H",1,0,"H",2.32,3.41,3.3,"1-0","1-0",13,4,9,2,1,2,0,0,2,10,13,11,1,12,24,"2-10","N","N","N",3,0,23
"474","E1",2023-12-23,"Norwich","Huddersfield",2,0,"H",0,0,"D",1.61,4.22,5.75,"0-0","2-0",21,8,5,1,1,1,0,0,12,2,9,10,2,14,19,"12-2","Y","N","N",2,0,23
"475","E1",2023-12-23,"Plymouth","Birmingham",3,3,"D",1,2,"A",2.22,3.74,3.23,"1-2","3-3",15,8,13,7,2,5,0,1,7,3,7,15,6,10,22,"7-3","Y","Y","Y",7,1,23
"476","E1",2023-12-23,"QPR","Southampton",0,1,"A",0,1,"A",4.9,3.81,1.78,"0-1","0-1",12,2,13,4,1,3,0,1,7,5,8,12,1,12,20,"7-5","N","N","N",4,1,23
"477","E1",2023-12-23,"Sheffield Weds","Cardiff",1,2,"A",1,0,"H",2.18,3.34,3.71,"1-0","1-2",18,5,7,3,3,2,0,0,10,3,10,12,3,13,22,"10-3","Y","Y","N",5,0,23
"478","E1",2023-12-23,"Stoke","Millwall",0,0,"D",0,0,"D",2.15,3.47,3.63,"0-0","0-0",19,3,2,1,1,3,0,0,7,1,11,16,0,8,27,"7-1","N","N","N",4,0,23
"479","E1",2023-12-23,"Sunderland","Coventry",0,3,"A",0,1,"A",2.1,3.65,3.59,"0-1","0-3",21,6,10,5,3,2,0,0,7,7,11,11,3,14,22,"7-7","Y","Y","N",5,0,23
"480","E1",2023-12-26,"Preston","Leeds",2,1,"H",0,0,"D",6.03,4.29,1.58,"0-0","2-1",13,4,11,2,5,1,0,1,5,6,22,12,3,11,34,"5-6","Y","Y","N",6,1,24
"481","E1",2023-12-26,"Millwall","QPR",2,0,"H",1,0,"H",2.2,3.27,3.72,"1-0","2-0",13,3,10,1,3,3,0,0,4,6,12,12,2,10,24,"4-6","Y","N","N",6,0,24
"482","E1",2023-12-26,"Cardiff","Plymouth",2,2,"D",1,1,"D",2.02,3.78,3.73,"1-1","2-2",17,4,13,6,0,1,0,0,7,3,5,9,4,10,14,"7-3","Y","Y","Y",1,0,24
"483","E1",2023-12-26,"Coventry","Sheffield Weds",2,0,"H",1,0,"H",1.76,3.85,4.95,"1-0","2-0",9,2,11,2,1,1,1,1,5,9,7,12,2,14,19,"5-9","Y","N","N",2,2,24
"484","E1",2023-12-26,"Huddersfield","Blackburn",3,0,"H",1,0,"H",3.27,3.77,2.19,"1-0","3-0",12,6,10,1,1,4,0,0,6,4,10,8,3,10,18,"6-4","Y","Y","N",5,0,24
"485","E1",2023-12-26,"Hull","Sunderland",0,1,"A",0,0,"D",2.53,3.47,2.91,"0-0","0-1",10,6,17,3,1,1,0,0,3,7,6,8,1,10,14,"3-7","N","N","N",2,0,24
"486","E1",2023-12-26,"Rotherham","Middlesbrough",1,0,"H",0,0,"D",5.82,4.27,1.6,"0-0","1-0",3,1,19,5,0,0,0,0,0,11,12,8,1,11,20,"0-11","N","N","N",0,0,24
"487","E1",2023-12-26,"Southampton","Swansea",5,0,"H",1,0,"H",1.48,4.83,6.71,"1-0","5-0",11,9,4,1,2,4,0,0,3,1,15,13,5,4,28,"3-1","Y","Y","Y",6,0,24
"488","E1",2023-12-26,"Watford","Bristol City",1,4,"A",0,2,"A",1.97,3.53,4.21,"0-2","1-4",13,5,15,5,1,0,0,0,6,6,10,4,5,12,14,"6-6","Y","Y","Y",1,0,24
"489","E1",2023-12-26,"West Brom","Norwich",1,0,"H",0,0,"D",1.88,3.8,4.24,"0-0","1-0",21,3,7,3,0,0,0,1,12,4,5,8,1,16,13,"12-4","N","N","N",0,1,24
"490","E1",2023-12-26,"Birmingham","Stoke",1,3,"A",0,2,"A",2.73,3.35,2.76,"0-2","1-3",14,5,11,5,2,3,0,0,5,3,10,12,4,8,22,"5-3","Y","Y","Y",5,0,24
"491","E1",2023-12-26,"Ipswich","Leicester",1,1,"D",0,1,"A",3.13,3.67,2.29,"0-1","1-1",19,2,5,2,1,2,0,0,11,2,9,9,2,13,18,"11-2","Y","N","N",3,0,24
"492","E1",2023-12-29,"Southampton","Plymouth",2,1,"H",0,0,"D",1.33,5.98,8.73,"0-0","2-1",26,7,8,1,3,2,0,0,9,3,8,8,3,12,16,"9-3","Y","Y","N",5,0,25
"493","E1",2023-12-29,"Birmingham","Bristol City",0,0,"D",0,0,"D",2.84,3.39,2.63,"0-0","0-0",5,1,8,0,0,0,0,0,1,6,11,6,0,7,17,"1-6","N","N","N",0,0,25
"494","E1",2023-12-29,"Cardiff","Leicester",0,2,"A",0,1,"A",6.02,4.09,1.61,"0-1","0-2",10,2,9,4,1,0,0,0,5,2,11,7,2,7,18,"5-2","Y","N","N",1,0,25
"495","E1",2023-12-29,"Coventry","Swansea",2,2,"D",1,1,"D",1.8,3.96,4.5,"1-1","2-2",21,5,12,4,1,4,0,0,12,4,14,11,4,16,25,"12-4","Y","Y","Y",5,0,25
"496","E1",2023-12-29,"Huddersfield","Middlesbrough",1,2,"A",0,0,"D",4.59,3.92,1.79,"0-0","1-2",16,5,9,5,0,2,0,0,7,2,11,11,3,9,22,"7-2","Y","Y","N",2,0,25
"497","E1",2023-12-29,"Hull","Blackburn",3,2,"H",2,2,"D",1.87,3.98,4.11,"2-2","3-2",21,9,10,4,3,3,0,1,4,4,15,12,5,8,27,"4-4","Y","Y","Y",6,1,25
"498","E1",2023-12-29,"Ipswich","QPR",0,0,"D",0,0,"D",1.47,4.69,7.14,"0-0","0-0",7,5,10,2,3,2,0,0,5,9,13,5,0,14,18,"5-9","N","N","N",5,0,25
"499","E1",2023-12-29,"Millwall","Norwich",1,0,"H",1,0,"H",2.57,3.36,2.94,"1-0","1-0",11,5,11,3,4,5,1,0,5,3,11,12,1,8,23,"5-3","N","N","N",9,1,25
"500","E1",2023-12-29,"Preston","Sheffield Weds",0,1,"A",0,1,"A",2.39,3.12,3.47,"0-1","0-1",9,2,6,3,4,2,0,1,3,0,10,11,1,3,21,"3-0","N","N","N",6,1,25
"501","E1",2023-12-29,"Rotherham","Sunderland",1,1,"D",0,0,"D",6.53,4.32,1.55,"0-0","1-1",13,4,10,3,2,1,0,0,4,8,10,9,2,12,19,"4-8","Y","N","N",3,0,25
"502","E1",2023-12-29,"Watford","Stoke",1,1,"D",1,1,"D",2.19,3.49,3.52,"1-1","1-1",13,6,14,4,4,1,1,0,5,4,7,10,2,9,17,"5-4","Y","N","N",5,1,25
"503","E1",2023-12-29,"West Brom","Leeds",1,0,"H",1,0,"H",3.36,3.39,2.3,"1-0","1-0",13,3,15,1,1,1,0,0,11,8,8,10,1,19,18,"11-8","N","N","N",2,0,25
"504","E1",2024-01-01,"Sunderland","Preston",2,0,"H",2,0,"H",1.6,4.19,6,"2-0","2-0",7,4,12,3,0,1,0,0,2,3,6,12,2,5,18,"2-3","Y","N","N",1,0,26
"505","E1",2024-01-01,"Blackburn","Rotherham",2,2,"D",1,1,"D",1.52,4.85,6.05,"1-1","2-2",18,9,13,4,0,1,0,0,5,5,5,11,4,10,16,"5-5","Y","Y","Y",1,0,26
"506","E1",2024-01-01,"Bristol City","Millwall",0,1,"A",0,0,"D",2.15,3.33,3.8,"0-0","0-1",5,1,11,2,1,2,0,0,6,5,5,10,1,11,15,"6-5","N","N","N",3,0,26
"507","E1",2024-01-01,"Leeds","Birmingham",3,0,"H",2,0,"H",1.25,6.48,12.14,"2-0","3-0",21,11,8,1,0,2,0,0,6,3,10,14,3,9,24,"6-3","Y","Y","N",2,0,26
"508","E1",2024-01-01,"Leicester","Huddersfield",4,1,"H",1,0,"H",1.2,7.26,15.24,"1-0","4-1",19,6,12,4,0,1,0,0,3,4,5,9,5,7,14,"3-4","Y","Y","Y",1,0,26
"509","E1",2024-01-01,"Middlesbrough","Coventry",1,3,"A",1,1,"D",2.04,3.82,3.62,"1-1","1-3",19,7,17,8,2,2,0,0,12,9,10,11,4,21,21,"12-9","Y","Y","Y",4,0,26
"510","E1",2024-01-01,"Norwich","Southampton",1,1,"D",0,0,"D",3.36,3.71,2.17,"0-0","1-1",7,2,21,4,5,0,0,0,1,12,8,8,2,13,16,"1-12","Y","N","N",5,0,26
"511","E1",2024-01-01,"Plymouth","Watford",3,3,"D",3,2,"H",3.04,3.75,2.31,"3-2","3-3",31,11,18,5,2,3,0,0,9,5,11,12,6,14,23,"9-5","Y","Y","Y",5,0,26
"512","E1",2024-01-01,"QPR","Cardiff",1,2,"A",0,1,"A",2.36,3.2,3.44,"0-1","1-2",8,3,10,5,2,5,0,0,1,6,12,20,3,7,32,"1-6","Y","Y","N",7,0,26
"513","E1",2024-01-01,"Stoke","Ipswich",0,0,"D",0,0,"D",2.98,3.48,2.47,"0-0","0-0",8,4,13,2,1,2,1,0,8,5,7,15,0,13,22,"8-5","N","N","N",3,1,26
"514","E1",2024-01-01,"Swansea","West Brom",1,0,"H",0,0,"D",3.35,3.49,2.26,"0-0","1-0",10,4,10,5,2,0,0,0,3,5,10,7,1,8,17,"3-5","N","N","N",2,0,26
"515","E1",2024-01-01,"Sheffield Weds","Hull",3,1,"H",0,0,"D",3.23,3.22,2.46,"0-0","3-1",23,6,5,1,3,4,0,1,10,4,13,13,4,14,26,"10-4","Y","Y","Y",7,1,26
"516","E1",2024-01-12,"Hull","Norwich",1,2,"A",0,1,"A",2.28,3.58,3.23,"0-1","1-2",19,5,9,4,2,4,0,0,9,2,12,14,3,11,26,"9-2","Y","Y","N",6,0,27
"517","E1",2024-01-13,"Coventry","Leicester",3,1,"H",0,1,"A",3.7,3.71,2.05,"0-1","3-1",14,6,8,4,5,3,0,1,7,1,12,14,4,8,26,"7-1","Y","Y","Y",8,1,27
"518","E1",2024-01-13,"Birmingham","Swansea",2,2,"D",1,1,"D",2.33,3.62,3.1,"1-1","2-2",11,6,6,3,5,3,0,0,5,5,21,11,4,10,32,"5-5","Y","Y","Y",8,0,27
"519","E1",2024-01-13,"Cardiff","Leeds",0,3,"A",0,2,"A",5.24,4.11,1.68,"0-2","0-3",9,1,15,7,1,1,0,0,5,4,5,7,3,9,12,"5-4","Y","Y","N",2,0,27
"520","E1",2024-01-13,"Huddersfield","Plymouth",1,1,"D",1,1,"D",2.57,3.72,2.71,"1-1","1-1",13,4,9,3,1,4,0,0,3,5,13,16,2,8,29,"3-5","Y","N","N",5,0,27
"521","E1",2024-01-13,"Millwall","Middlesbrough",1,3,"A",1,1,"D",2.85,3.36,2.64,"1-1","1-3",15,5,14,6,3,1,0,0,5,4,9,10,4,9,19,"5-4","Y","Y","Y",4,0,27
"522","E1",2024-01-13,"Preston","Bristol City",2,0,"H",0,0,"D",2.67,3.19,2.95,"0-0","2-0",12,7,15,6,1,2,0,0,8,6,13,7,2,14,20,"8-6","Y","N","N",3,0,27
"523","E1",2024-01-13,"Rotherham","Stoke",0,1,"A",0,1,"A",4.07,3.66,1.96,"0-1","0-1",3,0,4,3,2,3,0,0,3,6,11,13,1,9,24,"3-6","N","N","N",5,0,27
"524","E1",2024-01-13,"Southampton","Sheffield Weds",4,0,"H",1,0,"H",1.42,4.93,8.13,"1-0","4-0",15,7,6,4,3,3,0,0,14,3,9,12,4,17,21,"14-3","Y","Y","Y",6,0,27
"525","E1",2024-01-13,"West Brom","Blackburn",4,1,"H",3,0,"H",1.75,4.02,4.77,"3-0","4-1",16,8,12,3,2,0,0,0,6,3,8,9,5,9,17,"6-3","Y","Y","Y",2,0,27
"526","E1",2024-01-13,"Ipswich","Sunderland",2,1,"H",1,1,"D",2.15,3.5,3.6,"1-1","2-1",17,5,10,3,5,2,0,0,3,1,17,8,3,4,25,"3-1","Y","Y","N",7,0,27
"527","E1",2024-01-14,"QPR","Watford",1,2,"A",0,0,"D",3.13,3.32,2.46,"0-0","1-2",16,7,9,2,3,3,0,0,8,4,17,13,3,12,30,"8-4","Y","Y","N",6,0,27
"528","E2",2023-08-05,"Barnsley","Port Vale",7,0,"H",2,0,"H",1.8,3.72,4.72,"2-0","7-0",12,8,13,4,6,2,0,0,3,6,15,14,7,9,29,"3-6","Y","Y","Y",8,0,1
"529","E2",2023-08-05,"Blackpool","Burton",2,0,"H",2,0,"H",1.61,4.33,5.45,"2-0","2-0",15,4,9,3,4,1,0,0,7,4,10,12,2,11,22,"7-4","Y","N","N",5,0,1
"530","E2",2023-08-05,"Bolton","Lincoln",3,0,"H",1,0,"H",1.66,3.74,5.02,"1-0","3-0",16,4,6,0,3,3,0,0,10,1,19,16,3,11,35,"10-1","Y","Y","N",6,0,1
"531","E2",2023-08-05,"Cambridge","Oxford",2,0,"H",2,0,"H",3.25,3.34,2.31,"2-0","2-0",10,6,10,3,4,1,0,0,2,10,9,10,2,12,19,"2-10","Y","N","N",5,0,1
"532","E2",2023-08-05,"Carlisle","Fleetwood Town",1,1,"D",1,1,"D",2.27,3.41,3.33,"1-1","1-1",15,6,13,5,2,3,0,0,5,2,8,18,2,7,26,"5-2","Y","N","N",5,0,1
"533","E2",2023-08-05,"Charlton","Leyton Orient",1,0,"H",1,0,"H",2.18,3.48,3.49,"1-0","1-0",13,5,8,3,3,2,0,0,2,3,9,14,1,5,23,"2-3","N","N","N",5,0,1
"534","E2",2023-08-05,"Derby","Wigan",1,2,"A",0,1,"A",1.68,3.97,5.27,"0-1","1-2",21,5,7,3,2,2,0,0,11,4,11,6,3,15,17,"11-4","Y","Y","N",4,0,1
"535","E2",2023-08-05,"Northampton","Stevenage",0,1,"A",0,0,"D",2.68,3.17,2.9,"0-0","0-1",8,0,14,5,2,3,0,0,7,4,13,12,1,11,25,"7-4","N","N","N",5,0,1
"536","E2",2023-08-05,"Portsmouth","Bristol Rvs",1,1,"D",0,1,"A",1.92,3.71,4.09,"0-1","1-1",21,5,10,6,4,3,0,0,11,3,14,13,2,14,27,"11-3","Y","N","N",7,0,1
"537","E2",2023-08-05,"Reading","Peterboro",0,1,"A",0,1,"A",3.15,3.5,2.33,"0-1","0-1",15,4,13,6,6,4,0,0,6,6,12,9,1,12,21,"6-6","N","N","N",10,0,1
"538","E2",2023-08-05,"Shrewsbury","Cheltenham",1,0,"H",0,0,"D",2.34,3.28,3.31,"0-0","1-0",12,3,16,4,3,2,0,0,5,4,10,7,1,9,17,"5-4","N","N","N",5,0,1
"539","E2",2023-08-05,"Wycombe","Exeter",0,3,"A",0,2,"A",1.93,3.68,4.07,"0-2","0-3",10,1,11,7,2,2,0,0,4,5,11,12,3,9,23,"4-5","Y","Y","N",4,0,1
"540","E2",2023-08-12,"Bristol Rvs","Barnsley",1,1,"D",0,1,"A",3.18,3.47,2.32,"0-1","1-1",15,4,9,3,0,3,0,0,7,2,13,10,2,9,23,"7-2","Y","N","N",3,0,2
"541","E2",2023-08-12,"Burton","Derby",0,3,"A",0,1,"A",4.22,3.84,1.85,"0-1","0-3",14,2,8,5,1,3,0,0,6,2,12,7,3,8,19,"6-2","Y","Y","N",4,0,2
"542","E2",2023-08-12,"Cheltenham","Bolton",0,3,"A",0,3,"A",4.17,3.51,1.96,"0-3","0-3",5,2,16,7,2,1,0,0,3,9,7,9,3,12,16,"3-9","Y","Y","N",3,0,2
"543","E2",2023-08-12,"Exeter","Blackpool",0,0,"D",0,0,"D",2.96,3.32,2.54,"0-0","0-0",11,1,4,3,2,1,0,0,6,7,6,7,0,13,13,"6-7","N","N","N",3,0,2
"544","E2",2023-08-12,"Fleetwood Town","Cambridge",0,2,"A",0,1,"A",2.21,3.33,3.56,"0-1","0-2",13,2,16,7,3,3,0,0,9,6,16,14,2,15,30,"9-6","Y","N","N",6,0,2
"545","E2",2023-08-12,"Leyton Orient","Portsmouth",0,4,"A",0,2,"A",2.77,3.51,2.53,"0-2","0-4",11,3,10,4,2,2,0,0,3,3,10,8,4,6,18,"3-3","Y","Y","Y",4,0,2
"546","E2",2023-08-12,"Lincoln","Wycombe",3,0,"H",0,0,"D",2.52,3.27,3.03,"0-0","3-0",14,8,7,4,2,2,0,0,3,6,11,12,3,9,23,"3-6","Y","Y","N",4,0,2
"547","E2",2023-08-12,"Oxford","Carlisle",1,0,"H",0,0,"D",1.79,3.81,4.68,"0-0","1-0",14,3,8,0,0,4,0,0,5,4,9,17,1,9,26,"5-4","N","N","N",4,0,2
"548","E2",2023-08-12,"Peterboro","Charlton",1,0,"H",1,0,"H",1.96,3.78,3.83,"1-0","1-0",14,3,12,2,5,5,0,0,7,5,15,12,1,12,27,"7-5","N","N","N",10,0,2
"549","E2",2023-08-12,"Port Vale","Reading",1,0,"H",0,0,"D",2.7,3.45,2.68,"0-0","1-0",17,3,9,1,0,2,0,0,5,2,7,11,1,7,18,"5-2","N","N","N",2,0,2
"550","E2",2023-08-12,"Stevenage","Shrewsbury",2,0,"H",0,0,"D",2.18,3.27,3.72,"0-0","2-0",14,6,2,1,0,3,0,0,13,3,7,12,2,16,19,"13-3","Y","N","N",3,0,2
"551","E2",2023-08-12,"Wigan","Northampton",2,1,"H",0,1,"A",2.02,3.63,3.78,"0-1","2-1",24,5,17,3,4,4,0,0,8,5,10,14,3,13,24,"8-5","Y","Y","N",8,0,2
"552","E2",2023-08-15,"Barnsley","Peterboro",1,3,"A",0,0,"D",2.26,3.48,3.3,"0-0","1-3",13,7,18,9,0,1,0,0,10,5,7,7,4,15,14,"10-5","Y","Y","Y",1,0,3
"553","E2",2023-08-15,"Blackpool","Port Vale",0,0,"D",0,0,"D",1.85,3.7,4.47,"0-0","0-0",14,4,8,1,1,1,0,0,4,2,5,9,0,6,14,"4-2","N","N","N",2,0,3
"554","E2",2023-08-15,"Bolton","Fleetwood Town",3,1,"H",3,0,"H",1.6,4.27,5.58,"3-0","3-1",8,5,10,7,2,4,1,0,5,12,11,12,4,17,23,"5-12","Y","Y","Y",6,1,3
"555","E2",2023-08-15,"Cambridge","Stevenage",1,2,"A",0,1,"A",2.76,3.28,2.74,"0-1","1-2",11,3,11,6,0,3,0,0,6,3,11,17,3,9,28,"6-3","Y","Y","N",3,0,3
"556","E2",2023-08-15,"Carlisle","Wigan",1,1,"D",0,1,"A",2.82,3.24,2.71,"0-1","1-1",11,2,14,4,4,2,0,0,3,5,15,6,2,8,21,"3-5","Y","N","N",6,0,3
"557","E2",2023-08-15,"Charlton","Bristol Rvs",1,2,"A",0,0,"D",2.29,3.46,3.24,"0-0","1-2",18,5,14,7,1,2,0,0,7,5,12,6,3,12,18,"7-5","Y","Y","N",3,0,3
"558","E2",2023-08-15,"Derby","Oxford",1,2,"A",0,1,"A",1.93,3.55,4.28,"0-1","1-2",11,4,14,4,5,2,0,0,15,4,17,13,3,19,30,"15-4","Y","Y","N",7,0,3
"559","E2",2023-08-15,"Northampton","Lincoln",2,2,"D",0,1,"A",2.85,3.14,2.74,"0-1","2-2",19,9,6,3,1,0,0,0,3,1,9,7,4,4,16,"3-1","Y","Y","Y",1,0,3
"560","E2",2023-08-15,"Shrewsbury","Burton",2,1,"H",2,0,"H",2.36,3.45,3.12,"2-0","2-1",9,3,12,4,1,4,0,0,4,3,7,14,3,7,21,"4-3","Y","Y","N",5,0,3
"561","E2",2023-08-15,"Wycombe","Leyton Orient",3,2,"H",1,1,"D",2.14,3.41,3.66,"1-1","3-2",15,6,15,6,1,3,0,1,3,7,4,8,5,10,12,"3-7","Y","Y","Y",4,1,3
"562","E2",2023-08-15,"Portsmouth","Exeter",1,0,"H",0,0,"D",1.89,3.67,4.24,"0-0","1-0",13,7,9,5,5,1,0,0,8,6,14,11,1,14,25,"8-6","N","N","N",6,0,3
"563","E2",2023-08-15,"Reading","Cheltenham",1,0,"H",1,0,"H",1.84,3.56,4.76,"1-0","1-0",11,4,10,3,2,2,0,0,7,7,11,7,1,14,18,"7-7","N","N","N",4,0,3
"564","E2",2023-08-19,"Bolton","Wigan",0,4,"A",0,3,"A",1.79,3.81,4.63,"0-3","0-4",20,4,11,5,2,3,0,0,4,2,18,11,4,6,29,"4-2","Y","Y","Y",5,0,4
"565","E2",2023-08-19,"Barnsley","Oxford",1,3,"A",0,1,"A",2.13,3.54,3.56,"0-1","1-3",14,6,14,8,3,2,0,0,9,8,10,5,4,17,15,"9-8","Y","Y","Y",5,0,4
"566","E2",2023-08-19,"Blackpool","Leyton Orient",0,0,"D",0,0,"D",1.65,4.18,5.28,"0-0","0-0",15,5,9,2,0,4,0,0,8,1,8,8,0,9,16,"8-1","N","N","N",4,0,4
"567","E2",2023-08-19,"Cambridge","Bristol Rvs",2,0,"H",0,0,"D",2.82,3.45,2.53,"0-0","2-0",12,4,7,5,1,3,0,0,6,4,16,10,2,10,26,"6-4","Y","N","N",4,0,4
"568","E2",2023-08-19,"Carlisle","Exeter",0,2,"A",0,0,"D",2.72,3.31,2.75,"0-0","0-2",13,6,11,3,0,1,0,0,11,3,5,10,2,14,15,"11-3","Y","N","N",1,0,4
"569","E2",2023-08-19,"Charlton","Port Vale",2,3,"A",1,0,"H",1.98,3.71,3.86,"1-0","2-3",17,7,15,5,4,3,0,0,9,4,15,13,5,13,28,"9-4","Y","Y","Y",7,0,4
"570","E2",2023-08-19,"Derby","Fleetwood Town",1,0,"H",1,0,"H",1.57,4.3,5.9,"1-0","1-0",14,3,8,2,3,3,0,0,7,9,11,13,1,16,24,"7-9","N","N","N",6,0,4
"571","E2",2023-08-19,"Northampton","Peterboro",1,0,"H",0,0,"D",3.46,3.7,2.11,"0-0","1-0",9,2,17,1,1,2,0,0,4,5,7,9,1,9,16,"4-5","N","N","N",3,0,4
"572","E2",2023-08-19,"Portsmouth","Cheltenham",0,0,"D",0,0,"D",1.49,4.38,7.18,"0-0","0-0",15,5,12,1,0,3,0,0,5,5,9,14,0,10,23,"5-5","N","N","N",3,0,4
"573","E2",2023-08-19,"Reading","Stevenage",2,0,"H",1,0,"H",2.66,3.28,2.85,"1-0","2-0",20,7,6,4,0,3,0,1,7,0,12,8,2,7,20,"7-0","Y","N","N",3,1,4
"574","E2",2023-08-19,"Shrewsbury","Lincoln",0,1,"A",0,0,"D",2.67,3.16,2.93,"0-0","0-1",11,2,7,3,2,4,0,0,6,1,9,13,1,7,22,"6-1","N","N","N",6,0,4
"575","E2",2023-08-19,"Wycombe","Burton",0,0,"D",0,0,"D",1.91,3.66,4.19,"0-0","0-0",14,8,7,3,2,2,0,0,6,2,10,10,0,8,20,"6-2","N","N","N",4,0,4
"576","E2",2023-08-26,"Bristol Rvs","Wycombe",1,2,"A",0,1,"A",2.13,3.58,3.52,"0-1","1-2",12,1,12,5,3,0,0,0,7,3,12,6,3,10,18,"7-3","Y","Y","N",3,0,5
"577","E2",2023-08-26,"Burton","Bolton",1,1,"D",0,0,"D",3.83,3.61,1.98,"0-0","1-1",13,3,17,6,6,2,0,0,4,8,13,12,2,12,25,"4-8","Y","N","N",8,0,5
"578","E2",2023-08-26,"Cheltenham","Northampton",0,1,"A",0,0,"D",2.6,3.46,2.78,"0-0","0-1",8,2,15,2,1,2,0,0,1,8,8,8,1,9,16,"1-8","N","N","N",3,0,5
"579","E2",2023-08-26,"Exeter","Reading",2,1,"H",1,1,"D",2.03,3.56,3.73,"1-1","2-1",20,4,12,3,3,4,0,0,7,7,10,9,3,14,19,"7-7","Y","Y","N",7,0,5
"580","E2",2023-08-26,"Fleetwood Town","Shrewsbury",0,1,"A",0,1,"A",2.02,3.41,3.95,"0-1","0-1",9,1,5,2,1,3,2,0,9,1,14,12,1,10,26,"9-1","N","N","N",4,2,5
"581","E2",2023-08-26,"Leyton Orient","Cambridge",2,0,"H",1,0,"H",2.45,3.48,2.96,"1-0","2-0",16,3,10,3,4,4,0,0,5,7,15,14,2,12,29,"5-7","Y","N","N",8,0,5
"582","E2",2023-08-26,"Lincoln","Blackpool",3,0,"H",2,0,"H",2.72,3.18,2.85,"2-0","3-0",11,5,14,3,1,0,0,1,1,2,13,13,3,3,26,"1-2","Y","Y","N",1,1,5
"583","E2",2023-08-26,"Oxford","Charlton",2,1,"H",1,0,"H",1.92,3.82,3.97,"1-0","2-1",16,5,9,3,3,6,0,0,7,1,11,16,3,8,27,"7-1","Y","Y","N",9,0,5
"584","E2",2023-08-26,"Peterboro","Derby",2,4,"A",1,4,"A",2.47,3.41,2.92,"1-4","2-4",16,6,14,5,2,1,0,0,8,9,6,12,6,17,18,"8-9","Y","Y","Y",3,0,5
"585","E2",2023-08-26,"Port Vale","Carlisle",1,0,"H",0,0,"D",1.92,3.71,4.08,"0-0","1-0",17,5,10,2,0,0,0,0,8,8,6,9,1,16,15,"8-8","N","N","N",0,0,5
"586","E2",2023-08-26,"Stevenage","Portsmouth",0,0,"D",0,0,"D",2.75,3.36,2.69,"0-0","0-0",12,3,13,2,4,3,1,1,4,7,12,13,0,11,25,"4-7","N","N","N",7,2,5
"587","E2",2023-08-26,"Wigan","Barnsley",0,2,"A",0,1,"A",2.38,3.53,3.02,"0-1","0-2",9,1,19,8,1,3,1,0,4,5,7,14,2,9,21,"4-5","Y","N","N",4,1,5
"588","E2",2023-09-02,"Blackpool","Wigan",2,1,"H",1,0,"H",2.26,3.46,3.31,"1-0","2-1",14,7,6,3,3,3,0,0,4,3,14,7,3,7,21,"4-3","Y","Y","N",6,0,6
"589","E2",2023-09-02,"Bolton","Derby",2,1,"H",1,1,"D",2.2,3.49,3.42,"1-1","2-1",17,4,10,1,3,2,0,1,7,6,11,9,3,13,20,"7-6","Y","Y","N",5,1,6
"590","E2",2023-09-02,"Bristol Rvs","Lincoln",1,1,"D",0,0,"D",2.39,3.59,2.98,"0-0","1-1",11,3,12,5,2,3,0,0,7,5,9,8,2,12,17,"7-5","Y","N","N",5,0,6
"591","E2",2023-09-02,"Burton","Exeter",0,1,"A",0,0,"D",2.9,3.43,2.52,"0-0","0-1",9,5,16,4,2,1,1,0,3,5,14,8,1,8,22,"3-5","N","N","N",3,1,6
"592","E2",2023-09-02,"Carlisle","Shrewsbury",2,0,"H",0,0,"D",2.38,3.33,3.2,"0-0","2-0",11,2,9,2,2,4,0,0,8,6,11,8,2,14,19,"8-6","Y","N","N",6,0,6
"593","E2",2023-09-02,"Charlton","Fleetwood Town",2,1,"H",1,1,"D",2.12,3.8,3.35,"1-1","2-1",17,4,11,3,4,3,0,0,13,4,12,12,3,17,24,"13-4","Y","Y","N",7,0,6
"594","E2",2023-09-02,"Cheltenham","Barnsley",0,2,"A",0,0,"D",4.26,3.76,1.87,"0-0","0-2",17,5,19,5,3,3,0,0,7,4,9,11,2,11,20,"7-4","Y","N","N",6,0,6
"595","E2",2023-09-02,"Leyton Orient","Stevenage",0,3,"A",0,2,"A",2.81,3.36,2.64,"0-2","0-3",8,2,10,4,2,1,0,0,9,6,13,9,3,15,22,"9-6","Y","Y","N",3,0,6
"596","E2",2023-09-02,"Northampton","Wycombe",0,1,"A",0,1,"A",2.45,3.43,2.99,"0-1","0-1",20,6,7,1,0,2,0,0,5,3,12,9,1,8,21,"5-3","N","N","N",2,0,6
"597","E2",2023-09-02,"Oxford","Port Vale",1,2,"A",0,0,"D",1.71,3.87,5.2,"0-0","1-2",13,6,8,5,1,2,2,0,5,3,8,14,3,8,22,"5-3","Y","Y","N",3,2,6
"598","E2",2023-09-02,"Portsmouth","Peterboro",3,1,"H",2,1,"H",2.26,3.58,3.22,"2-1","3-1",18,7,16,4,1,3,1,0,10,9,10,12,4,19,22,"10-9","Y","Y","Y",4,1,6
"599","E2",2023-09-04,"Cambridge","Reading",1,0,"H",0,0,"D",2.27,3.35,3.26,"0-0","1-0",17,3,13,4,1,4,0,0,9,5,8,15,1,14,23,"9-5","N","N","N",5,0,6
"600","E2",2023-09-09,"Exeter","Leyton Orient",1,2,"A",0,0,"D",1.75,3.87,4.85,"0-0","1-2",5,2,19,7,3,3,0,0,4,10,12,10,3,14,22,"4-10","Y","Y","N",6,0,7
"601","E2",2023-09-09,"Stevenage","Carlisle",2,2,"D",1,1,"D",1.79,3.67,4.86,"1-1","2-2",16,8,4,2,2,2,0,0,11,2,13,10,4,13,23,"11-2","Y","Y","Y",4,0,7
"602","E2",2023-09-16,"Barnsley","Burton",2,0,"H",1,0,"H",1.67,4.12,5.1,"1-0","2-0",8,3,8,1,0,0,0,0,0,2,5,10,2,2,15,"0-2","Y","N","N",0,0,7
"603","E2",2023-09-16,"Derby","Portsmouth",1,1,"D",0,0,"D",2.16,3.54,3.47,"0-0","1-1",8,1,14,5,2,3,0,0,4,8,16,9,2,12,25,"4-8","Y","N","N",5,0,7
"604","E2",2023-09-16,"Exeter","Cheltenham",1,0,"H",0,0,"D",1.71,3.78,5.3,"0-0","1-0",20,7,9,2,3,2,0,0,8,2,11,9,1,10,20,"8-2","N","N","N",5,0,7
"605","E2",2023-09-16,"Fleetwood Town","Oxford",0,3,"A",0,2,"A",3.22,3.59,2.25,"0-2","0-3",11,0,10,5,2,0,0,0,9,4,12,7,3,13,19,"9-4","Y","Y","N",2,0,7
"606","E2",2023-09-16,"Lincoln","Carlisle",1,1,"D",0,1,"A",1.88,3.53,4.55,"0-1","1-1",12,4,14,6,1,5,0,0,2,1,9,13,2,3,22,"2-1","Y","N","N",6,0,7
"607","E2",2023-09-16,"Peterboro","Leyton Orient",1,1,"D",1,1,"D",1.85,4.04,4.04,"1-1","1-1",7,5,6,2,2,3,0,0,6,3,8,17,2,9,25,"6-3","Y","N","N",5,0,7
"608","E2",2023-09-16,"Port Vale","Northampton",1,0,"H",0,0,"D",2,3.62,3.88,"0-0","1-0",13,4,5,1,1,0,0,0,5,3,7,6,1,8,13,"5-3","N","N","N",1,0,7
"609","E2",2023-09-16,"Reading","Bolton",2,1,"H",0,1,"A",3.6,3.7,2.06,"0-1","2-1",18,7,10,5,3,4,0,1,6,4,17,15,3,10,32,"6-4","Y","Y","N",7,1,7
"610","E2",2023-09-16,"Shrewsbury","Bristol Rvs",0,2,"A",0,0,"D",3.02,3.34,2.48,"0-0","0-2",12,4,9,4,2,3,0,0,5,6,14,10,2,11,24,"5-6","Y","N","N",5,0,7
"611","E2",2023-09-16,"Stevenage","Charlton",1,1,"D",1,0,"H",2.01,3.68,3.78,"1-0","1-1",9,3,12,1,3,3,0,0,5,4,10,16,2,9,26,"5-4","Y","N","N",6,0,7
"612","E2",2023-09-16,"Wigan","Cambridge",2,1,"H",0,0,"D",2.15,3.71,3.35,"0-0","2-1",6,3,18,3,2,0,0,0,3,2,13,10,3,5,23,"3-2","Y","Y","N",2,0,8
"613","E2",2023-09-16,"Wycombe","Blackpool",2,0,"H",1,0,"H",2.81,3.43,2.59,"1-0","2-0",10,4,11,2,3,1,0,0,0,5,14,11,2,5,25,"0-5","Y","N","N",4,0,8
"614","E2",2023-09-19,"Barnsley","Portsmouth",2,3,"A",0,3,"A",2.49,3.47,2.91,"0-3","2-3",15,3,16,6,0,1,0,0,3,5,13,8,5,8,21,"3-5","Y","Y","Y",1,0,8
"615","E2",2023-09-19,"Peterboro","Cheltenham",3,0,"H",0,0,"D",1.45,4.76,7.19,"0-0","3-0",24,5,2,0,0,0,0,2,15,1,7,6,3,16,13,"15-1","Y","Y","N",0,2,8
"616","E2",2023-09-19,"Port Vale","Burton",2,3,"A",1,1,"D",1.94,3.52,4.23,"1-1","2-3",19,9,8,3,2,3,0,0,7,1,11,12,5,8,23,"7-1","Y","Y","Y",5,0,8
"617","E2",2023-09-23,"Blackpool","Reading",4,1,"H",3,0,"H",1.89,3.65,4.3,"3-0","4-1",17,6,5,4,0,1,0,0,10,3,7,12,5,13,19,"10-3","Y","Y","Y",1,0,8
"618","E2",2023-09-23,"Bolton","Peterboro",1,1,"D",1,1,"D",2.07,3.57,3.69,"1-1","1-1",7,3,25,6,4,2,1,0,8,10,11,14,2,18,25,"8-10","Y","N","N",6,1,8
"619","E2",2023-09-23,"Bristol Rvs","Wigan",4,1,"H",2,1,"H",2.24,3.6,3.23,"2-1","4-1",15,6,9,3,3,2,0,0,3,5,12,15,5,8,27,"3-5","Y","Y","Y",5,0,8
"620","E2",2023-09-23,"Burton","Fleetwood Town",1,1,"D",1,1,"D",2.64,3.49,2.72,"1-1","1-1",13,2,13,4,2,0,0,0,4,5,9,9,2,9,18,"4-5","Y","N","N",2,0,8
"621","E2",2023-09-23,"Cambridge","Port Vale",1,1,"D",0,1,"A",2.33,3.29,3.34,"0-1","1-1",12,5,8,2,0,4,0,0,7,7,9,14,2,14,23,"7-7","Y","N","N",4,0,8
"622","E2",2023-09-23,"Carlisle","Derby",0,2,"A",0,1,"A",3.43,3.54,2.14,"0-1","0-2",9,4,9,2,1,1,0,0,8,2,8,13,2,10,21,"8-2","Y","N","N",2,0,8
"623","E2",2023-09-23,"Charlton","Wycombe",3,1,"H",1,0,"H",2.23,3.6,3.24,"1-0","3-1",9,6,12,1,3,2,0,0,7,6,15,10,4,13,25,"7-6","Y","Y","Y",5,0,8
"624","E2",2023-09-23,"Cheltenham","Stevenage",0,3,"A",0,1,"A",4.39,3.59,1.89,"0-1","0-3",9,2,21,9,1,1,0,0,5,4,4,14,3,9,18,"5-4","Y","Y","N",2,0,9
"625","E2",2023-09-23,"Leyton Orient","Shrewsbury",1,0,"H",1,0,"H",1.94,3.47,4.31,"1-0","1-0",9,1,12,5,4,1,0,0,7,7,12,9,1,14,21,"7-7","N","N","N",5,0,9
"626","E2",2023-09-23,"Northampton","Barnsley",1,2,"A",0,1,"A",3.17,3.61,2.27,"0-1","1-2",12,5,9,4,0,4,0,0,10,2,9,13,3,12,22,"10-2","Y","Y","N",4,0,9
"627","E2",2023-09-23,"Oxford","Exeter",3,0,"H",1,0,"H",1.81,3.83,4.51,"1-0","3-0",9,4,14,5,1,1,0,0,3,4,11,13,3,7,24,"3-4","Y","Y","N",2,0,9
"628","E2",2023-09-23,"Portsmouth","Lincoln",2,1,"H",2,1,"H",1.68,3.86,5.55,"2-1","2-1",11,3,10,4,3,2,0,0,3,1,7,11,3,4,18,"3-1","Y","Y","N",5,0,9
"629","E2",2023-09-30,"Barnsley","Blackpool",0,1,"A",0,1,"A",2.26,3.6,3.19,"0-1","0-1",13,0,6,3,1,7,0,0,5,2,10,13,1,7,23,"5-2","N","N","N",8,0,9
"630","E2",2023-09-30,"Derby","Cambridge",0,0,"D",0,0,"D",1.67,4.17,5.03,"0-0","0-0",12,2,4,1,2,2,0,0,9,3,11,12,0,12,23,"9-3","N","N","N",4,0,9
"631","E2",2023-09-30,"Exeter","Northampton",0,2,"A",0,1,"A",2.07,3.51,3.75,"0-1","0-2",10,2,11,7,1,5,0,0,6,2,11,14,2,8,25,"6-2","Y","N","N",6,0,9
"632","E2",2023-09-30,"Fleetwood Town","Leyton Orient",1,0,"H",0,0,"D",2.45,3.39,3.02,"0-0","1-0",14,3,15,5,1,3,1,1,6,6,10,10,1,12,20,"6-6","N","N","N",4,2,9
"633","E2",2023-09-30,"Lincoln","Cheltenham",2,0,"H",2,0,"H",1.66,4.01,5.36,"2-0","2-0",9,3,10,1,4,1,0,0,2,5,14,10,2,7,24,"2-5","Y","N","N",5,0,9
"634","E2",2023-09-30,"Peterboro","Bristol Rvs",2,0,"H",1,0,"H",1.89,3.73,4.2,"1-0","2-0",15,7,16,2,5,2,0,0,9,9,9,14,2,18,23,"9-9","Y","N","N",7,0,9
"635","E2",2023-09-30,"Port Vale","Bolton",0,1,"A",0,1,"A",3.03,3.45,2.38,"0-1","0-1",15,6,13,5,2,3,0,0,8,5,6,14,1,13,20,"8-5","N","N","N",5,0,9
"636","E2",2023-09-30,"Reading","Burton",0,0,"D",0,0,"D",1.96,3.66,3.96,"0-0","0-0",20,7,3,1,1,4,0,0,5,2,7,11,0,7,18,"5-2","N","N","N",5,0,10
"637","E2",2023-09-30,"Shrewsbury","Charlton",0,0,"D",0,0,"D",3.07,3.43,2.4,"0-0","0-0",15,8,14,6,1,4,0,0,7,7,6,9,0,14,15,"7-7","N","N","N",5,0,10
"638","E2",2023-09-30,"Stevenage","Oxford",1,3,"A",1,1,"D",2.4,3.38,3.12,"1-1","1-3",11,3,15,4,1,2,0,0,9,8,10,9,4,17,19,"9-8","Y","Y","Y",3,0,10
"639","E2",2023-09-30,"Wigan","Portsmouth",1,2,"A",1,2,"A",3.15,3.52,2.31,"1-2","1-2",7,1,16,5,3,2,1,0,1,9,17,16,3,10,33,"1-9","Y","Y","N",5,1,10
"640","E2",2023-09-30,"Wycombe","Carlisle",2,0,"H",1,0,"H",1.88,3.68,4.32,"1-0","2-0",19,6,12,1,2,1,0,1,8,2,12,10,2,10,22,"8-2","Y","N","N",3,1,10
"641","E2",2023-10-03,"Blackpool","Derby",1,3,"A",0,0,"D",2.35,3.38,3.2,"0-0","1-3",10,4,9,5,1,1,0,0,9,3,6,11,4,12,17,"9-3","Y","Y","Y",2,0,10
"642","E2",2023-10-03,"Bolton","Stevenage",3,2,"H",1,1,"D",2.1,3.51,3.65,"1-1","3-2",9,4,11,3,3,2,0,0,4,5,13,13,5,9,26,"4-5","Y","Y","Y",5,0,10
"643","E2",2023-10-03,"Bristol Rvs","Port Vale",3,0,"H",2,0,"H",2.07,3.55,3.7,"2-0","3-0",10,7,6,2,1,1,0,1,8,3,11,13,3,11,24,"8-3","Y","Y","N",2,1,10
"644","E2",2023-10-03,"Burton","Wigan",2,1,"H",0,1,"A",2.74,3.37,2.7,"0-1","2-1",15,5,12,1,2,3,1,0,3,4,14,16,3,7,30,"3-4","Y","Y","N",5,1,10
"645","E2",2023-10-03,"Cambridge","Barnsley",0,4,"A",0,2,"A",2.96,3.55,2.42,"0-2","0-4",17,8,12,7,2,2,0,0,6,6,7,12,4,12,19,"6-6","Y","Y","Y",4,0,10
"646","E2",2023-10-03,"Carlisle","Peterboro",1,1,"D",0,0,"D",3.76,3.61,2.04,"0-0","1-1",8,1,15,6,2,0,0,0,3,8,8,14,2,11,22,"3-8","Y","N","N",2,0,10
"647","E2",2023-10-03,"Charlton","Exeter",4,1,"H",1,1,"D",2.08,3.65,3.57,"1-1","4-1",21,10,12,3,1,0,0,1,9,5,12,10,5,14,22,"9-5","Y","Y","Y",1,1,10
"648","E2",2023-10-03,"Cheltenham","Fleetwood Town",0,2,"A",0,1,"A",3.23,3.43,2.31,"0-1","0-2",7,2,20,5,2,5,1,0,0,3,16,11,2,3,27,"0-3","Y","N","N",7,1,11
"649","E2",2023-10-03,"Northampton","Reading",3,1,"H",2,0,"H",2.41,3.53,2.99,"2-0","3-1",12,5,7,4,1,3,0,0,4,1,5,14,4,5,19,"4-1","Y","Y","Y",4,0,11
"650","E2",2023-10-03,"Oxford","Shrewsbury",3,0,"H",1,0,"H",1.57,4.12,6.29,"1-0","3-0",14,5,4,1,3,0,0,1,4,4,12,12,3,8,24,"4-4","Y","Y","N",3,1,11
"651","E2",2023-10-03,"Portsmouth","Wycombe",2,1,"H",0,1,"A",1.75,3.89,4.82,"0-1","2-1",11,3,8,1,2,4,0,0,14,2,8,13,3,16,21,"14-2","Y","Y","N",6,0,11
"652","E2",2023-10-07,"Oxford","Bristol Rvs",2,1,"H",1,0,"H",1.8,4.01,4.31,"1-0","2-1",17,6,15,7,2,2,2,1,8,3,12,11,3,11,23,"8-3","Y","Y","N",4,3,11
"653","E2",2023-10-07,"Bolton","Carlisle",1,3,"A",1,1,"D",1.5,4.46,6.75,"1-1","1-3",12,3,15,9,2,3,0,0,7,7,11,9,4,14,20,"7-7","Y","Y","Y",5,0,11
"654","E2",2023-10-07,"Charlton","Blackpool",2,2,"D",0,1,"A",2.38,3.57,3,"0-1","2-2",18,5,9,4,2,3,0,0,5,3,5,6,4,8,11,"5-3","Y","Y","Y",5,0,11
"655","E2",2023-10-07,"Cheltenham","Derby",1,1,"D",1,1,"D",6.65,4.35,1.52,"1-1","1-1",6,2,17,8,1,0,0,0,1,8,17,8,2,9,25,"1-8","Y","N","N",1,0,11
"656","E2",2023-10-07,"Exeter","Barnsley",0,1,"A",0,0,"D",2.62,3.66,2.64,"0-0","0-1",13,1,13,3,2,2,0,0,6,6,6,14,1,12,20,"6-6","N","N","N",4,0,11
"657","E2",2023-10-07,"Fleetwood Town","Wycombe",1,4,"A",0,3,"A",2.52,3.43,2.9,"0-3","1-4",9,4,17,12,2,2,1,0,5,3,14,5,5,8,19,"5-3","Y","Y","Y",4,1,11
"658","E2",2023-10-07,"Leyton Orient","Reading",2,1,"H",1,1,"D",2.22,3.59,3.28,"1-1","2-1",17,4,11,5,3,2,0,0,11,7,6,8,3,18,14,"11-7","Y","Y","N",5,0,11
"659","E2",2023-10-07,"Peterboro","Lincoln",2,0,"H",0,0,"D",1.68,3.97,5.33,"0-0","2-0",13,5,12,0,1,2,0,0,6,4,10,8,2,10,18,"6-4","Y","N","N",3,0,11
"660","E2",2023-10-07,"Portsmouth","Port Vale",2,0,"H",0,0,"D",1.66,4.07,5.06,"0-0","2-0",13,4,14,3,1,3,0,0,6,6,8,14,2,12,22,"6-6","Y","N","N",4,0,12
"661","E2",2023-10-07,"Shrewsbury","Northampton",1,0,"H",0,0,"D",2.99,3.22,2.58,"0-0","1-0",13,2,17,2,1,3,0,0,3,10,9,13,1,13,22,"3-10","N","N","N",4,0,12
"662","E2",2023-10-07,"Stevenage","Wigan",1,0,"H",1,0,"H",1.79,3.86,4.55,"1-0","1-0",13,5,10,2,3,9,1,1,8,3,18,18,1,11,36,"8-3","N","N","N",12,2,12
"663","E2",2023-10-09,"Burton","Cambridge",2,1,"H",2,0,"H",2.42,3.25,3.09,"2-0","2-1",11,3,10,2,2,0,0,0,7,7,12,5,3,14,17,"7-7","Y","Y","N",2,0,12
"664","E2",2023-10-14,"Blackpool","Stevenage",3,0,"H",1,0,"H",2.45,3.35,3.06,"1-0","3-0",14,3,7,3,1,3,0,0,6,7,9,7,3,13,16,"6-7","Y","Y","N",4,0,12
"665","E2",2023-10-14,"Cambridge","Shrewsbury",1,1,"D",0,0,"D",2.09,3.4,3.84,"0-0","1-1",10,1,15,2,2,1,0,0,4,5,11,10,2,9,21,"4-5","Y","N","N",3,0,12
"666","E2",2023-10-14,"Carlisle","Leyton Orient",0,1,"A",0,1,"A",2.66,3.27,2.85,"0-1","0-1",10,1,12,5,0,3,0,0,9,3,6,18,1,12,24,"9-3","N","N","N",3,0,12
"667","E2",2023-10-14,"Lincoln","Burton",0,1,"A",0,0,"D",2.05,3.41,3.95,"0-0","0-1",10,3,6,1,1,4,1,0,4,4,8,9,1,8,17,"4-4","N","N","N",5,1,12
"668","E2",2023-10-21,"Bolton","Northampton",2,1,"H",2,0,"H",1.93,3.83,3.88,"2-0","2-1",16,6,9,4,0,1,0,0,6,2,14,11,3,8,25,"6-2","Y","Y","N",1,0,12
"669","E2",2023-10-21,"Burton","Bristol Rvs",4,1,"H",2,1,"H",2.76,3.51,2.59,"2-1","4-1",10,4,13,4,3,1,0,1,4,5,15,8,5,9,23,"4-5","Y","Y","Y",4,1,12
"670","E2",2023-10-21,"Charlton","Reading",4,0,"H",0,0,"D",1.77,4.11,4.38,"0-0","4-0",15,8,15,5,0,0,0,0,6,11,7,10,4,17,17,"6-11","Y","Y","Y",0,0,12
"671","E2",2023-10-21,"Cheltenham","Cambridge",1,0,"H",1,0,"H",3.03,3.3,2.5,"1-0","1-0",20,7,12,2,4,1,0,0,4,3,14,13,1,7,27,"4-3","N","N","N",5,0,12
"672","E2",2023-10-21,"Exeter","Wigan",0,2,"A",0,1,"A",2.17,3.7,3.29,"0-1","0-2",30,4,5,1,4,3,0,0,17,1,10,16,2,18,26,"17-1","Y","N","N",7,0,13
"673","E2",2023-10-21,"Fleetwood Town","Lincoln",0,1,"A",0,1,"A",2.25,3.47,3.32,"0-1","0-1",13,4,11,3,3,4,1,0,8,5,14,13,1,13,27,"8-5","N","N","N",7,1,13
"674","E2",2023-10-21,"Leyton Orient","Barnsley",1,1,"D",1,0,"H",2.89,3.37,2.56,"1-0","1-1",13,4,6,2,0,0,0,1,5,4,6,7,2,9,13,"5-4","Y","N","N",0,1,13
"675","E2",2023-10-21,"Oxford","Blackpool",1,1,"D",1,0,"H",1.94,3.64,4.09,"1-0","1-1",4,2,9,3,0,5,0,0,2,1,8,15,2,3,23,"2-1","Y","N","N",5,0,13
"676","E2",2023-10-21,"Peterboro","Wycombe",2,2,"D",2,1,"H",1.8,3.98,4.38,"2-1","2-2",9,6,13,8,1,0,0,0,9,8,6,6,4,17,12,"9-8","Y","Y","Y",1,0,13
"677","E2",2023-10-21,"Portsmouth","Carlisle",1,0,"H",0,0,"D",1.51,4.46,6.57,"0-0","1-0",18,8,14,3,1,3,0,0,6,3,8,16,1,9,24,"6-3","N","N","N",4,0,13
"678","E2",2023-10-21,"Shrewsbury","Derby",1,0,"H",0,0,"D",4.44,3.6,1.88,"0-0","1-0",16,7,11,6,1,2,0,0,9,8,9,12,1,17,21,"9-8","N","N","N",3,0,13
"679","E2",2023-10-21,"Stevenage","Port Vale",0,0,"D",0,0,"D",1.85,3.68,4.51,"0-0","0-0",12,2,8,3,3,3,0,0,6,7,10,8,0,13,18,"6-7","N","N","N",6,0,13
"680","E2",2023-10-24,"Barnsley","Shrewsbury",3,0,"H",2,0,"H",1.65,3.93,5.75,"2-0","3-0",11,3,13,2,1,2,0,0,3,7,8,9,3,10,17,"3-7","Y","Y","N",3,0,13
"681","E2",2023-10-24,"Blackpool","Cheltenham",3,2,"H",3,1,"H",1.34,5.11,10.33,"3-1","3-2",15,6,8,3,0,2,0,0,2,4,16,16,5,6,32,"2-4","Y","Y","Y",2,0,13
"682","E2",2023-10-24,"Bristol Rvs","Stevenage",1,1,"D",0,1,"A",2.56,3.41,2.86,"0-1","1-1",18,2,11,4,6,4,0,0,4,4,16,22,2,8,38,"4-4","Y","N","N",10,0,13
"683","E2",2023-10-24,"Cambridge","Portsmouth",0,0,"D",0,0,"D",4.95,3.83,1.75,"0-0","0-0",6,1,16,3,1,4,0,0,4,7,11,10,0,11,21,"4-7","N","N","N",5,0,13
"684","E2",2023-10-24,"Carlisle","Burton",2,1,"H",0,1,"A",2.59,3.34,2.88,"0-1","2-1",16,7,5,2,1,3,0,0,7,2,7,10,3,9,17,"7-2","Y","Y","N",4,0,14
"685","E2",2023-10-24,"Derby","Exeter",2,0,"H",1,0,"H",1.6,4.2,5.74,"1-0","2-0",26,8,3,0,2,1,0,0,4,3,9,11,2,7,20,"4-3","Y","N","N",3,0,14
"686","E2",2023-10-24,"Lincoln","Charlton",3,1,"H",1,1,"D",2.99,3.45,2.45,"1-1","3-1",23,9,13,4,0,0,0,0,6,5,8,6,4,11,14,"6-5","Y","Y","Y",0,0,14
"687","E2",2023-10-24,"Northampton","Leyton Orient",2,2,"D",0,1,"A",2.69,3.29,2.8,"0-1","2-2",7,4,19,7,1,3,1,0,5,6,6,10,4,11,16,"5-6","Y","Y","Y",4,1,14
"688","E2",2023-10-24,"Port Vale","Peterboro",0,1,"A",0,1,"A",3.44,3.6,2.15,"0-1","0-1",16,5,10,5,1,5,0,0,6,5,7,10,1,11,17,"6-5","N","N","N",6,0,14
"689","E2",2023-10-24,"Wigan","Oxford",2,0,"H",1,0,"H",3.39,3.7,2.13,"1-0","2-0",10,6,11,6,3,2,0,0,6,9,12,9,2,15,21,"6-9","Y","N","N",5,0,14
"690","E2",2023-10-24,"Wycombe","Bolton",2,4,"A",0,2,"A",2.78,3.44,2.61,"0-2","2-4",12,6,8,4,3,1,0,0,1,3,9,13,6,4,22,"1-3","Y","Y","Y",4,0,14
"691","E2",2023-10-24,"Reading","Fleetwood Town",1,2,"A",0,1,"A",2.29,3.54,3.17,"0-1","1-2",18,6,15,6,1,2,0,0,9,11,12,3,3,20,15,"9-11","Y","Y","N",3,0,14
"692","E2",2023-10-28,"Barnsley","Fleetwood Town",2,2,"D",1,2,"A",1.8,4.02,4.33,"1-2","2-2",25,8,7,4,2,2,0,0,7,3,11,13,4,10,24,"7-3","Y","Y","Y",4,0,14
"693","E2",2023-10-28,"Blackpool","Peterboro",2,4,"A",0,1,"A",2.36,3.38,3.19,"0-1","2-4",11,5,12,5,2,3,1,0,2,6,12,12,6,8,24,"2-6","Y","Y","Y",5,1,14
"694","E2",2023-10-28,"Bristol Rvs","Northampton",2,1,"H",2,0,"H",2.19,3.6,3.34,"2-0","2-1",12,6,12,5,3,1,0,0,2,4,10,11,3,6,21,"2-4","Y","Y","N",4,0,14
"695","E2",2023-10-28,"Burton","Leyton Orient",0,0,"D",0,0,"D",2.75,3.37,2.68,"0-0","0-0",15,3,12,4,1,1,0,0,3,4,5,10,0,7,15,"3-4","N","N","N",2,0,14
"696","E2",2023-10-28,"Cambridge","Carlisle",1,0,"H",0,0,"D",2.46,3.16,3.23,"0-0","1-0",14,3,8,0,2,0,0,2,7,6,7,13,1,13,20,"7-6","N","N","N",2,2,15
"697","E2",2023-10-28,"Charlton","Bolton",0,2,"A",0,2,"A",2.47,3.61,2.84,"0-2","0-2",12,1,12,5,1,1,0,0,9,3,8,10,2,12,18,"9-3","Y","N","N",2,0,15
"698","E2",2023-10-28,"Exeter","Lincoln",1,1,"D",0,1,"A",2.35,3.34,3.24,"0-1","1-1",16,5,12,3,4,4,0,0,7,9,10,12,2,16,22,"7-9","Y","N","N",8,0,15
"699","E2",2023-10-28,"Oxford","Wycombe",2,2,"D",1,0,"H",2,3.6,3.9,"1-0","2-2",18,5,7,4,3,5,0,0,7,5,10,11,4,12,21,"7-5","Y","Y","Y",8,0,15
"700","E2",2023-10-28,"Port Vale","Cheltenham",1,2,"A",1,1,"D",1.68,3.95,5.32,"1-1","1-2",16,5,9,3,2,4,0,0,11,7,12,19,3,18,31,"11-7","Y","Y","N",6,0,15
"701","E2",2023-10-28,"Reading","Portsmouth",2,3,"A",2,2,"D",3.52,3.56,2.13,"2-2","2-3",13,5,18,9,4,2,1,0,6,9,14,8,5,15,22,"6-9","Y","Y","Y",6,1,15
"702","E2",2023-10-28,"Stevenage","Derby",3,1,"H",2,1,"H",2.66,3.25,2.87,"2-1","3-1",11,6,13,3,2,2,0,0,3,7,11,14,4,10,25,"3-7","Y","Y","Y",4,0,15
"703","E2",2023-10-28,"Wigan","Shrewsbury",2,0,"H",1,0,"H",2.05,3.53,3.8,"1-0","2-0",20,7,6,0,1,1,0,1,3,1,9,7,2,4,16,"3-1","Y","N","N",2,1,15
"704","E2",2023-10-31,"Derby","Northampton",4,0,"H",3,0,"H",1.55,4.17,6.61,"3-0","4-0",16,5,3,1,1,2,0,0,8,2,5,9,4,10,14,"8-2","Y","Y","Y",3,0,15
"705","E2",2023-10-31,"Lincoln","Oxford",0,2,"A",0,1,"A",3.6,3.38,2.17,"0-1","0-2",8,3,19,9,0,2,0,0,6,9,6,8,2,15,14,"6-9","Y","N","N",2,0,15
"706","E2",2023-10-31,"Wigan","Charlton",2,3,"A",0,3,"A",2.34,3.7,2.99,"0-3","2-3",13,4,17,7,2,1,0,0,3,4,10,9,5,7,19,"3-4","Y","Y","Y",3,0,15
"707","E2",2023-10-31,"Wycombe","Cambridge",0,0,"D",0,0,"D",1.74,3.9,4.9,"0-0","0-0",12,4,8,1,2,3,0,0,8,1,12,12,0,9,24,"8-1","N","N","N",5,0,15
"708","E2",2023-11-01,"Fleetwood Town","Blackpool",3,3,"D",2,0,"H",3.05,3.38,2.44,"2-0","3-3",14,8,30,7,2,3,0,0,2,8,15,7,6,10,22,"2-8","Y","Y","Y",5,0,16
"709","E2",2023-11-07,"Shrewsbury","Bolton",0,2,"A",0,0,"D",4.23,3.57,1.93,"0-0","0-2",5,2,10,2,0,0,0,0,5,1,10,13,2,6,23,"5-1","Y","N","N",0,0,16
"710","E2",2023-11-07,"Wigan","Peterboro",2,1,"H",1,0,"H",3.2,3.7,2.22,"1-0","2-1",12,3,22,7,3,2,0,0,2,6,15,10,3,8,25,"2-6","Y","Y","N",5,0,16
"711","E2",2023-11-07,"Reading","Bristol Rvs",1,1,"D",1,0,"H",2.7,3.57,2.61,"1-0","1-1",6,5,11,5,3,1,0,0,0,4,16,9,2,4,25,"0-4","Y","N","N",4,0,16
"712","E2",2023-11-11,"Peterboro","Cambridge",5,0,"H",3,0,"H",1.58,4.28,5.78,"3-0","5-0",13,7,7,3,0,0,0,0,4,5,9,7,5,9,16,"4-5","Y","Y","Y",0,0,16
"713","E2",2023-11-11,"Bolton","Blackpool",1,0,"H",0,0,"D",2.16,3.76,3.28,"0-0","1-0",15,5,11,0,5,1,0,0,6,4,14,11,1,10,25,"6-4","N","N","N",6,0,16
"714","E2",2023-11-11,"Carlisle","Bristol Rvs",0,1,"A",0,1,"A",2.99,3.39,2.48,"0-1","0-1",16,5,6,2,4,3,0,1,10,0,11,15,1,10,26,"10-0","N","N","N",7,1,16
"715","E2",2023-11-11,"Cheltenham","Wigan",1,1,"D",1,1,"D",3.33,3.51,2.23,"1-1","1-1",18,6,4,1,2,3,0,0,6,1,15,12,2,7,27,"6-1","Y","N","N",5,0,16
"716","E2",2023-11-11,"Derby","Barnsley",3,0,"H",1,0,"H",1.87,3.72,4.34,"1-0","3-0",14,6,9,1,2,1,0,0,7,8,13,14,3,15,27,"7-8","Y","Y","N",3,0,16
"717","E2",2023-11-11,"Fleetwood Town","Exeter",3,0,"H",3,0,"H",2.28,3.56,3.2,"3-0","3-0",20,12,11,7,2,2,0,0,9,5,8,19,3,14,27,"9-5","Y","Y","N",4,0,16
"718","E2",2023-11-11,"Leyton Orient","Oxford",2,3,"A",0,2,"A",2.78,3.46,2.6,"0-2","2-3",10,1,13,7,2,2,0,0,4,4,7,8,5,8,15,"4-4","Y","Y","Y",4,0,16
"719","E2",2023-11-11,"Lincoln","Port Vale",1,1,"D",0,1,"A",2.32,3.44,3.21,"0-1","1-1",15,3,6,4,0,1,1,1,9,1,5,5,2,10,10,"9-1","Y","N","N",1,2,16
"720","E2",2023-11-11,"Northampton","Burton",2,0,"H",0,0,"D",2.31,3.35,3.3,"0-0","2-0",19,6,10,3,0,2,0,0,5,7,7,13,2,12,20,"5-7","Y","N","N",2,0,17
"721","E2",2023-11-11,"Portsmouth","Charlton",2,2,"D",1,0,"H",1.75,4.08,4.57,"1-0","2-2",21,9,13,7,0,4,0,0,10,3,10,15,4,13,25,"10-3","Y","Y","Y",4,0,17
"722","E2",2023-11-11,"Shrewsbury","Reading",3,2,"H",1,2,"A",2.44,3.37,3.07,"1-2","3-2",17,4,12,3,2,2,0,0,11,5,6,6,5,16,12,"11-5","Y","Y","Y",4,0,17
"723","E2",2023-11-11,"Wycombe","Stevenage",0,1,"A",0,1,"A",2.65,3.37,2.79,"0-1","0-1",4,0,8,2,3,2,0,0,2,7,15,16,1,9,31,"2-7","N","N","N",5,0,17
"724","E2",2023-11-18,"Blackpool","Shrewsbury",4,0,"H",2,0,"H",1.59,3.97,6.41,"2-0","4-0",9,7,8,2,0,1,0,0,5,4,12,11,4,9,23,"5-4","Y","Y","Y",1,0,17
"725","E2",2023-11-18,"Stevenage","Lincoln",1,0,"H",0,0,"D",1.86,3.38,4.95,"0-0","1-0",15,5,4,2,1,1,0,0,6,4,11,12,1,10,23,"6-4","N","N","N",2,0,17
"726","E2",2023-11-21,"Leyton Orient","Lincoln",0,1,"A",0,0,"D",1.98,3.37,4.28,"0-0","0-1",17,6,11,5,2,0,0,0,3,4,13,7,1,7,20,"3-4","N","N","N",2,0,17
"727","E2",2023-11-25,"Bolton","Exeter",7,0,"H",2,0,"H",1.47,4.55,7.21,"2-0","7-0",24,10,1,0,0,1,0,0,5,0,4,9,7,5,13,"5-0","Y","Y","Y",1,0,17
"728","E2",2023-11-25,"Carlisle","Charlton",1,1,"D",0,0,"D",3.06,3.52,2.37,"0-0","1-1",14,5,22,8,0,0,0,0,4,8,8,4,2,12,12,"4-8","Y","N","N",0,0,17
"729","E2",2023-11-25,"Cheltenham","Oxford",2,0,"H",1,0,"H",4.36,3.63,1.69,"1-0","2-0",17,4,20,6,3,2,1,1,8,10,13,14,2,18,27,"8-10","Y","N","N",5,2,17
"730","E2",2023-11-25,"Derby","Bristol Rvs",2,1,"H",0,0,"D",1.59,4.26,5.51,"0-0","2-1",10,6,13,3,0,0,0,0,8,1,5,12,3,9,17,"8-1","Y","Y","N",0,0,17
"731","E2",2023-11-25,"Fleetwood Town","Stevenage",0,3,"A",0,1,"A",3.12,3.52,2.33,"0-1","0-3",31,7,8,3,0,0,0,0,10,6,11,13,3,16,24,"10-6","Y","Y","N",0,0,17
"732","E2",2023-11-25,"Leyton Orient","Wigan",1,1,"D",1,1,"D",1.95,3.7,3.98,"1-1","1-1",16,7,5,2,5,1,0,0,3,3,16,9,2,6,25,"3-3","Y","N","N",6,0,18
"733","E2",2023-11-25,"Lincoln","Barnsley",2,2,"D",1,0,"H",2.96,3.56,2.41,"1-0","2-2",10,4,13,4,1,1,0,0,3,6,9,9,4,9,18,"3-6","Y","Y","Y",2,0,18
"734","E2",2023-11-25,"Northampton","Cambridge",2,1,"H",0,0,"D",2,3.46,3.97,"0-0","2-1",13,5,12,5,1,2,0,1,6,1,11,12,3,7,23,"6-1","Y","Y","N",3,1,18
"735","E2",2023-11-25,"Peterboro","Burton",4,0,"H",2,0,"H",1.51,4.45,6.61,"2-0","4-0",25,8,10,2,1,3,0,0,4,2,6,9,4,6,15,"4-2","Y","Y","Y",4,0,18
"736","E2",2023-11-25,"Portsmouth","Blackpool",0,4,"A",0,1,"A",2.03,3.72,3.58,"0-1","0-4",14,5,17,5,3,3,1,0,7,5,11,12,4,12,23,"7-5","Y","Y","Y",6,1,18
"737","E2",2023-11-25,"Shrewsbury","Port Vale",2,1,"H",1,0,"H",2.49,3.39,2.98,"1-0","2-1",10,4,22,5,4,1,0,0,2,14,14,11,3,16,25,"2-14","Y","Y","N",5,0,18
"738","E2",2023-11-25,"Wycombe","Reading",1,2,"A",1,2,"A",1.85,3.85,4.23,"1-2","1-2",8,1,13,6,2,0,0,0,4,7,9,16,3,11,25,"4-7","Y","Y","N",2,0,18
"739","E2",2023-11-28,"Barnsley","Wycombe",1,0,"H",0,0,"D",1.95,3.82,3.85,"0-0","1-0",15,2,10,2,0,3,0,1,9,2,6,6,1,11,12,"9-2","N","N","N",3,1,18
"740","E2",2023-11-28,"Blackpool","Northampton",1,2,"A",0,1,"A",1.52,4.36,6.66,"0-1","1-2",18,5,10,4,0,4,0,0,4,2,9,12,3,6,21,"4-2","Y","Y","N",4,0,18
"741","E2",2023-11-28,"Bristol Rvs","Leyton Orient",1,1,"D",1,0,"H",2.25,3.45,3.35,"1-0","1-1",10,4,10,3,1,3,0,0,4,11,9,9,2,15,18,"4-11","Y","N","N",4,0,18
"742","E2",2023-11-28,"Burton","Portsmouth",0,2,"A",0,1,"A",4.32,3.68,1.88,"0-1","0-2",20,5,13,3,1,0,1,0,6,4,12,9,2,10,21,"6-4","Y","N","N",1,1,18
"743","E2",2023-11-28,"Cambridge","Lincoln",0,3,"A",0,2,"A",2.61,3.17,2.99,"0-2","0-3",5,2,14,7,2,2,0,0,2,4,13,18,3,6,31,"2-4","Y","Y","N",4,0,18
"744","E2",2023-11-28,"Charlton","Cheltenham",2,1,"H",1,1,"D",1.53,4.46,6.3,"1-1","2-1",19,7,11,1,1,5,0,0,9,4,10,18,3,13,28,"9-4","Y","Y","N",6,0,19
"745","E2",2023-11-28,"Exeter","Shrewsbury",0,0,"D",0,0,"D",2.13,3.43,3.68,"0-0","0-0",13,5,11,4,2,1,0,0,7,5,12,11,0,12,23,"7-5","N","N","N",3,0,19
"746","E2",2023-11-28,"Oxford","Bolton",0,0,"D",0,0,"D",2.76,3.52,2.58,"0-0","0-0",7,5,10,3,2,2,0,0,5,4,9,13,0,9,22,"5-4","N","N","N",4,0,19
"747","E2",2023-11-28,"Port Vale","Derby",0,1,"A",0,0,"D",3.81,3.58,2.03,"0-0","0-1",8,3,11,7,2,0,0,0,9,6,12,9,1,15,21,"9-6","N","N","N",2,0,19
"748","E2",2023-11-28,"Stevenage","Peterboro",2,2,"D",2,0,"H",2.72,3.44,2.67,"2-0","2-2",11,5,22,6,2,0,0,0,5,9,16,13,4,14,29,"5-9","Y","Y","Y",2,0,19
"749","E2",2023-11-28,"Wigan","Fleetwood Town",3,0,"H",2,0,"H",2.3,3.67,3.07,"2-0","3-0",13,7,7,3,1,3,0,1,8,5,9,9,3,13,18,"8-5","Y","Y","N",4,1,19
"750","E2",2023-11-28,"Reading","Carlisle",5,1,"H",3,1,"H",1.89,3.68,4.27,"3-1","5-1",16,6,15,6,1,1,0,0,2,5,13,7,6,7,20,"2-5","Y","Y","Y",2,0,19
"751","E2",2023-12-02,"Northampton","Portsmouth",0,3,"A",0,2,"A",3.66,3.4,2.14,"0-2","0-3",8,3,17,5,1,1,0,0,0,8,7,8,3,8,15,"0-8","Y","Y","N",2,0,19
"752","E2",2023-12-09,"Blackpool","Carlisle",3,0,"H",1,0,"H",1.5,4.44,6.82,"1-0","3-0",13,6,8,4,0,3,0,0,9,4,6,14,3,13,20,"9-4","Y","Y","N",3,0,19
"753","E2",2023-12-09,"Bristol Rvs","Cheltenham",1,1,"D",0,1,"A",1.63,4.11,5.61,"0-1","1-1",15,5,8,1,1,2,0,0,4,6,11,15,2,10,26,"4-6","Y","N","N",3,0,19
"754","E2",2023-12-09,"Burton","Stevenage",1,2,"A",1,1,"D",3.03,3.63,2.22,"1-1","1-2",8,5,14,4,3,2,0,0,3,5,17,7,3,8,24,"3-5","Y","Y","N",5,0,19
"755","E2",2023-12-09,"Charlton","Cambridge",2,2,"D",0,0,"D",1.64,4.29,5.13,"0-0","2-2",10,3,16,6,0,0,0,0,6,10,13,10,4,16,23,"6-10","Y","Y","Y",0,0,19
"756","E2",2023-12-09,"Exeter","Port Vale",0,1,"A",0,1,"A",2.28,3.56,2.98,"0-1","0-1",12,5,12,3,1,2,1,0,12,6,10,9,1,18,19,"12-6","N","N","N",3,1,20
"757","E2",2023-12-09,"Leyton Orient","Derby",0,3,"A",0,1,"A",3.92,3.39,2.07,"0-1","0-3",8,2,13,9,1,1,1,0,8,4,8,15,3,12,23,"8-4","Y","Y","N",2,1,20
"758","E2",2023-12-09,"Northampton","Fleetwood Town",3,0,"H",2,0,"H",2.37,3.44,3.12,"2-0","3-0",23,9,10,4,1,1,0,0,2,6,8,5,3,8,13,"2-6","Y","Y","N",2,0,20
"759","E2",2023-12-09,"Peterboro","Oxford",3,0,"H",2,0,"H",1.91,3.54,3.97,"2-0","3-0",16,9,8,2,1,1,0,0,5,4,10,6,3,9,16,"5-4","Y","Y","N",2,0,20
"760","E2",2023-12-09,"Reading","Barnsley",1,3,"A",1,1,"D",2.83,3.5,2.54,"1-1","1-3",13,6,21,4,2,5,0,0,3,6,12,15,4,9,27,"3-6","Y","Y","Y",7,0,20
"761","E2",2023-12-09,"Wigan","Lincoln",0,0,"D",0,0,"D",2.3,3.51,3.18,"0-0","0-0",3,0,8,1,4,4,0,0,6,5,15,13,0,11,28,"6-5","N","N","N",8,0,20
"762","E2",2023-12-09,"Wycombe","Shrewsbury",0,1,"A",0,1,"A",1.95,3.53,4.18,"0-1","0-1",16,5,6,1,0,0,0,0,7,4,9,6,1,11,15,"7-4","N","N","N",0,0,20
"763","E2",2023-12-11,"Portsmouth","Bolton",2,0,"H",1,0,"H",2.44,3.4,2.94,"1-0","2-0",12,6,10,2,3,4,0,0,6,1,17,13,2,7,30,"6-1","Y","N","N",7,0,20
"764","E2",2023-12-12,"Reading","Oxford",1,1,"D",1,1,"D",2.9,3.48,2.49,"1-1","1-1",7,4,9,1,2,1,0,0,4,7,14,7,2,11,21,"4-7","Y","N","N",3,0,20
"765","E2",2023-12-16,"Barnsley","Charlton",1,1,"D",1,0,"H",1.94,4,3.69,"1-0","1-1",18,5,15,3,4,4,0,0,7,5,12,3,2,12,15,"7-5","Y","N","N",8,0,20
"766","E2",2023-12-16,"Bolton","Bristol Rvs",1,2,"A",0,2,"A",1.65,4.13,5.35,"0-2","1-2",9,3,15,8,4,3,1,0,6,7,7,13,3,13,20,"6-7","Y","Y","N",7,1,20
"767","E2",2023-12-16,"Cambridge","Blackpool",2,1,"H",2,1,"H",4.09,3.65,1.93,"2-1","2-1",8,4,13,5,4,3,1,0,3,5,13,14,3,8,27,"3-5","Y","Y","N",7,1,20
"768","E2",2023-12-16,"Carlisle","Northampton",2,2,"D",0,1,"A",2.81,3.23,2.72,"0-1","2-2",18,3,9,4,0,2,0,0,10,2,6,9,4,12,15,"10-2","Y","Y","Y",2,0,21
"769","E2",2023-12-16,"Cheltenham","Leyton Orient",1,2,"A",0,0,"D",2.8,3.25,2.71,"0-0","1-2",9,3,13,3,2,4,1,0,3,7,12,17,3,10,29,"3-7","Y","Y","N",6,1,21
"770","E2",2023-12-16,"Derby","Wycombe",1,1,"D",0,0,"D",1.49,4.38,7.19,"0-0","1-1",8,2,9,1,5,3,0,0,5,2,8,8,2,7,16,"5-2","Y","N","N",8,0,21
"771","E2",2023-12-16,"Fleetwood Town","Peterboro",0,1,"A",0,1,"A",4.25,4.03,1.81,"0-1","0-1",12,3,24,7,2,0,0,0,4,12,7,11,1,16,18,"4-12","N","N","N",2,0,21
"772","E2",2023-12-16,"Lincoln","Reading",1,1,"D",1,0,"H",2.26,3.45,3.33,"1-0","1-1",4,0,14,6,3,3,0,0,1,5,14,14,2,6,28,"1-5","Y","N","N",6,0,21
"773","E2",2023-12-16,"Oxford","Burton",3,0,"H",1,0,"H",1.58,4.16,6.03,"1-0","3-0",28,14,7,1,0,1,0,0,5,0,6,13,3,5,19,"5-0","Y","Y","N",1,0,21
"774","E2",2023-12-16,"Port Vale","Wigan",3,2,"H",2,0,"H",2.29,3.48,3.24,"2-0","3-2",21,8,7,2,4,5,0,0,6,3,6,10,5,9,16,"6-3","Y","Y","Y",9,0,21
"775","E2",2023-12-16,"Shrewsbury","Portsmouth",0,3,"A",0,1,"A",4.67,3.61,1.83,"0-1","0-3",9,5,13,6,0,2,0,0,0,5,14,12,3,5,26,"0-5","Y","Y","N",2,0,21
"776","E2",2023-12-16,"Stevenage","Exeter",1,1,"D",1,0,"H",1.57,4.13,6.27,"1-0","1-1",11,3,7,3,1,4,0,1,12,3,10,13,2,15,23,"12-3","Y","N","N",5,1,21
"777","E2",2023-12-21,"Derby","Lincoln",3,1,"H",1,1,"D",1.5,4.24,6.79,"1-1","3-1",10,5,6,2,2,3,0,0,4,3,13,6,4,7,19,"4-3","Y","Y","Y",5,0,21
"778","E2",2023-12-22,"Cambridge","Exeter",2,0,"H",1,0,"H",2.08,3.25,4.08,"1-0","2-0",18,4,9,4,0,2,0,0,5,6,5,13,2,11,18,"5-6","Y","N","N",2,0,21
"779","E2",2023-12-23,"Barnsley","Stevenage",2,1,"H",1,1,"D",2.29,3.47,3.24,"1-1","2-1",9,5,14,4,3,1,0,0,1,4,12,11,3,5,23,"1-4","Y","Y","N",4,0,21
"780","E2",2023-12-23,"Blackpool","Bristol Rvs",3,1,"H",1,1,"D",1.81,3.89,4.41,"1-1","3-1",10,6,10,7,2,0,0,0,4,5,4,15,4,9,19,"4-5","Y","Y","Y",2,0,22
"781","E2",2023-12-23,"Bolton","Leyton Orient",3,2,"H",3,0,"H",1.59,4.15,5.94,"3-0","3-2",10,5,16,4,0,4,0,0,2,6,11,17,5,8,28,"2-6","Y","Y","Y",4,0,22
"782","E2",2023-12-23,"Carlisle","Cheltenham",0,1,"A",0,1,"A",2.19,3.41,3.51,"0-1","0-1",10,2,8,2,2,3,0,0,6,4,10,15,1,10,25,"6-4","N","N","N",5,0,22
"783","E2",2023-12-23,"Charlton","Burton",1,1,"D",1,0,"H",1.56,4.47,5.82,"1-0","1-1",15,2,8,3,2,2,0,0,5,5,7,15,2,10,22,"5-5","Y","N","N",4,0,22
"784","E2",2023-12-23,"Northampton","Oxford",2,1,"H",0,0,"D",3.29,3.42,2.29,"0-0","2-1",12,5,9,3,2,1,0,0,5,1,15,11,3,6,26,"5-1","Y","Y","N",3,0,22
"785","E2",2023-12-23,"Portsmouth","Fleetwood Town",1,1,"D",1,0,"H",1.38,5.19,8.14,"1-0","1-1",14,1,14,4,3,1,0,0,7,3,13,17,2,10,30,"7-3","Y","N","N",4,0,22
"786","E2",2023-12-23,"Reading","Wigan",2,0,"H",1,0,"H",2.14,3.6,3.47,"1-0","2-0",10,3,14,2,1,5,0,0,4,2,17,12,2,6,29,"4-2","Y","N","N",6,0,22
"787","E2",2023-12-23,"Shrewsbury","Peterboro",1,2,"A",0,0,"D",5.58,4.29,1.6,"0-0","1-2",7,1,17,4,3,1,0,0,4,9,8,8,3,13,16,"4-9","Y","Y","N",4,0,22
"788","E2",2023-12-23,"Wycombe","Port Vale",1,1,"D",0,0,"D",2.32,3.49,3.16,"0-0","1-1",19,6,8,2,6,1,0,0,7,3,11,6,2,10,17,"7-3","Y","N","N",7,0,22
"789","E2",2023-12-26,"Leyton Orient","Charlton",1,0,"H",0,0,"D",2.58,3.52,2.76,"0-0","1-0",8,4,10,5,5,1,0,0,7,5,12,5,1,12,17,"7-5","N","N","N",6,0,22
"790","E2",2023-12-26,"Bristol Rvs","Portsmouth",2,1,"H",0,0,"D",3.42,3.49,2.21,"0-0","2-1",12,3,11,6,4,6,0,0,3,3,13,16,3,6,29,"3-3","Y","Y","N",10,0,22
"791","E2",2023-12-26,"Burton","Blackpool",1,0,"H",1,0,"H",4.41,3.75,1.85,"1-0","1-0",8,2,10,0,2,1,0,0,3,8,14,13,1,11,27,"3-8","N","N","N",3,0,22
"792","E2",2023-12-26,"Cheltenham","Shrewsbury",2,0,"H",1,0,"H",2.26,3.27,3.52,"1-0","2-0",14,5,16,0,2,5,0,0,5,3,14,15,2,8,29,"5-3","Y","N","N",7,0,23
"793","E2",2023-12-26,"Exeter","Wycombe",1,0,"H",0,0,"D",2.95,3.35,2.53,"0-0","1-0",14,5,11,4,3,2,0,0,8,9,12,8,1,17,20,"8-9","N","N","N",5,0,23
"794","E2",2023-12-26,"Fleetwood Town","Carlisle",1,1,"D",1,1,"D",2.14,3.58,3.48,"1-1","1-1",11,2,9,3,1,0,0,0,5,4,11,7,2,9,18,"5-4","Y","N","N",1,0,23
"795","E2",2023-12-26,"Lincoln","Bolton",0,1,"A",0,0,"D",3.55,3.43,2.18,"0-0","0-1",4,1,21,4,3,1,1,0,0,14,12,7,1,14,19,"0-14","N","N","N",4,1,23
"796","E2",2023-12-26,"Oxford","Cambridge",2,1,"H",0,1,"A",1.76,3.82,4.9,"0-1","2-1",16,9,15,2,2,4,0,0,4,6,9,15,3,10,24,"4-6","Y","Y","N",6,0,23
"797","E2",2023-12-26,"Peterboro","Reading",2,2,"D",1,0,"H",1.5,4.71,6.31,"1-0","2-2",20,5,6,2,1,3,0,0,16,2,7,17,4,18,24,"16-2","Y","Y","Y",4,0,23
"798","E2",2023-12-26,"Port Vale","Barnsley",2,3,"A",0,3,"A",2.94,3.35,2.54,"0-3","2-3",22,7,11,7,3,1,0,0,10,3,7,7,5,13,14,"10-3","Y","Y","Y",4,0,23
"799","E2",2023-12-26,"Stevenage","Northampton",3,0,"H",2,0,"H",1.72,3.8,5.22,"2-0","3-0",11,7,2,0,0,1,0,0,6,1,12,15,3,7,27,"6-1","Y","Y","N",1,0,23
"800","E2",2023-12-26,"Wigan","Derby",0,1,"A",0,1,"A",4.69,3.88,1.78,"0-1","0-1",10,0,12,4,4,3,0,0,6,5,11,13,1,11,24,"6-5","N","N","N",7,0,23
"801","E2",2023-12-29,"Wigan","Carlisle",2,0,"H",2,0,"H",2.06,3.42,3.91,"2-0","2-0",19,3,12,2,4,6,0,0,6,5,11,11,2,11,22,"6-5","Y","N","N",10,0,23
"802","E2",2023-12-29,"Bristol Rvs","Charlton",2,1,"H",0,0,"D",2.07,3.73,3.53,"0-0","2-1",15,5,11,4,0,3,0,0,7,4,10,16,3,11,26,"7-4","Y","Y","N",3,0,23
"803","E2",2023-12-29,"Burton","Shrewsbury",1,0,"H",1,0,"H",2.18,3.16,3.86,"1-0","1-0",5,4,12,1,2,1,0,0,4,7,15,15,1,11,30,"4-7","N","N","N",3,0,23
"804","E2",2023-12-29,"Cheltenham","Reading",2,2,"D",2,2,"D",2.76,3.49,2.61,"2-2","2-2",20,8,13,5,2,4,0,0,7,5,10,13,4,12,23,"7-5","Y","Y","Y",6,0,24
"805","E2",2023-12-29,"Exeter","Portsmouth",0,0,"D",0,0,"D",5.09,3.75,1.75,"0-0","0-0",15,2,10,2,1,2,0,0,3,6,13,13,0,9,26,"3-6","N","N","N",3,0,24
"806","E2",2023-12-29,"Fleetwood Town","Bolton",0,2,"A",0,0,"D",4.82,3.97,1.74,"0-0","0-2",4,1,18,6,2,1,0,0,3,6,14,7,2,9,21,"3-6","Y","N","N",3,0,24
"807","E2",2023-12-29,"Leyton Orient","Wycombe",0,0,"D",0,0,"D",2.5,3.18,3.13,"0-0","0-0",11,3,5,0,1,0,0,0,10,6,7,8,0,16,15,"10-6","N","N","N",1,0,24
"808","E2",2023-12-29,"Lincoln","Northampton",1,2,"A",0,1,"A",2.46,3.19,3.2,"0-1","1-2",13,5,8,4,1,5,1,0,8,4,8,11,3,12,19,"8-4","Y","Y","N",6,1,24
"809","E2",2023-12-29,"Oxford","Derby",2,3,"A",2,1,"H",3.3,3.39,2.29,"2-1","2-3",9,6,20,5,1,4,0,0,2,19,4,17,5,21,21,"2-19","Y","Y","Y",5,0,24
"810","E2",2023-12-29,"Peterboro","Barnsley",2,2,"D",1,2,"A",1.64,4.46,4.95,"1-2","2-2",15,5,20,5,0,1,0,0,3,6,5,13,4,9,18,"3-6","Y","Y","Y",1,0,24
"811","E2",2023-12-29,"Port Vale","Blackpool",3,0,"H",1,0,"H",3.31,3.47,2.15,"1-0","3-0",15,8,14,3,1,2,0,0,3,10,10,17,3,13,27,"3-10","Y","Y","N",3,0,24
"812","E2",2024-01-01,"Barnsley","Wigan",1,1,"D",1,0,"H",1.62,4.21,5.49,"1-0","1-1",12,4,13,1,3,2,0,0,3,7,6,15,2,10,21,"3-7","Y","N","N",5,0,24
"813","E2",2024-01-01,"Blackpool","Lincoln",2,0,"H",1,0,"H",1.68,3.85,5.46,"1-0","2-0",13,5,8,1,3,1,0,0,8,2,18,13,2,10,31,"8-2","Y","N","N",4,0,24
"814","E2",2024-01-01,"Bolton","Burton",1,0,"H",0,0,"D",1.38,5.06,8.52,"0-0","1-0",21,4,7,1,1,2,0,0,11,3,6,13,1,14,19,"11-3","N","N","N",3,0,24
"815","E2",2024-01-01,"Cambridge","Leyton Orient",0,2,"A",0,0,"D",2.51,3.2,3.1,"0-0","0-2",9,2,9,3,1,5,0,0,4,5,5,11,2,9,16,"4-5","Y","N","N",6,0,24
"816","E2",2024-01-01,"Carlisle","Port Vale",2,1,"H",0,0,"D",2.98,3.26,2.56,"0-0","2-1",15,4,10,4,3,2,0,0,6,1,10,16,3,7,26,"6-1","Y","Y","N",5,0,25
"817","E2",2024-01-01,"Charlton","Oxford",1,2,"A",1,1,"D",2.69,3.62,2.59,"1-1","1-2",11,3,12,4,2,2,0,0,9,3,11,10,3,12,21,"9-3","Y","Y","N",4,0,25
"818","E2",2024-01-01,"Derby","Peterboro",2,3,"A",1,1,"D",2.08,3.6,3.61,"1-1","2-3",13,5,20,6,1,1,0,0,1,11,9,4,5,12,13,"1-11","Y","Y","Y",2,0,25
"819","E2",2024-01-01,"Northampton","Cheltenham",1,0,"H",0,0,"D",2.08,3.42,3.83,"0-0","1-0",9,3,14,3,2,3,0,0,7,2,9,11,1,9,20,"7-2","N","N","N",5,0,25
"820","E2",2024-01-01,"Portsmouth","Stevenage",2,1,"H",2,1,"H",2.2,3.49,3.41,"2-1","2-1",12,6,9,5,3,5,0,1,1,5,14,20,3,6,34,"1-5","Y","Y","N",8,1,25
"821","E2",2024-01-01,"Reading","Exeter",3,2,"H",2,1,"H",1.85,3.85,4.28,"2-1","3-2",14,2,8,2,2,0,0,0,0,4,7,9,5,4,16,"0-4","Y","Y","Y",2,0,25
"822","E2",2024-01-01,"Shrewsbury","Fleetwood Town",3,1,"H",2,0,"H",2.66,3.35,2.78,"2-0","3-1",16,6,17,6,4,2,0,0,4,8,18,10,4,12,28,"4-8","Y","Y","Y",6,0,25
"823","E2",2024-01-01,"Wycombe","Bristol Rvs",3,2,"H",1,0,"H",2.81,3.65,2.48,"1-0","3-2",24,8,19,7,6,2,1,0,6,6,12,5,5,12,17,"6-6","Y","Y","Y",8,1,25
"824","E2",2024-01-06,"Fleetwood Town","Derby",1,3,"A",0,2,"A",5.58,4.24,1.61,"0-2","1-3",13,1,11,6,1,1,0,0,3,11,11,9,4,14,20,"3-11","Y","Y","Y",2,0,25
"825","E2",2024-01-06,"Burton","Wycombe",1,1,"D",0,0,"D",3.14,3.29,2.44,"0-0","1-1",10,2,21,4,2,2,0,0,2,10,11,9,2,12,20,"2-10","Y","N","N",4,0,25
"826","E2",2024-01-06,"Cheltenham","Portsmouth",2,1,"H",0,0,"D",4.43,3.88,1.81,"0-0","2-1",11,3,17,6,4,5,0,0,3,9,17,9,3,12,26,"3-9","Y","Y","N",9,0,25
"827","E2",2024-01-06,"Exeter","Carlisle",2,1,"H",0,0,"D",2.19,3.37,3.56,"0-0","2-1",16,6,11,3,4,1,0,0,7,3,10,6,3,10,16,"7-3","Y","Y","N",5,0,25
"828","E2",2024-01-06,"Port Vale","Charlton",3,3,"D",1,1,"D",2.27,3.79,3.04,"1-1","3-3",29,12,7,4,1,4,0,0,12,4,8,12,6,16,20,"12-4","Y","Y","Y",5,0,26
"829","E2",2024-01-13,"Barnsley","Bristol Rvs",2,1,"H",1,0,"H",1.94,3.71,3.98,"1-0","2-1",14,5,15,7,3,1,0,0,6,3,10,10,3,9,20,"6-3","Y","Y","N",4,0,26
"830","E2",2024-01-13,"Blackpool","Exeter",2,0,"H",1,0,"H",1.59,4.21,5.89,"1-0","2-0",14,5,10,4,4,5,0,0,9,4,6,11,2,13,17,"9-4","Y","N","N",9,0,26
"831","E2",2024-01-13,"Cambridge","Fleetwood Town",2,1,"H",0,0,"D",1.99,3.6,3.95,"0-0","2-1",13,3,15,8,0,2,0,0,5,2,8,15,3,7,23,"5-2","Y","Y","N",2,0,26
"832","E2",2024-01-13,"Carlisle","Oxford",1,3,"A",0,1,"A",3.43,3.46,2.21,"0-1","1-3",16,7,11,7,4,2,0,0,3,3,7,4,4,6,11,"3-3","Y","Y","Y",6,0,26
"833","E2",2024-01-13,"Charlton","Peterboro",1,2,"A",0,1,"A",3.16,4.24,2.07,"0-1","1-2",13,5,17,6,1,1,0,0,1,6,11,7,3,7,18,"1-6","Y","Y","N",2,0,26
"834","E2",2024-01-13,"Northampton","Wigan",1,1,"D",1,0,"H",2.37,3.46,3.1,"1-0","1-1",7,2,11,2,3,6,0,0,1,9,17,10,2,10,27,"1-9","Y","N","N",9,0,26
"835","E2",2024-01-13,"Portsmouth","Leyton Orient",0,3,"A",0,3,"A",1.59,4.18,5.93,"0-3","0-3",14,4,14,6,1,4,0,0,5,8,7,12,3,13,19,"5-8","Y","Y","N",5,0,26
"836","E2",2024-01-13,"Shrewsbury","Stevenage",0,1,"A",0,0,"D",4.09,3.39,2.02,"0-0","0-1",6,3,12,2,1,2,0,0,3,2,16,8,1,5,24,"3-2","N","N","N",3,0,26
"837","E2",2024-01-13,"Wycombe","Lincoln",1,1,"D",1,0,"H",1.88,3.47,4.62,"1-0","1-1",12,2,17,3,1,1,0,0,7,7,10,6,2,14,16,"7-7","Y","N","N",2,0,26
"838","E2",2024-01-15,"Derby","Burton",3,2,"H",1,0,"H",1.3,5.41,10.38,"1-0","3-2",19,7,6,2,0,1,0,0,4,3,10,12,5,7,22,"4-3","Y","Y","Y",1,0,26
"839","E3",2023-08-05,"Accrington","Newport County",3,0,"H",1,0,"H",2.49,3.27,3.07,"1-0","3-0",16,8,17,2,2,0,0,0,7,4,11,13,3,11,24,"7-4","Y","Y","N",2,0,1
"840","E3",2023-08-05,"Crawley Town","Bradford",1,0,"H",1,0,"H",4.1,3.5,1.98,"1-0","1-0",21,3,14,7,6,3,0,1,2,4,14,14,1,6,28,"2-4","N","N","N",9,1,1
"841","E3",2023-08-05,"Crewe","Mansfield",2,2,"D",1,2,"A",4.15,3.75,1.87,"1-2","2-2",13,3,21,9,2,4,0,1,10,5,8,16,4,15,24,"10-5","Y","Y","Y",6,1,1
"842","E3",2023-08-05,"Doncaster","Harrogate",0,1,"A",0,0,"D",2.26,3.42,3.35,"0-0","0-1",12,3,7,6,1,4,0,0,6,5,7,20,1,11,27,"6-5","N","N","N",5,0,1
"843","E3",2023-08-05,"Forest Green","Salford",0,2,"A",0,0,"D",3.55,3.53,2.13,"0-0","0-2",19,4,7,3,3,3,0,0,10,4,17,9,2,14,26,"10-4","Y","N","N",6,0,1
"844","E3",2023-08-05,"Grimsby","AFC Wimbledon",0,0,"D",0,0,"D",2.06,3.45,3.87,"0-0","0-0",15,5,10,4,4,3,0,0,8,5,10,12,0,13,22,"8-5","N","N","N",7,0,1
"845","E3",2023-08-05,"Morecambe","Walsall",2,1,"H",1,1,"D",2.7,3.26,2.82,"1-1","2-1",7,5,11,1,6,4,0,0,5,3,12,7,3,8,19,"5-3","Y","Y","N",10,0,1
"846","E3",2023-08-05,"Stockport","Gillingham",0,1,"A",0,0,"D",1.79,3.57,5.1,"0-0","0-1",16,3,6,3,0,5,0,0,6,1,11,11,1,7,22,"6-1","N","N","N",5,0,1
"847","E3",2023-08-05,"Sutton","Notts County",5,1,"H",2,0,"H",4.71,4.13,1.72,"2-0","5-1",12,6,14,3,3,3,0,1,4,5,16,8,6,9,24,"4-5","Y","Y","Y",6,1,1
"848","E3",2023-08-05,"Tranmere","Barrow",1,2,"A",0,1,"A",2.45,3.17,3.23,"0-1","1-2",17,3,7,3,2,2,0,0,7,4,9,8,3,11,17,"7-4","Y","Y","N",4,0,1
"849","E3",2023-08-05,"Wrexham","Milton Keynes Dons",3,5,"A",1,2,"A",1.69,3.98,5.13,"1-2","3-5",23,5,8,6,2,3,0,0,5,4,15,9,8,9,24,"5-4","Y","Y","Y",5,0,1
"850","E3",2023-08-12,"AFC Wimbledon","Wrexham",1,1,"D",0,1,"A",3.61,3.62,2.08,"0-1","1-1",13,3,10,6,3,2,0,0,6,4,12,12,2,10,24,"6-4","Y","N","N",5,0,1
"851","E3",2023-08-12,"Barrow","Sutton",2,1,"H",0,1,"A",2.45,3.13,3.28,"0-1","2-1",17,7,9,3,0,1,0,1,9,1,8,7,3,10,15,"9-1","Y","Y","N",1,1,2
"852","E3",2023-08-12,"Bradford","Colchester",2,1,"H",1,1,"D",1.92,3.57,4.15,"1-1","2-1",19,7,11,2,2,2,0,0,4,11,3,9,3,15,12,"4-11","Y","Y","N",4,0,2
"853","E3",2023-08-12,"Gillingham","Accrington",1,0,"H",1,0,"H",2.08,3.31,3.99,"1-0","1-0",17,4,9,1,3,2,0,0,9,1,14,13,1,10,27,"9-1","N","N","N",5,0,2
"854","E3",2023-08-12,"Harrogate","Forest Green",0,1,"A",0,0,"D",2.4,3.46,3.06,"0-0","0-1",10,3,15,2,1,3,0,0,8,5,7,11,1,13,18,"8-5","N","N","N",4,0,2
"855","E3",2023-08-12,"Mansfield","Morecambe",3,0,"H",1,0,"H",1.56,4.48,5.82,"1-0","3-0",27,6,5,0,2,2,0,0,5,4,9,11,3,9,20,"5-4","Y","Y","N",4,0,2
"856","E3",2023-08-12,"Milton Keynes Dons","Tranmere",1,0,"H",1,0,"H",1.79,3.69,4.83,"1-0","1-0",7,2,16,3,2,1,0,0,3,11,8,12,1,14,20,"3-11","N","N","N",3,0,2
"857","E3",2023-08-12,"Newport County","Doncaster",4,0,"H",3,0,"H",2.25,3.47,3.33,"3-0","4-0",14,6,8,2,4,6,0,0,2,5,10,18,4,7,28,"2-5","Y","Y","Y",10,0,2
"858","E3",2023-08-12,"Notts County","Grimsby",3,2,"H",1,2,"A",1.78,4.16,4.32,"1-2","3-2",12,8,10,3,4,4,0,0,7,6,6,16,5,13,22,"7-6","Y","Y","Y",8,0,2
"859","E3",2023-08-12,"Salford","Crawley Town",1,1,"D",0,1,"A",1.48,4.67,6.68,"0-1","1-1",7,3,16,2,1,4,0,0,2,3,13,10,2,5,23,"2-3","Y","N","N",5,0,2
"860","E3",2023-08-12,"Swindon","Crewe",2,2,"D",1,0,"H",1.86,3.6,4.54,"1-0","2-2",20,6,16,5,4,6,0,0,7,2,13,13,4,9,26,"7-2","Y","Y","Y",10,0,2
"861","E3",2023-08-12,"Walsall","Stockport",2,1,"H",1,0,"H",4.13,3.32,2.04,"1-0","2-1",9,2,18,3,3,5,0,0,4,11,8,9,3,15,17,"4-11","Y","Y","N",8,0,2
"862","E3",2023-08-15,"Accrington","Barrow",1,1,"D",1,0,"H",2.61,3.19,2.97,"1-0","1-1",7,2,13,1,2,1,0,0,1,10,10,5,2,11,15,"1-10","Y","N","N",3,0,2
"863","E3",2023-08-15,"Colchester","AFC Wimbledon",0,2,"A",0,0,"D",2.37,3.21,3.34,"0-0","0-2",9,4,21,7,3,3,0,0,7,9,8,12,2,16,20,"7-9","Y","N","N",6,0,3
"864","E3",2023-08-15,"Crawley Town","Milton Keynes Dons",2,1,"H",1,1,"D",3.06,3.44,2.41,"1-1","2-1",14,5,8,2,1,2,0,0,7,5,8,11,3,12,19,"7-5","Y","Y","N",3,0,3
"865","E3",2023-08-15,"Crewe","Newport County",4,2,"H",1,1,"D",3.21,3.42,2.33,"1-1","4-2",10,6,14,7,0,2,0,0,1,5,4,12,6,6,16,"1-5","Y","Y","Y",2,0,3
"866","E3",2023-08-15,"Doncaster","Mansfield",2,2,"D",1,1,"D",4.3,3.71,1.88,"1-1","2-2",11,5,21,8,1,3,0,0,3,7,8,10,4,10,18,"3-7","Y","Y","Y",4,0,3
"867","E3",2023-08-15,"Forest Green","Swindon",1,2,"A",1,0,"H",2.75,3.4,2.66,"1-0","1-2",13,5,21,8,4,3,1,0,6,5,12,11,3,11,23,"6-5","Y","Y","N",7,1,3
"868","E3",2023-08-15,"Grimsby","Salford",2,0,"H",1,0,"H",2.7,3.3,2.78,"1-0","2-0",10,2,7,1,0,3,0,1,2,7,16,16,2,9,32,"2-7","Y","N","N",3,1,3
"869","E3",2023-08-15,"Morecambe","Notts County",0,0,"D",0,0,"D",4.3,4.03,1.8,"0-0","0-0",13,1,9,1,1,1,0,0,4,5,7,4,0,9,11,"4-5","N","N","N",2,0,3
"870","E3",2023-08-15,"Stockport","Bradford",1,1,"D",0,0,"D",1.85,3.46,4.84,"0-0","1-1",15,5,10,6,2,3,0,0,7,4,8,16,2,11,24,"7-4","Y","N","N",5,0,3
"871","E3",2023-08-15,"Sutton","Gillingham",0,1,"A",0,1,"A",2.68,3.18,2.91,"0-1","0-1",6,2,5,1,2,1,0,0,2,9,6,10,1,11,16,"2-9","N","N","N",3,0,3
"872","E3",2023-08-15,"Tranmere","Harrogate",3,0,"H",2,0,"H",2.14,3.4,3.67,"2-0","3-0",11,5,11,2,2,1,0,0,6,3,10,17,3,9,27,"6-3","Y","Y","N",3,0,3
"873","E3",2023-08-15,"Wrexham","Walsall",4,2,"H",2,1,"H",1.62,4.28,5.36,"2-1","4-2",20,11,12,5,1,3,0,0,6,3,3,9,6,9,12,"6-3","Y","Y","Y",4,0,3
"874","E3",2023-08-19,"Accrington","Harrogate",2,1,"H",1,0,"H",2.13,3.46,3.53,"1-0","2-1",23,7,11,2,4,4,1,0,5,3,14,15,3,8,29,"5-3","Y","Y","N",8,1,3
"875","E3",2023-08-19,"Colchester","Milton Keynes Dons",2,3,"A",2,1,"H",2.86,3.28,2.64,"2-1","2-3",12,4,18,6,5,4,0,0,3,6,16,8,5,9,24,"3-6","Y","Y","Y",9,0,4
"876","E3",2023-08-19,"Crawley Town","Gillingham",0,1,"A",0,1,"A",3.13,3.1,2.52,"0-1","0-1",17,7,7,2,3,3,0,0,9,4,8,10,1,13,18,"9-4","N","N","N",6,0,4
"877","E3",2023-08-19,"Crewe","Walsall",2,2,"D",0,2,"A",2.71,3.41,2.7,"0-2","2-2",11,3,19,7,1,1,0,0,8,5,6,10,4,13,16,"8-5","Y","Y","Y",2,0,4
"878","E3",2023-08-19,"Doncaster","Notts County",1,3,"A",0,1,"A",4.23,3.75,1.88,"0-1","1-3",10,6,8,5,0,3,0,0,4,3,10,8,4,7,18,"4-3","Y","Y","Y",3,0,4
"879","E3",2023-08-19,"Forest Green","Newport County",0,3,"A",0,2,"A",2.55,3.47,2.83,"0-2","0-3",12,1,10,7,2,0,1,0,7,4,6,7,3,11,13,"7-4","Y","Y","N",2,1,4
"880","E3",2023-08-19,"Grimsby","Mansfield",1,1,"D",1,0,"H",3.23,3.46,2.3,"1-0","1-1",8,3,20,4,0,0,0,0,4,6,7,11,2,10,18,"4-6","Y","N","N",0,0,4
"881","E3",2023-08-19,"Morecambe","Bradford",3,0,"H",1,0,"H",3.53,3.45,2.17,"1-0","3-0",11,3,12,5,3,3,0,0,6,3,15,11,3,9,26,"6-3","Y","Y","N",6,0,4
"882","E3",2023-08-19,"Stockport","Barrow",1,0,"H",0,0,"D",1.72,3.87,5.08,"0-0","1-0",11,5,10,3,2,1,0,0,4,3,10,5,1,7,15,"4-3","N","N","N",3,0,4
"883","E3",2023-08-19,"Sutton","AFC Wimbledon",0,3,"A",0,0,"D",2.46,3.27,3.13,"0-0","0-3",10,4,15,5,2,1,0,0,4,5,7,18,3,9,25,"4-5","Y","Y","N",3,0,4
"884","E3",2023-08-19,"Tranmere","Salford",3,4,"A",2,1,"H",2.86,3.36,2.59,"2-1","3-4",13,6,15,6,1,2,0,0,4,5,14,10,7,9,24,"4-5","Y","Y","Y",3,0,4
"885","E3",2023-08-19,"Wrexham","Swindon",5,5,"D",1,4,"A",1.62,4.31,5.37,"1-4","5-5",28,12,8,6,1,3,0,0,9,2,12,17,10,11,29,"9-2","Y","Y","Y",4,0,4
"886","E3",2023-08-26,"AFC Wimbledon","Forest Green",1,1,"D",1,0,"H",1.82,3.7,4.64,"1-0","1-1",22,6,8,3,2,1,0,0,9,2,12,4,2,11,16,"9-2","Y","N","N",3,0,4
"887","E3",2023-08-26,"Barrow","Wrexham",1,1,"D",0,1,"A",3.37,3.54,2.2,"0-1","1-1",5,2,12,4,3,2,0,0,3,10,9,9,2,13,18,"3-10","Y","N","N",5,0,5
"888","E3",2023-08-26,"Bradford","Crewe",1,0,"H",1,0,"H",1.65,4.24,5.13,"1-0","1-0",12,2,10,3,2,0,0,0,4,11,10,8,1,15,18,"4-11","N","N","N",2,0,5
"889","E3",2023-08-26,"Gillingham","Colchester",0,3,"A",0,0,"D",1.83,3.44,5.02,"0-0","0-3",10,4,12,5,2,4,1,0,3,4,14,18,3,7,32,"3-4","Y","Y","N",6,1,5
"890","E3",2023-08-26,"Harrogate","Morecambe",2,0,"H",1,0,"H",2.39,3.51,3.03,"1-0","2-0",16,6,9,1,3,3,0,1,1,4,13,11,2,5,24,"1-4","Y","N","N",6,1,5
"891","E3",2023-08-26,"Mansfield","Stockport",3,2,"H",1,2,"A",2.36,3.36,3.22,"1-2","3-2",28,11,10,3,1,0,0,0,11,1,5,7,5,12,12,"11-1","Y","Y","Y",1,0,5
"892","E3",2023-08-26,"Milton Keynes Dons","Doncaster",2,1,"H",2,0,"H",1.7,3.96,5.11,"2-0","2-1",9,5,17,6,1,1,0,0,2,8,8,17,3,10,25,"2-8","Y","Y","N",2,0,5
"893","E3",2023-08-26,"Newport County","Sutton",3,1,"H",0,0,"D",1.99,3.54,3.99,"0-0","3-1",13,5,15,5,1,3,0,0,1,6,8,10,4,7,18,"1-6","Y","Y","Y",4,0,5
"894","E3",2023-08-26,"Notts County","Tranmere",2,1,"H",1,0,"H",1.6,4.43,5.35,"1-0","2-1",17,6,12,4,3,3,0,0,11,3,6,8,3,14,14,"11-3","Y","Y","N",6,0,5
"895","E3",2023-08-26,"Salford","Accrington",1,2,"A",0,2,"A",1.77,3.84,4.59,"0-2","1-2",16,2,16,6,3,3,0,0,1,6,20,10,3,7,30,"1-6","Y","Y","N",6,0,5
"896","E3",2023-08-26,"Swindon","Crawley Town",6,0,"H",1,0,"H",2.08,3.78,3.46,"1-0","6-0",17,10,14,3,0,1,0,0,5,6,10,10,6,11,20,"5-6","Y","Y","Y",1,0,5
"897","E3",2023-08-26,"Walsall","Grimsby",1,1,"D",0,0,"D",2.46,3.35,3.05,"0-0","1-1",16,6,11,2,2,3,1,0,8,10,13,11,2,18,24,"8-10","Y","N","N",5,1,5
"898","E3",2023-09-02,"Tranmere","Wrexham",0,1,"A",0,0,"D",3.58,3.91,2,"0-0","0-1",11,2,23,5,1,1,0,0,7,17,7,11,1,24,18,"7-17","N","N","N",2,0,5
"899","E3",2023-09-02,"Crewe","Milton Keynes Dons",3,1,"H",0,1,"A",3.03,3.57,2.36,"0-1","3-1",15,7,12,4,4,1,0,0,8,2,12,8,4,10,20,"8-2","Y","Y","Y",5,0,6
"900","E3",2023-09-02,"Doncaster","Swindon",0,0,"D",0,0,"D",2.88,3.46,2.52,"0-0","0-0",6,3,13,2,4,4,1,0,1,11,9,15,0,12,24,"1-11","N","N","N",8,1,6
"901","E3",2023-09-02,"Grimsby","Gillingham",2,0,"H",2,0,"H",2.52,3.3,3.01,"2-0","2-0",12,4,6,3,1,0,0,0,6,4,6,12,2,10,18,"6-4","Y","N","N",1,0,6
"902","E3",2023-09-02,"Harrogate","Barrow",0,1,"A",0,1,"A",2.6,3.3,2.9,"0-1","0-1",12,5,10,2,2,2,0,0,8,6,11,10,1,14,21,"8-6","N","N","N",4,0,6
"903","E3",2023-09-02,"Mansfield","Bradford",0,0,"D",0,0,"D",1.82,3.78,4.51,"0-0","0-0",11,1,9,2,2,4,0,0,8,2,10,12,0,10,22,"8-2","N","N","N",6,0,6
"904","E3",2023-09-02,"Morecambe","Salford",1,0,"H",1,0,"H",2.94,3.54,2.44,"1-0","1-0",11,5,7,2,0,0,0,1,9,3,14,11,1,12,25,"9-3","N","N","N",0,1,6
"905","E3",2023-09-02,"Newport County","AFC Wimbledon",2,2,"D",1,2,"A",2.61,3.34,2.86,"1-2","2-2",11,4,14,4,1,1,0,0,6,3,6,8,4,9,14,"6-3","Y","Y","Y",2,0,6
"906","E3",2023-09-02,"Notts County","Accrington",3,1,"H",1,1,"D",1.59,4.51,5.32,"1-1","3-1",10,5,16,6,4,2,0,0,2,7,11,11,4,9,22,"2-7","Y","Y","Y",6,0,6
"907","E3",2023-09-02,"Stockport","Crawley Town",3,3,"D",2,1,"H",1.56,4.35,6.01,"2-1","3-3",17,5,8,5,1,5,0,0,2,3,7,12,6,5,19,"2-3","Y","Y","Y",6,0,6
"908","E3",2023-09-02,"Sutton","Forest Green",0,1,"A",0,0,"D",2.09,3.45,3.76,"0-0","0-1",12,2,17,6,1,2,0,0,7,3,13,14,1,10,27,"7-3","N","N","N",3,0,6
"909","E3",2023-09-02,"Walsall","Colchester",1,0,"H",0,0,"D",2.14,3.46,3.6,"0-0","1-0",16,7,10,3,4,1,0,0,6,4,17,9,1,10,26,"6-4","N","N","N",5,0,6
"910","E3",2023-09-09,"Bradford","Grimsby",1,1,"D",0,1,"A",2.06,3.45,3.87,"0-1","1-1",9,1,7,3,2,4,0,0,7,2,10,10,2,9,20,"7-2","Y","N","N",6,0,6
"911","E3",2023-09-09,"Accrington","Mansfield",0,3,"A",0,2,"A",3.56,3.57,2.11,"0-2","0-3",13,2,12,5,1,1,0,0,5,4,13,17,3,9,30,"5-4","Y","Y","N",2,0,7
"912","E3",2023-09-09,"AFC Wimbledon","Stockport",1,2,"A",1,0,"H",2.81,3.34,2.65,"1-0","1-2",9,4,12,3,2,2,0,0,3,5,13,7,3,8,20,"3-5","Y","Y","N",4,0,7
"913","E3",2023-09-09,"Colchester","Tranmere",2,0,"H",1,0,"H",2.32,3.5,3.16,"1-0","2-0",27,12,10,4,2,4,0,0,11,5,10,8,2,16,18,"11-5","Y","N","N",6,0,7
"914","E3",2023-09-09,"Crawley Town","Newport County",4,1,"H",1,1,"D",3.07,3.49,2.38,"1-1","4-1",13,8,9,5,2,1,0,0,4,0,8,9,5,4,17,"4-0","Y","Y","Y",3,0,7
"915","E3",2023-09-09,"Forest Green","Crewe",1,4,"A",1,0,"H",2.18,3.52,3.44,"1-0","1-4",9,4,18,5,4,3,0,0,3,7,12,10,5,10,22,"3-7","Y","Y","Y",7,0,7
"916","E3",2023-09-09,"Gillingham","Harrogate",1,0,"H",0,0,"D",1.85,3.57,4.69,"0-0","1-0",15,4,5,2,3,1,0,0,10,2,12,7,1,12,19,"10-2","N","N","N",4,0,7
"917","E3",2023-09-09,"Milton Keynes Dons","Notts County",1,1,"D",0,0,"D",2.89,3.86,2.33,"0-0","1-1",11,3,9,3,1,0,0,0,3,6,12,5,2,9,17,"3-6","Y","N","N",1,0,7
"918","E3",2023-09-09,"Salford","Walsall",1,2,"A",1,0,"H",2.1,3.68,3.49,"1-0","1-2",20,7,10,5,2,1,0,0,12,1,12,12,3,13,24,"12-1","Y","Y","N",3,0,7
"919","E3",2023-09-09,"Swindon","Sutton",5,3,"H",3,2,"H",1.83,3.85,4.34,"3-2","5-3",15,7,13,5,1,2,0,0,5,3,4,6,8,8,10,"5-3","Y","Y","Y",3,0,7
"920","E3",2023-09-09,"Wrexham","Doncaster",2,1,"H",1,0,"H",1.43,5.03,7.21,"1-0","2-1",16,8,8,2,2,3,0,0,6,4,9,13,3,10,22,"6-4","Y","Y","N",5,0,7
"921","E3",2023-09-15,"Salford","Notts County",0,2,"A",0,1,"A",3.05,3.9,2.23,"0-1","0-2",12,2,14,4,3,2,1,1,1,8,11,11,2,9,22,"1-8","Y","N","N",5,2,7
"922","E3",2023-09-16,"Accrington","Sutton",4,1,"H",1,0,"H",2.09,3.63,3.57,"1-0","4-1",15,5,12,1,3,1,0,0,2,3,10,12,5,5,22,"2-3","Y","Y","Y",4,0,7
"923","E3",2023-09-16,"AFC Wimbledon","Crewe",2,2,"D",2,0,"H",1.8,3.96,4.41,"2-0","2-2",21,6,9,4,2,2,0,0,13,7,11,9,4,20,20,"13-7","Y","Y","Y",4,0,8
"924","E3",2023-09-16,"Bradford","Harrogate",1,1,"D",0,0,"D",1.76,3.74,4.95,"0-0","1-1",9,3,8,1,0,2,0,0,3,5,8,10,2,8,18,"3-5","Y","N","N",2,0,8
"925","E3",2023-09-16,"Colchester","Mansfield",1,1,"D",1,0,"H",3.64,3.83,2,"1-0","1-1",12,4,10,5,4,3,0,0,3,4,9,4,2,7,13,"3-4","Y","N","N",7,0,8
"926","E3",2023-09-16,"Crawley Town","Tranmere",3,2,"H",0,1,"A",2.22,3.59,3.28,"0-1","3-2",16,7,7,4,4,5,0,0,9,0,7,9,5,9,16,"9-0","Y","Y","Y",9,0,8
"927","E3",2023-09-16,"Forest Green","Doncaster",1,2,"A",0,1,"A",2.21,3.59,3.3,"0-1","1-2",28,3,15,7,4,2,0,0,10,12,8,10,3,22,18,"10-12","Y","Y","N",6,0,8
"928","E3",2023-09-16,"Gillingham","Morecambe",2,1,"H",2,1,"H",1.79,3.7,4.81,"2-1","2-1",11,5,5,3,2,3,0,1,4,3,8,16,3,7,24,"4-3","Y","Y","N",5,1,8
"929","E3",2023-09-16,"Milton Keynes Dons","Stockport",1,2,"A",1,2,"A",3.03,3.61,2.35,"1-2","1-2",20,3,10,5,4,2,0,0,9,4,11,10,3,13,21,"9-4","Y","Y","N",6,0,8
"930","E3",2023-09-16,"Newport County","Barrow",1,1,"D",1,0,"H",2.09,3.44,3.77,"1-0","1-1",8,2,6,3,2,2,1,0,3,10,13,17,2,13,30,"3-10","Y","N","N",4,1,8
"931","E3",2023-09-16,"Swindon","Walsall",2,0,"H",1,0,"H",1.97,3.81,3.76,"1-0","2-0",12,6,7,2,2,2,0,1,4,2,5,10,2,6,15,"4-2","Y","N","N",4,1,8
"932","E3",2023-09-16,"Wrexham","Grimsby",3,0,"H",2,0,"H",1.66,4.19,5.1,"2-0","3-0",17,9,9,1,2,2,0,0,3,1,7,6,3,4,13,"3-1","Y","Y","N",4,0,8
"933","E3",2023-09-23,"Crewe","Colchester",2,1,"H",2,0,"H",2.48,3.65,2.8,"2-0","2-1",10,3,21,6,1,0,0,0,6,10,15,11,3,16,26,"6-10","Y","Y","N",1,0,8
"934","E3",2023-09-23,"Doncaster","Gillingham",2,1,"H",1,1,"D",3.26,3.17,2.43,"1-1","2-1",13,6,15,5,2,2,0,0,7,6,9,10,3,13,19,"7-6","Y","Y","N",4,0,8
"935","E3",2023-09-23,"Grimsby","Crawley Town",2,3,"A",2,2,"D",2.07,3.62,3.64,"2-2","2-3",18,7,13,3,1,1,0,0,5,5,14,8,5,10,22,"5-5","Y","Y","Y",2,0,9
"936","E3",2023-09-23,"Harrogate","Salford",3,2,"H",2,1,"H",2.95,3.45,2.47,"2-1","3-2",16,7,18,5,2,2,0,0,7,5,6,10,5,12,16,"7-5","Y","Y","Y",4,0,9
"937","E3",2023-09-23,"Mansfield","Barrow",1,0,"H",0,0,"D",1.66,3.95,5.56,"0-0","1-0",14,2,9,2,2,1,0,1,6,2,9,11,1,8,20,"6-2","N","N","N",3,1,9
"938","E3",2023-09-23,"Morecambe","Swindon",2,2,"D",1,1,"D",3.39,3.77,2.11,"1-1","2-2",16,4,13,5,1,2,1,0,9,4,11,6,4,13,17,"9-4","Y","Y","Y",3,1,9
"939","E3",2023-09-23,"Newport County","Bradford",1,4,"A",1,3,"A",2.4,3.32,3.16,"1-3","1-4",7,1,17,7,2,1,0,0,6,7,9,8,5,13,17,"6-7","Y","Y","Y",3,0,9
"940","E3",2023-09-23,"Notts County","Forest Green",4,3,"H",2,0,"H",1.51,4.79,5.96,"2-0","4-3",11,6,14,4,3,5,0,0,7,10,10,11,7,17,21,"7-10","Y","Y","Y",8,0,9
"941","E3",2023-09-23,"Stockport","Wrexham",5,0,"H",3,0,"H",2.52,3.73,2.72,"3-0","5-0",10,5,20,5,1,1,0,0,1,5,10,13,5,6,23,"1-5","Y","Y","Y",2,0,9
"942","E3",2023-09-23,"Sutton","Milton Keynes Dons",1,1,"D",1,0,"H",2.66,3.42,2.74,"1-0","1-1",10,5,12,2,0,1,0,0,7,10,10,13,2,17,23,"7-10","Y","N","N",1,0,9
"943","E3",2023-09-23,"Tranmere","Accrington",2,0,"H",1,0,"H",2.74,3.49,2.62,"1-0","2-0",17,7,9,3,0,3,0,1,8,6,11,16,2,14,27,"8-6","Y","N","N",3,1,9
"944","E3",2023-09-23,"Walsall","AFC Wimbledon",1,3,"A",0,1,"A",2.64,3.43,2.76,"0-1","1-3",5,1,15,6,0,2,1,0,0,5,9,13,4,5,22,"0-5","Y","Y","Y",2,1,9
"945","E3",2023-09-30,"Accrington","Stockport",1,3,"A",0,2,"A",3.68,3.77,2.01,"0-2","1-3",14,4,6,4,1,1,0,0,9,4,16,10,4,13,26,"9-4","Y","Y","Y",2,0,9
"946","E3",2023-09-30,"AFC Wimbledon","Tranmere",4,1,"H",2,1,"H",1.72,3.93,4.97,"2-1","4-1",19,8,8,2,1,2,0,1,4,4,9,10,5,8,19,"4-4","Y","Y","Y",3,1,9
"947","E3",2023-09-30,"Barrow","Doncaster",3,2,"H",1,0,"H",1.94,3.64,4.07,"1-0","3-2",7,4,12,4,4,3,0,0,1,8,12,16,5,9,28,"1-8","Y","Y","Y",7,0,10
"948","E3",2023-09-30,"Bradford","Walsall",1,3,"A",1,2,"A",1.82,3.65,4.53,"1-2","1-3",10,2,7,4,1,4,0,0,10,5,8,9,4,15,17,"10-5","Y","Y","Y",5,0,10
"949","E3",2023-09-30,"Colchester","Notts County",5,4,"H",3,1,"H",3.6,3.87,2.01,"3-1","5-4",15,8,21,7,3,3,1,0,3,8,8,9,9,11,17,"3-8","Y","Y","Y",6,1,10
"950","E3",2023-09-30,"Crawley Town","Sutton",3,0,"H",1,0,"H",2.02,3.72,3.68,"1-0","3-0",18,7,7,2,1,3,0,0,5,4,8,12,3,9,20,"5-4","Y","Y","N",4,0,10
"951","E3",2023-09-30,"Forest Green","Morecambe",1,2,"A",0,1,"A",1.98,3.69,3.88,"0-1","1-2",13,2,14,11,3,2,0,0,7,7,8,6,3,14,14,"7-7","Y","Y","N",5,0,10
"952","E3",2023-09-30,"Gillingham","Mansfield",1,1,"D",1,1,"D",3.15,3.28,2.43,"1-1","1-1",20,4,17,3,4,2,0,0,5,11,11,13,2,16,24,"5-11","Y","N","N",6,0,10
"953","E3",2023-09-30,"Milton Keynes Dons","Harrogate",0,1,"A",0,1,"A",1.85,3.81,4.3,"0-1","0-1",27,4,3,3,3,1,0,0,11,3,12,5,1,14,17,"11-3","N","N","N",4,0,10
"954","E3",2023-09-30,"Salford","Newport County",2,1,"H",2,1,"H",2.28,3.66,3.11,"2-1","2-1",10,2,15,4,1,3,0,0,2,6,11,12,3,8,23,"2-6","Y","Y","N",4,0,10
"955","E3",2023-09-30,"Swindon","Grimsby",2,1,"H",1,0,"H",1.86,3.91,4.12,"1-0","2-1",8,3,13,4,2,2,0,0,9,7,5,10,3,16,15,"9-7","Y","Y","N",4,0,10
"956","E3",2023-09-30,"Wrexham","Crewe",3,3,"D",1,2,"A",1.42,5.24,7.06,"1-2","3-3",12,6,11,7,4,4,1,0,7,6,12,12,6,13,24,"7-6","Y","Y","Y",8,1,10
"957","E3",2023-10-03,"Crewe","Gillingham",2,0,"H",1,0,"H",2.78,3.44,2.61,"1-0","2-0",9,4,13,5,1,0,0,0,6,4,7,9,2,10,16,"6-4","Y","N","N",1,0,10
"958","E3",2023-10-03,"Doncaster","Crawley Town",2,0,"H",1,0,"H",2.68,3.67,2.58,"1-0","2-0",17,8,15,4,3,3,0,0,5,5,15,12,2,10,27,"5-5","Y","N","N",6,0,10
"959","E3",2023-10-03,"Grimsby","Barrow",2,1,"H",1,0,"H",2.17,3.33,3.68,"1-0","2-1",9,6,24,7,1,1,0,0,4,7,13,11,3,11,24,"4-7","Y","Y","N",2,0,11
"960","E3",2023-10-03,"Harrogate","AFC Wimbledon",0,1,"A",0,1,"A",3.6,3.39,2.17,"0-1","0-1",4,2,16,4,2,2,0,0,2,4,10,15,1,6,25,"2-4","N","N","N",4,0,11
"961","E3",2023-10-03,"Mansfield","Wrexham",0,0,"D",0,0,"D",2.28,3.74,3.06,"0-0","0-0",19,5,7,1,2,1,0,0,10,6,10,5,0,16,15,"10-6","N","N","N",3,0,11
"962","E3",2023-10-03,"Morecambe","Accrington",1,1,"D",0,0,"D",2.58,3.47,2.8,"0-0","1-1",15,6,15,3,3,3,0,0,4,9,17,9,2,13,26,"4-9","Y","N","N",6,0,11
"963","E3",2023-10-03,"Newport County","Colchester",2,1,"H",1,1,"D",2.3,3.61,3.12,"1-1","2-1",18,7,14,4,2,2,0,1,8,5,12,11,3,13,23,"8-5","Y","Y","N",4,1,11
"964","E3",2023-10-03,"Notts County","Swindon",3,1,"H",3,0,"H",1.86,4.36,3.71,"3-0","3-1",10,6,19,4,3,2,0,0,3,5,13,14,4,8,27,"3-5","Y","Y","Y",5,0,11
"965","E3",2023-10-03,"Stockport","Forest Green",2,0,"H",2,0,"H",1.43,4.75,7.79,"2-0","2-0",15,6,6,1,1,0,0,1,4,3,8,15,2,7,23,"4-3","Y","N","N",1,1,11
"966","E3",2023-10-03,"Sutton","Salford",0,2,"A",0,0,"D",2.56,3.59,2.75,"0-0","0-2",8,2,11,5,1,3,0,0,4,3,15,10,2,7,25,"4-3","Y","N","N",4,0,11
"967","E3",2023-10-03,"Tranmere","Bradford",2,1,"H",1,0,"H",3.36,3.34,2.29,"1-0","2-1",9,5,10,5,3,3,0,0,5,6,6,15,3,11,21,"5-6","Y","Y","N",6,0,11
"968","E3",2023-10-03,"Walsall","Milton Keynes Dons",0,0,"D",0,0,"D",2.74,3.4,2.67,"0-0","0-0",12,4,18,5,3,3,0,0,5,3,17,8,0,8,25,"5-3","N","N","N",6,0,11
"969","E3",2023-10-07,"Accrington","Forest Green",2,1,"H",1,0,"H",2.11,3.81,3.37,"1-0","2-1",16,4,15,5,1,1,0,0,4,5,13,12,3,9,25,"4-5","Y","Y","N",2,0,11
"970","E3",2023-10-07,"Barrow","Notts County",1,1,"D",0,1,"A",3.64,3.73,2.04,"0-1","1-1",14,6,5,1,1,3,0,0,2,5,7,11,2,7,18,"2-5","Y","N","N",4,0,11
"971","E3",2023-10-07,"Bradford","Swindon",1,0,"H",0,0,"D",2.42,3.73,2.84,"0-0","1-0",19,4,11,2,3,3,0,0,6,3,11,7,1,9,18,"6-3","N","N","N",6,0,12
"972","E3",2023-10-07,"Colchester","Morecambe",1,3,"A",0,1,"A",1.92,3.8,3.99,"0-1","1-3",21,5,15,7,2,4,0,1,5,4,7,12,4,9,19,"5-4","Y","Y","Y",6,1,12
"973","E3",2023-10-07,"Crawley Town","Wrexham",0,1,"A",0,1,"A",3.75,4.06,1.92,"0-1","0-1",25,5,10,5,2,6,0,1,6,8,8,9,1,14,17,"6-8","N","N","N",8,1,12
"974","E3",2023-10-07,"Gillingham","Milton Keynes Dons",2,1,"H",1,0,"H",2.4,3.38,3.12,"1-0","2-1",16,6,27,8,2,3,0,1,6,4,11,10,3,10,21,"6-4","Y","Y","N",5,1,12
"975","E3",2023-10-07,"Mansfield","AFC Wimbledon",0,0,"D",0,0,"D",1.98,3.63,3.92,"0-0","0-0",20,4,8,4,2,2,0,0,6,3,13,13,0,9,26,"6-3","N","N","N",4,0,12
"976","E3",2023-10-07,"Newport County","Harrogate",1,2,"A",0,1,"A",1.96,3.62,4.03,"0-1","1-2",11,4,7,3,2,2,0,0,5,4,16,6,3,9,22,"5-4","Y","Y","N",4,0,12
"977","E3",2023-10-07,"Salford","Crewe",4,2,"H",1,1,"D",2.12,3.75,3.3,"1-1","4-2",14,7,14,3,2,2,0,0,5,1,13,14,6,6,27,"5-1","Y","Y","Y",4,0,12
"978","E3",2023-10-07,"Stockport","Doncaster",1,0,"H",0,0,"D",1.49,4.65,6.59,"0-0","1-0",10,4,6,4,2,1,0,0,6,6,6,11,1,12,17,"6-6","N","N","N",3,0,12
"979","E3",2023-10-07,"Sutton","Walsall",4,0,"H",4,0,"H",2.56,3.42,2.8,"4-0","4-0",12,6,13,5,0,0,0,0,4,5,15,8,4,9,23,"4-5","Y","Y","Y",0,0,12
"980","E3",2023-10-07,"Tranmere","Grimsby",2,2,"D",1,2,"A",2.73,3.42,2.67,"1-2","2-2",8,3,13,5,1,1,0,0,1,5,10,9,4,6,19,"1-5","Y","Y","Y",2,0,12
"981","E3",2023-10-14,"Notts County","Mansfield",1,4,"A",1,1,"D",2.24,3.98,2.98,"1-1","1-4",9,2,21,9,1,1,0,0,5,6,4,10,5,11,14,"5-6","Y","Y","Y",2,0,12
"982","E3",2023-10-14,"AFC Wimbledon","Bradford",0,1,"A",0,0,"D",2.07,3.44,3.85,"0-0","0-1",11,5,7,2,3,2,0,0,10,4,13,13,1,14,26,"10-4","N","N","N",5,0,12
"983","E3",2023-10-14,"Crewe","Tranmere",2,0,"H",1,0,"H",1.97,3.8,3.79,"1-0","2-0",16,4,13,3,3,1,0,2,10,4,7,10,2,14,17,"10-4","Y","N","N",4,2,13
"984","E3",2023-10-14,"Doncaster","Sutton",4,1,"H",1,0,"H",2.1,3.59,3.58,"1-0","4-1",12,5,6,3,2,3,0,0,2,1,15,10,5,3,25,"2-1","Y","Y","Y",5,0,13
"985","E3",2023-10-14,"Forest Green","Colchester",5,0,"H",1,0,"H",2.51,3.59,2.8,"1-0","5-0",14,10,6,1,1,1,0,1,5,3,11,12,5,8,23,"5-3","Y","Y","Y",2,1,13
"986","E3",2023-10-14,"Grimsby","Accrington",0,2,"A",0,0,"D",2.19,3.54,3.4,"0-0","0-2",11,2,12,2,0,2,1,0,9,4,17,14,2,13,31,"9-4","Y","N","N",2,1,13
"987","E3",2023-10-14,"Harrogate","Stockport",1,3,"A",0,1,"A",4.73,3.88,1.76,"0-1","1-3",6,4,16,7,0,1,0,0,5,8,7,12,4,13,19,"5-8","Y","Y","Y",1,0,13
"988","E3",2023-10-14,"Milton Keynes Dons","Barrow",2,2,"D",2,0,"H",2.13,3.49,3.62,"2-0","2-2",15,5,18,9,2,1,0,0,1,8,14,11,4,9,25,"1-8","Y","Y","Y",3,0,13
"989","E3",2023-10-14,"Swindon","Newport County",2,0,"H",1,0,"H",1.74,4.11,4.57,"1-0","2-0",13,6,11,4,1,0,0,0,7,5,12,14,2,12,26,"7-5","Y","N","N",1,0,13
"990","E3",2023-10-14,"Walsall","Gillingham",4,1,"H",2,0,"H",2.85,3.29,2.65,"2-0","4-1",13,7,14,5,3,3,0,0,0,4,14,6,5,4,20,"0-4","Y","Y","Y",6,0,13
"991","E3",2023-10-14,"Wrexham","Salford",3,2,"H",1,2,"A",1.53,4.64,5.9,"1-2","3-2",21,7,10,4,3,4,0,0,11,3,13,8,5,14,21,"11-3","Y","Y","Y",7,0,13
"992","E3",2023-10-20,"Newport County","Walsall",3,3,"D",2,1,"H",2.4,3.48,3.04,"2-1","3-3",8,5,16,6,0,2,0,0,7,6,10,9,6,13,19,"7-6","Y","Y","Y",2,0,13
"993","E3",2023-10-20,"Tranmere","Doncaster",1,2,"A",0,1,"A",2.8,3.47,2.58,"0-1","1-2",12,3,11,5,3,2,0,0,5,3,9,6,3,8,15,"5-3","Y","Y","N",5,0,13
"994","E3",2023-10-21,"Accrington","Milton Keynes Dons",1,0,"H",1,0,"H",2.7,3.57,2.62,"1-0","1-0",13,4,10,1,2,1,0,0,6,4,24,7,1,10,31,"6-4","N","N","N",3,0,13
"995","E3",2023-10-21,"Barrow","AFC Wimbledon",0,0,"D",0,0,"D",2.93,3.34,2.54,"0-0","0-0",13,3,10,4,0,2,0,0,6,4,12,9,0,10,21,"6-4","N","N","N",2,0,14
"996","E3",2023-10-21,"Bradford","Wrexham",1,1,"D",0,0,"D",3.05,3.57,2.35,"0-0","1-1",21,5,8,1,3,2,0,0,11,3,10,8,2,14,18,"11-3","Y","N","N",5,0,14
"997","E3",2023-10-21,"Colchester","Harrogate",1,2,"A",0,0,"D",1.98,3.69,3.88,"0-0","1-2",20,5,8,2,1,0,0,0,10,3,6,3,3,13,9,"10-3","Y","Y","N",1,0,14
"998","E3",2023-10-21,"Crawley Town","Crewe",2,4,"A",2,1,"H",2.08,3.92,3.36,"2-1","2-4",14,5,12,8,4,2,0,0,6,7,9,10,6,13,19,"6-7","Y","Y","Y",6,0,14
"999","E3",2023-10-21,"Gillingham","Notts County",1,2,"A",0,1,"A",2.6,3.68,2.66,"0-1","1-2",11,2,10,7,2,3,0,0,3,5,8,5,3,8,13,"3-5","Y","Y","N",5,0,14
"1000","E3",2023-10-21,"Salford","Swindon",2,2,"D",1,1,"D",2.71,3.8,2.49,"1-1","2-2",15,7,15,7,3,1,1,0,2,11,8,6,4,13,14,"2-11","Y","Y","Y",4,1,14
"1001","E3",2023-10-21,"Stockport","Grimsby",3,2,"H",2,1,"H",1.54,4.45,6.15,"2-1","3-2",11,6,10,4,2,3,0,0,3,0,14,22,5,3,36,"3-0","Y","Y","Y",5,0,14
"1002","E3",2023-10-21,"Sutton","Morecambe",2,3,"A",1,2,"A",2.44,3.58,2.91,"1-2","2-3",7,2,7,5,1,2,0,0,11,4,5,10,5,15,15,"11-4","Y","Y","Y",3,0,14
"1003","E3",2023-10-24,"AFC Wimbledon","Accrington",2,4,"A",0,2,"A",1.7,4.03,4.97,"0-2","2-4",14,7,17,9,3,3,0,0,4,2,16,17,6,6,33,"4-2","Y","Y","Y",6,0,14
"1004","E3",2023-10-24,"Crewe","Stockport",0,2,"A",0,0,"D",4.17,4.09,1.81,"0-0","0-2",5,0,7,3,2,1,0,0,6,4,9,12,2,10,21,"6-4","Y","N","N",3,0,14
"1005","E3",2023-10-24,"Doncaster","Salford",0,3,"A",0,2,"A",2.2,3.6,3.33,"0-2","0-3",20,4,11,4,0,2,0,0,8,3,5,10,3,11,15,"8-3","Y","Y","N",2,0,14
"1006","E3",2023-10-24,"Forest Green","Barrow",0,2,"A",0,2,"A",2.61,3.36,2.84,"0-2","0-2",17,7,12,4,2,1,0,0,5,4,12,9,2,9,21,"5-4","Y","N","N",3,0,14
"1007","E3",2023-10-24,"Grimsby","Colchester",2,3,"A",1,2,"A",2.12,3.69,3.43,"1-2","2-3",18,6,9,4,1,3,0,0,3,3,11,7,5,6,18,"3-3","Y","Y","Y",4,0,15
"1008","E3",2023-10-24,"Harrogate","Mansfield",1,4,"A",0,3,"A",5.6,4.11,1.63,"0-3","1-4",11,3,34,11,1,3,0,0,2,7,9,13,5,9,22,"2-7","Y","Y","Y",4,0,15
"1009","E3",2023-10-24,"Milton Keynes Dons","Bradford",4,1,"H",2,1,"H",2.48,3.34,3.03,"2-1","4-1",18,11,7,2,0,4,0,0,4,1,11,11,5,5,22,"4-1","Y","Y","Y",4,0,15
"1010","E3",2023-10-24,"Morecambe","Tranmere",1,0,"H",0,0,"D",2.06,3.61,3.68,"0-0","1-0",15,5,13,5,2,2,0,0,10,5,9,9,1,15,18,"10-5","N","N","N",4,0,15
"1011","E3",2023-10-24,"Notts County","Newport County",3,0,"H",2,0,"H",1.58,4.65,5.32,"2-0","3-0",18,4,10,3,0,1,0,0,5,2,6,5,3,7,11,"5-2","Y","Y","N",1,0,15
"1012","E3",2023-10-24,"Swindon","Gillingham",0,1,"A",0,1,"A",1.85,3.83,4.25,"0-1","0-1",22,7,12,4,0,2,0,0,6,10,6,10,1,16,16,"6-10","N","N","N",2,0,15
"1013","E3",2023-10-24,"Walsall","Crawley Town",1,1,"D",0,0,"D",2.18,3.66,3.31,"0-0","1-1",17,7,7,4,0,3,0,0,6,6,11,8,2,12,19,"6-6","Y","N","N",3,0,15
"1014","E3",2023-10-24,"Wrexham","Sutton",2,1,"H",1,0,"H",1.39,5.46,7.26,"1-0","2-1",15,5,12,1,3,0,0,0,10,2,10,6,3,12,16,"10-2","Y","Y","N",3,0,15
"1015","E3",2023-10-28,"Accrington","Colchester",0,1,"A",0,0,"D",2.07,3.79,3.47,"0-0","0-1",31,6,7,6,1,3,0,0,11,0,9,12,1,11,21,"11-0","N","N","N",4,0,15
"1016","E3",2023-10-28,"Barrow","Salford",0,0,"D",0,0,"D",2.04,3.62,3.74,"0-0","0-0",13,2,9,0,2,0,0,0,6,4,11,5,0,10,16,"6-4","N","N","N",2,0,15
"1017","E3",2023-10-28,"Doncaster","Grimsby",1,0,"H",0,0,"D",2.3,3.52,3.18,"0-0","1-0",9,2,6,1,3,2,0,0,8,4,7,11,1,12,18,"8-4","N","N","N",5,0,15
"1018","E3",2023-10-28,"Forest Green","Crawley Town",2,1,"H",2,1,"H",2.15,3.83,3.26,"2-1","2-1",8,5,13,6,4,0,0,0,4,7,16,4,3,11,20,"4-7","Y","Y","N",4,0,15
"1019","E3",2023-10-28,"Gillingham","Newport County",0,2,"A",0,2,"A",1.89,3.59,4.37,"0-2","0-2",15,3,12,5,1,3,0,0,4,4,7,14,2,8,21,"4-4","Y","N","N",4,0,16
"1020","E3",2023-10-28,"Harrogate","Crewe",0,1,"A",0,1,"A",2.94,3.63,2.4,"0-1","0-1",12,3,15,4,3,0,0,0,6,6,13,11,1,12,24,"6-6","N","N","N",3,0,16
"1021","E3",2023-10-28,"Mansfield","Walsall",2,1,"H",1,0,"H",1.51,4.56,6.44,"1-0","2-1",22,7,7,1,3,2,0,0,6,5,12,11,3,11,23,"6-5","Y","Y","N",5,0,16
"1022","E3",2023-10-28,"Milton Keynes Dons","Swindon",3,2,"H",1,0,"H",2.52,3.69,2.74,"1-0","3-2",10,6,7,3,3,4,0,0,3,0,13,11,5,3,24,"3-0","Y","Y","Y",7,0,16
"1023","E3",2023-10-28,"Morecambe","AFC Wimbledon",4,1,"H",0,0,"D",3.17,3.41,2.36,"0-0","4-1",11,6,22,5,2,1,0,0,2,8,7,13,5,10,20,"2-8","Y","Y","Y",3,0,16
"1024","E3",2023-10-28,"Notts County","Wrexham",0,2,"A",0,0,"D",2.4,3.84,2.81,"0-0","0-2",16,6,15,8,2,3,0,0,10,7,6,15,2,17,21,"10-7","Y","N","N",5,0,16
"1025","E3",2023-10-28,"Stockport","Tranmere",2,0,"H",1,0,"H",1.35,5.27,9.22,"1-0","2-0",26,7,9,4,0,1,0,1,13,3,5,7,2,16,12,"13-3","Y","N","N",1,1,16
"1026","E3",2023-10-28,"Sutton","Bradford",2,1,"H",1,0,"H",3.18,3.35,2.38,"1-0","2-1",11,2,10,1,2,1,0,0,6,8,13,13,3,14,26,"6-8","Y","Y","N",3,0,16
"1027","E3",2023-10-31,"Barrow","Morecambe",1,0,"H",1,0,"H",1.81,3.74,4.61,"1-0","1-0",7,3,3,0,1,1,0,0,4,2,7,15,1,6,22,"4-2","N","N","N",2,0,16
"1028","E3",2023-11-07,"Colchester","Swindon",3,1,"H",0,1,"A",2.69,3.84,2.49,"0-1","3-1",12,2,13,3,1,2,0,0,4,4,3,16,4,8,19,"4-4","Y","Y","Y",3,0,16
"1029","E3",2023-11-11,"AFC Wimbledon","Doncaster",2,0,"H",1,0,"H",1.85,3.83,4.28,"1-0","2-0",5,2,8,1,3,2,2,0,8,3,17,6,2,11,23,"8-3","Y","N","N",5,2,16
"1030","E3",2023-11-11,"Bradford","Barrow",1,2,"A",1,1,"D",2.32,3.07,3.61,"1-1","1-2",9,5,7,4,2,2,0,0,5,4,10,6,3,9,16,"5-4","Y","Y","N",4,0,16
"1031","E3",2023-11-11,"Colchester","Sutton",1,1,"D",0,0,"D",2.02,3.93,3.51,"0-0","1-1",11,4,13,3,3,4,0,0,6,3,14,9,2,9,23,"6-3","Y","N","N",7,0,17
"1032","E3",2023-11-11,"Crawley Town","Accrington",3,1,"H",1,1,"D",2.42,3.78,2.81,"1-1","3-1",9,4,14,6,2,4,0,1,1,8,14,19,4,9,33,"1-8","Y","Y","Y",6,1,17
"1033","E3",2023-11-11,"Crewe","Notts County",1,0,"H",0,0,"D",3.03,3.83,2.26,"0-0","1-0",15,4,12,2,2,5,0,0,3,7,16,15,1,10,31,"3-7","N","N","N",7,0,17
"1034","E3",2023-11-11,"Grimsby","Morecambe",3,2,"H",0,1,"A",2.25,3.44,3.35,"0-1","3-2",20,10,16,6,3,1,0,0,9,6,9,9,5,15,18,"9-6","Y","Y","Y",4,0,17
"1035","E3",2023-11-11,"Newport County","Milton Keynes Dons",0,0,"D",0,0,"D",3.12,3.64,2.28,"0-0","0-0",16,1,11,5,2,2,0,0,2,4,14,11,0,6,25,"2-4","N","N","N",4,0,17
"1036","E3",2023-11-11,"Salford","Mansfield",1,2,"A",1,2,"A",4.34,4.04,1.79,"1-2","1-2",18,7,9,5,1,2,0,0,7,4,10,13,3,11,23,"7-4","Y","Y","N",3,0,17
"1037","E3",2023-11-11,"Swindon","Stockport",2,4,"A",1,0,"H",3.34,4.23,2,"1-0","2-4",13,4,16,8,2,2,0,0,8,4,9,10,6,12,19,"8-4","Y","Y","Y",4,0,17
"1038","E3",2023-11-11,"Tranmere","Forest Green",3,0,"H",1,0,"H",2.67,3.65,2.6,"1-0","3-0",16,7,15,8,1,2,0,1,12,11,8,11,3,23,19,"12-11","Y","Y","N",3,1,17
"1039","E3",2023-11-11,"Walsall","Harrogate",0,1,"A",0,0,"D",1.79,3.9,4.51,"0-0","0-1",25,3,7,2,0,2,0,0,11,6,8,9,1,17,17,"11-6","N","N","N",2,0,17
"1040","E3",2023-11-11,"Wrexham","Gillingham",2,0,"H",1,0,"H",1.63,4.28,5.3,"1-0","2-0",15,5,8,2,0,0,0,0,5,5,13,7,2,10,20,"5-5","Y","N","N",0,0,17
"1041","E3",2023-11-18,"Notts County","Bradford",4,2,"H",4,0,"H",1.89,3.94,3.97,"4-0","4-2",15,8,24,6,3,0,0,0,6,4,3,12,6,10,15,"6-4","Y","Y","Y",3,0,17
"1042","E3",2023-11-18,"Accrington","Wrexham",2,0,"H",0,0,"D",3.21,4.03,2.11,"0-0","2-0",14,6,10,4,1,0,0,0,7,6,20,12,2,13,32,"7-6","Y","N","N",1,0,17
"1043","E3",2023-11-18,"Barrow","Crawley Town",1,0,"H",0,0,"D",1.93,3.65,4.08,"0-0","1-0",11,3,10,2,2,3,0,0,4,5,8,13,1,9,21,"4-5","N","N","N",5,0,18
"1044","E3",2023-11-18,"Forest Green","Grimsby",2,2,"D",2,0,"H",2.54,3.4,2.89,"2-0","2-2",15,5,16,5,1,2,0,0,6,7,8,5,4,13,13,"6-7","Y","Y","Y",3,0,18
"1045","E3",2023-11-18,"Gillingham","Salford",3,1,"H",1,1,"D",2.08,3.59,3.63,"1-1","3-1",10,5,15,4,2,1,0,0,3,2,7,7,4,5,14,"3-2","Y","Y","Y",3,0,18
"1046","E3",2023-11-18,"Harrogate","Swindon",1,1,"D",0,1,"A",3.72,3.96,1.94,"0-1","1-1",12,5,15,3,1,2,0,0,5,10,4,13,2,15,17,"5-10","Y","N","N",3,0,18
"1047","E3",2023-11-18,"Mansfield","Newport County",2,0,"H",1,0,"H",1.37,5.32,8.19,"1-0","2-0",19,8,14,2,0,4,0,0,5,8,7,18,2,13,25,"5-8","Y","N","N",4,0,18
"1048","E3",2023-11-18,"Stockport","Colchester",2,0,"H",1,0,"H",1.37,5.37,8.23,"1-0","2-0",13,4,12,5,3,1,0,0,6,1,18,9,2,7,27,"6-1","Y","N","N",4,0,18
"1049","E3",2023-11-18,"Sutton","Tranmere",1,1,"D",0,1,"A",2.19,3.59,3.35,"0-1","1-1",13,2,10,3,2,1,0,0,4,2,9,8,2,6,17,"4-2","Y","N","N",3,0,18
"1050","E3",2023-11-25,"AFC Wimbledon","Notts County",4,2,"H",2,0,"H",2.55,3.63,2.73,"2-0","4-2",13,8,10,5,2,1,0,0,2,6,20,8,6,8,28,"2-6","Y","Y","Y",3,0,18
"1051","E3",2023-11-25,"Bradford","Accrington",1,0,"H",0,0,"D",2.18,3.58,3.39,"0-0","1-0",12,2,12,3,3,4,0,0,5,3,15,16,1,8,31,"5-3","N","N","N",7,0,18
"1052","E3",2023-11-25,"Colchester","Barrow",1,4,"A",1,0,"H",2.99,3.33,2.51,"1-0","1-4",12,8,16,6,2,3,1,0,6,5,8,8,5,11,16,"6-5","Y","Y","Y",5,1,18
"1053","E3",2023-11-25,"Crawley Town","Harrogate",2,1,"H",1,1,"D",1.86,3.8,4.24,"1-1","2-1",13,6,15,3,3,3,0,0,5,8,8,14,3,13,22,"5-8","Y","Y","N",6,0,18
"1054","E3",2023-11-25,"Crewe","Doncaster",3,2,"H",2,1,"H",2.21,3.73,3.2,"2-1","3-2",19,9,22,6,1,2,0,0,8,8,10,14,5,16,24,"8-8","Y","Y","Y",3,0,18
"1055","E3",2023-11-25,"Grimsby","Sutton",1,1,"D",1,1,"D",2,3.65,3.84,"1-1","1-1",13,4,13,2,0,0,0,0,8,4,9,5,2,12,14,"8-4","Y","N","N",0,0,19
"1056","E3",2023-11-25,"Newport County","Stockport",2,1,"H",1,0,"H",4.89,3.89,1.74,"1-0","2-1",6,2,13,4,0,1,0,0,2,8,12,13,3,10,25,"2-8","Y","Y","N",1,0,19
"1057","E3",2023-11-25,"Salford","Milton Keynes Dons",2,4,"A",2,1,"H",2.78,3.6,2.53,"2-1","2-4",9,4,16,5,2,2,0,0,2,2,15,12,6,4,27,"2-2","Y","Y","Y",4,0,19
"1058","E3",2023-11-25,"Swindon","Mansfield",2,1,"H",1,0,"H",3.76,4.01,1.93,"1-0","2-1",20,6,15,6,1,1,0,0,3,2,10,12,3,5,22,"3-2","Y","Y","N",2,0,19
"1059","E3",2023-11-25,"Tranmere","Gillingham",3,1,"H",1,0,"H",3.03,3.3,2.5,"1-0","3-1",8,3,11,5,3,2,0,0,0,10,8,7,4,10,15,"0-10","Y","Y","Y",5,0,19
"1060","E3",2023-11-25,"Walsall","Forest Green",0,0,"D",0,0,"D",2.2,3.73,3.22,"0-0","0-0",11,2,8,1,2,3,0,0,6,4,10,14,0,10,24,"6-4","N","N","N",5,0,19
"1061","E3",2023-11-25,"Wrexham","Morecambe",6,0,"H",3,0,"H",1.41,5.16,7.35,"3-0","6-0",19,8,14,2,1,1,0,0,5,7,11,10,6,12,21,"5-7","Y","Y","Y",2,0,19
"1062","E3",2023-11-28,"Accrington","Swindon",3,4,"A",0,2,"A",2.16,3.82,3.23,"0-2","3-4",29,8,12,5,6,2,0,0,11,3,15,9,7,14,24,"11-3","Y","Y","Y",8,0,19
"1063","E3",2023-11-28,"Barrow","Walsall",2,0,"H",1,0,"H",1.97,3.5,4.13,"1-0","2-0",11,4,11,4,1,2,0,0,7,3,15,15,2,10,30,"7-3","Y","N","N",3,0,19
"1064","E3",2023-11-28,"Doncaster","Colchester",3,1,"H",1,1,"D",2.04,3.61,3.75,"1-1","3-1",15,5,14,7,2,4,0,0,8,4,7,14,4,12,21,"8-4","Y","Y","Y",6,0,19
"1065","E3",2023-11-28,"Forest Green","Bradford",0,3,"A",0,2,"A",2.83,3.32,2.64,"0-2","0-3",13,2,13,4,2,1,0,1,8,4,7,7,3,12,14,"8-4","Y","Y","N",3,1,19
"1066","E3",2023-11-28,"Gillingham","AFC Wimbledon",1,0,"H",0,0,"D",2.97,3.34,2.52,"0-0","1-0",8,4,9,3,0,1,0,0,3,4,8,9,1,7,17,"3-4","N","N","N",1,0,19
"1067","E3",2023-11-28,"Harrogate","Wrexham",2,2,"D",1,2,"A",5.68,4.32,1.59,"1-2","2-2",10,4,22,7,2,2,0,0,4,7,6,11,4,11,17,"4-7","Y","Y","Y",4,0,20
"1068","E3",2023-11-28,"Mansfield","Tranmere",2,2,"D",1,1,"D",1.37,5.35,8.31,"1-1","2-2",21,5,15,7,2,2,0,1,5,1,9,16,4,6,25,"5-1","Y","Y","Y",4,1,20
"1069","E3",2023-11-28,"Milton Keynes Dons","Grimsby",1,1,"D",0,1,"A",1.71,4.05,4.84,"0-1","1-1",13,3,19,6,1,3,0,0,5,10,10,12,2,15,22,"5-10","Y","N","N",4,0,20
"1070","E3",2023-11-28,"Morecambe","Newport County",1,2,"A",1,1,"D",2.22,3.54,3.32,"1-1","1-2",12,3,15,3,1,1,0,0,8,7,11,6,3,15,17,"8-7","Y","Y","N",2,0,20
"1071","E3",2023-11-28,"Notts County","Crawley Town",3,1,"H",1,1,"D",1.62,4.62,4.9,"1-1","3-1",14,5,18,6,1,3,0,0,3,6,7,13,4,9,20,"3-6","Y","Y","Y",4,0,20
"1072","E3",2023-11-28,"Stockport","Salford",0,0,"D",0,0,"D",1.46,4.86,6.78,"0-0","0-0",19,5,9,2,2,2,0,0,7,3,13,5,0,10,18,"7-3","N","N","N",4,0,20
"1073","E3",2023-11-28,"Sutton","Crewe",1,1,"D",1,1,"D",2.71,3.57,2.6,"1-1","1-1",9,3,22,4,2,1,0,0,3,9,14,10,2,12,24,"3-9","Y","N","N",3,0,20
"1074","E3",2023-12-09,"Accrington","Doncaster",0,0,"D",0,0,"D",1.99,3.86,3.66,"0-0","0-0",12,3,4,0,2,0,0,0,5,3,8,16,0,8,24,"5-3","N","N","N",2,0,20
"1075","E3",2023-12-09,"AFC Wimbledon","Swindon",4,0,"H",1,0,"H",2,3.92,3.58,"1-0","4-0",16,9,10,1,2,1,0,0,7,3,11,10,4,10,21,"7-3","Y","Y","Y",3,0,20
"1076","E3",2023-12-09,"Colchester","Crawley Town",1,2,"A",0,1,"A",2.4,3.66,2.91,"0-1","1-2",11,2,12,4,3,2,0,0,4,5,10,9,3,9,19,"4-5","Y","Y","N",5,0,20
"1077","E3",2023-12-09,"Grimsby","Crewe",2,1,"H",2,0,"H",2.39,3.53,3.02,"2-0","2-1",17,3,11,2,1,3,0,0,6,5,10,11,3,11,21,"6-5","Y","Y","N",4,0,20
"1078","E3",2023-12-09,"Morecambe","Stockport",1,1,"D",0,0,"D",4.89,3.92,1.74,"0-0","1-1",4,3,11,5,1,0,0,0,3,5,6,5,2,8,11,"3-5","Y","N","N",1,0,20
"1079","E3",2023-12-09,"Notts County","Walsall",1,2,"A",1,0,"H",1.58,4.63,5.25,"1-0","1-2",6,2,7,4,2,2,0,0,6,4,9,11,3,10,20,"6-4","Y","Y","N",4,0,21
"1080","E3",2023-12-09,"Tranmere","Newport County",2,1,"H",0,1,"A",2.44,3.5,2.96,"0-1","2-1",14,3,10,3,3,3,0,0,8,2,12,11,3,10,23,"8-2","Y","Y","N",6,0,21
"1081","E3",2023-12-16,"Crawley Town","Mansfield",1,3,"A",1,1,"D",3.89,4.02,1.89,"1-1","1-3",11,2,14,6,4,3,1,0,2,3,12,14,4,5,26,"2-3","Y","Y","Y",7,1,21
"1082","E3",2023-12-16,"Crewe","Accrington",3,3,"D",2,1,"H",2.56,3.82,2.62,"2-1","3-3",13,3,19,8,2,1,1,0,6,3,10,10,6,9,20,"6-3","Y","Y","Y",3,1,21
"1083","E3",2023-12-16,"Doncaster","Morecambe",0,5,"A",0,2,"A",2.1,3.74,3.44,"0-2","0-5",12,3,15,9,2,3,0,0,6,6,10,10,5,12,20,"6-6","Y","Y","Y",5,0,21
"1084","E3",2023-12-16,"Gillingham","Bradford",0,2,"A",0,1,"A",2.45,3.19,3.21,"0-1","0-2",7,1,12,2,3,5,0,0,6,2,11,19,2,8,30,"6-2","Y","N","N",8,0,21
"1085","E3",2023-12-16,"Harrogate","Notts County",3,1,"H",2,0,"H",4.04,4.01,1.85,"2-0","3-1",14,5,10,3,2,3,0,0,2,4,8,10,4,6,18,"2-4","Y","Y","Y",5,0,21
"1086","E3",2023-12-16,"Milton Keynes Dons","Forest Green",2,0,"H",2,0,"H",1.67,4.29,4.92,"2-0","2-0",14,6,8,0,4,4,0,0,4,4,11,18,2,8,29,"4-4","Y","N","N",8,0,21
"1087","E3",2023-12-16,"Newport County","Grimsby",1,1,"D",0,0,"D",2.79,3.2,2.76,"0-0","1-1",19,3,19,5,1,0,0,0,10,2,8,6,2,12,14,"10-2","Y","N","N",1,0,21
"1088","E3",2023-12-16,"Salford","AFC Wimbledon",0,0,"D",0,0,"D",3.54,3.54,2.13,"0-0","0-0",8,3,20,2,2,1,0,0,1,11,9,14,0,12,23,"1-11","N","N","N",3,0,21
"1089","E3",2023-12-16,"Stockport","Sutton",8,0,"H",4,0,"H",1.38,5.26,8.03,"4-0","8-0",18,11,7,1,0,1,0,0,5,1,12,10,8,6,22,"5-1","Y","Y","Y",1,0,21
"1090","E3",2023-12-16,"Swindon","Barrow",0,3,"A",0,1,"A",2.7,3.72,2.54,"0-1","0-3",4,1,8,3,1,1,0,0,7,5,12,14,3,12,26,"7-5","Y","Y","N",2,0,21
"1091","E3",2023-12-16,"Walsall","Tranmere",1,0,"H",0,0,"D",1.99,3.57,3.96,"0-0","1-0",13,4,17,6,4,1,0,0,4,1,14,9,1,5,23,"4-1","N","N","N",5,0,22
"1092","E3",2023-12-16,"Wrexham","Colchester",2,1,"H",1,0,"H",1.41,5.19,7.44,"1-0","2-1",11,5,18,4,3,2,1,0,4,7,8,7,3,11,15,"4-7","Y","Y","N",5,1,22
"1093","E3",2023-12-22,"Forest Green","Gillingham",0,0,"D",0,0,"D",2.82,3.29,2.67,"0-0","0-0",11,4,11,3,2,1,0,0,3,8,11,9,0,11,20,"3-8","N","N","N",3,0,22
"1094","E3",2023-12-22,"Colchester","Salford",2,1,"H",1,0,"H",2.09,3.66,3.54,"1-0","2-1",11,5,11,4,5,1,0,0,9,7,11,10,3,16,21,"9-7","Y","Y","N",6,0,22
"1095","E3",2023-12-22,"Crawley Town","AFC Wimbledon",1,2,"A",0,2,"A",3.93,3.71,1.96,"0-2","1-2",18,7,12,2,2,3,0,1,6,5,11,11,3,11,22,"6-5","Y","Y","N",5,1,22
"1096","E3",2023-12-22,"Crewe","Barrow",1,3,"A",0,1,"A",2.61,3.43,2.79,"0-1","1-3",7,3,11,6,4,4,0,0,5,2,12,10,4,7,22,"5-2","Y","Y","Y",8,0,22
"1097","E3",2023-12-22,"Doncaster","Bradford",1,3,"A",1,2,"A",3.12,3.26,2.47,"1-2","1-3",7,2,13,5,1,1,0,0,9,4,9,13,4,13,22,"9-4","Y","Y","Y",2,0,22
"1098","E3",2023-12-22,"Stockport","Notts County",2,1,"H",1,0,"H",1.7,4.03,5,"1-0","2-1",9,5,12,3,4,2,0,0,4,3,14,6,3,7,20,"4-3","Y","Y","N",6,0,22
"1099","E3",2023-12-23,"Accrington","Walsall",2,1,"H",1,1,"D",2.34,3.73,2.78,"1-1","2-1",13,6,13,1,1,0,0,0,9,7,11,6,3,16,17,"9-7","Y","Y","N",1,0,22
"1100","E3",2023-12-23,"Grimsby","Harrogate",1,2,"A",0,1,"A",1.8,3.82,4.59,"0-1","1-2",14,1,14,5,1,1,0,0,9,6,11,7,3,15,18,"9-6","Y","Y","N",2,0,22
"1101","E3",2023-12-23,"Morecambe","Milton Keynes Dons",1,3,"A",0,1,"A",3.08,3.55,2.35,"0-1","1-3",9,4,20,7,3,1,0,0,4,5,12,12,4,9,24,"4-5","Y","Y","Y",4,0,22
"1102","E3",2023-12-23,"Sutton","Mansfield",0,2,"A",0,1,"A",4.98,4.25,1.66,"0-1","0-2",7,1,17,5,1,1,0,0,2,5,10,10,2,7,20,"2-5","Y","N","N",2,0,22
"1103","E3",2023-12-23,"Tranmere","Swindon",2,1,"H",0,1,"A",2.27,3.8,3.04,"0-1","2-1",18,9,8,5,2,3,0,0,6,3,11,10,3,9,21,"6-3","Y","Y","N",5,0,23
"1104","E3",2023-12-23,"Wrexham","Newport County",2,0,"H",0,0,"D",1.43,4.98,7.34,"0-0","2-0",16,5,9,2,0,1,0,0,7,5,9,9,2,12,18,"7-5","Y","N","N",1,0,23
"1105","E3",2023-12-26,"Mansfield","Grimsby",2,0,"H",2,0,"H",1.53,4.5,6.14,"2-0","2-0",39,16,13,5,3,1,0,0,15,2,17,10,2,17,27,"15-2","Y","N","N",4,0,23
"1106","E3",2023-12-26,"Gillingham","Crawley Town",0,2,"A",0,1,"A",2.04,3.65,3.7,"0-1","0-2",16,5,8,3,2,5,0,0,8,1,10,15,2,9,25,"8-1","Y","N","N",7,0,23
"1107","E3",2023-12-26,"AFC Wimbledon","Sutton",0,1,"A",0,0,"D",1.56,4.28,6.06,"0-0","0-1",11,5,12,6,3,3,0,0,2,6,13,11,1,8,24,"2-6","N","N","N",6,0,23
"1108","E3",2023-12-26,"Barrow","Stockport",2,2,"D",2,1,"H",3.39,3.34,2.28,"2-1","2-2",13,5,17,5,2,4,0,0,3,6,17,14,4,9,31,"3-6","Y","Y","Y",6,0,23
"1109","E3",2023-12-26,"Bradford","Morecambe",2,2,"D",0,2,"A",1.7,3.88,5.25,"0-2","2-2",17,6,7,2,2,3,0,0,5,5,7,9,4,10,16,"5-5","Y","Y","Y",5,0,23
"1110","E3",2023-12-26,"Harrogate","Accrington",2,1,"H",0,0,"D",3.1,3.43,2.38,"0-0","2-1",13,5,14,6,0,0,0,0,4,11,7,11,3,15,18,"4-11","Y","Y","N",0,0,23
"1111","E3",2023-12-26,"Milton Keynes Dons","Colchester",1,0,"H",0,0,"D",1.65,4.16,5.31,"0-0","1-0",27,4,7,3,3,1,0,0,11,1,12,8,1,12,20,"11-1","N","N","N",4,0,23
"1112","E3",2023-12-26,"Newport County","Forest Green",4,2,"H",0,2,"A",2.11,3.65,3.52,"0-2","4-2",13,8,12,4,3,4,0,1,7,7,10,22,6,14,32,"7-7","Y","Y","Y",7,1,23
"1113","E3",2023-12-26,"Notts County","Doncaster",3,0,"H",2,0,"H",1.65,4.28,5.11,"2-0","3-0",20,10,13,4,0,2,0,0,13,3,6,11,3,16,17,"13-3","Y","Y","N",2,0,23
"1114","E3",2023-12-26,"Salford","Tranmere",1,5,"A",0,2,"A",2.37,3.69,2.94,"0-2","1-5",10,5,19,9,3,1,1,0,4,3,7,11,6,7,18,"4-3","Y","Y","Y",4,1,23
"1115","E3",2023-12-26,"Swindon","Wrexham",0,1,"A",0,1,"A",4.12,4.12,1.82,"0-1","0-1",16,3,15,4,1,0,0,1,8,5,8,10,1,13,18,"8-5","N","N","N",1,1,24
"1116","E3",2023-12-26,"Walsall","Crewe",2,0,"H",1,0,"H",2.17,3.66,3.33,"1-0","2-0",15,5,15,4,1,5,0,0,5,4,9,11,2,9,20,"5-4","Y","N","N",6,0,24
"1117","E3",2023-12-29,"AFC Wimbledon","Colchester",5,3,"H",2,2,"D",1.55,4.36,6.15,"2-2","5-3",31,13,14,4,3,1,0,1,5,2,16,7,8,7,23,"5-2","Y","Y","Y",4,1,24
"1118","E3",2023-12-29,"Barrow","Accrington",1,1,"D",0,0,"D",1.8,3.79,4.61,"0-0","1-1",18,5,11,3,0,6,0,0,8,3,12,12,2,11,24,"8-3","Y","N","N",6,0,24
"1119","E3",2023-12-29,"Bradford","Stockport",0,0,"D",0,0,"D",3.29,3.34,2.32,"0-0","0-0",8,1,10,1,2,2,0,0,6,3,16,7,0,9,23,"6-3","N","N","N",4,0,24
"1120","E3",2023-12-29,"Gillingham","Sutton",1,0,"H",0,0,"D",1.89,3.65,4.31,"0-0","1-0",24,4,4,2,1,3,0,1,12,0,6,10,1,12,16,"12-0","N","N","N",4,1,24
"1121","E3",2023-12-29,"Harrogate","Tranmere",0,2,"A",0,0,"D",2.67,3.36,2.77,"0-0","0-2",12,2,10,4,1,2,0,0,7,6,5,9,2,13,14,"7-6","Y","N","N",3,0,24
"1122","E3",2023-12-29,"Mansfield","Doncaster",1,1,"D",1,0,"H",1.39,5.15,8.1,"1-0","1-1",12,6,12,4,1,1,0,0,7,4,9,13,2,11,22,"7-4","Y","N","N",2,0,24
"1123","E3",2023-12-29,"Milton Keynes Dons","Crawley Town",2,0,"H",1,0,"H",1.61,4.38,5.35,"1-0","2-0",13,8,10,3,3,0,0,1,6,2,7,9,2,8,16,"6-2","Y","N","N",3,1,24
"1124","E3",2023-12-29,"Newport County","Crewe",1,1,"D",0,0,"D",2.25,3.71,3.13,"0-0","1-1",19,3,22,4,0,1,0,0,7,5,10,6,2,12,16,"7-5","Y","N","N",1,0,24
"1125","E3",2023-12-29,"Notts County","Morecambe",5,0,"H",4,0,"H",1.59,4.36,5.61,"4-0","5-0",13,7,6,2,1,2,0,0,4,2,7,8,5,6,15,"4-2","Y","Y","Y",3,0,24
"1126","E3",2023-12-29,"Salford","Grimsby",0,3,"A",0,1,"A",2.62,3.55,2.71,"0-1","0-3",10,2,22,5,0,1,0,0,5,12,10,8,3,17,18,"5-12","Y","Y","N",1,0,24
"1127","E3",2023-12-29,"Swindon","Forest Green",2,1,"H",0,0,"D",2.1,3.81,3.39,"0-0","2-1",15,5,19,7,3,5,0,0,6,4,11,20,3,10,31,"6-4","Y","Y","N",8,0,25
"1128","E3",2023-12-29,"Walsall","Wrexham",3,1,"H",1,1,"D",3.47,3.71,2.1,"1-1","3-1",22,8,16,5,3,1,0,0,2,4,7,9,4,6,16,"2-4","Y","Y","Y",4,0,25
"1129","E3",2024-01-01,"Accrington","Salford",3,0,"H",3,0,"H",1.82,4.09,4.14,"3-0","3-0",17,6,12,5,4,2,0,0,5,3,13,9,3,8,22,"5-3","Y","Y","N",6,0,25
"1130","E3",2024-01-01,"Colchester","Gillingham",0,1,"A",0,0,"D",2.84,3.48,2.54,"0-0","0-1",15,4,15,7,1,3,0,0,0,6,9,7,1,6,16,"0-6","N","N","N",4,0,25
"1131","E3",2024-01-01,"Crawley Town","Swindon",3,1,"H",2,0,"H",2.36,3.72,2.94,"2-0","3-1",11,3,14,8,0,0,0,0,3,9,15,12,4,12,27,"3-9","Y","Y","Y",0,0,25
"1132","E3",2024-01-01,"Crewe","Bradford",1,0,"H",1,0,"H",3.12,3.74,2.24,"1-0","1-0",4,1,16,4,5,2,0,0,1,8,12,18,1,9,30,"1-8","N","N","N",7,0,25
"1133","E3",2024-01-01,"Doncaster","Milton Keynes Dons",3,0,"H",3,0,"H",3.59,3.71,2.06,"3-0","3-0",20,6,12,3,2,4,0,0,6,5,17,13,3,11,30,"6-5","Y","Y","N",6,0,25
"1134","E3",2024-01-01,"Forest Green","AFC Wimbledon",1,1,"D",1,1,"D",3.98,3.71,1.94,"1-1","1-1",16,4,14,4,1,2,0,0,7,9,10,7,2,16,17,"7-9","Y","N","N",3,0,25
"1135","E3",2024-01-01,"Grimsby","Walsall",1,6,"A",1,2,"A",2.36,3.44,3.13,"1-2","1-6",8,3,18,7,0,1,0,0,9,7,12,14,7,16,26,"9-7","Y","Y","Y",1,0,25
"1136","E3",2024-01-01,"Morecambe","Harrogate",2,2,"D",0,1,"A",2.23,3.81,3.09,"0-1","2-2",17,6,11,5,3,2,0,0,7,4,6,8,4,11,14,"7-4","Y","Y","Y",5,0,25
"1137","E3",2024-01-01,"Stockport","Mansfield",0,2,"A",0,0,"D",2.32,3.43,3.22,"0-0","0-2",11,4,8,3,1,3,0,0,3,6,10,8,2,9,18,"3-6","Y","N","N",4,0,25
"1138","E3",2024-01-01,"Sutton","Newport County",1,1,"D",0,0,"D",2.49,3.41,2.96,"0-0","1-1",13,4,11,2,1,0,0,0,3,7,8,5,2,10,13,"3-7","Y","N","N",1,0,25
"1139","E3",2024-01-01,"Tranmere","Notts County",4,2,"H",2,2,"D",3.14,3.94,2.17,"2-2","4-2",14,7,12,7,1,1,0,0,7,7,10,5,6,14,15,"7-7","Y","Y","Y",2,0,26
"1140","E3",2024-01-01,"Wrexham","Barrow",4,1,"H",3,1,"H",1.91,3.7,4.16,"3-1","4-1",16,10,7,3,1,4,0,0,3,0,12,14,5,3,26,"3-0","Y","Y","Y",5,0,26
"1141","E3",2024-01-06,"Harrogate","Doncaster",3,1,"H",1,1,"D",2.6,3.35,2.86,"1-1","3-1",11,4,17,2,0,3,0,0,3,4,8,11,4,7,19,"3-4","Y","Y","Y",3,0,26
"1142","E3",2024-01-06,"Barrow","Tranmere",1,0,"H",0,0,"D",1.93,3.57,4.19,"0-0","1-0",15,2,6,1,1,1,0,0,4,5,10,11,1,9,21,"4-5","N","N","N",2,0,26
"1143","E3",2024-01-06,"Bradford","Crawley Town",2,4,"A",0,1,"A",1.74,3.94,4.82,"0-1","2-4",20,8,13,6,1,2,0,0,10,3,6,11,6,13,17,"10-3","Y","Y","Y",3,0,26
"1144","E3",2024-01-06,"Mansfield","Crewe",0,1,"A",0,1,"A",1.45,4.97,6.73,"0-1","0-1",21,3,12,3,2,2,0,0,12,5,7,8,1,17,15,"12-5","N","N","N",4,0,26
"1145","E3",2024-01-06,"Salford","Forest Green",2,2,"D",1,1,"D",2.41,3.66,2.89,"1-1","2-2",12,5,13,3,2,2,1,1,8,4,9,14,4,12,23,"8-4","Y","Y","Y",4,2,26
"1146","E3",2024-01-06,"Swindon","Colchester",2,2,"D",2,1,"H",2.1,4.14,3.16,"2-1","2-2",9,4,17,6,1,2,0,0,5,2,8,9,4,7,17,"5-2","Y","Y","Y",3,0,26
"1147","E3",2024-01-13,"Accrington","Gillingham",1,2,"A",0,0,"D",2.4,3.39,3.1,"0-0","1-2",14,5,11,3,2,2,0,0,5,7,9,12,3,12,21,"5-7","Y","Y","N",4,0,26
"1148","E3",2024-01-13,"Colchester","Bradford",1,1,"D",0,1,"A",3.73,3.63,2.04,"0-1","1-1",6,3,22,3,0,0,0,0,2,8,5,11,2,10,16,"2-8","Y","N","N",0,0,26
"1149","E3",2024-01-13,"Crawley Town","Salford",0,1,"A",0,0,"D",1.93,3.86,3.9,"0-0","0-1",10,1,35,12,1,3,0,0,2,10,8,15,1,12,23,"2-10","N","N","N",4,0,26
"1150","E3",2024-01-13,"Crewe","Swindon",2,1,"H",1,1,"D",1.93,4,3.73,"1-1","2-1",11,5,11,3,3,3,0,0,3,8,7,9,3,11,16,"3-8","Y","Y","N",6,0,26
"1151","E3",2024-01-13,"Doncaster","Newport County",0,1,"A",0,0,"D",2.2,3.94,3.07,"0-0","0-1",13,5,5,1,1,2,0,0,2,4,12,16,1,6,28,"2-4","N","N","N",3,0,27
"1152","E3",2024-01-13,"Forest Green","Harrogate",0,2,"A",0,0,"D",2.21,3.52,3.37,"0-0","0-2",4,1,17,5,2,2,1,0,3,8,19,6,2,11,25,"3-8","Y","N","N",4,1,27
"1153","E3",2024-01-13,"Grimsby","Notts County",5,5,"D",2,2,"D",2.76,3.84,2.44,"2-2","5-5",22,9,19,9,1,3,0,0,9,2,10,9,10,11,19,"9-2","Y","Y","Y",4,0,27
"1154","E3",2024-01-13,"Morecambe","Mansfield",1,1,"D",0,0,"D",5.81,4.29,1.58,"0-0","1-1",9,3,6,3,3,1,0,0,3,5,9,9,2,8,18,"3-5","Y","N","N",4,0,27
"1155","E3",2024-01-13,"Stockport","Walsall",3,1,"H",1,1,"D",1.57,4.33,5.88,"1-1","3-1",15,6,7,3,1,1,0,0,8,6,10,10,4,14,20,"8-6","Y","Y","Y",2,0,27
"1156","E3",2024-01-13,"Sutton","Barrow",2,2,"D",1,1,"D",3.8,3.44,2.08,"1-1","2-2",9,4,16,5,1,0,0,0,5,5,8,7,4,10,15,"5-5","Y","Y","Y",1,0,27
"1157","E3",2024-01-13,"Tranmere","Milton Keynes Dons",1,2,"A",1,1,"D",2.69,3.78,2.53,"1-1","1-2",5,2,24,6,1,0,0,0,2,6,7,9,3,8,16,"2-6","Y","Y","N",1,0,27
"1158","E3",2024-01-13,"Wrexham","AFC Wimbledon",2,0,"H",0,0,"D",1.89,3.85,4.04,"0-0","2-0",10,5,17,1,1,1,0,0,5,5,11,13,2,10,24,"5-5","Y","N","N",2,0,27
"1159","EC",2023-08-05,"Aldershot","Oxford City",5,2,"H",3,1,"H",1.99,3.68,3.69,"3-1","5-2",0,0,0,0,2,1,0,0,0,0,0,0,7,0,0,"0-0","Y","Y","Y",3,0,1
"1160","EC",2023-08-05,"Altrincham","Dag and Red",1,1,"D",0,0,"D",2.25,3.43,3.23,"0-0","1-1",0,0,0,0,2,2,0,0,0,0,0,0,2,0,0,"0-0","Y","N","N",4,0,1
"1161","EC",2023-08-05,"Barnet","Hartlepool",3,2,"H",1,0,"H",2.09,3.65,3.35,"1-0","3-2",0,0,0,0,1,3,0,0,0,0,0,0,5,0,0,"0-0","Y","Y","Y",4,0,1
"1162","EC",2023-08-05,"Chesterfield","Dorking",4,3,"H",1,1,"D",1.25,6.07,10.66,"1-1","4-3",0,0,0,0,2,3,0,1,0,0,0,0,7,0,0,"0-0","Y","Y","Y",5,1,1
"1163","EC",2023-08-05,"Gateshead","Boreham Wood",2,2,"D",2,0,"H",2.12,3.37,3.63,"2-0","2-2",0,0,0,0,1,3,0,1,0,0,0,0,4,0,0,"0-0","Y","Y","Y",4,1,1
"1164","EC",2023-08-05,"Halifax","Bromley",2,0,"H",0,0,"D",2.79,3.24,2.61,"0-0","2-0",0,0,0,0,3,2,0,0,0,0,0,0,2,0,0,"0-0","Y","N","N",5,0,1
"1165","EC",2023-08-05,"Kidderminster","Woking",0,0,"D",0,0,"D",2.96,3.29,2.49,"0-0","0-0",0,0,0,0,3,2,0,0,0,0,0,0,0,0,0,"0-0","N","N","N",5,0,1
"1166","EC",2023-08-05,"Maidenhead","Fylde",2,2,"D",2,1,"H",2.46,3.33,2.9,"2-1","2-2",0,0,0,0,3,1,0,1,0,0,0,0,4,0,0,"0-0","Y","Y","Y",4,1,1
"1167","EC",2023-08-05,"Solihull","Eastleigh",1,1,"D",0,0,"D",2.6,3.76,2.53,"0-0","1-1",0,0,0,0,1,2,1,0,0,0,0,0,2,0,0,"0-0","Y","N","N",3,1,1
"1168","EC",2023-08-05,"Southend","Oldham",4,0,"H",1,0,"H",3.1,3.37,2.35,"1-0","4-0",0,0,0,0,2,5,0,1,0,0,0,0,4,0,0,"0-0","Y","Y","Y",7,1,1
"1169","EC",2023-08-05,"Wealdstone","York",2,1,"H",0,1,"A",2.68,3.54,2.58,"0-1","2-1",0,0,0,0,3,1,0,1,0,0,0,0,3,0,0,"0-0","Y","Y","N",4,1,1
"1170","EC",2023-08-05,"Rochdale","Ebbsfleet",0,1,"A",0,1,"A",1.69,4.25,4.37,"0-1","0-1",0,0,0,0,2,5,0,0,0,0,0,0,1,0,0,"0-0","N","N","N",7,0,1
"1171","EC",2023-08-12,"Boreham Wood","Halifax",2,0,"H",0,0,"D",2.23,3.13,3.63,"0-0","2-0",0,0,0,0,1,2,0,0,0,0,0,0,2,0,0,"0-0","Y","N","N",3,0,2
"1172","EC",2023-08-12,"Dag and Red","Southend",0,2,"A",0,1,"A",2.68,3.47,2.61,"0-1","0-2",0,0,0,0,3,1,0,0,0,0,0,0,2,0,0,"0-0","Y","N","N",4,0,2
"1173","EC",2023-08-12,"Dorking","Maidenhead",0,2,"A",0,0,"D",2.05,3.69,3.49,"0-0","0-2",0,0,0,0,5,1,0,1,0,0,0,0,2,0,0,"0-0","Y","N","N",6,1,2
"1174","EC",2023-08-12,"Eastleigh","Wealdstone",0,0,"D",0,0,"D",1.7,3.93,4.68,"0-0","0-0",0,0,0,0,5,3,0,0,0,0,0,0,0,0,0,"0-0","N","N","N",8,0,2
"1175","EC",2023-08-12,"Ebbsfleet","Solihull",1,2,"A",0,1,"A",2.17,3.51,3.34,"0-1","1-2",0,0,0,0,3,5,0,0,0,0,0,0,3,0,0,"0-0","Y","Y","N",8,0,2
"1176","EC",2023-08-12,"Fylde","Chesterfield",2,4,"A",0,3,"A",3.94,3.92,1.86,"0-3","2-4",0,0,0,0,3,3,1,0,0,0,0,0,6,0,0,"0-0","Y","Y","Y",6,1,2
"1177","EC",2023-08-12,"Hartlepool","Gateshead",2,1,"H",1,0,"H",2.54,3.6,2.69,"1-0","2-1",0,0,0,0,2,2,1,0,0,0,0,0,3,0,0,"0-0","Y","Y","N",4,1,2
"1178","EC",2023-08-12,"Oldham","Aldershot",5,1,"H",3,0,"H",2.07,3.41,3.7,"3-0","5-1",0,0,0,0,2,1,0,1,0,0,0,0,6,0,0,"0-0","Y","Y","Y",3,1,2
"1179","EC",2023-08-12,"Oxford City","Rochdale",0,1,"A",0,0,"D",3.15,3.64,2.21,"0-0","0-1",0,0,0,0,2,1,0,0,0,0,0,0,1,0,0,"0-0","N","N","N",3,0,2
"1180","EC",2023-08-12,"Woking","Altrincham",2,3,"A",2,2,"D",1.59,4.37,5.24,"2-2","2-3",0,0,0,0,1,4,0,0,0,0,0,0,5,0,0,"0-0","Y","Y","Y",5,0,2
"1181","EC",2023-08-12,"York","Kidderminster",0,1,"A",0,0,"D",1.94,3.57,3.97,"0-0","0-1",0,0,0,0,2,2,0,0,0,0,0,0,1,0,0,"0-0","N","N","N",4,0,2
"1182","EC",2023-08-12,"Bromley","Barnet",0,2,"A",0,1,"A",2.25,3.74,3.01,"0-1","0-2",0,0,0,0,2,0,0,0,0,0,0,0,2,0,0,"0-0","Y","N","N",2,0,2
"1183","EC",2023-08-15,"Bromley","Wealdstone",1,1,"D",0,1,"A",1.71,4.01,4.63,"0-1","1-1",0,0,0,0,5,2,0,0,0,0,0,0,2,0,0,"0-0","Y","N","N",7,0,3
"1184","EC",2023-08-15,"Dag and Red","Gateshead",2,4,"A",0,1,"A",3.64,3.73,1.99,"0-1","2-4",0,0,0,0,4,3,0,0,0,0,0,0,6,0,0,"0-0","Y","Y","Y",7,0,3
"1185","EC",2023-08-15,"Dorking","Southend",2,1,"H",1,1,"D",4.21,3.82,1.83,"1-1","2-1",0,0,0,0,1,1,0,0,0,0,0,0,3,0,0,"0-0","Y","Y","N",2,0,3
"1186","EC",2023-08-15,"Eastleigh","Barnet",3,3,"D",1,3,"A",2.58,3.55,2.67,"1-3","3-3",0,0,0,0,3,3,0,0,0,0,0,0,6,0,0,"0-0","Y","Y","Y",6,0,3
"1187","EC",2023-08-15,"Ebbsfleet","Aldershot",2,0,"H",1,0,"H",1.99,3.66,3.71,"1-0","2-0",0,0,0,0,3,3,0,0,0,0,0,0,2,0,0,"0-0","Y","N","N",6,0,3
"1188","EC",2023-08-15,"Fylde","Kidderminster",2,1,"H",0,0,"D",2.18,3.53,3.31,"0-0","2-1",0,0,0,0,3,2,0,0,0,0,0,0,3,0,0,"0-0","Y","Y","N",5,0,3
"1189","EC",2023-08-15,"Hartlepool","Maidenhead",3,1,"H",0,0,"D",1.85,3.79,4.14,"0-0","3-1",0,0,0,0,4,2,0,0,0,0,0,0,4,0,0,"0-0","Y","Y","Y",6,0,3
"1190","EC",2023-08-15,"Oldham","Halifax",1,2,"A",1,1,"D",1.93,3.27,4.48,"1-1","1-2",0,0,0,0,4,3,0,0,0,0,0,0,3,0,0,"0-0","Y","Y","N",7,0,3
"1191","EC",2023-08-15,"Oxford City","Chesterfield",1,2,"A",0,1,"A",6.35,5.09,1.43,"0-1","1-2",0,0,0,0,2,1,0,0,0,0,0,0,3,0,0,"0-0","Y","Y","N",3,0,3
"1192","EC",2023-08-15,"Woking","Rochdale",3,2,"H",0,1,"A",2.04,3.54,3.67,"0-1","3-2",0,0,0,0,5,4,0,0,0,0,0,0,5,0,0,"0-0","Y","Y","Y",9,0,3
"1193","EC",2023-08-15,"York","Altrincham",2,2,"D",2,1,"H",2.16,3.77,3.16,"2-1","2-2",0,0,0,0,5,3,0,0,0,0,0,0,4,0,0,"0-0","Y","Y","Y",8,0,3
"1194","EC",2023-08-16,"Boreham Wood","Solihull",1,2,"A",0,1,"A",2,3.33,4.06,"0-1","1-2",0,0,0,0,2,1,0,0,0,0,0,0,3,0,0,"0-0","Y","Y","N",3,0,3
"1195","EC",2023-08-19,"Chesterfield","Oldham",1,1,"D",0,0,"D",1.6,4.29,5.27,"0-0","1-1",0,0,0,0,0,3,0,0,0,0,0,0,2,0,0,"0-0","Y","N","N",3,0,4
"1196","EC",2023-08-19,"Aldershot","York",1,1,"D",1,0,"H",2.47,3.5,2.83,"1-0","1-1",0,0,0,0,4,2,0,0,0,0,0,0,2,0,0,"0-0","Y","N","N",6,0,4
"1197","EC",2023-08-19,"Altrincham","Boreham Wood",1,1,"D",1,0,"H",2.44,3.45,2.91,"1-0","1-1",0,0,0,0,3,2,0,0,0,0,0,0,2,0,0,"0-0","Y","N","N",5,0,4
"1198","EC",2023-08-19,"Barnet","Woking",2,0,"H",1,0,"H",2.35,3.48,3.02,"1-0","2-0",0,0,0,0,1,1,0,0,0,0,0,0,2,0,0,"0-0","Y","N","N",2,0,4
"1199","EC",2023-08-19,"Gateshead","Ebbsfleet",4,1,"H",1,1,"D",1.9,3.91,3.78,"1-1","4-1",0,0,0,0,3,3,0,0,0,0,0,0,5,0,0,"0-0","Y","Y","Y",6,0,4
"1200","EC",2023-08-19,"Halifax","Oxford City",1,1,"D",1,0,"H",1.66,3.91,5.22,"1-0","1-1",0,0,0,0,2,1,0,0,0,0,0,0,2,0,0,"0-0","Y","N","N",3,0,4
"1201","EC",2023-08-19,"Kidderminster","Bromley",0,0,"D",0,0,"D",2.3,3.34,3.22,"0-0","0-0",0,0,0,0,1,2,1,1,0,0,0,0,0,0,0,"0-0","N","N","N",3,2,4
"1202","EC",2023-08-19,"Maidenhead","Dag and Red",1,0,"H",0,0,"D",2.45,3.32,2.98,"0-0","1-0",0,0,0,0,1,1,0,0,0,0,0,0,1,0,0,"0-0","N","N","N",2,0,4
"1203","EC",2023-08-19,"Rochdale","Eastleigh",2,0,"H",2,0,"H",2.03,3.69,3.54,"2-0","2-0",0,0,0,0,2,5,0,0,0,0,0,0,2,0,0,"0-0","Y","N","N",7,0,4
"1204","EC",2023-08-19,"Solihull","Dorking",3,0,"H",2,0,"H",1.76,4.16,4.16,"2-0","3-0",0,0,0,0,0,3,0,1,0,0,0,0,3,0,0,"0-0","Y","Y","N",3,1,4
"1205","EC",2023-08-19,"Southend","Hartlepool",2,3,"A",1,1,"D",1.99,3.6,3.75,"1-1","2-3",0,0,0,0,0,0,0,0,0,0,0,0,5,0,0,"0-0","Y","Y","Y",0,0,4
"1206","EC",2023-08-19,"Wealdstone","Fylde",3,2,"H",1,1,"D",2.66,3.73,2.5,"1-1","3-2",0,0,0,0,1,2,0,1,0,0,0,0,5,0,0,"0-0","Y","Y","Y",3,1,4
"1207","EC",2023-08-25,"Rochdale","Bromley",2,2,"D",1,1,"D",1.88,3.64,4.14,"1-1","2-2",0,0,0,0,0,1,1,1,0,0,0,0,4,0,0,"0-0","Y","Y","Y",1,2,5
"1208","EC",2023-08-25,"Solihull","Halifax",1,1,"D",1,0,"H",2.34,3.34,3.15,"1-0","1-1",0,0,0,0,1,1,0,0,0,0,0,0,2,0,0,"0-0","Y","N","N",2,0,5
"1209","EC",2023-08-25,"Southend","Eastleigh",2,0,"H",2,0,"H",1.84,3.79,4.18,"2-0","2-0",0,0,0,0,1,1,0,0,0,0,0,0,2,0,0,"0-0","Y","N","N",2,0,5
"1210","EC",2023-08-26,"Aldershot","Wealdstone",3,1,"H",1,0,"H",2.32,3.82,2.85,"1-0","3-1",0,0,0,0,3,2,0,0,0,0,0,0,4,0,0,"0-0","Y","Y","Y",5,0,5
"1211","EC",2023-08-26,"Altrincham","Chesterfield",2,1,"H",0,1,"A",4.03,4.25,1.78,"0-1","2-1",0,0,0,0,1,4,0,0,0,0,0,0,3,0,0,"0-0","Y","Y","N",5,0,5
"1212","EC",2023-08-26,"Boreham Wood","Oldham",0,0,"D",0,0,"D",2.62,3.37,2.73,"0-0","0-0",0,0,0,0,2,0,0,0,0,0,0,0,0,0,0,"0-0","N","N","N",2,0,5
"1213","EC",2023-08-26,"Dag and Red","Barnet",1,0,"H",0,0,"D",3.83,3.83,1.91,"0-0","1-0",0,0,0,0,4,0,0,0,0,0,0,0,1,0,0,"0-0","N","N","N",4,0,5
"1214","EC",2023-08-26,"Dorking","York",2,2,"D",1,0,"H",3.09,3.64,2.24,"1-0","2-2",0,0,0,0,1,1,0,1,0,0,0,0,4,0,0,"0-0","Y","Y","Y",2,1,5
"1215","EC",2023-08-26,"Ebbsfleet","Kidderminster",3,0,"H",3,0,"H",2.57,3.53,2.69,"3-0","3-0",0,0,0,0,1,0,0,1,0,0,0,0,3,0,0,"0-0","Y","Y","N",1,1,5
"1216","EC",2023-08-26,"Gateshead","Woking",1,3,"A",1,0,"H",2.08,3.61,3.48,"1-0","1-3",0,0,0,0,1,4,0,0,0,0,0,0,4,0,0,"0-0","Y","Y","Y",5,0,5
"1217","EC",2023-08-26,"Maidenhead","Oxford City",0,0,"D",0,0,"D",2.2,3.79,3.06,"0-0","0-0",0,0,0,0,3,2,0,0,0,0,0,0,0,0,0,"0-0","N","N","N",5,0,5
"1218","EC",2023-08-26,"Hartlepool","Fylde",3,1,"H",2,1,"H",2.12,3.67,3.33,"2-1","3-1",0,0,0,0,2,1,0,0,0,0,0,0,4,0,0,"0-0","Y","Y","Y",3,0,5
"1219","EC",2023-08-28,"Barnet","Ebbsfleet",3,2,"H",1,1,"D",2.01,3.81,3.5,"1-1","3-2",0,0,0,0,2,3,0,0,0,0,0,0,5,0,0,"0-0","Y","Y","Y",5,0,6
"1220","EC",2023-08-28,"Bromley","Southend",2,1,"H",1,0,"H",3.75,3.48,2.03,"1-0","2-1",0,0,0,0,3,1,0,0,0,0,0,0,3,0,0,"0-0","Y","Y","N",4,0,6
"1221","EC",2023-08-28,"Chesterfield","Hartlepool",3,2,"H",1,2,"A",1.76,4.22,4.1,"1-2","3-2",0,0,0,0,3,4,0,0,0,0,0,0,5,0,0,"0-0","Y","Y","Y",7,0,6
"1222","EC",2023-08-28,"Eastleigh","Aldershot",3,0,"H",1,0,"H",2.47,3.51,2.82,"1-0","3-0",0,0,0,0,0,1,0,1,0,0,0,0,3,0,0,"0-0","Y","Y","N",1,1,6
"1223","EC",2023-08-28,"Fylde","Altrincham",3,3,"D",0,2,"A",2.45,3.73,2.72,"0-2","3-3",0,0,0,0,4,1,0,0,0,0,0,0,6,0,0,"0-0","Y","Y","Y",5,0,6
"1224","EC",2023-08-28,"Halifax","Gateshead",0,0,"D",0,0,"D",2.79,3.51,2.49,"0-0","0-0",0,0,0,0,4,3,0,1,0,0,0,0,0,0,0,"0-0","N","N","N",7,1,6
"1225","EC",2023-08-28,"Kidderminster","Maidenhead",0,0,"D",0,0,"D",1.98,3.5,3.93,"0-0","0-0",0,0,0,0,2,2,0,0,0,0,0,0,0,0,0,"0-0","N","N","N",4,0,6
"1226","EC",2023-08-28,"Oldham","Solihull",0,2,"A",0,0,"D",1.9,3.98,3.72,"0-0","0-2",0,0,0,0,4,0,1,0,0,0,0,0,2,0,0,"0-0","Y","N","N",4,1,6
"1227","EC",2023-08-28,"Oxford City","Boreham Wood",4,0,"H",0,0,"D",3.48,3.47,2.13,"0-0","4-0",0,0,0,0,2,2,0,0,0,0,0,0,4,0,0,"0-0","Y","Y","Y",4,0,6
"1228","EC",2023-08-28,"Wealdstone","Dag and Red",0,2,"A",0,0,"D",2.25,3.77,2.98,"0-0","0-2",0,0,0,0,1,0,0,0,0,0,0,0,2,0,0,"0-0","Y","N","N",1,0,6
"1229","EC",2023-08-28,"Woking","Dorking",2,0,"H",1,0,"H",1.58,4.38,5.25,"1-0","2-0",0,0,0,0,2,0,0,0,0,0,0,0,2,0,0,"0-0","Y","N","N",2,0,6
"1230","EC",2023-08-28,"York","Rochdale",1,3,"A",1,1,"D",2.67,3.41,2.66,"1-1","1-3",0,0,0,0,5,4,1,0,0,0,0,0,4,0,0,"0-0","Y","Y","Y",9,1,6
"1231","EC",2023-09-02,"Aldershot","Chesterfield",3,4,"A",1,1,"D",4.25,3.97,1.79,"1-1","3-4",0,0,0,0,1,3,1,0,0,0,0,0,7,0,0,"0-0","Y","Y","Y",4,1,7
"1232","EC",2023-09-02,"Altrincham","Bromley",1,2,"A",1,1,"D",1.74,4,4.35,"1-1","1-2",0,0,0,0,2,1,0,0,0,0,0,0,3,0,0,"0-0","Y","Y","N",3,0,7
"1233","EC",2023-09-02,"Boreham Wood","Barnet",0,1,"A",0,0,"D",2.67,3.42,2.65,"0-0","0-1",0,0,0,0,3,2,0,0,0,0,0,0,1,0,0,"0-0","N","N","N",5,0,7
"1234","EC",2023-09-02,"Dag and Red","Fylde",3,1,"H",2,1,"H",2.55,3.49,2.69,"2-1","3-1",0,0,0,0,1,3,0,0,0,0,0,0,4,0,0,"0-0","Y","Y","Y",4,0,7
"1235","EC",2023-09-02,"Dorking","Eastleigh",0,0,"D",0,0,"D",3.03,3.64,2.27,"0-0","0-0",0,0,0,0,1,2,0,0,0,0,0,0,0,0,0,"0-0","N","N","N",3,0,7
"1236","EC",2023-09-02,"Ebbsfleet","York",4,1,"H",2,1,"H",2.06,3.64,3.49,"2-1","4-1",0,0,0,0,1,3,0,0,0,0,0,0,5,0,0,"0-0","Y","Y","Y",4,0,7
"1237","EC",2023-09-02,"Hartlepool","Wealdstone",2,1,"H",1,0,"H",1.7,4.12,4.57,"1-0","2-1",0,0,0,0,1,0,0,0,0,0,0,0,3,0,0,"0-0","Y","Y","N",1,0,7
"1238","EC",2023-09-02,"Maidenhead","Woking",0,0,"D",0,0,"D",3.79,3.37,2.06,"0-0","0-0",0,0,0,0,1,2,0,0,0,0,0,0,0,0,0,"0-0","N","N","N",3,0,7
"1239","EC",2023-09-02,"Rochdale","Halifax",0,1,"A",0,1,"A",1.96,3.53,3.96,"0-1","0-1",0,0,0,0,4,1,0,0,0,0,0,0,1,0,0,"0-0","N","N","N",5,0,7
"1240","EC",2023-09-02,"Solihull","Oxford City",3,3,"D",2,1,"H",1.8,4.06,4.06,"2-1","3-3",0,0,0,0,0,3,0,0,0,0,0,0,6,0,0,"0-0","Y","Y","Y",3,0,7
"1241","EC",2023-09-02,"Southend","Kidderminster",2,1,"H",0,0,"D",1.88,3.41,4.53,"0-0","2-1",0,0,0,0,1,2,0,0,0,0,0,0,3,0,0,"0-0","Y","Y","N",3,0,7
"1242","EC",2023-09-02,"Gateshead","Oldham",2,2,"D",0,1,"A",1.88,3.89,3.86,"0-1","2-2",0,0,0,0,2,4,0,1,0,0,0,0,4,0,0,"0-0","Y","Y","Y",6,1,7
"1243","EC",2023-09-09,"Halifax","Southend",1,1,"D",0,0,"D",2.66,3.25,2.78,"0-0","1-1",0,0,0,0,2,2,1,0,0,0,0,0,2,0,0,"0-0","Y","N","N",4,1,8
"1244","EC",2023-09-09,"Barnet","Altrincham",3,0,"H",1,0,"H",1.92,3.81,3.81,"1-0","3-0",0,0,0,0,2,3,0,0,0,0,0,0,3,0,0,"0-0","Y","Y","N",5,0,8
"1245","EC",2023-09-09,"Bromley","Maidenhead",4,1,"H",3,0,"H",2.2,3.49,3.3,"3-0","4-1",0,0,0,0,1,0,0,0,0,0,0,0,5,0,0,"0-0","Y","Y","Y",1,0,8
"1246","EC",2023-09-09,"Chesterfield","Dag and Red",3,1,"H",0,1,"A",1.47,4.78,6.23,"0-1","3-1",0,0,0,0,0,2,0,1,0,0,0,0,4,0,0,"0-0","Y","Y","Y",2,1,8
"1247","EC",2023-09-09,"Eastleigh","Gateshead",0,6,"A",0,4,"A",2.95,3.45,2.37,"0-4","0-6",0,0,0,0,4,3,0,0,0,0,0,0,6,0,0,"0-0","Y","Y","Y",7,0,8
"1248","EC",2023-09-09,"Fylde","Aldershot",0,2,"A",0,0,"D",1.95,4.06,3.46,"0-0","0-2",0,0,0,0,1,1,0,0,0,0,0,0,2,0,0,"0-0","Y","N","N",2,0,8
"1249","EC",2023-09-09,"Kidderminster","Rochdale",1,1,"D",1,0,"H",2.59,3.14,2.94,"1-0","1-1",0,0,0,0,4,1,0,0,0,0,0,0,2,0,0,"0-0","Y","N","N",5,0,8
"1250","EC",2023-09-09,"Oldham","Dorking",0,0,"D",0,0,"D",1.58,4.35,5.14,"0-0","0-0",0,0,0,0,2,2,0,0,0,0,0,0,0,0,0,"0-0","N","N","N",4,0,8
"1251","EC",2023-09-09,"Oxford City","Hartlepool",5,2,"H",1,2,"A",3.71,3.93,1.92,"1-2","5-2",0,0,0,0,4,0,0,0,0,0,0,0,7,0,0,"0-0","Y","Y","Y",4,0,8
"1252","EC",2023-09-09,"Wealdstone","Ebbsfleet",2,1,"H",0,0,"D",2.79,3.89,2.29,"0-0","2-1",0,0,0,0,4,5,1,1,0,0,0,0,3,0,0,"0-0","Y","Y","N",9,2,8
"1253","EC",2023-09-09,"Woking","Solihull",1,1,"D",0,1,"A",1.68,4.08,4.62,"0-1","1-1",0,0,0,0,4,3,0,0,0,0,0,0,2,0,0,"0-0","Y","N","N",7,0,8
"1254","EC",2023-09-09,"York","Boreham Wood",2,2,"D",1,0,"H",2.58,3.34,2.81,"1-0","2-2",0,0,0,0,1,4,0,0,0,0,0,0,4,0,0,"0-0","Y","Y","Y",5,0,8
"1255","EC",2023-09-16,"Aldershot","Gateshead",1,1,"D",0,0,"D",3.28,3.85,2.05,"0-0","1-1",0,0,0,0,2,0,0,0,0,0,0,0,2,0,0,"0-0","Y","N","N",2,0,9
"1256","EC",2023-09-16,"Bromley","Oldham",3,0,"H",2,0,"H",2.92,3.69,2.32,"2-0","3-0",0,0,0,0,1,1,0,0,0,0,0,0,3,0,0,"0-0","Y","Y","N",2,0,9
"1257","EC",2023-09-16,"Ebbsfleet","Chesterfield",0,1,"A",0,0,"D",3.26,4.09,2.02,"0-0","0-1",0,0,0,0,4,3,0,1,0,0,0,0,1,0,0,"0-0","N","N","N",7,1,9
"1258","EC",2023-09-16,"Fylde","Eastleigh",1,2,"A",0,1,"A",2.09,3.68,3.39,"0-1","1-2",0,0,0,0,1,2,1,0,0,0,0,0,3,0,0,"0-0","Y","Y","N",3,1,9
"1259","EC",2023-09-16,"Halifax","Dorking",0,1,"A",0,1,"A",1.71,4.04,4.47,"0-1","0-1",0,0,0,0,1,4,0,0,0,0,0,0,1,0,0,"0-0","N","N","N",5,0,9
"1260","EC",2023-09-16,"Hartlepool","Woking",0,2,"A",0,0,"D",2.28,3.53,3.11,"0-0","0-2",0,0,0,0,1,1,0,0,0,0,0,0,2,0,0,"0-0","Y","N","N",2,0,9
"1261","EC",2023-09-16,"Maidenhead","Boreham Wood",0,1,"A",0,0,"D",2.95,3.21,2.5,"0-0","0-1",0,0,0,0,0,3,0,0,0,0,0,0,1,0,0,"0-0","N","N","N",3,0,9
"1262","EC",2023-09-16,"Oxford City","Dag and Red",0,0,"D",0,0,"D",2.52,3.5,2.72,"0-0","0-0",0,0,0,0,2,1,0,0,0,0,0,0,0,0,0,"0-0","N","N","N",3,0,9
"1263","EC",2023-09-16,"Rochdale","Barnet",4,2,"H",2,1,"H",2.9,3.49,2.43,"2-1","4-2",0,0,0,0,2,1,0,0,0,0,0,0,6,0,0,"0-0","Y","Y","Y",3,0,9
"1264","EC",2023-09-16,"Wealdstone","Altrincham",0,0,"D",0,0,"D",2.66,3.8,2.47,"0-0","0-0",0,0,0,0,1,1,0,0,0,0,0,0,0,0,0,"0-0","N","N","N",2,0,9
"1265","EC",2023-09-16,"York","Southend",3,0,"H",1,0,"H",3.57,3.69,2.02,"1-0","3-0",0,0,0,0,2,2,0,2,0,0,0,0,3,0,0,"0-0","Y","Y","N",4,2,9
"1266","EC",2023-09-16,"Kidderminster","Solihull",0,1,"A",0,1,"A",2.22,3.45,3.28,"0-1","0-1",0,0,0,0,1,2,0,0,0,0,0,0,1,0,0,"0-0","N","N","N",3,0,9
"1267","EC",2023-09-19,"Altrincham","Hartlepool",2,2,"D",2,1,"H",2.9,3.76,2.3,"2-1","2-2",0,0,0,0,2,5,0,0,0,0,0,0,4,0,0,"0-0","Y","Y","Y",7,0,10
"1268","EC",2023-09-19,"Barnet","Aldershot",2,1,"H",1,0,"H",1.58,4.4,5.25,"1-0","2-1",0,0,0,0,3,3,0,0,0,0,0,0,3,0,0,"0-0","Y","Y","N",6,0,10
"1269","EC",2023-09-19,"Boreham Wood","Rochdale",1,1,"D",0,0,"D",2.65,3.18,2.84,"0-0","1-1",0,0,0,0,1,0,0,0,0,0,0,0,2,0,0,"0-0","Y","N","N",1,0,10
"1270","EC",2023-09-19,"Chesterfield","Halifax",3,2,"H",2,1,"H",1.46,4.46,7.03,"2-1","3-2",0,0,0,0,4,3,1,1,0,0,0,0,5,0,0,"0-0","Y","Y","Y",7,2,10
"1271","EC",2023-09-19,"Dag and Red","Bromley",0,1,"A",0,0,"D",2.66,3.11,2.89,"0-0","0-1",0,0,0,0,2,2,0,0,0,0,0,0,1,0,0,"0-0","N","N","N",4,0,10
"1272","EC",2023-09-19,"Dorking","Wealdstone",3,1,"H",3,0,"H",3.27,3.85,2.08,"3-0","3-1",0,0,0,0,3,2,0,0,0,0,0,0,4,0,0,"0-0","Y","Y","Y",5,0,10
"1273","EC",2023-09-19,"Eastleigh","Oxford City",2,2,"D",1,0,"H",2.16,3.78,3.15,"1-0","2-2",0,0,0,0,1,2,0,0,0,0,0,0,4,0,0,"0-0","Y","Y","Y",3,0,10
"1274","EC",2023-09-19,"Gateshead","Kidderminster",3,0,"H",2,0,"H",1.76,3.96,4.37,"2-0","3-0",0,0,0,0,0,1,0,0,0,0,0,0,3,0,0,"0-0","Y","Y","N",1,0,10
"1275","EC",2023-09-19,"Oldham","York",2,0,"H",1,0,"H",2.01,3.84,3.47,"1-0","2-0",0,0,0,0,3,1,0,0,0,0,0,0,2,0,0,"0-0","Y","N","N",4,0,10
"1276","EC",2023-09-19,"Solihull","Fylde",2,1,"H",2,1,"H",2.4,3.76,2.76,"2-1","2-1",0,0,0,0,2,3,0,0,0,0,0,0,3,0,0,"0-0","Y","Y","N",5,0,10
"1277","EC",2023-09-19,"Southend","Maidenhead",2,0,"H",0,0,"D",2.15,3.32,3.59,"0-0","2-0",0,0,0,0,1,1,0,0,0,0,0,0,2,0,0,"0-0","Y","N","N",2,0,10
"1278","EC",2023-09-19,"Woking","Ebbsfleet",1,1,"D",1,0,"H",1.72,3.89,4.76,"1-0","1-1",0,0,0,0,3,1,0,0,0,0,0,0,2,0,0,"0-0","Y","N","N",4,0,10
"1279","EC",2023-09-23,"Woking","York",1,2,"A",0,1,"A",1.82,3.82,4.24,"0-1","1-2",0,0,0,0,1,1,0,0,0,0,0,0,3,0,0,"0-0","Y","Y","N",2,0,11
"1280","EC",2023-09-23,"Altrincham","Ebbsfleet",6,1,"H",4,1,"H",2.1,3.49,3.55,"4-1","6-1",0,0,0,0,2,1,0,0,0,0,0,0,7,0,0,"0-0","Y","Y","Y",3,0,11
"1281","EC",2023-09-23,"Barnet","Halifax",0,0,"D",0,0,"D",1.79,3.5,4.92,"0-0","0-0",0,0,0,0,3,1,0,0,0,0,0,0,0,0,0,"0-0","N","N","N",4,0,11
"1282","EC",2023-09-23,"Boreham Wood","Aldershot",1,2,"A",0,1,"A",1.9,3.69,3.91,"0-1","1-2",0,0,0,0,2,0,0,0,0,0,0,0,3,0,0,"0-0","Y","Y","N",2,0,11
"1283","EC",2023-09-23,"Chesterfield","Wealdstone",3,2,"H",0,1,"A",1.42,5.39,6.12,"0-1","3-2",0,0,0,0,2,5,0,0,0,0,0,0,5,0,0,"0-0","Y","Y","Y",7,0,11
"1284","EC",2023-09-23,"Dag and Red","Hartlepool",0,1,"A",0,1,"A",3.19,3.57,2.22,"0-1","0-1",0,0,0,0,1,3,0,0,0,0,0,0,1,0,0,"0-0","N","N","N",4,0,11
"1285","EC",2023-09-23,"Dorking","Rochdale",1,2,"A",0,0,"D",3.81,3.82,1.88,"0-0","1-2",0,0,0,0,3,1,1,0,0,0,0,0,3,0,0,"0-0","Y","Y","N",4,1,11
"1286","EC",2023-09-23,"Eastleigh","Kidderminster",2,1,"H",2,1,"H",2.51,3.36,2.87,"2-1","2-1",0,0,0,0,2,1,0,0,0,0,0,0,3,0,0,"0-0","Y","Y","N",3,0,11
"1287","EC",2023-09-23,"Gateshead","Maidenhead",3,0,"H",0,0,"D",1.47,4.64,6.53,"0-0","3-0",0,0,0,0,0,1,0,0,0,0,0,0,3,0,0,"0-0","Y","Y","N",1,0,11
"1288","EC",2023-09-23,"Oldham","Oxford City",4,0,"H",2,0,"H",1.66,4.09,4.94,"2-0","4-0",0,0,0,0,1,2,0,0,0,0,0,0,4,0,0,"0-0","Y","Y","Y",3,0,11
"1289","EC",2023-09-23,"Solihull","Bromley",1,1,"D",0,0,"D",2.13,3.75,3.24,"0-0","1-1",0,0,0,0,1,2,0,0,0,0,0,0,2,0,0,"0-0","Y","N","N",3,0,11
"1290","EC",2023-09-23,"Southend","Fylde",1,2,"A",0,1,"A",1.83,3.81,4.21,"0-1","1-2",0,0,0,0,0,1,0,0,0,0,0,0,3,0,0,"0-0","Y","Y","N",1,0,11
"1291","EC",2023-09-26,"Aldershot","Southend",1,1,"D",1,0,"H",2.96,3.56,2.35,"1-0","1-1",0,0,0,0,2,3,0,0,0,0,0,0,2,0,0,"0-0","Y","N","N",5,0,12
"1292","EC",2023-09-26,"Bromley","Eastleigh",1,0,"H",1,0,"H",2.18,3.49,3.34,"1-0","1-0",0,0,0,0,1,2,0,0,0,0,0,0,1,0,0,"0-0","N","N","N",3,0,12
"1293","EC",2023-09-26,"Ebbsfleet","Dorking",0,1,"A",0,0,"D",1.63,4.38,4.79,"0-0","0-1",0,0,0,0,0,4,0,0,0,0,0,0,1,0,0,"0-0","N","N","N",4,0,12
"1294","EC",2023-09-26,"Fylde","Boreham Wood",2,2,"D",1,1,"D",2.43,3.44,2.93,"1-1","2-2",0,0,0,0,1,2,0,0,0,0,0,0,4,0,0,"0-0","Y","Y","Y",3,0,12
"1295","EC",2023-09-26,"Halifax","Dag and Red",0,0,"D",0,0,"D",2.14,3.25,3.68,"0-0","0-0",0,0,0,0,3,4,0,0,0,0,0,0,0,0,0,"0-0","N","N","N",7,0,12
"1296","EC",2023-09-26,"Hartlepool","Solihull",0,2,"A",0,2,"A",2.01,3.78,3.52,"0-2","0-2",0,0,0,0,3,3,0,0,0,0,0,0,2,0,0,"0-0","Y","N","N",6,0,12
"1297","EC",2023-09-26,"Kidderminster","Oldham",1,2,"A",0,1,"A",2.98,3.31,2.46,"0-1","1-2",0,0,0,0,1,1,0,0,0,0,0,0,3,0,0,"0-0","Y","Y","N",2,0,12
"1298","EC",2023-09-26,"Maidenhead","Altrincham",0,1,"A",0,0,"D",3.11,3.52,2.28,"0-0","0-1",0,0,0,0,2,1,0,0,0,0,0,0,1,0,0,"0-0","N","N","N",3,0,12
"1299","EC",2023-09-26,"Oxford City","Gateshead",0,4,"A",0,1,"A",4.94,4.43,1.61,"0-1","0-4",0,0,0,0,1,3,0,0,0,0,0,0,4,0,0,"0-0","Y","Y","Y",4,0,12
"1300","EC",2023-09-26,"Wealdstone","Woking",1,0,"H",1,0,"H",3.26,3.85,2.09,"1-0","1-0",0,0,0,0,2,0,0,0,0,0,0,0,1,0,0,"0-0","N","N","N",2,0,12
"1301","EC",2023-09-26,"York","Barnet",2,4,"A",1,1,"D",3.1,3.61,2.25,"1-1","2-4",0,0,0,0,0,2,0,0,0,0,0,0,6,0,0,"0-0","Y","Y","Y",2,0,12
"1302","EC",2023-09-26,"Rochdale","Chesterfield",1,2,"A",1,2,"A",3.46,3.73,2.05,"1-2","1-2",0,0,0,0,3,3,0,0,0,0,0,0,3,0,0,"0-0","Y","Y","N",6,0,12
"1303","EC",2023-09-30,"Aldershot","Dag and Red",3,2,"H",1,1,"D",2.33,3.6,2.97,"1-1","3-2",0,0,0,0,1,5,0,1,0,0,0,0,5,0,0,"0-0","Y","Y","Y",6,1,13
"1304","EC",2023-09-30,"Bromley","Gateshead",3,1,"H",0,0,"D",3.72,3.57,2.01,"0-0","3-1",0,0,0,0,4,2,1,0,0,0,0,0,4,0,0,"0-0","Y","Y","Y",6,1,13
"1305","EC",2023-09-30,"Ebbsfleet","Boreham Wood",3,1,"H",2,1,"H",2.56,3.65,2.63,"2-1","3-1",0,0,0,0,2,6,0,1,0,0,0,0,4,0,0,"0-0","Y","Y","Y",8,1,13
"1306","EC",2023-09-30,"Fylde","Woking",0,2,"A",0,1,"A",2.86,3.55,2.42,"0-1","0-2",0,0,0,0,1,3,0,0,0,0,0,0,2,0,0,"0-0","Y","N","N",4,0,13
"1307","EC",2023-09-30,"Halifax","Eastleigh",2,3,"A",0,1,"A",1.99,3.44,3.95,"0-1","2-3",0,0,0,0,1,2,0,0,0,0,0,0,5,0,0,"0-0","Y","Y","Y",3,0,13
"1308","EC",2023-09-30,"Hartlepool","Dorking",0,2,"A",0,0,"D",1.56,4.6,5.22,"0-0","0-2",0,0,0,0,1,1,0,0,0,0,0,0,2,0,0,"0-0","Y","N","N",2,0,13
"1309","EC",2023-09-30,"Kidderminster","Barnet",1,2,"A",0,2,"A",3.2,3.61,2.16,"0-2","1-2",0,0,0,0,2,3,0,0,0,0,0,0,3,0,0,"0-0","Y","Y","N",5,0,13
"1310","EC",2023-09-30,"Maidenhead","Chesterfield",1,1,"D",1,0,"H",6.46,4.21,1.52,"1-0","1-1",0,0,0,0,3,3,0,0,0,0,0,0,2,0,0,"0-0","Y","N","N",6,0,13
"1311","EC",2023-09-30,"Rochdale","Southend",2,2,"D",2,1,"H",2.36,3.39,3,"2-1","2-2",0,0,0,0,0,4,0,0,0,0,0,0,4,0,0,"0-0","Y","Y","Y",4,0,13
"1312","EC",2023-09-30,"Wealdstone","Oldham",1,1,"D",1,1,"D",3.3,3.7,2.08,"1-1","1-1",0,0,0,0,1,1,0,0,0,0,0,0,2,0,0,"0-0","Y","N","N",2,0,13
"1313","EC",2023-09-30,"York","Solihull",2,2,"D",1,0,"H",2.44,3.69,2.7,"1-0","2-2",0,0,0,0,2,1,0,0,0,0,0,0,4,0,0,"0-0","Y","Y","Y",3,0,13
"1314","EC",2023-09-30,"Oxford City","Altrincham",1,2,"A",0,1,"A",3.21,3.86,2.11,"0-1","1-2",0,0,0,0,1,0,0,0,0,0,0,0,3,0,0,"0-0","Y","Y","N",1,0,13
"1315","EC",2023-10-03,"Altrincham","Aldershot",2,1,"H",1,0,"H",1.81,3.96,4.1,"1-0","2-1",0,0,0,0,2,2,0,0,0,0,0,0,3,0,0,"0-0","Y","Y","N",4,0,14
"1316","EC",2023-10-03,"Barnet","Fylde",2,1,"H",0,1,"A",1.51,4.56,6.01,"0-1","2-1",0,0,0,0,1,6,0,1,0,0,0,0,3,0,0,"0-0","Y","Y","N",7,1,14
"1317","EC",2023-10-03,"Chesterfield","Bromley",2,0,"H",0,0,"D",1.41,5.02,7.1,"0-0","2-0",0,0,0,0,2,2,0,0,0,0,0,0,2,0,0,"0-0","Y","N","N",4,0,14
"1318","EC",2023-10-03,"Dag and Red","York",1,2,"A",0,0,"D",2.5,3.13,3.08,"0-0","1-2",0,0,0,0,2,1,0,0,0,0,0,0,3,0,0,"0-0","Y","Y","N",3,0,14
"1319","EC",2023-10-03,"Dorking","Kidderminster",0,1,"A",0,1,"A",2.63,3.52,2.63,"0-1","0-1",0,0,0,0,2,1,0,0,0,0,0,0,1,0,0,"0-0","N","N","N",3,0,14
"1320","EC",2023-10-03,"Eastleigh","Ebbsfleet",5,2,"H",2,1,"H",2.1,3.88,3.21,"2-1","5-2",0,0,0,0,4,3,0,1,0,0,0,0,7,0,0,"0-0","Y","Y","Y",7,1,14
"1321","EC",2023-10-03,"Gateshead","Wealdstone",2,1,"H",0,0,"D",1.44,4.92,6.53,"0-0","2-1",0,0,0,0,1,2,0,0,0,0,0,0,3,0,0,"0-0","Y","Y","N",3,0,14
"1322","EC",2023-10-03,"Oldham","Maidenhead",1,1,"D",1,0,"H",1.62,4.22,5.11,"1-0","1-1",0,0,0,0,2,2,0,0,0,0,0,0,2,0,0,"0-0","Y","N","N",4,0,14
"1323","EC",2023-10-03,"Solihull","Rochdale",2,0,"H",0,0,"D",2.46,3.44,2.89,"0-0","2-0",0,0,0,0,0,3,0,0,0,0,0,0,2,0,0,"0-0","Y","N","N",3,0,14
"1324","EC",2023-10-03,"Southend","Oxford City",2,0,"H",2,0,"H",1.52,4.39,6.12,"2-0","2-0",0,0,0,0,2,1,0,0,0,0,0,0,2,0,0,"0-0","Y","N","N",3,0,14
"1325","EC",2023-10-03,"Woking","Halifax",1,2,"A",1,0,"H",1.88,3.47,4.39,"1-0","1-2",0,0,0,0,4,0,0,0,0,0,0,0,3,0,0,"0-0","Y","Y","N",4,0,14
"1326","EC",2023-10-04,"Boreham Wood","Hartlepool",1,0,"H",0,0,"D",2.56,3.45,2.75,"0-0","1-0",0,0,0,0,2,1,0,0,0,0,0,0,1,0,0,"0-0","N","N","N",3,0,14
"1327","EC",2023-10-07,"Boreham Wood","Chesterfield",0,2,"A",0,1,"A",3.87,3.67,1.93,"0-1","0-2",0,0,0,0,1,0,0,0,0,0,0,0,2,0,0,"0-0","Y","N","N",1,0,15
"1328","EC",2023-10-07,"Ebbsfleet","Halifax",0,2,"A",0,1,"A",2.48,3.54,2.79,"0-1","0-2",0,0,0,0,2,2,0,0,0,0,0,0,2,0,0,"0-0","Y","N","N",4,0,15
"1329","EC",2023-10-07,"Gateshead","Altrincham",0,2,"A",0,0,"D",1.59,4.4,5.18,"0-0","0-2",0,0,0,0,5,2,0,0,0,0,0,0,2,0,0,"0-0","Y","N","N",7,0,15
"1330","EC",2023-10-07,"Hartlepool","Eastleigh",3,1,"H",1,1,"D",2.07,3.92,3.19,"1-1","3-1",0,0,0,0,1,2,0,0,0,0,0,0,4,0,0,"0-0","Y","Y","Y",3,0,15
"1331","EC",2023-10-07,"Kidderminster","Wealdstone",1,0,"H",0,0,"D",2.21,3.61,3.18,"0-0","1-0",0,0,0,0,1,2,0,0,0,0,0,0,1,0,0,"0-0","N","N","N",3,0,15
"1332","EC",2023-10-07,"Maidenhead","Rochdale",2,2,"D",0,1,"A",3.37,3.43,2.19,"0-1","2-2",0,0,0,0,3,3,0,0,0,0,0,0,4,0,0,"0-0","Y","Y","Y",6,0,15
"1333","EC",2023-10-07,"Oldham","Dag and Red",1,1,"D",1,0,"H",1.8,3.69,4.51,"1-0","1-1",0,0,0,0,0,1,0,0,0,0,0,0,2,0,0,"0-0","Y","N","N",1,0,15
"1334","EC",2023-10-07,"Oxford City","Fylde",3,0,"H",1,0,"H",3.01,3.32,2.44,"1-0","3-0",0,0,0,0,2,2,0,0,0,0,0,0,3,0,0,"0-0","Y","Y","N",4,0,15
"1335","EC",2023-10-07,"Solihull","Aldershot",0,1,"A",0,0,"D",1.89,3.9,3.82,"0-0","0-1",0,0,0,0,1,4,0,0,0,0,0,0,1,0,0,"0-0","N","N","N",5,0,15
"1336","EC",2023-10-07,"Woking","Southend",0,2,"A",0,1,"A",2.13,3.59,3.29,"0-1","0-2",0,0,0,0,2,1,0,0,0,0,0,0,2,0,0,"0-0","Y","N","N",3,0,15
"1337","EC",2023-10-07,"York","Bromley",2,2,"D",1,0,"H",2.34,3.43,3.02,"1-0","2-2",0,0,0,0,2,2,0,0,0,0,0,0,4,0,0,"0-0","Y","Y","Y",4,0,15
"1338","EC",2023-10-07,"Dorking","Barnet",2,3,"A",2,0,"H",4.86,3.95,1.69,"2-0","2-3",0,0,0,0,3,1,0,0,0,0,0,0,5,0,0,"0-0","Y","Y","Y",4,0,15
"1339","EC",2023-10-21,"Aldershot","Hartlepool",2,1,"H",0,0,"D",2.82,3.78,2.35,"0-0","2-1",0,0,0,0,3,2,0,0,0,0,0,0,3,0,0,"0-0","Y","Y","N",5,0,16
"1340","EC",2023-10-21,"Barnet","Maidenhead",3,2,"H",1,2,"A",1.41,4.77,7.54,"1-2","3-2",0,0,0,0,2,5,0,1,0,0,0,0,5,0,0,"0-0","Y","Y","Y",7,1,16
"1341","EC",2023-10-21,"Bromley","Oxford City",3,1,"H",1,1,"D",1.71,4.25,4.36,"1-1","3-1",0,0,0,0,2,0,0,0,0,0,0,0,4,0,0,"0-0","Y","Y","Y",2,0,16
"1342","EC",2023-10-21,"Dag and Red","Woking",2,1,"H",1,1,"D",2.92,3.32,2.5,"1-1","2-1",0,0,0,0,3,1,0,1,0,0,0,0,3,0,0,"0-0","Y","Y","N",4,1,16
"1343","EC",2023-10-21,"Eastleigh","York",3,1,"H",1,0,"H",2.07,3.78,3.36,"1-0","3-1",0,0,0,0,1,2,0,0,0,0,0,0,4,0,0,"0-0","Y","Y","Y",3,0,16
"1344","EC",2023-10-21,"Fylde","Ebbsfleet",1,1,"D",0,1,"A",2.1,4.02,3.12,"0-1","1-1",0,0,0,0,1,1,0,1,0,0,0,0,2,0,0,"0-0","Y","N","N",2,1,16
"1345","EC",2023-10-21,"Halifax","Kidderminster",2,1,"H",1,1,"D",2.13,3.26,3.71,"1-1","2-1",0,0,0,0,1,2,0,0,0,0,0,0,3,0,0,"0-0","Y","Y","N",3,0,16
"1346","EC",2023-10-21,"Rochdale","Oldham",3,4,"A",0,1,"A",2.29,3.66,2.99,"0-1","3-4",0,0,0,0,0,2,0,0,0,0,0,0,7,0,0,"0-0","Y","Y","Y",2,0,16
"1347","EC",2023-10-21,"Southend","Solihull",5,0,"H",2,0,"H",1.93,3.49,4.14,"2-0","5-0",0,0,0,0,2,5,0,0,0,0,0,0,5,0,0,"0-0","Y","Y","Y",7,0,16
"1348","EC",2023-10-21,"Wealdstone","Boreham Wood",1,1,"D",1,1,"D",2.6,3.35,2.77,"1-1","1-1",0,0,0,0,1,4,1,0,0,0,0,0,2,0,0,"0-0","Y","N","N",5,1,16
"1349","EC",2023-10-24,"Aldershot","Maidenhead",4,2,"H",2,2,"D",1.91,3.77,3.87,"2-2","4-2",0,0,0,0,2,3,0,0,0,0,0,0,6,0,0,"0-0","Y","Y","Y",5,0,16
"1350","EC",2023-10-24,"Altrincham","Kidderminster",1,1,"D",1,1,"D",2.08,3.55,3.53,"1-1","1-1",0,0,0,0,1,3,0,0,0,0,0,0,2,0,0,"0-0","Y","N","N",4,0,16
"1351","EC",2023-10-24,"Barnet","Solihull",1,1,"D",0,0,"D",1.56,4.33,5.59,"0-0","1-1",0,0,0,0,3,3,0,0,0,0,0,0,2,0,0,"0-0","Y","N","N",6,0,17
"1352","EC",2023-10-24,"Bromley","Dorking",2,1,"H",1,1,"D",1.64,4.29,4.87,"1-1","2-1",0,0,0,0,3,3,0,0,0,0,0,0,3,0,0,"0-0","Y","Y","N",6,0,17
"1353","EC",2023-10-24,"Chesterfield","York",4,0,"H",0,0,"D",1.31,5.71,8.83,"0-0","4-0",0,0,0,0,1,1,0,0,0,0,0,0,4,0,0,"0-0","Y","Y","Y",2,0,17
"1354","EC",2023-10-24,"Dag and Red","Boreham Wood",1,3,"A",1,1,"D",2.44,3.21,3.09,"1-1","1-3",0,0,0,0,0,1,0,0,0,0,0,0,4,0,0,"0-0","Y","Y","Y",1,0,17
"1355","EC",2023-10-24,"Eastleigh","Woking",0,1,"A",0,1,"A",3.08,3.58,2.27,"0-1","0-1",0,0,0,0,0,3,0,0,0,0,0,0,1,0,0,"0-0","N","N","N",3,0,17
"1356","EC",2023-10-24,"Fylde","Oldham",3,0,"H",2,0,"H",2.86,3.72,2.35,"2-0","3-0",0,0,0,0,2,1,0,1,0,0,0,0,3,0,0,"0-0","Y","Y","N",3,1,17
"1357","EC",2023-10-24,"Halifax","Hartlepool",2,1,"H",1,1,"D",2.51,3.34,2.88,"1-1","2-1",0,0,0,0,2,5,0,0,0,0,0,0,3,0,0,"0-0","Y","Y","N",7,0,17
"1358","EC",2023-10-24,"Rochdale","Gateshead",2,2,"D",2,0,"H",3.44,3.78,2.04,"2-0","2-2",0,0,0,0,2,3,0,1,0,0,0,0,4,0,0,"0-0","Y","Y","Y",5,1,17
"1359","EC",2023-10-24,"Southend","Ebbsfleet",3,0,"H",1,0,"H",1.47,4.72,6.27,"1-0","3-0",0,0,0,0,0,3,0,0,0,0,0,0,3,0,0,"0-0","Y","Y","N",3,0,17
"1360","EC",2023-10-24,"Wealdstone","Oxford City",3,1,"H",1,1,"D",1.64,4.23,4.94,"1-1","3-1",0,0,0,0,2,0,0,0,0,0,0,0,4,0,0,"0-0","Y","Y","Y",2,0,17
"1361","EC",2023-10-28,"Boreham Wood","Southend",1,1,"D",0,1,"A",3.57,3.66,2.03,"0-1","1-1",0,0,0,0,4,3,0,0,0,0,0,0,2,0,0,"0-0","Y","N","N",7,0,17
"1362","EC",2023-10-28,"Dorking","Aldershot",2,1,"H",1,0,"H",2.82,3.79,2.35,"1-0","2-1",0,0,0,0,6,2,0,0,0,0,0,0,3,0,0,"0-0","Y","Y","N",8,0,17
"1363","EC",2023-10-28,"Ebbsfleet","Dag and Red",0,1,"A",0,0,"D",2.27,3.74,2.83,"0-0","0-1",0,0,0,0,1,4,0,0,0,0,0,0,1,0,0,"0-0","N","N","N",5,0,18
"1364","EC",2023-10-28,"Gateshead","Fylde",0,4,"A",0,2,"A",1.5,4.79,5.79,"0-2","0-4",0,0,0,0,1,2,0,0,0,0,0,0,4,0,0,"0-0","Y","Y","Y",3,0,18
"1365","EC",2023-10-28,"Hartlepool","Rochdale",2,3,"A",1,3,"A",2.23,4.01,2.88,"1-3","2-3",0,0,0,0,1,0,0,0,0,0,0,0,5,0,0,"0-0","Y","Y","Y",1,0,18
"1366","EC",2023-10-28,"Kidderminster","Chesterfield",1,3,"A",1,1,"D",4.53,3.83,1.77,"1-1","1-3",0,0,0,0,2,2,1,0,0,0,0,0,4,0,0,"0-0","Y","Y","Y",4,1,18
"1367","EC",2023-10-28,"Maidenhead","Eastleigh",3,2,"H",2,0,"H",2.93,3.68,2.32,"2-0","3-2",0,0,0,0,2,6,0,0,0,0,0,0,5,0,0,"0-0","Y","Y","Y",8,0,18
"1368","EC",2023-10-28,"Oldham","Altrincham",2,2,"D",1,2,"A",2.25,3.86,2.93,"1-2","2-2",0,0,0,0,2,1,0,0,0,0,0,0,4,0,0,"0-0","Y","Y","Y",3,0,18
"1369","EC",2023-10-28,"Oxford City","Barnet",0,2,"A",0,2,"A",6.08,4.59,1.5,"0-2","0-2",0,0,0,0,1,1,0,0,0,0,0,0,2,0,0,"0-0","Y","N","N",2,0,18
"1370","EC",2023-10-28,"Solihull","Wealdstone",1,0,"H",0,0,"D",2.12,3.82,3.2,"0-0","1-0",0,0,0,0,1,1,0,1,0,0,0,0,1,0,0,"0-0","N","N","N",2,1,18
"1371","EC",2023-10-28,"Woking","Bromley",0,1,"A",0,0,"D",2.05,3.57,3.59,"0-0","0-1",0,0,0,0,2,0,0,0,0,0,0,0,1,0,0,"0-0","N","N","N",2,0,18
"1372","EC",2023-10-28,"York","Halifax",1,1,"D",0,0,"D",2.98,3.65,2.3,"0-0","1-1",0,0,0,0,2,1,0,0,0,0,0,0,2,0,0,"0-0","Y","N","N",3,0,18
"1373","EC",2023-11-04,"Dorking","Dag and Red",1,3,"A",1,2,"A",2.85,3.57,2.42,"1-2","1-3",0,0,0,0,3,1,0,0,0,0,0,0,4,0,0,"0-0","Y","Y","Y",4,0,18
"1374","EC",2023-11-11,"Aldershot","Kidderminster",1,0,"H",1,0,"H",2.16,3.74,3.17,"1-0","1-0",0,0,0,0,0,1,0,0,0,0,0,0,1,0,0,"0-0","N","N","N",1,0,18
"1375","EC",2023-11-11,"Altrincham","Southend",2,0,"H",0,0,"D",2.69,3.59,2.54,"0-0","2-0",0,0,0,0,0,0,0,0,0,0,0,0,2,0,0,"0-0","Y","N","N",0,0,19
"1376","EC",2023-11-11,"Boreham Wood","Bromley",1,1,"D",0,1,"A",2.6,3.27,2.83,"0-1","1-1",0,0,0,0,0,2,1,0,0,0,0,0,2,0,0,"0-0","Y","N","N",2,1,19
"1377","EC",2023-11-11,"Chesterfield","Barnet",4,2,"H",0,0,"D",1.9,3.9,3.8,"0-0","4-2",0,0,0,0,1,2,0,0,0,0,0,0,6,0,0,"0-0","Y","Y","Y",3,0,19
"1378","EC",2023-11-11,"Fylde","York",0,2,"A",0,2,"A",1.89,3.85,3.88,"0-2","0-2",0,0,0,0,0,1,0,0,0,0,0,0,2,0,0,"0-0","Y","N","N",1,0,19
"1379","EC",2023-11-11,"Gateshead","Dorking",6,0,"H",3,0,"H",1.37,5.18,7.75,"3-0","6-0",0,0,0,0,1,3,0,0,0,0,0,0,6,0,0,"0-0","Y","Y","Y",4,0,19
"1380","EC",2023-11-11,"Hartlepool","Ebbsfleet",2,2,"D",1,1,"D",1.71,4.45,4.15,"1-1","2-2",0,0,0,0,2,2,0,0,0,0,0,0,4,0,0,"0-0","Y","Y","Y",4,0,19
"1381","EC",2023-11-11,"Maidenhead","Halifax",1,0,"H",1,0,"H",2.65,3.41,2.64,"1-0","1-0",0,0,0,0,2,1,1,0,0,0,0,0,1,0,0,"0-0","N","N","N",3,1,19
"1382","EC",2023-11-11,"Oldham","Eastleigh",1,1,"D",0,1,"A",1.56,4.1,4.71,"0-1","1-1",0,0,0,0,4,1,0,0,0,0,0,0,2,0,0,"0-0","Y","N","N",5,0,19
"1383","EC",2023-11-11,"Oxford City","Woking",3,2,"H",2,0,"H",4.26,4.09,1.76,"2-0","3-2",0,0,0,0,4,1,0,0,0,0,0,0,5,0,0,"0-0","Y","Y","Y",5,0,19
"1384","EC",2023-11-11,"Wealdstone","Rochdale",3,2,"H",1,1,"D",2.74,3.54,2.48,"1-1","3-2",0,0,0,0,4,1,0,0,0,0,0,0,5,0,0,"0-0","Y","Y","Y",5,0,19
"1385","EC",2023-11-11,"Dag and Red","Solihull",1,2,"A",1,1,"D",2.41,3.27,3.08,"1-1","1-2",0,0,0,0,2,4,0,0,0,0,0,0,3,0,0,"0-0","Y","Y","N",6,0,19
"1386","EC",2023-11-18,"Barnet","Gateshead",0,2,"A",0,0,"D",2.05,3.99,3.26,"0-0","0-2",0,0,0,0,1,2,0,0,0,0,0,0,2,0,0,"0-0","Y","N","N",3,0,19
"1387","EC",2023-11-18,"Bromley","Fylde",1,0,"H",0,0,"D",1.75,4.07,4.32,"0-0","1-0",0,0,0,0,2,1,0,0,0,0,0,0,1,0,0,"0-0","N","N","N",3,0,20
"1388","EC",2023-11-18,"Dorking","Boreham Wood",2,1,"H",1,0,"H",3.83,3.79,1.92,"1-0","2-1",0,0,0,0,0,0,0,0,0,0,0,0,3,0,0,"0-0","Y","Y","N",0,0,20
"1389","EC",2023-11-18,"Eastleigh","Altrincham",2,1,"H",1,0,"H",3.07,3.8,2.19,"1-0","2-1",0,0,0,0,5,0,0,0,0,0,0,0,3,0,0,"0-0","Y","Y","N",5,0,20
"1390","EC",2023-11-18,"Ebbsfleet","Oxford City",0,4,"A",0,2,"A",1.81,4.12,3.97,"0-2","0-4",0,0,0,0,4,2,1,0,0,0,0,0,4,0,0,"0-0","Y","Y","Y",6,1,20
"1391","EC",2023-11-18,"Halifax","Wealdstone",1,0,"H",0,0,"D",2.08,3.77,3.35,"0-0","1-0",0,0,0,0,2,1,0,0,0,0,0,0,1,0,0,"0-0","N","N","N",3,0,20
"1392","EC",2023-11-18,"Kidderminster","Dag and Red",0,1,"A",0,0,"D",2.7,3,2.94,"0-0","0-1",0,0,0,0,2,2,0,0,0,0,0,0,1,0,0,"0-0","N","N","N",4,0,20
"1393","EC",2023-11-18,"Rochdale","Aldershot",2,1,"H",1,1,"D",1.76,4.17,4.17,"1-1","2-1",0,0,0,0,1,0,0,0,0,0,0,0,3,0,0,"0-0","Y","Y","N",1,0,20
"1394","EC",2023-11-18,"Solihull","Maidenhead",1,2,"A",0,1,"A",1.93,3.73,3.88,"0-1","1-2",0,0,0,0,5,2,0,0,0,0,0,0,3,0,0,"0-0","Y","Y","N",7,0,20
"1395","EC",2023-11-18,"Southend","Chesterfield",2,1,"H",0,1,"A",4.1,4.24,1.76,"0-1","2-1",0,0,0,0,0,1,0,0,0,0,0,0,3,0,0,"0-0","Y","Y","N",1,0,20
"1396","EC",2023-11-18,"Woking","Oldham",0,1,"A",0,0,"D",2.05,3.57,3.6,"0-0","0-1",0,0,0,0,2,1,0,0,0,0,0,0,1,0,0,"0-0","N","N","N",3,0,20
"1397","EC",2023-11-18,"York","Hartlepool",1,3,"A",0,2,"A",2.75,3.68,2.44,"0-2","1-3",0,0,0,0,1,0,0,0,0,0,0,0,4,0,0,"0-0","Y","Y","Y",1,0,20
"1398","EC",2023-11-21,"Bromley","Aldershot",2,3,"A",2,0,"H",1.85,3.75,4.18,"2-0","2-3",0,0,0,0,1,5,1,0,0,0,0,0,5,0,0,"0-0","Y","Y","Y",6,1,20
"1399","EC",2023-11-21,"Eastleigh","Boreham Wood",2,1,"H",1,1,"D",2.66,3.55,2.59,"1-1","2-1",0,0,0,0,1,4,0,0,0,0,0,0,3,0,0,"0-0","Y","Y","N",5,0,21
"1400","EC",2023-11-21,"Ebbsfleet","Maidenhead",1,1,"D",0,0,"D",2.24,3.68,3.05,"0-0","1-1",0,0,0,0,0,3,0,0,0,0,0,0,2,0,0,"0-0","Y","N","N",3,0,21
"1401","EC",2023-11-21,"Halifax","Fylde",2,2,"D",0,1,"A",1.95,3.69,3.81,"0-1","2-2",0,0,0,0,2,3,0,1,0,0,0,0,4,0,0,"0-0","Y","Y","Y",5,1,21
"1402","EC",2023-11-21,"Kidderminster","Hartlepool",1,1,"D",1,1,"D",2.73,3.36,2.64,"1-1","1-1",0,0,0,0,1,2,0,0,0,0,0,0,2,0,0,"0-0","Y","N","N",3,0,21
"1403","EC",2023-11-21,"Rochdale","Altrincham",3,0,"H",1,0,"H",2.28,3.62,3.03,"1-0","3-0",0,0,0,0,2,2,0,0,0,0,0,0,3,0,0,"0-0","Y","Y","N",4,0,21
"1404","EC",2023-11-21,"Solihull","Gateshead",1,2,"A",0,2,"A",3.86,3.85,1.89,"0-2","1-2",0,0,0,0,1,4,0,0,0,0,0,0,3,0,0,"0-0","Y","Y","N",5,0,21
"1405","EC",2023-11-21,"Woking","Chesterfield",0,2,"A",0,1,"A",5.57,4.34,1.56,"0-1","0-2",0,0,0,0,2,1,0,0,0,0,0,0,2,0,0,"0-0","Y","N","N",3,0,21
"1406","EC",2023-11-21,"York","Oxford City",2,0,"H",2,0,"H",1.78,4.03,4.23,"2-0","2-0",0,0,0,0,1,0,0,0,0,0,0,0,2,0,0,"0-0","Y","N","N",1,0,21
"1407","EC",2023-11-22,"Barnet","Oldham",1,4,"A",0,1,"A",1.87,3.86,3.95,"0-1","1-4",0,0,0,0,2,3,0,0,0,0,0,0,5,0,0,"0-0","Y","Y","Y",5,0,21
"1408","EC",2023-11-25,"Fylde","Dorking",3,3,"D",3,1,"H",1.62,4.48,4.77,"3-1","3-3",0,0,0,0,1,1,0,0,0,0,0,0,6,0,0,"0-0","Y","Y","Y",2,0,21
"1409","EC",2023-11-25,"Aldershot","Halifax",1,0,"H",0,0,"D",2.01,3.85,3.46,"0-0","1-0",0,0,0,0,7,2,0,0,0,0,0,0,1,0,0,"0-0","N","N","N",9,0,21
"1410","EC",2023-11-25,"Altrincham","Solihull",6,1,"H",3,0,"H",1.75,4.1,4.28,"3-0","6-1",0,0,0,0,0,1,0,0,0,0,0,0,7,0,0,"0-0","Y","Y","Y",1,0,21
"1411","EC",2023-11-25,"Boreham Wood","Woking",4,2,"H",1,2,"A",2.35,3.31,3.16,"1-2","4-2",0,0,0,0,0,3,0,0,0,0,0,0,6,0,0,"0-0","Y","Y","Y",3,0,22
"1412","EC",2023-11-25,"Chesterfield","Eastleigh",3,2,"H",0,0,"D",1.26,6.25,9.92,"0-0","3-2",0,0,0,0,0,0,0,0,0,0,0,0,5,0,0,"0-0","Y","Y","Y",0,0,22
"1413","EC",2023-11-25,"Dag and Red","Rochdale",1,2,"A",0,1,"A",2.7,3.66,2.49,"0-1","1-2",0,0,0,0,2,0,0,0,0,0,0,0,3,0,0,"0-0","Y","Y","N",2,0,22
"1414","EC",2023-11-25,"Gateshead","Southend",1,1,"D",1,0,"H",1.93,3.8,3.79,"1-0","1-1",0,0,0,0,1,0,0,0,0,0,0,0,2,0,0,"0-0","Y","N","N",1,0,22
"1415","EC",2023-11-25,"Hartlepool","Bromley",1,4,"A",0,2,"A",2.49,3.78,2.65,"0-2","1-4",0,0,0,0,2,3,0,0,0,0,0,0,5,0,0,"0-0","Y","Y","Y",5,0,22
"1416","EC",2023-11-25,"Maidenhead","York",1,1,"D",0,0,"D",2.13,3.49,3.26,"0-0","1-1",0,0,0,0,2,1,0,1,0,0,0,0,2,0,0,"0-0","Y","N","N",3,1,22
"1417","EC",2023-11-25,"Oldham","Ebbsfleet",1,4,"A",0,1,"A",1.68,4.22,4.63,"0-1","1-4",0,0,0,0,0,3,0,0,0,0,0,0,5,0,0,"0-0","Y","Y","Y",3,0,22
"1418","EC",2023-11-25,"Oxford City","Kidderminster",2,2,"D",2,1,"H",2.82,3.44,2.51,"2-1","2-2",0,0,0,0,4,2,0,0,0,0,0,0,4,0,0,"0-0","Y","Y","Y",6,0,22
"1419","EC",2023-11-25,"Wealdstone","Barnet",3,2,"H",1,2,"A",3.74,3.83,1.93,"1-2","3-2",0,0,0,0,2,3,0,0,0,0,0,0,5,0,0,"0-0","Y","Y","Y",5,0,22
"1420","EC",2023-12-02,"Bromley","Rochdale",1,0,"H",0,0,"D",2.44,3.52,2.85,"0-0","1-0",0,0,0,0,0,2,0,0,0,0,0,0,1,0,0,"0-0","N","N","N",2,0,22
"1421","EC",2023-12-02,"Kidderminster","Ebbsfleet",2,0,"H",2,0,"H",2.11,3.52,3.49,"2-0","2-0",0,0,0,0,3,4,0,0,0,0,0,0,2,0,0,"0-0","Y","N","N",7,0,22
"1422","EC",2023-12-02,"Oxford City","Maidenhead",1,4,"A",0,3,"A",3.18,3.58,2.22,"0-3","1-4",0,0,0,0,0,1,0,0,0,0,0,0,5,0,0,"0-0","Y","Y","Y",1,0,22
"1423","EC",2023-12-16,"Gateshead","Halifax",0,2,"A",0,1,"A",1.62,4.14,5.23,"0-1","0-2",0,0,0,0,0,1,0,0,0,0,0,0,2,0,0,"0-0","Y","N","N",1,0,23
"1424","EC",2023-12-16,"Aldershot","Eastleigh",3,5,"A",0,3,"A",1.79,4.33,3.86,"0-3","3-5",0,0,0,0,3,4,0,1,0,0,0,0,8,0,0,"0-0","Y","Y","Y",7,1,23
"1425","EC",2023-12-16,"Altrincham","Fylde",2,1,"H",0,1,"A",1.88,3.95,3.84,"0-1","2-1",0,0,0,0,3,3,0,0,0,0,0,0,3,0,0,"0-0","Y","Y","N",6,0,23
"1426","EC",2023-12-16,"Boreham Wood","Oxford City",2,1,"H",2,1,"H",1.41,4.89,7.31,"2-1","2-1",0,0,0,0,3,1,0,0,0,0,0,0,3,0,0,"0-0","Y","Y","N",4,0,23
"1427","EC",2023-12-16,"Dag and Red","Wealdstone",0,2,"A",0,0,"D",2.3,3.37,3.19,"0-0","0-2",0,0,0,0,3,4,0,0,0,0,0,0,2,0,0,"0-0","Y","N","N",7,0,23
"1428","EC",2023-12-16,"Dorking","Woking",1,2,"A",1,1,"D",3.5,3.77,2.02,"1-1","1-2",0,0,0,0,1,2,0,0,0,0,0,0,3,0,0,"0-0","Y","Y","N",3,0,23
"1429","EC",2023-12-16,"Ebbsfleet","Barnet",1,1,"D",0,0,"D",3.8,4.29,1.81,"0-0","1-1",0,0,0,0,3,1,0,0,0,0,0,0,2,0,0,"0-0","Y","N","N",4,0,23
"1430","EC",2023-12-16,"Hartlepool","Chesterfield",0,1,"A",0,1,"A",5.42,4.31,1.58,"0-1","0-1",0,0,0,0,5,5,0,0,0,0,0,0,1,0,0,"0-0","N","N","N",10,0,23
"1431","EC",2023-12-16,"Maidenhead","Kidderminster",1,0,"H",0,0,"D",2.58,3.17,2.93,"0-0","1-0",0,0,0,0,1,1,0,0,0,0,0,0,1,0,0,"0-0","N","N","N",2,0,23
"1432","EC",2023-12-16,"Rochdale","York",0,0,"D",0,0,"D",1.74,4.05,4.4,"0-0","0-0",0,0,0,0,2,1,0,0,0,0,0,0,0,0,0,"0-0","N","N","N",3,0,23
"1433","EC",2023-12-16,"Solihull","Oldham",2,3,"A",1,0,"H",2.89,3.61,2.38,"1-0","2-3",0,0,0,0,1,4,0,0,0,0,0,0,5,0,0,"0-0","Y","Y","Y",5,0,23
"1434","EC",2023-12-16,"Southend","Bromley",1,2,"A",0,1,"A",2.23,3.67,3.09,"0-1","1-2",0,0,0,0,3,1,0,0,0,0,0,0,3,0,0,"0-0","Y","Y","N",4,0,23
"1435","EC",2023-12-23,"Barnet","Boreham Wood",6,0,"H",3,0,"H",1.93,4,3.59,"3-0","6-0",0,0,0,0,1,2,0,1,0,0,0,0,6,0,0,"0-0","Y","Y","Y",3,1,24
"1436","EC",2023-12-23,"Chesterfield","Aldershot",4,1,"H",1,1,"D",1.29,5.74,9.31,"1-1","4-1",0,0,0,0,0,2,0,0,0,0,0,0,5,0,0,"0-0","Y","Y","Y",2,0,24
"1437","EC",2023-12-23,"Eastleigh","Dorking",2,1,"H",1,0,"H",1.69,4.2,4.57,"1-0","2-1",0,0,0,0,1,0,0,0,0,0,0,0,3,0,0,"0-0","Y","Y","N",1,0,24
"1438","EC",2023-12-23,"Fylde","Dag and Red",1,1,"D",0,1,"A",2.26,3.57,3.1,"0-1","1-1",0,0,0,0,1,2,0,0,0,0,0,0,2,0,0,"0-0","Y","N","N",3,0,24
"1439","EC",2023-12-23,"Halifax","Rochdale",2,2,"D",2,1,"H",2.51,3.19,3,"2-1","2-2",0,0,0,0,2,3,0,0,0,0,0,0,4,0,0,"0-0","Y","Y","Y",5,0,24
"1440","EC",2023-12-23,"Kidderminster","Southend",1,2,"A",1,2,"A",2.75,3.24,2.69,"1-2","1-2",0,0,0,0,0,2,0,0,0,0,0,0,3,0,0,"0-0","Y","Y","N",2,0,24
"1441","EC",2023-12-23,"Oldham","Gateshead",1,2,"A",1,0,"H",3.15,3.68,2.2,"1-0","1-2",0,0,0,0,3,2,0,0,0,0,0,0,3,0,0,"0-0","Y","Y","N",5,0,24
"1442","EC",2023-12-23,"Oxford City","Solihull",1,2,"A",0,0,"D",3.1,3.71,2.21,"0-0","1-2",0,0,0,0,2,0,0,0,0,0,0,0,3,0,0,"0-0","Y","Y","N",2,0,24
"1443","EC",2023-12-23,"Wealdstone","Hartlepool",4,4,"D",3,2,"H",2.32,3.74,2.89,"3-2","4-4",0,0,0,0,0,2,0,0,0,0,0,0,8,0,0,"0-0","Y","Y","Y",2,0,24
"1444","EC",2023-12-23,"Woking","Maidenhead",0,0,"D",0,0,"D",2.02,3.57,3.68,"0-0","0-0",0,0,0,0,2,4,0,0,0,0,0,0,0,0,0,"0-0","N","N","N",6,0,24
"1445","EC",2023-12-23,"York","Ebbsfleet",1,1,"D",1,0,"H",2.27,3.59,3.08,"1-0","1-1",0,0,0,0,1,1,0,0,0,0,0,0,2,0,0,"0-0","Y","N","N",2,0,24
"1446","EC",2023-12-23,"Bromley","Altrincham",2,2,"D",0,1,"A",2.13,3.9,3.14,"0-1","2-2",0,0,0,0,2,2,1,1,0,0,0,0,4,0,0,"0-0","Y","Y","Y",4,2,24
"1447","EC",2023-12-26,"Aldershot","Woking",0,0,"D",0,0,"D",2.23,3.71,3.07,"0-0","0-0",0,0,0,0,3,0,0,0,0,0,0,0,0,0,0,"0-0","N","N","N",3,0,25
"1448","EC",2023-12-26,"Altrincham","Halifax",1,2,"A",0,1,"A",1.94,3.65,3.87,"0-1","1-2",0,0,0,0,2,0,0,0,0,0,0,0,3,0,0,"0-0","Y","Y","N",2,0,25
"1449","EC",2023-12-26,"Boreham Wood","Kidderminster",1,1,"D",0,0,"D",2.16,3.48,3.39,"0-0","1-1",0,0,0,0,3,0,0,0,0,0,0,0,2,0,0,"0-0","Y","N","N",3,0,25
"1450","EC",2023-12-26,"Dag and Red","Eastleigh",4,1,"H",1,0,"H",2.14,3.79,3.19,"1-0","4-1",0,0,0,0,1,4,0,0,0,0,0,0,5,0,0,"0-0","Y","Y","Y",5,0,25
"1451","EC",2023-12-26,"Dorking","Oxford City",0,2,"A",0,0,"D",2.21,3.84,3.05,"0-0","0-2",0,0,0,0,0,1,0,0,0,0,0,0,2,0,0,"0-0","Y","N","N",1,0,25
"1452","EC",2023-12-26,"Ebbsfleet","Bromley",2,3,"A",0,1,"A",3.38,3.72,2.08,"0-1","2-3",0,0,0,0,2,1,0,0,0,0,0,0,5,0,0,"0-0","Y","Y","Y",3,0,25
"1453","EC",2023-12-26,"Gateshead","York",1,1,"D",0,1,"A",1.44,4.77,6.8,"0-1","1-1",0,0,0,0,2,2,0,0,0,0,0,0,2,0,0,"0-0","Y","N","N",4,0,25
"1454","EC",2023-12-26,"Hartlepool","Oldham",1,3,"A",1,2,"A",2.63,3.53,2.66,"1-2","1-3",0,0,0,0,1,4,0,0,0,0,0,0,4,0,0,"0-0","Y","Y","Y",5,0,25
"1455","EC",2023-12-26,"Maidenhead","Wealdstone",0,2,"A",0,2,"A",2.64,3.22,2.82,"0-2","0-2",0,0,0,0,2,1,0,0,0,0,0,0,2,0,0,"0-0","Y","N","N",3,0,25
"1456","EC",2023-12-26,"Rochdale","Fylde",2,0,"H",1,0,"H",1.97,3.82,3.64,"1-0","2-0",0,0,0,0,2,1,0,0,0,0,0,0,2,0,0,"0-0","Y","N","N",3,0,25
"1457","EC",2023-12-26,"Solihull","Chesterfield",2,0,"H",2,0,"H",5.8,4.5,1.53,"2-0","2-0",0,0,0,0,1,2,0,1,0,0,0,0,2,0,0,"0-0","Y","N","N",3,1,25
"1458","EC",2023-12-26,"Southend","Barnet",0,2,"A",0,1,"A",2.42,3.65,2.8,"0-1","0-2",0,0,0,0,2,2,0,0,0,0,0,0,2,0,0,"0-0","Y","N","N",4,0,25
"1459","EC",2023-12-30,"Barnet","Southend",1,0,"H",0,0,"D",2.1,3.86,3.23,"0-0","1-0",0,0,0,0,4,4,0,0,0,0,0,0,1,0,0,"0-0","N","N","N",8,0,26
"1460","EC",2023-12-30,"Bromley","Ebbsfleet",5,1,"H",2,1,"H",1.56,4.4,5.49,"2-1","5-1",0,0,0,0,1,2,0,0,0,0,0,0,6,0,0,"0-0","Y","Y","Y",3,0,26
"1461","EC",2023-12-30,"Kidderminster","Boreham Wood",1,2,"A",1,2,"A",2.53,3.39,2.82,"1-2","1-2",0,0,0,0,1,2,0,0,0,0,0,0,3,0,0,"0-0","Y","Y","N",3,0,26
"1462","EC",2023-12-30,"Oldham","Hartlepool",2,0,"H",1,0,"H",2,3.77,3.56,"1-0","2-0",0,0,0,0,1,1,0,0,0,0,0,0,2,0,0,"0-0","Y","N","N",2,0,26
"1463","EC",2024-01-01,"Chesterfield","Solihull",3,2,"H",0,1,"A",1.32,5.95,8.05,"0-1","3-2",0,0,0,0,0,1,0,0,0,0,0,0,5,0,0,"0-0","Y","Y","Y",1,0,26
"1464","EC",2024-01-01,"Eastleigh","Dag and Red",4,4,"D",2,2,"D",2.83,3.9,2.3,"2-2","4-4",0,0,0,0,3,2,0,0,0,0,0,0,8,0,0,"0-0","Y","Y","Y",5,0,26
"1465","EC",2024-01-01,"Fylde","Rochdale",2,0,"H",0,0,"D",2.33,4.01,2.73,"0-0","2-0",0,0,0,0,0,2,0,0,0,0,0,0,2,0,0,"0-0","Y","N","N",2,0,26
"1466","EC",2024-01-01,"Halifax","Altrincham",0,0,"D",0,0,"D",2.2,3.36,3.4,"0-0","0-0",0,0,0,0,4,2,0,1,0,0,0,0,0,0,0,"0-0","N","N","N",6,1,26
"1467","EC",2024-01-01,"Oxford City","Dorking",1,2,"A",0,0,"D",2.07,3.82,3.33,"0-0","1-2",0,0,0,0,3,4,0,0,0,0,0,0,3,0,0,"0-0","Y","Y","N",7,0,26
"1468","EC",2024-01-01,"Woking","Aldershot",2,3,"A",1,2,"A",2.3,3.79,2.9,"1-2","2-3",0,0,0,0,3,3,0,1,0,0,0,0,5,0,0,"0-0","Y","Y","Y",6,1,26
"1469","EC",2024-01-01,"York","Gateshead",2,0,"H",1,0,"H",4.81,4.48,1.62,"1-0","2-0",0,0,0,0,2,1,0,0,0,0,0,0,2,0,0,"0-0","Y","N","N",3,0,26
"1470","EC",2024-01-06,"Altrincham","Barnet",3,2,"H",2,0,"H",2.97,3.66,2.3,"2-0","3-2",0,0,0,0,2,1,0,0,0,0,0,0,5,0,0,"0-0","Y","Y","Y",3,0,26
"1471","EC",2024-01-06,"Dorking","Oldham",0,1,"A",0,1,"A",4.16,4.31,1.74,"0-1","0-1",0,0,0,0,0,2,0,0,0,0,0,0,1,0,0,"0-0","N","N","N",2,0,27
"1472","EC",2024-01-06,"Ebbsfleet","Wealdstone",2,0,"H",1,0,"H",2.64,3.81,2.48,"1-0","2-0",0,0,0,0,0,2,0,0,0,0,0,0,2,0,0,"0-0","Y","N","N",2,0,27
"1473","EC",2024-01-06,"Hartlepool","Oxford City",2,1,"H",0,0,"D",1.64,4.48,4.68,"0-0","2-1",0,0,0,0,1,1,0,0,0,0,0,0,3,0,0,"0-0","Y","Y","N",2,0,27
"1474","EC",2024-01-06,"Maidenhead","Bromley",0,0,"D",0,0,"D",3.3,3.59,2.16,"0-0","0-0",0,0,0,0,0,2,0,0,0,0,0,0,0,0,0,"0-0","N","N","N",2,0,27
"1475","EC",2024-01-06,"Rochdale","Kidderminster",2,0,"H",0,0,"D",2.14,3.53,3.4,"0-0","2-0",0,0,0,0,2,2,0,0,0,0,0,0,2,0,0,"0-0","Y","N","N",4,0,27
"1476","EC",2024-01-06,"Solihull","Woking",3,0,"H",1,0,"H",2.49,3.39,2.88,"1-0","3-0",0,0,0,0,1,1,0,0,0,0,0,0,3,0,0,"0-0","Y","Y","N",2,0,27
"1477","EC",2024-01-06,"Southend","Halifax",3,0,"H",1,0,"H",2.08,3.29,3.85,"1-0","3-0",0,0,0,0,0,0,0,0,0,0,0,0,3,0,0,"0-0","Y","Y","N",0,0,27
"1478","EC",2024-01-07,"Boreham Wood","York",1,1,"D",0,0,"D",2.06,3.25,3.78,"0-0","1-1",0,0,0,0,2,3,0,0,0,0,0,0,2,0,0,"0-0","Y","N","N",5,0,27
"1479","EC",2024-01-09,"Barnet","Dag and Red",2,1,"H",1,1,"D",1.76,4.24,4.11,"1-1","2-1",0,0,0,0,2,1,0,0,0,0,0,0,3,0,0,"0-0","Y","Y","N",3,0,27
"1480","EC",2024-01-09,"Fylde","Hartlepool",2,1,"H",2,0,"H",1.93,3.92,3.64,"2-0","2-1",0,0,0,0,0,2,0,0,0,0,0,0,3,0,0,"0-0","Y","Y","N",2,0,27
"1481","EC",2024-01-10,"Chesterfield","Gateshead",5,0,"H",4,0,"H",1.52,4.49,5.87,"4-0","5-0",0,0,0,0,1,1,0,0,0,0,0,0,5,0,0,"0-0","Y","Y","Y",2,0,27
"1482","EC",2024-01-13,"Eastleigh","Southend",0,1,"A",0,0,"D",4.11,4.01,1.8,"0-0","0-1",0,0,0,0,2,4,0,0,0,0,0,0,1,0,0,"0-0","N","N","N",6,0,27
"2227","F1",2023-08-11,"Nice","Lille",1,1,"D",1,0,"H",2.63,3.47,2.83,"1-0","1-1",8,3,12,5,3,2,0,0,3,3,13,9,2,6,22,"3-3","Y","N","N",5,0,1
"2228","F1",2023-08-12,"Marseille","Reims",2,1,"H",1,1,"D",1.73,4.04,4.89,"1-1","2-1",14,4,11,4,1,3,0,0,10,10,7,16,3,20,23,"10-10","Y","Y","N",4,0,1
"2229","F1",2023-08-12,"Paris SG","Lorient",0,0,"D",0,0,"D",1.35,5.73,8.38,"0-0","0-0",20,4,4,0,0,0,0,0,9,2,8,6,0,11,14,"9-2","N","N","N",0,0,1
"2230","F1",2023-08-13,"Brest","Lens",3,2,"H",1,2,"A",4.01,3.62,1.99,"1-2","3-2",15,8,10,2,2,3,0,1,6,8,13,15,5,14,28,"6-8","Y","Y","Y",5,1,1
"2231","F1",2023-08-13,"Clermont","Monaco",2,4,"A",1,2,"A",3.69,3.8,2.02,"1-2","2-4",15,7,14,8,0,4,0,0,6,2,7,16,6,8,23,"6-2","Y","Y","Y",4,0,1
"2232","F1",2023-08-13,"Montpellier","Le Havre",2,2,"D",0,1,"A",2.04,3.47,3.99,"0-1","2-2",15,5,12,4,1,2,0,0,5,2,8,12,4,7,20,"5-2","Y","Y","Y",3,0,1
"2233","F1",2023-08-13,"Nantes","Toulouse",1,2,"A",1,0,"H",2.66,3.36,2.82,"1-0","1-2",9,4,9,5,2,2,0,0,7,5,14,14,3,12,28,"7-5","Y","Y","N",4,0,1
"2234","F1",2023-08-13,"Rennes","Metz",5,1,"H",1,1,"D",1.42,5.07,7.64,"1-1","5-1",29,14,9,3,0,2,0,0,5,4,7,10,6,9,17,"5-4","Y","Y","Y",2,0,1
"2235","F1",2023-08-13,"Strasbourg","Lyon",2,1,"H",0,0,"D",2.61,3.55,2.76,"0-0","2-1",8,2,23,7,2,2,0,0,1,6,8,11,3,7,19,"1-6","Y","Y","N",4,0,1
"2236","F1",2023-08-18,"Metz","Marseille",2,2,"D",0,1,"A",4.96,4.13,1.72,"0-1","2-2",10,5,22,5,3,2,1,0,4,9,15,9,4,13,24,"4-9","Y","Y","Y",5,1,2
"2237","F1",2023-08-19,"Lyon","Montpellier",1,4,"A",0,2,"A",1.72,4.25,4.67,"0-2","1-4",7,3,14,8,4,1,1,0,6,2,20,10,5,8,30,"6-2","Y","Y","Y",5,1,2
"2238","F1",2023-08-19,"Toulouse","Paris SG",1,1,"D",0,0,"D",5.01,4.25,1.68,"0-0","1-1",8,2,16,3,0,3,0,0,5,5,8,11,2,10,19,"5-5","Y","N","N",3,0,2
"2239","F1",2023-08-20,"Lille","Nantes",2,0,"H",0,0,"D",1.43,4.96,7.54,"0-0","2-0",18,8,14,4,0,2,1,0,7,5,8,15,2,12,23,"7-5","Y","N","N",2,1,2
"2240","F1",2023-08-20,"Le Havre","Brest",1,2,"A",0,1,"A",2.82,3.22,2.76,"0-1","1-2",18,7,10,5,0,2,0,0,5,3,18,15,3,8,33,"5-3","Y","Y","N",2,0,2
"2241","F1",2023-08-20,"Lorient","Nice",1,1,"D",0,0,"D",3.49,3.52,2.19,"0-0","1-1",9,2,21,8,1,1,0,0,0,9,8,10,2,9,18,"0-9","Y","N","N",2,0,2
"2242","F1",2023-08-20,"Reims","Clermont",2,0,"H",1,0,"H",1.93,3.72,4.1,"1-0","2-0",8,4,11,4,0,0,0,0,3,10,9,6,2,13,15,"3-10","Y","N","N",0,0,2
"2243","F1",2023-08-20,"Monaco","Strasbourg",3,0,"H",2,0,"H",1.84,4.1,4.13,"2-0","3-0",9,4,4,1,2,1,0,0,4,3,19,16,3,7,35,"4-3","Y","Y","N",3,0,2
"2244","F1",2023-08-20,"Lens","Rennes",1,1,"D",1,0,"H",2.42,3.78,2.86,"1-0","1-1",15,4,10,5,2,1,0,0,11,0,15,10,2,11,25,"11-0","Y","N","N",3,0,2
"2245","F1",2023-08-25,"Nantes","Monaco",3,3,"D",2,1,"H",4.87,3.81,1.79,"2-1","3-3",3,3,27,10,2,2,0,0,1,10,8,7,6,11,15,"1-10","Y","Y","Y",4,0,3
"2246","F1",2023-08-26,"Marseille","Brest",2,0,"H",1,0,"H",1.53,4.48,6.43,"1-0","2-0",15,6,18,7,0,1,0,0,3,10,4,8,2,13,12,"3-10","Y","N","N",1,0,3
"2247","F1",2023-08-26,"Paris SG","Lens",3,1,"H",1,0,"H",1.63,4.27,5.45,"1-0","3-1",17,7,12,4,0,5,0,0,5,5,8,16,4,10,24,"5-5","Y","Y","Y",5,0,3
"2248","F1",2023-08-27,"Rennes","Le Havre",2,2,"D",2,1,"H",1.44,4.76,7.86,"2-1","2-2",22,8,7,3,1,2,0,1,5,2,5,7,4,7,12,"5-2","Y","Y","Y",3,1,3
"2249","F1",2023-08-27,"Clermont","Metz",0,1,"A",0,0,"D",1.93,3.83,3.99,"0-0","0-1",16,4,10,5,1,1,0,0,10,2,8,10,1,12,18,"10-2","N","N","N",2,0,3
"2250","F1",2023-08-27,"Montpellier","Reims",1,3,"A",1,2,"A",2.41,3.54,3.02,"1-2","1-3",19,3,12,6,1,1,0,0,5,3,9,19,4,8,28,"5-3","Y","Y","Y",2,0,3
"2251","F1",2023-08-27,"Strasbourg","Toulouse",2,0,"H",0,0,"D",2.17,3.75,3.32,"0-0","2-0",11,3,7,1,1,3,0,0,3,3,16,17,2,6,33,"3-3","Y","N","N",4,0,3
"2252","F1",2023-08-27,"Lorient","Lille",4,1,"H",2,0,"H",3.83,3.75,1.99,"2-0","4-1",9,6,18,7,2,4,0,0,5,8,22,12,5,13,34,"5-8","Y","Y","Y",6,0,3
"2253","F1",2023-08-27,"Nice","Lyon",0,0,"D",0,0,"D",2.11,3.79,3.44,"0-0","0-0",21,4,6,1,1,4,0,0,7,2,8,14,0,9,22,"7-2","N","N","N",5,0,3
"2254","F1",2023-09-01,"Nantes","Marseille",1,1,"D",1,1,"D",4.97,4.02,1.73,"1-1","1-1",10,2,26,9,0,2,1,0,2,7,7,13,2,9,20,"2-7","Y","N","N",2,1,4
"2255","F1",2023-09-02,"Brest","Rennes",0,0,"D",0,0,"D",3.37,3.68,2.18,"0-0","0-0",13,2,6,3,3,1,0,0,7,5,12,12,0,12,24,"7-5","N","N","N",4,0,4
"2256","F1",2023-09-02,"Monaco","Lens",3,0,"H",2,0,"H",2.11,3.93,3.33,"2-0","3-0",11,6,12,1,4,2,0,0,5,2,21,16,3,7,37,"5-2","Y","Y","N",6,0,4
"2257","F1",2023-09-03,"Toulouse","Clermont",2,2,"D",2,1,"H",2.02,3.69,3.82,"2-1","2-2",9,5,15,3,1,3,0,0,0,8,19,17,4,8,36,"0-8","Y","Y","Y",4,0,4
"2258","F1",2023-09-03,"Le Havre","Lorient",3,0,"H",0,0,"D",2.87,3.12,2.79,"0-0","3-0",17,6,9,2,0,0,0,0,5,4,10,7,3,9,17,"5-4","Y","Y","N",0,0,4
"2259","F1",2023-09-03,"Lille","Montpellier",1,0,"H",1,0,"H",1.83,4.25,4.05,"1-0","1-0",15,6,9,5,2,1,0,0,5,5,15,14,1,10,29,"5-5","N","N","N",3,0,4
"2260","F1",2023-09-03,"Metz","Reims",2,2,"D",1,1,"D",4.09,3.72,1.93,"1-1","2-2",12,4,12,2,0,4,0,0,4,1,10,17,4,5,27,"4-1","Y","Y","Y",4,0,4
"2261","F1",2023-09-03,"Nice","Strasbourg",2,0,"H",1,0,"H",1.98,3.58,4.06,"1-0","2-0",16,6,4,0,2,1,0,0,5,2,7,12,2,7,19,"5-2","Y","N","N",3,0,4
"2262","F1",2023-09-03,"Lyon","Paris SG",1,4,"A",0,4,"A",5.79,5.01,1.52,"0-4","1-4",19,8,22,8,2,2,0,0,5,2,9,5,5,7,14,"5-2","Y","Y","Y",4,0,4
"2263","F1",2023-09-15,"Paris SG","Nice",2,3,"A",1,1,"D",1.56,4.6,5.86,"1-1","2-3",12,3,14,8,2,5,0,0,4,3,8,17,5,7,25,"4-3","Y","Y","Y",7,0,5
"2264","F1",2023-09-16,"Rennes","Lille",2,2,"D",0,1,"A",2.17,3.69,3.37,"0-1","2-2",7,4,10,6,1,4,0,0,5,2,11,16,4,7,27,"5-2","Y","Y","Y",5,0,5
"2265","F1",2023-09-16,"Lens","Metz",0,1,"A",0,1,"A",1.52,4.62,6.36,"0-1","0-1",31,10,2,2,1,2,0,0,9,1,12,12,1,10,24,"9-1","N","N","N",3,0,5
"2266","F1",2023-09-17,"Lorient","Monaco",2,2,"D",1,1,"D",4.12,3.98,1.87,"1-1","2-2",10,3,20,7,0,1,0,0,8,6,13,14,4,14,27,"8-6","Y","Y","Y",1,0,5
"2267","F1",2023-09-17,"Clermont","Nantes",0,1,"A",0,0,"D",2.04,3.6,3.85,"0-0","0-1",16,3,8,5,2,2,0,0,6,3,16,16,1,9,32,"6-3","N","N","N",4,0,5
"2268","F1",2023-09-17,"Reims","Brest",1,2,"A",1,0,"H",1.9,3.6,4.43,"1-0","1-2",13,7,18,7,2,4,0,0,8,8,7,11,3,16,18,"8-8","Y","Y","N",6,0,5
"2269","F1",2023-09-17,"Strasbourg","Montpellier",2,2,"D",0,2,"A",2.39,3.61,3.01,"0-2","2-2",14,7,11,4,4,6,0,0,2,4,17,17,4,6,34,"2-4","Y","Y","Y",10,0,5
"2270","F1",2023-09-17,"Marseille","Toulouse",0,0,"D",0,0,"D",1.5,4.87,6.33,"0-0","0-0",24,6,10,3,2,5,0,0,6,1,9,11,0,7,20,"6-1","N","N","N",7,0,5
"2271","F1",2023-09-17,"Lyon","Le Havre",0,0,"D",0,0,"D",1.7,4.23,4.82,"0-0","0-0",23,7,7,0,3,2,0,0,6,1,13,12,0,7,25,"6-1","N","N","N",5,0,5
"2272","F1",2023-09-22,"Monaco","Nice",0,1,"A",0,0,"D",2.25,3.61,3.27,"0-0","0-1",9,3,13,7,1,1,0,0,5,2,13,15,1,7,28,"5-2","N","N","N",2,0,6
"2273","F1",2023-09-23,"Nantes","Lorient",5,3,"H",1,1,"D",2.46,3.45,3.02,"1-1","5-3",19,9,10,7,1,3,0,0,4,2,8,17,8,6,25,"4-2","Y","Y","Y",4,0,6
"2274","F1",2023-09-23,"Brest","Lyon",1,0,"H",0,0,"D",2.57,3.67,2.73,"0-0","1-0",27,11,6,3,3,1,0,0,10,1,17,16,1,11,33,"10-1","N","N","N",4,0,6
"2275","F1",2023-09-24,"Metz","Strasbourg",0,1,"A",0,0,"D",3.01,3.23,2.59,"0-0","0-1",13,1,4,1,2,0,0,0,1,1,16,15,1,2,31,"1-1","N","N","N",2,0,6
"2276","F1",2023-09-24,"Le Havre","Clermont",2,1,"H",2,1,"H",2.48,3.26,3.15,"2-1","2-1",9,3,11,4,2,3,0,0,1,3,15,17,3,4,32,"1-3","Y","Y","N",5,0,6
"2277","F1",2023-09-24,"Lens","Toulouse",2,1,"H",1,1,"D",1.72,4.05,4.93,"1-1","2-1",27,7,7,2,2,1,0,0,9,4,16,15,3,13,31,"9-4","Y","Y","N",3,0,6
"2278","F1",2023-09-24,"Montpellier","Rennes",0,0,"D",0,0,"D",2.7,3.56,2.65,"0-0","0-0",13,4,18,6,2,1,0,0,3,6,10,15,0,9,25,"3-6","N","N","N",3,0,6
"2279","F1",2023-09-24,"Paris SG","Marseille",4,0,"H",2,0,"H",1.64,4.41,5.15,"2-0","4-0",15,5,6,0,0,3,0,0,8,3,11,14,4,11,25,"8-3","Y","Y","Y",3,0,6
"2280","F1",2023-09-26,"Lille","Reims",1,2,"A",0,2,"A",1.96,3.79,3.95,"0-2","1-2",14,3,4,4,1,2,0,0,4,2,4,19,3,6,23,"4-2","Y","Y","N",3,0,6
"2281","F1",2023-09-29,"Strasbourg","Lens",0,1,"A",0,1,"A",3.69,3.48,2.13,"0-1","0-1",8,2,9,2,2,4,0,0,2,3,16,15,1,5,31,"2-3","N","N","N",6,0,7
"2282","F1",2023-09-30,"Clermont","Paris SG",0,0,"D",0,0,"D",7.03,4.81,1.47,"0-0","0-0",12,3,21,10,2,3,0,0,6,9,11,16,0,15,27,"6-9","N","N","N",5,0,7
"2283","F1",2023-09-30,"Monaco","Marseille",3,2,"H",2,2,"D",2.21,3.88,3.14,"2-2","3-2",10,7,8,4,4,4,0,0,2,6,17,15,5,8,32,"2-6","Y","Y","Y",8,0,7
"2284","F1",2023-10-01,"Reims","Lyon",2,0,"H",1,0,"H",2.1,3.81,3.45,"1-0","2-0",8,3,11,6,2,2,0,0,1,5,19,14,2,6,33,"1-5","Y","N","N",4,0,7
"2285","F1",2023-10-01,"Le Havre","Lille",0,2,"A",0,1,"A",4.08,3.44,2.03,"0-1","0-2",5,0,16,6,0,0,0,0,6,6,18,6,2,12,24,"6-6","Y","N","N",0,0,7
"2286","F1",2023-10-01,"Nice","Brest",0,0,"D",0,0,"D",1.8,3.84,4.69,"0-0","0-0",12,1,7,2,1,3,0,0,6,4,13,9,0,10,22,"6-4","N","N","N",4,0,7
"2287","F1",2023-10-01,"Toulouse","Metz",3,0,"H",2,0,"H",2.13,3.47,3.7,"2-0","3-0",15,10,8,3,3,0,0,0,4,6,10,7,3,10,17,"4-6","Y","Y","N",3,0,7
"2288","F1",2023-10-01,"Lorient","Montpellier",0,3,"A",0,1,"A",2.95,3.59,2.44,"0-1","0-3",14,3,14,8,2,1,0,0,8,3,13,6,3,11,19,"8-3","Y","Y","N",3,0,7
"2289","F1",2023-10-01,"Rennes","Nantes",3,1,"H",1,1,"D",1.53,4.58,6.18,"1-1","3-1",16,5,10,3,3,6,0,1,6,4,11,17,4,10,28,"6-4","Y","Y","Y",9,1,7
"2290","F1",2023-10-06,"Strasbourg","Nantes",1,2,"A",0,0,"D",2.31,3.24,3.57,"0-0","1-2",11,3,16,7,4,0,0,0,3,11,15,12,3,14,27,"3-11","Y","Y","N",4,0,8
"2291","F1",2023-10-07,"Metz","Nice",0,1,"A",0,1,"A",5.12,3.91,1.72,"0-1","0-1",10,3,7,4,0,1,0,0,1,4,9,10,1,5,19,"1-4","N","N","N",1,0,8
"2292","F1",2023-10-07,"Reims","Monaco",1,3,"A",0,1,"A",2.68,3.62,2.64,"0-1","1-3",11,4,11,4,0,3,0,0,10,5,10,14,4,15,24,"10-5","Y","Y","Y",3,0,8
"2293","F1",2023-10-08,"Marseille","Le Havre",3,0,"H",2,0,"H",1.48,4.63,7.2,"2-0","3-0",14,6,7,1,0,3,0,1,4,3,6,16,3,7,22,"4-3","Y","Y","N",3,1,8
"2294","F1",2023-10-08,"Brest","Toulouse",1,1,"D",0,1,"A",1.85,3.74,4.54,"0-1","1-1",13,2,9,3,2,2,0,0,3,5,18,18,2,8,36,"3-5","Y","N","N",4,0,8
"2295","F1",2023-10-08,"Lyon","Lorient",3,3,"D",3,1,"H",1.71,4.06,5.04,"3-1","3-3",9,6,6,5,0,0,0,0,5,2,22,10,6,7,32,"5-2","Y","Y","Y",0,0,8
"2296","F1",2023-10-08,"Lens","Lille",1,1,"D",0,1,"A",2.27,3.48,3.34,"0-1","1-1",14,5,8,3,2,4,0,0,8,5,14,16,2,13,30,"8-5","Y","N","N",6,0,8
"2297","F1",2023-10-08,"Rennes","Paris SG",1,3,"A",0,2,"A",3.61,3.59,2.11,"0-2","1-3",14,4,17,7,1,0,0,0,1,7,12,15,4,8,27,"1-7","Y","Y","Y",1,0,8
"2298","F1",2023-10-20,"Le Havre","Lens",0,0,"D",0,0,"D",4.66,3.6,1.88,"0-0","0-0",14,5,13,7,2,3,0,0,3,3,16,9,0,6,25,"3-3","N","N","N",5,0,8
"2299","F1",2023-10-21,"Paris SG","Strasbourg",3,0,"H",2,0,"H",1.24,6.93,11.72,"2-0","3-0",8,4,7,1,2,0,0,0,1,6,11,10,3,7,21,"1-6","Y","Y","N",2,0,9
"2300","F1",2023-10-21,"Nice","Marseille",1,0,"H",0,0,"D",2.51,3.22,3.14,"0-0","1-0",10,2,9,1,4,3,0,1,4,2,13,6,1,6,19,"4-2","N","N","N",7,1,9
"2301","F1",2023-10-22,"Lorient","Rennes",2,1,"H",2,1,"H",4.02,3.79,1.93,"2-1","2-1",5,4,20,6,0,2,0,0,6,16,5,14,3,22,19,"6-16","Y","Y","N",2,0,9
"2302","F1",2023-10-22,"Lille","Brest",1,0,"H",1,0,"H",1.82,3.64,4.85,"1-0","1-0",6,4,9,1,2,3,0,0,3,5,12,13,1,8,25,"3-5","N","N","N",5,0,9
"2303","F1",2023-10-22,"Nantes","Montpellier",2,0,"H",1,0,"H",3.03,3.62,2.37,"1-0","2-0",14,5,11,6,2,1,0,0,4,3,16,13,2,7,29,"4-3","Y","N","N",3,0,9
"2304","F1",2023-10-22,"Toulouse","Reims",1,1,"D",0,0,"D",2.94,3.47,2.5,"0-0","1-1",11,5,15,4,2,0,0,0,5,7,18,15,2,12,33,"5-7","Y","N","N",2,0,9
"2305","F1",2023-10-22,"Monaco","Metz",2,1,"H",1,1,"D",1.36,5.75,8.16,"1-1","2-1",27,13,8,4,1,3,0,0,10,2,12,11,3,12,23,"10-2","Y","Y","N",4,0,9
"2306","F1",2023-10-22,"Lyon","Clermont",1,2,"A",0,2,"A",1.81,4.08,4.31,"0-2","1-2",25,6,12,5,4,6,0,0,10,3,16,12,3,13,28,"10-3","Y","Y","N",10,0,9
"2307","F1",2023-10-27,"Clermont","Nice",0,1,"A",0,0,"D",4.42,3.42,1.95,"0-0","0-1",8,3,11,5,0,2,0,0,2,2,14,12,1,4,26,"2-2","N","N","N",2,0,9
"2308","F1",2023-10-28,"Reims","Lorient",1,0,"H",0,0,"D",1.67,4.24,5.13,"0-0","1-0",12,5,9,1,1,3,0,0,4,4,16,7,1,8,23,"4-4","N","N","N",4,0,10
"2309","F1",2023-10-28,"Lens","Nantes",4,0,"H",1,0,"H",1.6,4.36,5.65,"1-0","4-0",11,7,11,1,1,2,0,0,4,1,12,17,4,5,29,"4-1","Y","Y","Y",3,0,10
"2310","F1",2023-10-29,"Brest","Paris SG",2,3,"A",1,2,"A",6.06,4.63,1.54,"1-2","2-3",20,5,17,10,3,4,0,0,9,5,14,10,5,14,24,"9-5","Y","Y","Y",7,0,10
"2311","F1",2023-10-29,"Lille","Monaco",2,0,"H",2,0,"H",2.34,3.82,2.95,"2-0","2-0",7,5,16,6,1,2,0,0,2,8,17,13,2,10,30,"2-8","Y","N","N",3,0,10
"2312","F1",2023-10-29,"Metz","Le Havre",0,0,"D",0,0,"D",2.61,3.26,2.96,"0-0","0-0",9,3,12,1,2,2,0,0,5,6,13,15,0,11,28,"5-6","N","N","N",4,0,10
"2313","F1",2023-10-29,"Montpellier","Toulouse",3,0,"H",1,0,"H",1.8,3.95,4.53,"1-0","3-0",19,6,16,5,2,3,0,0,3,4,13,15,3,7,28,"3-4","Y","Y","N",5,0,10
"2314","F1",2023-10-29,"Rennes","Strasbourg",1,1,"D",1,0,"H",1.6,4.19,5.92,"1-0","1-1",20,3,11,3,2,2,0,0,7,5,14,16,2,12,30,"7-5","Y","N","N",4,0,10
"2315","F1",2023-11-03,"Paris SG","Montpellier",3,0,"H",1,0,"H",1.26,6.76,10.17,"1-0","3-0",21,10,7,2,1,0,0,0,9,2,10,13,3,11,23,"9-2","Y","Y","N",1,0,10
"2316","F1",2023-11-04,"Lorient","Lens",0,0,"D",0,0,"D",4.73,3.95,1.75,"0-0","0-0",7,2,14,7,3,3,0,0,1,5,10,14,0,6,24,"1-5","N","N","N",6,0,10
"2317","F1",2023-11-04,"Marseille","Lille",0,0,"D",0,0,"D",2.21,3.59,3.31,"0-0","0-0",8,3,10,1,2,3,0,0,2,8,10,12,0,10,22,"2-8","N","N","N",5,0,11
"2318","F1",2023-11-05,"Lyon","Metz",1,1,"D",0,0,"D",1.67,4.04,5.24,"0-0","1-1",15,4,10,5,1,1,0,0,4,9,16,14,2,13,30,"4-9","Y","N","N",2,0,11
"2319","F1",2023-11-05,"Nantes","Reims",0,1,"A",0,0,"D",2.99,3.2,2.59,"0-0","0-1",17,4,7,4,1,2,0,0,10,6,5,11,1,16,16,"10-6","N","N","N",3,0,11
"2320","F1",2023-11-05,"Strasbourg","Clermont",0,0,"D",0,0,"D",2.42,3.23,3.22,"0-0","0-0",18,5,10,2,2,0,1,0,4,6,11,5,0,10,16,"4-6","N","N","N",2,1,11
"2321","F1",2023-11-05,"Toulouse","Le Havre",1,2,"A",0,0,"D",2.16,3.35,3.67,"0-0","1-2",17,5,15,7,2,2,0,0,4,6,9,12,3,10,21,"4-6","Y","Y","N",4,0,11
"2322","F1",2023-11-05,"Monaco","Brest",2,0,"H",1,0,"H",1.76,4.14,4.44,"1-0","2-0",12,6,15,1,2,4,0,1,6,4,15,11,2,10,26,"6-4","Y","N","N",6,1,11
"2323","F1",2023-11-05,"Nice","Rennes",2,0,"H",1,0,"H",2.13,3.36,3.74,"1-0","2-0",16,4,11,4,0,2,1,1,2,1,7,12,2,3,19,"2-1","Y","N","N",2,2,11
"2324","F1",2023-11-10,"Montpellier","Nice",0,0,"D",0,0,"D",3.61,3.39,2.17,"0-0","0-0",9,1,15,4,0,4,0,0,3,7,11,15,0,10,26,"3-7","N","N","N",4,0,11
"2325","F1",2023-11-11,"Reims","Paris SG",0,3,"A",0,1,"A",5.46,4.35,1.6,"0-1","0-3",19,6,14,6,1,0,0,0,8,4,14,6,3,12,20,"8-4","Y","Y","N",1,0,11
"2326","F1",2023-11-11,"Le Havre","Monaco",0,0,"D",0,0,"D",4.5,3.95,1.78,"0-0","0-0",9,5,10,4,2,3,0,0,2,4,10,18,0,6,28,"2-4","N","N","N",5,0,12
"2327","F1",2023-11-12,"Clermont","Lorient",1,0,"H",0,0,"D",2.18,3.35,3.63,"0-0","1-0",17,6,10,3,3,2,0,0,5,4,15,10,1,9,25,"5-4","N","N","N",5,0,12
"2328","F1",2023-11-12,"Lille","Toulouse",1,1,"D",1,0,"H",1.59,4.33,5.62,"1-0","1-1",13,6,2,1,3,4,0,0,11,1,12,16,2,12,28,"11-1","Y","N","N",7,0,12
"2329","F1",2023-11-12,"Metz","Nantes",3,1,"H",2,1,"H",3.04,3.24,2.53,"2-1","3-1",9,4,16,3,0,0,0,0,2,5,7,9,4,7,16,"2-5","Y","Y","Y",0,0,12
"2330","F1",2023-11-12,"Rennes","Lyon",0,1,"A",0,0,"D",1.75,4.12,4.48,"0-0","0-1",8,2,12,5,3,1,1,0,6,9,5,18,1,15,23,"6-9","N","N","N",4,1,12
"2331","F1",2023-11-12,"Lens","Marseille",1,0,"H",0,0,"D",2.27,3.54,3.22,"0-0","1-0",14,3,8,2,2,2,0,0,4,5,19,15,1,9,34,"4-5","N","N","N",4,0,12
"2332","F1",2023-11-24,"Paris SG","Monaco",5,2,"H",2,1,"H",1.5,5.1,5.7,"2-1","5-2",16,11,14,7,0,1,0,0,2,10,9,19,7,12,28,"2-10","Y","Y","Y",1,0,12
"2333","F1",2023-11-25,"Clermont","Lens",0,3,"A",0,1,"A",3.89,3.52,2.03,"0-1","0-3",13,4,16,10,2,3,1,1,2,4,16,17,3,6,33,"2-4","Y","Y","N",5,2,12
"2334","F1",2023-11-25,"Strasbourg","Marseille",1,1,"D",1,1,"D",3.94,3.58,1.99,"1-1","1-1",15,7,16,3,1,2,0,0,7,11,14,16,2,18,30,"7-11","Y","N","N",3,0,12
"2335","F1",2023-11-26,"Nice","Toulouse",1,0,"H",0,0,"D",1.52,4.18,7.02,"0-0","1-0",8,3,19,3,0,4,0,0,4,2,9,19,1,6,28,"4-2","N","N","N",4,0,13
"2336","F1",2023-11-26,"Lorient","Metz",2,3,"A",2,1,"H",2,3.45,4.07,"2-1","2-3",11,5,14,5,2,1,0,0,5,6,10,17,5,11,27,"5-6","Y","Y","Y",3,0,13
"2337","F1",2023-11-26,"Montpellier","Brest",1,3,"A",0,1,"A",2.31,3.39,3.27,"0-1","1-3",17,5,17,5,2,2,0,0,9,1,11,18,4,10,29,"9-1","Y","Y","Y",4,0,13
"2338","F1",2023-11-26,"Nantes","Le Havre",0,0,"D",0,0,"D",2.07,3.47,3.8,"0-0","0-0",19,3,6,0,1,2,0,1,10,5,10,17,0,15,27,"10-5","N","N","N",3,1,13
"2339","F1",2023-11-26,"Rennes","Reims",3,1,"H",1,1,"D",2,3.63,3.85,"1-1","3-1",10,5,15,5,2,2,0,0,1,8,10,18,4,9,28,"1-8","Y","Y","Y",4,0,13
"2340","F1",2023-11-26,"Lyon","Lille",0,2,"A",0,2,"A",3.1,3.28,2.47,"0-2","0-2",11,5,15,8,2,2,0,0,3,5,17,5,2,8,22,"3-5","Y","N","N",4,0,13
"2341","F1",2023-11-29,"Montpellier","Clermont",1,1,"D",0,1,"A",1.95,3.66,4,"0-1","1-1",32,10,5,1,3,4,0,0,8,0,23,14,2,8,37,"8-0","Y","N","N",7,0,13
"2342","F1",2023-12-01,"Reims","Strasbourg",2,1,"H",2,0,"H",1.76,3.87,4.93,"2-0","2-1",13,4,10,3,1,1,0,0,4,5,7,7,3,9,14,"4-5","Y","Y","N",2,0,13
"2343","F1",2023-12-02,"Lens","Lyon",3,2,"H",1,1,"D",1.7,4.14,4.81,"1-1","3-2",10,7,12,7,2,0,1,0,3,6,11,14,5,9,25,"3-6","Y","Y","Y",2,1,13
"2344","F1",2023-12-02,"Nantes","Nice",1,0,"H",1,0,"H",4.03,3.38,2.04,"1-0","1-0",13,4,13,6,3,0,0,0,5,6,15,18,1,11,33,"5-6","N","N","N",3,0,14
"2345","F1",2023-12-03,"Le Havre","Paris SG",0,2,"A",0,1,"A",9.54,5.88,1.31,"0-1","0-2",22,7,9,5,2,1,0,1,9,2,11,9,2,11,20,"9-2","Y","N","N",3,1,14
"2346","F1",2023-12-03,"Brest","Clermont",3,0,"H",2,0,"H",1.8,3.79,4.62,"2-0","3-0",12,7,10,1,1,2,0,0,4,2,11,17,3,6,28,"4-2","Y","Y","N",3,0,14
"2347","F1",2023-12-03,"Monaco","Montpellier",2,0,"H",1,0,"H",1.66,4.47,4.74,"1-0","2-0",27,9,9,4,2,3,0,1,8,2,15,13,2,10,28,"8-2","Y","N","N",5,1,14
"2348","F1",2023-12-03,"Toulouse","Lorient",1,1,"D",0,0,"D",2.03,3.53,3.86,"0-0","1-1",11,6,11,5,2,4,0,0,3,4,16,10,2,7,26,"3-4","Y","N","N",6,0,14
"2349","F1",2023-12-03,"Lille","Metz",2,0,"H",2,0,"H",1.45,4.82,7.11,"2-0","2-0",16,6,7,4,0,0,0,0,6,1,8,11,2,7,19,"6-1","Y","N","N",0,0,14
"2350","F1",2023-12-03,"Marseille","Rennes",2,0,"H",1,0,"H",1.92,3.84,3.95,"1-0","2-0",5,2,10,0,1,3,1,1,1,6,9,15,2,7,24,"1-6","Y","N","N",4,2,14
"2351","F1",2023-12-06,"Marseille","Lyon",3,0,"H",2,0,"H",1.71,3.94,5.06,"2-0","3-0",12,5,6,1,1,2,0,0,10,3,14,11,3,13,25,"10-3","Y","Y","N",3,0,14
"2352","F1",2023-12-07,"Brest","Strasbourg",1,1,"D",1,0,"H",1.83,3.68,4.61,"1-0","1-1",13,3,9,5,1,0,0,0,6,0,11,18,2,6,29,"6-0","Y","N","N",1,0,14
"2353","F1",2023-12-08,"Montpellier","Lens",0,0,"D",0,0,"D",3.49,3.51,2.19,"0-0","0-0",18,4,13,5,2,3,0,0,4,3,16,11,0,7,27,"4-3","N","N","N",5,0,15
"2354","F1",2023-12-09,"Rennes","Monaco",1,2,"A",0,0,"D",2.59,3.72,2.65,"0-0","1-2",15,5,12,5,3,6,0,1,5,5,9,22,3,10,31,"5-5","Y","Y","N",9,1,15
"2355","F1",2023-12-09,"Paris SG","Nantes",2,1,"H",1,0,"H",1.22,7.2,11.37,"1-0","2-1",16,6,10,4,1,3,0,0,5,3,9,12,3,8,21,"5-3","Y","Y","N",4,0,15
"2356","F1",2023-12-10,"Nice","Reims",2,1,"H",0,0,"D",1.89,3.53,4.46,"0-0","2-1",15,5,9,2,2,3,0,0,9,0,13,6,3,9,19,"9-0","Y","Y","N",5,0,15
"2357","F1",2023-12-10,"Clermont","Lille",0,0,"D",0,0,"D",5.08,3.74,1.75,"0-0","0-0",16,5,12,3,2,2,0,0,3,6,18,9,0,9,27,"3-6","N","N","N",4,0,15
"2358","F1",2023-12-10,"Metz","Brest",0,1,"A",0,0,"D",3.56,3.3,2.23,"0-0","0-1",6,3,4,3,3,2,0,0,3,2,14,16,1,5,30,"3-2","N","N","N",5,0,15
"2359","F1",2023-12-10,"Strasbourg","Le Havre",2,1,"H",1,0,"H",2.16,3.32,3.7,"1-0","2-1",12,3,15,3,3,1,0,0,4,3,14,15,3,7,29,"4-3","Y","Y","N",4,0,15
"2360","F1",2023-12-10,"Lyon","Toulouse",3,0,"H",2,0,"H",2,3.7,3.81,"2-0","3-0",15,7,16,6,2,3,0,0,2,1,15,15,3,3,30,"2-1","Y","Y","N",5,0,15
"2361","F1",2023-12-10,"Lorient","Marseille",2,4,"A",1,4,"A",4.58,3.78,1.81,"1-4","2-4",15,9,18,8,5,3,0,1,4,6,17,17,6,10,34,"4-6","Y","Y","Y",8,1,15
"2362","F1",2023-12-15,"Monaco","Lyon",0,1,"A",0,0,"D",1.76,4.22,4.47,"0-0","0-1",19,4,5,2,1,2,0,0,6,1,13,12,1,7,25,"6-1","N","N","N",3,0,16
"2363","F1",2023-12-16,"Le Havre","Nice",3,1,"H",2,0,"H",4.46,3.28,1.98,"2-0","3-1",9,5,13,6,3,2,1,1,2,9,13,9,4,11,22,"2-9","Y","Y","Y",5,2,16
"2364","F1",2023-12-16,"Lens","Reims",2,0,"H",1,0,"H",1.88,3.75,4.2,"1-0","2-0",7,2,14,3,0,1,0,0,4,7,9,10,2,11,19,"4-7","Y","N","N",1,0,16
"2365","F1",2023-12-17,"Nantes","Brest",0,2,"A",0,0,"D",2.67,3.29,2.81,"0-0","0-2",12,4,14,8,1,3,0,0,4,3,15,8,2,7,23,"4-3","Y","N","N",4,0,16
"2366","F1",2023-12-17,"Lorient","Strasbourg",1,2,"A",0,1,"A",2.6,3.25,2.94,"0-1","1-2",7,1,12,9,3,2,0,0,6,1,14,12,3,7,26,"6-1","Y","Y","N",5,0,16
"2367","F1",2023-12-17,"Metz","Montpellier",0,1,"A",0,1,"A",3.29,3.32,2.34,"0-1","0-1",19,4,6,3,2,2,0,0,12,5,15,14,1,17,29,"12-5","N","N","N",4,0,16
"2368","F1",2023-12-17,"Toulouse","Rennes",0,0,"D",0,0,"D",3.26,3.57,2.24,"0-0","0-0",15,6,11,4,3,2,0,0,4,4,17,14,0,8,31,"4-4","N","N","N",5,0,16
"2369","F1",2023-12-17,"Marseille","Clermont",2,1,"H",2,0,"H",1.43,4.79,7.84,"2-0","2-1",15,6,5,2,0,3,0,0,4,1,12,14,3,5,26,"4-1","Y","Y","N",3,0,16
"2370","F1",2023-12-17,"Lille","Paris SG",1,1,"D",0,0,"D",4.11,4.05,1.83,"0-0","1-1",15,3,10,2,1,1,0,0,8,8,9,19,2,16,28,"8-8","Y","N","N",2,0,16
"2371","F1",2023-12-20,"Brest","Lorient",4,0,"H",4,0,"H",1.61,4.06,5.91,"4-0","4-0",12,7,7,3,1,2,0,0,1,0,8,17,4,1,25,"1-0","Y","Y","Y",3,0,17
"2372","F1",2023-12-20,"Clermont","Rennes",1,3,"A",1,0,"H",3.44,3.4,2.23,"1-0","1-3",14,6,25,11,0,3,1,0,4,5,8,11,4,9,19,"4-5","Y","Y","Y",3,1,17
"2373","F1",2023-12-20,"Lyon","Nantes",1,0,"H",0,0,"D",1.7,4.2,4.71,"0-0","1-0",8,7,7,0,1,2,1,0,7,7,8,14,1,14,22,"7-7","N","N","N",3,1,17
"2374","F1",2023-12-20,"Montpellier","Marseille",1,1,"D",1,0,"H",3.62,3.59,2.09,"1-0","1-1",12,6,17,4,2,1,0,0,5,10,21,13,2,15,34,"5-10","Y","N","N",3,0,17
"2375","F1",2023-12-20,"Nice","Lens",2,0,"H",0,0,"D",2.34,3.19,3.41,"0-0","2-0",14,5,10,3,2,2,0,0,5,6,14,11,2,11,25,"5-6","Y","N","N",4,0,17
"2376","F1",2023-12-20,"Paris SG","Metz",3,1,"H",0,0,"D",1.15,9.06,16.98,"0-0","3-1",13,5,3,1,0,1,0,0,5,5,6,9,4,10,15,"5-5","Y","Y","Y",1,0,17
"2377","F1",2023-12-20,"Reims","Le Havre",1,0,"H",1,0,"H",1.69,3.92,5.28,"1-0","1-0",22,7,4,1,1,1,0,1,6,2,7,6,1,8,13,"6-2","N","N","N",2,1,17
"2378","F1",2023-12-20,"Strasbourg","Lille",2,1,"H",1,1,"D",4.01,3.57,1.98,"1-1","2-1",9,2,9,2,1,2,0,0,6,5,19,10,3,11,29,"6-5","Y","Y","N",3,0,17
"2379","F1",2023-12-20,"Toulouse","Monaco",1,2,"A",1,2,"A",4.31,3.94,1.82,"1-2","1-2",20,5,12,4,2,3,0,1,4,5,17,10,3,9,27,"4-5","Y","Y","N",5,1,17
"2380","F1",2024-01-12,"Marseille","Strasbourg",1,1,"D",1,0,"H",1.62,4.01,6.08,"1-0","1-1",8,2,18,4,3,2,0,0,6,4,11,10,2,10,21,"6-4","Y","N","N",5,0,18
"2381","F1",2024-01-13,"Monaco","Reims",1,3,"A",0,1,"A",1.76,4.08,4.46,"0-1","1-3",9,5,12,5,3,2,0,0,6,6,11,9,4,12,20,"6-6","Y","Y","Y",5,0,18
"2382","F1",2024-01-13,"Rennes","Nice",2,0,"H",1,0,"H",2.43,3.27,3.17,"1-0","2-0",15,5,9,2,1,0,0,0,6,6,13,11,2,12,24,"6-6","Y","N","N",1,0,18
"2383","F1",2024-01-14,"Lille","Lorient",3,0,"H",1,0,"H",1.38,5.04,8.5,"1-0","3-0",24,10,1,0,1,4,0,0,7,1,10,22,3,8,32,"7-1","Y","Y","N",5,0,18
"2384","F1",2024-01-14,"Brest","Montpellier",2,0,"H",0,0,"D",1.88,3.65,4.34,"0-0","2-0",26,9,9,4,1,2,0,0,3,3,6,7,2,6,13,"3-3","Y","N","N",3,0,18
"2385","F1",2024-01-14,"Metz","Toulouse",0,1,"A",0,1,"A",3.16,3.02,2.59,"0-1","0-1",14,2,4,2,3,2,1,0,5,2,20,18,1,7,38,"5-2","N","N","N",5,1,18
"2386","F1",2024-01-14,"Nantes","Clermont",1,2,"A",0,1,"A",2,3.44,4.11,"0-1","1-2",20,9,15,6,1,1,1,0,11,5,10,5,3,16,15,"11-5","Y","Y","N",2,1,18
"2387","F1",2024-01-14,"Le Havre","Lyon",3,1,"H",1,0,"H",3.26,3.29,2.36,"1-0","3-1",14,7,9,2,1,0,0,2,3,7,15,4,4,10,19,"3-7","Y","Y","Y",1,2,18
"2388","F1",2024-01-14,"Lens","Paris SG",0,2,"A",0,1,"A",3.81,4.06,1.9,"0-1","0-2",17,5,15,7,0,1,1,0,5,6,10,8,2,11,18,"5-6","Y","N","N",1,1,18
"2389","F2",2023-08-05,"St Etienne","Grenoble",0,1,"A",0,0,"D",1.65,3.78,6.05,"0-0","0-1",17,4,13,5,2,1,0,0,6,1,14,12,1,7,26,"6-1","N","N","N",3,0,1
"2390","F2",2023-08-05,"Ajaccio","Rodez",1,1,"D",1,1,"D",1.96,3.22,4.69,"1-1","1-1",19,6,8,3,1,3,0,0,7,4,9,12,2,11,21,"7-4","Y","N","N",4,0,1
"2391","F2",2023-08-05,"Amiens","Quevilly Rouen",1,0,"H",0,0,"D",2.59,3.46,2.79,"0-0","1-0",5,2,6,2,1,1,0,0,9,2,12,17,1,11,29,"9-2","N","N","N",2,0,1
"2392","F2",2023-08-05,"Annecy","Guingamp",1,4,"A",1,0,"H",3.6,3.41,2.16,"1-0","1-4",11,4,15,8,2,0,0,0,3,2,13,12,5,5,25,"3-2","Y","Y","Y",2,0,1
"2393","F2",2023-08-05,"Concarneau","Bastia",0,0,"D",0,0,"D",3.11,3.22,2.49,"0-0","0-0",13,3,8,1,0,3,0,0,5,6,7,17,0,11,24,"5-6","N","N","N",3,0,1
"2394","F2",2023-08-05,"Dunkerque","Troyes",2,2,"D",1,2,"A",2.82,3.14,2.78,"1-2","2-2",16,5,14,7,2,1,0,0,4,4,16,6,4,8,22,"4-4","Y","Y","Y",3,0,1
"2395","F2",2023-08-05,"Laval","Angers",1,0,"H",0,0,"D",2.67,3.29,2.82,"0-0","1-0",13,5,6,2,1,3,0,0,3,4,7,11,1,7,18,"3-4","N","N","N",4,0,1
"2396","F2",2023-08-05,"Paris FC","Caen",0,2,"A",0,1,"A",2.91,3.2,2.66,"0-1","0-2",2,0,12,5,2,2,1,0,2,6,12,13,2,8,25,"2-6","Y","N","N",4,1,1
"2397","F2",2023-08-05,"Valenciennes","Auxerre",1,4,"A",1,1,"D",3.97,3.4,2.05,"1-1","1-4",12,5,19,6,1,1,0,0,6,7,10,15,5,13,25,"6-7","Y","Y","Y",2,0,1
"2398","F2",2023-08-07,"Pau FC","Bordeaux",3,0,"H",2,0,"H",3.83,3.51,2,"2-0","3-0",7,4,15,6,2,0,0,0,2,8,21,8,3,10,29,"2-8","Y","Y","N",2,0,1
"2399","F2",2023-08-12,"Rodez","St Etienne",2,1,"H",1,0,"H",3.78,3.7,1.97,"1-0","2-1",21,7,15,8,0,2,0,0,10,2,7,11,3,12,18,"10-2","Y","Y","N",2,0,2
"2400","F2",2023-08-12,"Angers","Annecy",0,0,"D",0,0,"D",1.72,3.76,5.29,"0-0","0-0",12,1,5,2,2,2,0,0,8,3,17,13,0,11,30,"8-3","N","N","N",4,0,2
"2401","F2",2023-08-12,"Auxerre","Amiens",0,1,"A",0,0,"D",1.7,3.77,5.44,"0-0","0-1",15,0,7,1,0,1,0,0,6,5,8,11,1,11,19,"6-5","N","N","N",1,0,2
"2402","F2",2023-08-12,"Bastia","Valenciennes",3,0,"H",1,0,"H",1.81,3.56,4.95,"1-0","3-0",15,7,3,1,0,2,0,0,5,5,12,13,3,10,25,"5-5","Y","Y","N",2,0,2
"2403","F2",2023-08-12,"Caen","Pau FC",2,0,"H",2,0,"H",1.7,3.74,5.54,"2-0","2-0",23,5,7,2,0,2,0,1,8,3,10,16,2,11,26,"8-3","Y","N","N",2,1,2
"2404","F2",2023-08-12,"Grenoble","Paris FC",2,0,"H",0,0,"D",2.45,3.21,3.19,"0-0","2-0",11,7,3,3,1,2,0,1,5,6,9,10,2,11,19,"5-6","Y","N","N",3,1,2
"2405","F2",2023-08-12,"Guingamp","Dunkerque",0,1,"A",0,0,"D",1.93,3.56,4.21,"0-0","0-1",16,3,9,5,4,3,0,0,7,1,13,18,1,8,31,"7-1","N","N","N",7,0,2
"2406","F2",2023-08-12,"Quevilly Rouen","Ajaccio",0,1,"A",0,1,"A",2.57,3.08,3.14,"0-1","0-1",4,2,3,3,2,1,0,0,3,0,19,13,1,3,32,"3-0","N","N","N",3,0,2
"2407","F2",2023-08-12,"Troyes","Laval",3,1,"H",2,0,"H",2.09,3.55,3.64,"2-0","3-1",9,6,19,3,1,1,0,0,5,7,5,20,4,12,25,"5-7","Y","Y","Y",2,0,2
"2408","F2",2023-08-14,"Bordeaux","Concarneau",1,0,"H",0,0,"D",1.67,4.09,4.86,"0-0","1-0",16,5,10,4,2,1,0,0,8,5,16,10,1,13,26,"8-5","N","N","N",3,0,2
"2409","F2",2023-08-19,"Angers","Auxerre",2,2,"D",1,1,"D",2.8,3.39,2.63,"1-1","2-2",12,5,13,5,3,0,0,1,3,3,22,8,4,6,30,"3-3","Y","Y","Y",3,1,3
"2410","F2",2023-08-19,"Amiens","Bastia",2,1,"H",1,1,"D",2.6,3.16,3.02,"1-1","2-1",17,6,11,4,3,2,0,1,12,2,9,17,3,14,26,"12-2","Y","Y","N",5,1,3
"2411","F2",2023-08-19,"Annecy","Dunkerque",3,0,"H",0,0,"D",2.82,3.23,2.71,"0-0","3-0",11,4,4,2,3,1,0,0,4,3,11,9,3,7,20,"4-3","Y","Y","N",4,0,3
"2412","F2",2023-08-19,"Concarneau","Caen",0,2,"A",0,0,"D",3.4,3.45,2.23,"0-0","0-2",14,4,11,3,1,1,0,0,2,2,15,8,2,4,23,"2-2","Y","N","N",2,0,3
"2413","F2",2023-08-19,"Grenoble","Troyes",0,0,"D",0,0,"D",2.48,3.31,3.06,"0-0","0-0",18,7,6,1,1,1,0,1,14,5,13,13,0,19,26,"14-5","N","N","N",2,1,3
"2414","F2",2023-08-19,"Laval","Rodez",1,0,"H",0,0,"D",2.07,3.4,3.87,"0-0","1-0",9,4,7,1,2,0,0,0,2,3,11,13,1,5,24,"2-3","N","N","N",2,0,3
"2415","F2",2023-08-19,"Pau FC","Paris FC",2,0,"H",1,0,"H",2.52,3.27,3.02,"1-0","2-0",9,3,14,5,2,1,0,0,1,2,13,10,2,3,23,"1-2","Y","N","N",3,0,3
"2416","F2",2023-08-19,"St Etienne","Quevilly Rouen",2,1,"H",2,0,"H",1.75,3.93,4.8,"2-0","2-1",5,2,10,1,0,3,0,0,3,5,8,18,3,8,26,"3-5","Y","Y","N",3,0,3
"2417","F2",2023-08-19,"Valenciennes","Guingamp",0,0,"D",0,0,"D",3.43,3.33,2.26,"0-0","0-0",9,3,6,3,3,2,0,0,3,7,12,15,0,10,27,"3-7","N","N","N",5,0,3
"2418","F2",2023-08-21,"Ajaccio","Bordeaux",0,0,"D",0,0,"D",2.8,3.11,2.74,"0-0","0-0",9,2,15,4,4,3,1,0,1,4,11,8,0,5,19,"1-4","N","N","N",7,1,3
"2419","F2",2023-08-26,"Bordeaux","Amiens",2,0,"H",0,0,"D",1.81,3.79,4.55,"0-0","2-0",17,7,12,2,5,1,0,0,6,5,12,7,2,11,19,"6-5","Y","N","N",6,0,4
"2420","F2",2023-08-26,"Auxerre","Grenoble",0,0,"D",0,0,"D",1.86,3.66,4.43,"0-0","0-0",15,2,7,4,2,2,0,0,4,3,11,16,0,7,27,"4-3","N","N","N",4,0,4
"2421","F2",2023-08-26,"Bastia","Troyes",3,2,"H",0,2,"A",2,3.61,3.87,"0-2","3-2",24,6,9,6,2,1,1,1,6,2,18,15,5,8,33,"6-2","Y","Y","Y",3,2,4
"2422","F2",2023-08-26,"Caen","Ajaccio",3,0,"H",2,0,"H",1.85,3.35,5.02,"2-0","3-0",10,4,5,2,1,2,0,0,7,4,5,10,3,11,15,"7-4","Y","Y","N",3,0,4
"2423","F2",2023-08-26,"Dunkerque","Angers",0,1,"A",0,0,"D",2.83,3.35,2.62,"0-0","0-1",14,9,7,3,3,2,0,0,3,4,10,13,1,7,23,"3-4","N","N","N",5,0,4
"2424","F2",2023-08-26,"Guingamp","Pau FC",4,0,"H",2,0,"H",1.93,3.46,4.42,"2-0","4-0",23,9,13,6,3,2,0,0,6,2,17,14,4,8,31,"6-2","Y","Y","Y",5,0,4
"2425","F2",2023-08-26,"Paris FC","Concarneau",3,0,"H",1,0,"H",2.46,3.31,3.08,"1-0","3-0",13,6,13,4,1,0,0,0,3,8,14,14,3,11,28,"3-8","Y","Y","N",1,0,4
"2426","F2",2023-08-26,"Quevilly Rouen","Laval",0,0,"D",0,0,"D",2.31,3.27,3.39,"0-0","0-0",7,2,11,2,1,1,0,0,4,6,15,16,0,10,31,"4-6","N","N","N",2,0,4
"2427","F2",2023-08-26,"Rodez","Valenciennes",0,1,"A",0,1,"A",1.99,3.2,4.57,"0-1","0-1",19,7,10,4,2,3,0,0,7,1,8,18,1,8,26,"7-1","N","N","N",5,0,4
"2428","F2",2023-08-28,"Annecy","St Etienne",1,1,"D",1,0,"H",3.58,3.55,2.06,"1-0","1-1",17,5,10,4,2,2,0,0,3,3,15,13,2,6,28,"3-3","Y","N","N",4,0,4
"2429","F2",2023-09-02,"Bordeaux","Auxerre",2,4,"A",1,2,"A",2.07,3.66,3.6,"1-2","2-4",20,9,15,6,2,2,0,0,3,11,8,17,6,14,25,"3-11","Y","Y","Y",4,0,5
"2430","F2",2023-09-02,"Ajaccio","Dunkerque",2,2,"D",0,1,"A",1.91,3.41,4.58,"0-1","2-2",10,3,10,4,3,1,1,0,2,5,14,20,4,7,34,"2-5","Y","Y","Y",4,1,5
"2431","F2",2023-09-02,"Amiens","Guingamp",4,1,"H",1,1,"D",2.4,3.28,3.22,"1-1","4-1",11,7,12,4,1,4,0,0,2,4,16,15,5,6,31,"2-4","Y","Y","Y",5,0,5
"2432","F2",2023-09-02,"Angers","Paris FC",2,0,"H",1,0,"H",2.04,3.4,3.88,"1-0","2-0",11,4,9,3,1,2,0,0,5,4,12,14,2,9,26,"5-4","Y","N","N",3,0,5
"2433","F2",2023-09-02,"Concarneau","Annecy",1,1,"D",0,1,"A",2.26,3.36,3.33,"0-1","1-1",10,2,17,7,5,4,0,1,4,1,10,21,2,5,31,"4-1","Y","N","N",9,1,5
"2434","F2",2023-09-02,"Grenoble","Bastia",0,0,"D",0,0,"D",2.33,3.25,3.38,"0-0","0-0",22,3,11,1,0,1,0,0,8,3,6,14,0,11,20,"8-3","N","N","N",1,0,5
"2435","F2",2023-09-02,"Laval","Caen",2,1,"H",0,0,"D",3.63,3.17,2.26,"0-0","2-1",9,3,5,2,2,3,0,0,3,2,13,9,3,5,22,"3-2","Y","Y","N",5,0,5
"2436","F2",2023-09-02,"Pau FC","Rodez",2,2,"D",2,0,"H",2.84,3.34,2.62,"2-0","2-2",10,3,17,8,4,3,0,0,4,5,17,15,4,9,32,"4-5","Y","Y","Y",7,0,5
"2437","F2",2023-09-02,"St Etienne","Valenciennes",0,0,"D",0,0,"D",1.6,4.22,5.76,"0-0","0-0",11,1,9,3,7,3,0,0,4,4,11,13,0,8,24,"4-4","N","N","N",10,0,5
"2438","F2",2023-09-02,"Troyes","Quevilly Rouen",2,2,"D",0,2,"A",2.33,3.25,3.37,"0-2","2-2",10,4,10,3,2,1,0,0,5,7,14,9,4,12,23,"5-7","Y","Y","Y",3,0,5
"2439","F2",2023-09-16,"Caen","St Etienne",1,2,"A",0,1,"A",1.93,3.78,3.98,"0-1","1-2",14,6,8,3,3,1,0,0,3,1,12,10,3,4,22,"3-1","Y","Y","N",4,0,6
"2440","F2",2023-09-16,"Annecy","Troyes",0,0,"D",0,0,"D",2.45,3.46,2.98,"0-0","0-0",15,0,7,3,1,0,0,0,10,4,9,11,0,14,20,"10-4","N","N","N",1,0,6
"2441","F2",2023-09-16,"Auxerre","Pau FC",2,2,"D",1,1,"D",1.5,4.47,6.8,"1-1","2-2",24,6,6,4,2,3,0,0,13,4,10,3,4,17,13,"13-4","Y","Y","Y",5,0,6
"2442","F2",2023-09-16,"Bastia","Laval",0,3,"A",0,1,"A",2.19,3.35,3.6,"0-1","0-3",8,3,9,4,2,2,0,0,5,6,14,12,3,11,26,"5-6","Y","Y","N",4,0,6
"2443","F2",2023-09-16,"Dunkerque","Grenoble",0,0,"D",0,0,"D",2.81,3.23,2.72,"0-0","0-0",5,4,18,5,2,2,1,0,3,6,13,9,0,9,22,"3-6","N","N","N",4,1,6
"2444","F2",2023-09-16,"Paris FC","Amiens",3,0,"H",2,0,"H",2.78,3.31,2.7,"2-0","3-0",12,3,13,3,2,2,0,0,3,8,11,17,3,11,28,"3-8","Y","Y","N",4,0,6
"2445","F2",2023-09-16,"Quevilly Rouen","Concarneau",2,3,"A",0,3,"A",1.94,3.46,4.18,"0-3","2-3",23,8,9,6,1,1,0,0,7,1,18,12,5,8,30,"7-1","Y","Y","Y",2,0,6
"2446","F2",2023-09-16,"Rodez","Angers",4,1,"H",0,1,"A",2.96,3.19,2.62,"0-1","4-1",13,5,9,3,2,2,0,0,3,4,12,13,5,7,25,"3-4","Y","Y","Y",4,0,6
"2447","F2",2023-09-16,"Valenciennes","Bordeaux",1,2,"A",0,1,"A",4.26,3.66,1.89,"0-1","1-2",11,3,13,5,3,2,0,0,3,5,7,17,3,8,24,"3-5","Y","Y","N",5,0,6
"2448","F2",2023-09-18,"Guingamp","Ajaccio",3,0,"H",2,0,"H",2.27,3.19,3.45,"2-0","3-0",12,5,15,4,0,1,0,0,3,6,15,9,3,9,24,"3-6","Y","Y","N",1,0,6
"2449","F2",2023-09-23,"Troyes","Auxerre",1,2,"A",0,1,"A",3.45,3.74,2.1,"0-1","1-2",10,4,19,5,2,2,0,0,3,14,20,12,3,17,32,"3-14","Y","Y","N",4,0,7
"2450","F2",2023-09-23,"Ajaccio","Paris FC",2,1,"H",0,0,"D",1.97,3.41,4.26,"0-0","2-1",11,4,6,1,2,2,0,0,4,4,14,11,3,8,25,"4-4","Y","Y","N",4,0,7
"2451","F2",2023-09-23,"Amiens","Valenciennes",0,0,"D",0,0,"D",1.7,3.79,5.38,"0-0","0-0",12,4,8,3,3,3,0,0,4,5,21,19,0,9,40,"4-5","N","N","N",6,0,7
"2452","F2",2023-09-23,"Angers","Bastia",2,0,"H",1,0,"H",1.98,3.48,3.99,"1-0","2-0",10,7,9,3,1,3,0,1,9,3,13,10,2,12,23,"9-3","Y","N","N",4,1,7
"2453","F2",2023-09-23,"Concarneau","St Etienne",0,1,"A",0,0,"D",3.2,3.47,2.31,"0-0","0-1",9,3,16,4,1,1,0,0,5,9,13,11,1,14,24,"5-9","N","N","N",2,0,7
"2454","F2",2023-09-23,"Dunkerque","Rodez",1,2,"A",0,1,"A",2.56,3,3.17,"0-1","1-2",15,3,14,5,1,2,0,0,6,2,10,12,3,8,22,"6-2","Y","Y","N",3,0,7
"2455","F2",2023-09-23,"Grenoble","Quevilly Rouen",2,1,"H",1,1,"D",2.49,3.28,3.07,"1-1","2-1",10,4,11,5,1,2,0,0,4,1,9,11,3,5,20,"4-1","Y","Y","N",3,0,7
"2456","F2",2023-09-23,"Laval","Guingamp",2,1,"H",0,0,"D",2.62,3.09,3.06,"0-0","2-1",15,6,13,6,1,2,0,0,6,3,19,13,3,9,32,"6-3","Y","Y","N",3,0,7
"2457","F2",2023-09-23,"Pau FC","Annecy",0,3,"A",0,2,"A",2.9,3.21,2.65,"0-2","0-3",12,4,9,5,5,1,0,0,7,4,17,16,3,11,33,"7-4","Y","Y","N",6,0,7
"2458","F2",2023-09-26,"Amiens","Ajaccio",0,0,"D",0,0,"D",2.11,3.24,4,"0-0","0-0",7,0,6,2,2,5,0,0,3,3,16,27,0,6,43,"3-3","N","N","N",7,0,7
"2459","F2",2023-09-26,"Auxerre","Annecy",4,0,"H",2,0,"H",1.57,4.17,6.13,"2-0","4-0",11,5,5,1,0,1,0,0,3,5,7,15,4,8,22,"3-5","Y","Y","Y",1,0,8
"2460","F2",2023-09-26,"Bastia","Pau FC",1,4,"A",0,1,"A",1.72,3.87,5.08,"0-1","1-4",10,2,17,10,2,3,1,0,10,3,7,12,5,13,19,"10-3","Y","Y","Y",5,1,8
"2461","F2",2023-09-26,"Caen","Grenoble",1,2,"A",1,0,"H",1.94,3.47,4.33,"1-0","1-2",10,1,10,4,0,3,0,0,3,3,10,17,3,6,27,"3-3","Y","Y","N",3,0,8
"2462","F2",2023-09-26,"Guingamp","Bordeaux",0,0,"D",0,0,"D",2.91,3.19,2.66,"0-0","0-0",11,2,14,3,1,1,0,0,2,4,12,16,0,6,28,"2-4","N","N","N",2,0,8
"2463","F2",2023-09-26,"Paris FC","Laval",0,1,"A",0,0,"D",2.89,3.02,2.82,"0-0","0-1",15,4,11,2,1,1,0,0,9,3,13,11,1,12,24,"9-3","N","N","N",2,0,8
"2464","F2",2023-09-26,"Quevilly Rouen","Angers",0,1,"A",0,1,"A",2.84,3.13,2.77,"0-1","0-1",12,1,6,3,3,4,1,0,2,5,15,17,1,7,32,"2-5","N","N","N",7,1,8
"2465","F2",2023-09-26,"Rodez","Troyes",2,1,"H",0,0,"D",1.96,3.78,3.83,"0-0","2-1",19,5,7,3,1,2,0,0,8,3,11,11,3,11,22,"8-3","Y","Y","N",3,0,8
"2466","F2",2023-09-26,"Valenciennes","Concarneau",0,1,"A",0,1,"A",2.44,3.15,3.26,"0-1","0-1",19,2,9,3,3,4,0,0,4,8,22,20,1,12,42,"4-8","N","N","N",7,0,8
"2467","F2",2023-09-30,"Troyes","St Etienne",0,1,"A",0,0,"D",3.51,3.68,2.09,"0-0","0-1",20,4,11,5,1,1,0,0,11,4,9,6,1,15,15,"11-4","N","N","N",2,0,8
"2468","F2",2023-09-30,"Angers","Concarneau",2,0,"H",0,0,"D",1.74,3.62,5.41,"0-0","2-0",14,7,11,6,1,2,0,0,12,5,12,9,2,17,21,"12-5","Y","N","N",3,0,8
"2469","F2",2023-09-30,"Annecy","Paris FC",2,2,"D",1,0,"H",2.38,3.16,3.36,"1-0","2-2",9,5,11,2,4,2,0,0,7,6,15,7,4,13,22,"7-6","Y","Y","Y",6,0,9
"2470","F2",2023-09-30,"Auxerre","Rodez",3,1,"H",1,0,"H",1.57,4.36,5.76,"1-0","3-1",15,4,7,1,1,3,0,0,5,7,12,9,4,12,21,"5-7","Y","Y","Y",4,0,9
"2471","F2",2023-09-30,"Caen","Guingamp",0,1,"A",0,0,"D",2.03,3.4,4.04,"0-0","0-1",7,1,14,7,1,2,0,0,6,5,17,21,1,11,38,"6-5","N","N","N",3,0,9
"2472","F2",2023-09-30,"Dunkerque","Quevilly Rouen",0,1,"A",0,0,"D",2.48,3.23,3.12,"0-0","0-1",11,3,16,6,0,0,0,0,9,12,8,14,1,21,22,"9-12","N","N","N",0,0,9
"2473","F2",2023-09-30,"Grenoble","Bordeaux",2,0,"H",1,0,"H",2.73,3.17,2.84,"1-0","2-0",10,8,15,4,2,2,0,0,2,8,16,10,2,10,26,"2-8","Y","N","N",4,0,9
"2474","F2",2023-09-30,"Laval","Valenciennes",1,0,"H",0,0,"D",1.78,3.56,5.18,"0-0","1-0",17,8,7,2,1,1,0,0,4,4,19,14,1,8,33,"4-4","N","N","N",2,0,9
"2475","F2",2023-09-30,"Pau FC","Amiens",1,0,"H",1,0,"H",2.96,3.37,2.51,"1-0","1-0",15,6,14,7,2,0,0,0,4,3,14,15,1,7,29,"4-3","N","N","N",2,0,9
"2476","F2",2023-10-02,"Ajaccio","Bastia",2,0,"H",0,0,"D",2.33,3.08,3.44,"0-0","2-0",11,3,7,2,0,1,0,1,4,3,8,11,2,7,19,"4-3","Y","N","N",1,1,9
"2477","F2",2023-10-03,"Bordeaux","Caen",1,1,"D",1,1,"D",2.14,3.5,3.56,"1-1","1-1",19,8,7,2,3,1,0,0,4,4,17,16,2,8,33,"4-4","Y","N","N",4,0,9
"2478","F2",2023-10-04,"St Etienne","Dunkerque",2,0,"H",0,0,"D",1.68,4.12,5.02,"0-0","2-0",20,4,15,4,1,3,0,0,9,6,10,17,2,15,27,"9-6","Y","N","N",4,0,9
"2479","F2",2023-10-07,"Bordeaux","Laval",0,1,"A",0,1,"A",1.88,3.57,4.48,"0-1","0-1",18,5,7,3,1,3,0,0,7,4,12,22,1,11,34,"7-4","N","N","N",4,0,10
"2480","F2",2023-10-07,"Amiens","Angers",1,4,"A",1,2,"A",2.46,3.19,3.19,"1-2","1-4",17,7,15,6,4,4,1,1,11,3,22,13,5,14,35,"11-3","Y","Y","Y",8,2,10
"2481","F2",2023-10-07,"Bastia","Annecy",2,1,"H",0,0,"D",2.02,3.46,3.98,"0-0","2-1",6,2,9,2,3,3,0,0,4,4,7,13,3,8,20,"4-4","Y","Y","N",6,0,10
"2482","F2",2023-10-07,"Concarneau","Dunkerque",4,3,"H",1,2,"A",2.4,3.33,3.16,"1-2","4-3",13,6,12,3,2,4,0,0,3,2,9,20,7,5,29,"3-2","Y","Y","Y",6,0,10
"2483","F2",2023-10-07,"Guingamp","Grenoble",2,2,"D",2,1,"H",2.29,3.35,3.36,"2-1","2-2",13,8,6,2,0,1,0,0,6,3,17,16,4,9,33,"6-3","Y","Y","Y",1,0,10
"2484","F2",2023-10-07,"Paris FC","Auxerre",0,2,"A",0,1,"A",3.82,3.66,2,"0-1","0-2",18,3,7,4,2,0,0,0,10,2,12,14,2,12,26,"10-2","Y","N","N",2,0,10
"2485","F2",2023-10-07,"Quevilly Rouen","Pau FC",2,2,"D",1,1,"D",1.89,3.7,4.25,"1-1","2-2",19,4,4,2,1,3,0,1,3,0,17,14,4,3,31,"3-0","Y","Y","Y",4,1,10
"2486","F2",2023-10-07,"Rodez","Caen",5,3,"H",2,3,"A",3.02,3.2,2.52,"2-3","5-3",19,8,11,4,3,3,0,0,6,7,17,12,8,13,29,"6-7","Y","Y","Y",6,0,10
"2487","F2",2023-10-07,"St Etienne","Ajaccio",0,0,"D",0,0,"D",2.04,3.34,4.1,"0-0","0-0",8,1,5,2,2,2,0,0,4,3,15,16,0,7,31,"4-3","N","N","N",4,0,10
"2488","F2",2023-10-07,"Valenciennes","Troyes",1,1,"D",0,1,"A",2.65,3.08,3.02,"0-1","1-1",21,7,4,2,3,3,0,0,7,2,10,18,2,9,28,"7-2","Y","N","N",6,0,10
"2489","F2",2023-10-21,"Caen","Auxerre",1,1,"D",0,1,"A",3.21,3.66,2.23,"0-1","1-1",9,1,15,6,1,1,0,0,3,8,8,14,2,11,22,"3-8","Y","N","N",2,0,11
"2490","F2",2023-10-21,"Ajaccio","Pau FC",2,0,"H",0,0,"D",1.79,3.6,5.04,"0-0","2-0",11,3,4,1,0,2,0,0,1,4,10,13,2,5,23,"1-4","Y","N","N",2,0,11
"2491","F2",2023-10-21,"Angers","Bordeaux",2,0,"H",1,0,"H",2.56,3.32,2.93,"1-0","2-0",9,4,16,5,0,0,0,0,2,6,6,9,2,8,15,"2-6","Y","N","N",0,0,11
"2492","F2",2023-10-21,"Annecy","Amiens",1,1,"D",1,1,"D",2.85,3.16,2.74,"1-1","1-1",8,3,10,5,2,2,0,0,1,2,19,22,2,3,41,"1-2","Y","N","N",4,0,11
"2493","F2",2023-10-21,"Dunkerque","Paris FC",1,3,"A",0,1,"A",2.58,3.3,2.92,"0-1","1-3",13,4,15,5,2,0,0,0,7,3,18,8,4,10,26,"7-3","Y","Y","Y",2,0,11
"2494","F2",2023-10-21,"Grenoble","Valenciennes",3,3,"D",2,1,"H",1.98,3.3,4.38,"2-1","3-3",13,7,10,7,2,3,0,0,2,2,10,15,6,4,25,"2-2","Y","Y","Y",5,0,11
"2495","F2",2023-10-21,"Guingamp","Quevilly Rouen",2,2,"D",1,1,"D",1.94,3.53,4.23,"1-1","2-2",8,4,13,5,1,1,0,0,3,7,11,12,4,10,23,"3-7","Y","Y","Y",2,0,11
"2496","F2",2023-10-21,"Rodez","Bastia",1,1,"D",0,1,"A",2,3.44,4.08,"0-1","1-1",26,8,6,1,1,2,0,0,10,6,10,21,2,16,31,"10-6","Y","N","N",3,0,11
"2497","F2",2023-10-21,"Troyes","Concarneau",0,0,"D",0,0,"D",2.11,3.52,3.64,"0-0","0-0",8,3,21,5,2,2,1,0,1,6,6,18,0,7,24,"1-6","N","N","N",4,1,11
"2498","F2",2023-10-23,"Laval","St Etienne",0,1,"A",0,1,"A",2.62,3.17,2.88,"0-1","0-1",13,1,6,2,1,1,0,0,4,6,12,6,1,10,18,"4-6","N","N","N",2,0,11
"2499","F2",2023-10-28,"Bordeaux","Rodez",2,2,"D",2,1,"H",1.72,3.92,4.99,"2-1","2-2",11,6,9,3,4,2,1,1,3,4,12,12,4,7,24,"3-4","Y","Y","Y",6,2,12
"2500","F2",2023-10-28,"Amiens","Laval",0,0,"D",0,0,"D",2.53,3.08,3.2,"0-0","0-0",8,4,10,5,2,1,0,0,2,5,13,12,0,7,25,"2-5","N","N","N",3,0,12
"2501","F2",2023-10-28,"Auxerre","Dunkerque",0,1,"A",0,0,"D",1.42,4.93,7.65,"0-0","0-1",24,6,8,2,1,3,0,0,12,6,10,10,1,18,20,"12-6","N","N","N",4,0,12
"2502","F2",2023-10-28,"Bastia","Guingamp",0,0,"D",0,0,"D",2.9,3.35,2.57,"0-0","0-0",6,1,10,2,1,4,0,1,8,3,11,17,0,11,28,"8-3","N","N","N",5,1,12
"2503","F2",2023-10-28,"Concarneau","Ajaccio",2,1,"H",0,0,"D",3.02,3.06,2.62,"0-0","2-1",4,2,16,5,0,1,0,0,5,7,9,16,3,12,25,"5-7","Y","Y","N",1,0,12
"2504","F2",2023-10-28,"Paris FC","Troyes",2,2,"D",0,0,"D",1.98,3.65,3.92,"0-0","2-2",15,3,8,3,1,0,0,0,6,3,7,9,4,9,16,"6-3","Y","Y","Y",1,0,12
"2505","F2",2023-10-28,"Pau FC","Grenoble",3,2,"H",1,1,"D",3.33,3.42,2.23,"1-1","3-2",15,7,7,4,2,2,0,0,5,4,18,11,5,9,29,"5-4","Y","Y","Y",4,0,12
"2506","F2",2023-10-28,"Quevilly Rouen","Annecy",1,2,"A",1,1,"D",2.06,3.48,3.82,"1-1","1-2",19,6,8,3,2,2,0,0,6,8,9,11,3,14,20,"6-8","Y","Y","N",4,0,12
"2507","F2",2023-10-28,"Valenciennes","Caen",2,2,"D",2,0,"H",2.96,3.32,2.54,"2-0","2-2",9,4,14,4,0,2,0,0,5,7,14,8,4,12,22,"5-7","Y","Y","Y",2,0,12
"2508","F2",2023-10-30,"St Etienne","Angers",2,0,"H",0,0,"D",2.56,3.24,2.9,"0-0","2-0",20,10,14,3,2,1,0,0,5,11,15,8,2,16,23,"5-11","Y","N","N",3,0,12
"2509","F2",2023-11-04,"St Etienne","Paris FC",0,1,"A",0,0,"D",1.98,3.59,3.88,"0-0","0-1",11,1,15,5,0,3,0,0,9,8,8,14,1,17,22,"9-8","N","N","N",3,0,13
"2510","F2",2023-11-04,"Angers","Valenciennes",2,0,"H",2,0,"H",1.63,3.92,5.69,"2-0","2-0",9,6,5,2,5,3,0,0,8,1,15,11,2,9,26,"8-1","Y","N","N",8,0,13
"2511","F2",2023-11-04,"Annecy","Laval",1,3,"A",1,1,"D",3.07,3.08,2.61,"1-1","1-3",5,1,9,3,0,2,1,1,4,8,9,13,4,12,22,"4-8","Y","Y","Y",2,2,13
"2512","F2",2023-11-04,"Bastia","Bordeaux",3,1,"H",2,0,"H",3.61,3.47,2.14,"2-0","3-1",16,7,10,2,3,1,0,0,1,5,21,13,4,6,34,"1-5","Y","Y","Y",4,0,13
"2513","F2",2023-11-04,"Dunkerque","Amiens",0,1,"A",0,1,"A",2.99,3.11,2.65,"0-1","0-1",18,5,5,2,0,4,0,0,7,5,7,11,1,12,18,"7-5","N","N","N",4,0,13
"2514","F2",2023-11-04,"Grenoble","Ajaccio",0,3,"A",0,2,"A",2.19,3.06,3.99,"0-2","0-3",12,5,6,3,1,3,0,0,5,0,10,11,3,5,21,"5-0","Y","Y","N",4,0,13
"2515","F2",2023-11-04,"Quevilly Rouen","Rodez",3,1,"H",2,1,"H",2.28,3.46,3.28,"2-1","3-1",12,4,5,3,2,0,0,0,6,4,17,11,4,10,28,"6-4","Y","Y","Y",2,0,13
"2516","F2",2023-11-04,"Troyes","Caen",2,1,"H",1,0,"H",2.82,3.46,2.57,"1-0","2-1",8,4,22,5,4,1,0,0,0,11,15,12,3,11,27,"0-11","Y","Y","N",5,0,13
"2517","F2",2023-11-06,"Guingamp","Auxerre",2,1,"H",0,0,"D",3.33,3.39,2.22,"0-0","2-1",8,1,14,4,6,3,1,1,4,4,14,15,3,8,29,"4-4","Y","Y","N",9,2,13
"2518","F2",2023-11-11,"Bordeaux","Annecy",3,1,"H",2,1,"H",1.59,4.17,5.9,"2-1","3-1",11,7,9,3,1,2,0,0,3,5,9,21,4,8,30,"3-5","Y","Y","Y",3,0,13
"2519","F2",2023-11-11,"Ajaccio","Troyes",1,0,"H",1,0,"H",1.89,3.43,4.65,"1-0","1-0",7,3,3,1,2,1,0,0,1,2,13,17,1,3,30,"1-2","N","N","N",3,0,14
"2520","F2",2023-11-11,"Amiens","Grenoble",1,2,"A",1,1,"D",2.55,3.07,3.18,"1-1","1-2",10,4,6,4,1,2,0,0,1,4,9,12,3,5,21,"1-4","Y","Y","N",3,0,14
"2521","F2",2023-11-11,"Auxerre","St Etienne",5,2,"H",3,1,"H",1.82,3.83,4.46,"3-1","5-2",14,7,14,8,1,2,0,0,1,2,14,11,7,3,25,"1-2","Y","Y","Y",3,0,14
"2522","F2",2023-11-11,"Caen","Quevilly Rouen",3,3,"D",2,2,"D",2.3,3.45,3.24,"2-2","3-3",16,5,9,6,1,2,0,1,4,3,13,17,6,7,30,"4-3","Y","Y","Y",3,1,14
"2523","F2",2023-11-11,"Laval","Concarneau",0,3,"A",0,1,"A",1.77,3.6,5.18,"0-1","0-3",10,5,10,6,4,1,1,0,7,3,26,9,3,10,35,"7-3","Y","Y","N",5,1,14
"2524","F2",2023-11-11,"Paris FC","Bastia",1,0,"H",1,0,"H",2.01,3.57,3.88,"1-0","1-0",11,3,11,4,1,1,0,1,5,5,12,23,1,10,35,"5-5","N","N","N",2,1,14
"2525","F2",2023-11-11,"Pau FC","Angers",4,4,"D",2,1,"H",3.57,3.38,2.19,"2-1","4-4",12,6,7,5,3,0,0,0,6,7,16,8,8,13,24,"6-7","Y","Y","Y",3,0,14
"2526","F2",2023-11-11,"Rodez","Guingamp",0,0,"D",0,0,"D",2.5,3.29,3.04,"0-0","0-0",6,0,13,2,0,1,0,0,6,7,11,13,0,13,24,"6-7","N","N","N",1,0,14
"2527","F2",2023-11-11,"Valenciennes","Dunkerque",0,1,"A",0,0,"D",2.37,3.33,3.21,"0-0","0-1",13,4,11,3,4,3,0,0,4,7,14,22,1,11,36,"4-7","N","N","N",7,0,14
"2528","F2",2023-11-25,"St Etienne","Pau FC",1,2,"A",1,0,"H",1.66,4.03,4.87,"1-0","1-2",14,3,11,4,3,3,0,0,9,5,19,14,3,14,33,"9-5","Y","Y","N",6,0,14
"2529","F2",2023-11-25,"Amiens","Concarneau",1,1,"D",1,1,"D",2.02,3.39,4.07,"1-1","1-1",19,6,6,1,2,0,0,0,6,2,15,7,2,8,22,"6-2","Y","N","N",2,0,15
"2530","F2",2023-11-25,"Annecy","Ajaccio",2,0,"H",1,0,"H",2.96,2.87,2.8,"1-0","2-0",19,6,6,2,4,2,0,0,6,3,21,13,2,9,34,"6-3","Y","N","N",6,0,15
"2531","F2",2023-11-25,"Bastia","Auxerre",0,0,"D",0,0,"D",4.32,3.97,1.75,"0-0","0-0",6,1,20,7,1,2,0,0,1,7,15,5,0,8,20,"1-7","N","N","N",3,0,15
"2532","F2",2023-11-25,"Dunkerque","Laval",0,2,"A",0,2,"A",3.34,3.24,2.29,"0-2","0-2",11,3,5,3,1,4,0,0,6,2,10,15,2,8,25,"6-2","Y","N","N",5,0,15
"2533","F2",2023-11-25,"Grenoble","Rodez",2,1,"H",1,1,"D",1.92,3.62,4.02,"1-1","2-1",9,6,11,4,1,3,0,0,6,5,7,11,3,11,18,"6-5","Y","Y","N",4,0,15
"2534","F2",2023-11-25,"Paris FC","Bordeaux",1,2,"A",1,1,"D",3.21,3.49,2.24,"1-1","1-2",12,2,11,5,0,0,0,0,9,3,16,7,3,12,23,"9-3","Y","Y","N",0,0,15
"2535","F2",2023-11-25,"Quevilly Rouen","Valenciennes",0,0,"D",0,0,"D",1.68,3.91,5.03,"0-0","0-0",17,4,6,2,2,3,0,1,6,1,18,11,0,7,29,"6-1","N","N","N",5,1,15
"2536","F2",2023-11-25,"Troyes","Guingamp",0,1,"A",0,1,"A",3.53,3.41,2.13,"0-1","0-1",7,2,14,4,1,1,0,0,5,8,8,11,1,13,19,"5-8","N","N","N",2,0,15
"2537","F2",2023-11-27,"Angers","Caen",3,0,"H",1,0,"H",2.16,3.33,3.41,"1-0","3-0",11,6,10,2,1,5,0,1,2,6,13,14,3,8,27,"2-6","Y","Y","N",6,1,15
"2538","F2",2023-11-28,"Concarneau","Pau FC",1,2,"A",0,1,"A",2.23,3.37,3.47,"0-1","1-2",17,6,10,2,4,2,1,1,5,2,12,10,3,7,22,"5-2","Y","Y","N",6,2,15
"2539","F2",2023-12-02,"Bordeaux","Troyes",0,1,"A",0,1,"A",1.45,4.58,6.5,"0-1","0-1",24,4,12,3,3,5,1,0,10,5,16,20,1,15,36,"10-5","N","N","N",8,1,16
"2540","F2",2023-12-02,"Ajaccio","Angers",1,1,"D",1,1,"D",2.65,2.95,3.16,"1-1","1-1",13,5,5,2,3,1,0,0,3,3,11,14,2,6,25,"3-3","Y","N","N",4,0,16
"2541","F2",2023-12-02,"Amiens","St Etienne",1,0,"H",1,0,"H",2.82,3.16,2.61,"1-0","1-0",7,3,15,5,3,1,0,0,2,1,16,10,1,3,26,"2-1","N","N","N",4,0,16
"2542","F2",2023-12-02,"Auxerre","Quevilly Rouen",3,2,"H",1,2,"A",1.64,4.18,5.36,"1-2","3-2",17,3,15,6,1,1,0,0,3,3,10,15,5,6,25,"3-3","Y","Y","Y",2,0,16
"2543","F2",2023-12-02,"Caen","Bastia",1,0,"H",0,0,"D",1.88,3.65,4.32,"0-0","1-0",9,3,10,5,1,3,0,0,5,4,12,21,1,9,33,"5-4","N","N","N",4,0,16
"2544","F2",2023-12-02,"Guingamp","Paris FC",0,1,"A",0,0,"D",2.19,3.31,3.63,"0-0","0-1",7,3,4,1,2,3,0,0,4,2,19,14,1,6,33,"4-2","N","N","N",5,0,16
"2545","F2",2023-12-02,"Laval","Grenoble",1,1,"D",0,0,"D",2.35,3.18,3.42,"0-0","1-1",9,5,7,2,4,1,0,0,2,5,14,9,2,7,23,"2-5","Y","N","N",5,0,16
"2546","F2",2023-12-02,"Pau FC","Dunkerque",1,1,"D",1,0,"H",2.3,3.45,3.25,"1-0","1-1",10,5,8,4,2,2,0,0,3,3,14,13,2,6,27,"3-3","Y","N","N",4,0,16
"2547","F2",2023-12-02,"Rodez","Concarneau",2,0,"H",1,0,"H",1.85,3.68,4.51,"1-0","2-0",16,5,8,2,2,4,0,0,9,4,20,7,2,13,27,"9-4","Y","N","N",6,0,16
"2548","F2",2023-12-02,"Valenciennes","Annecy",0,0,"D",0,0,"D",2.54,3.1,3.16,"0-0","0-0",14,6,18,2,1,2,0,1,4,5,14,15,0,9,29,"4-5","N","N","N",3,1,16
"2549","F2",2023-12-05,"Ajaccio","Laval",2,0,"H",0,0,"D",2.53,2.85,3.49,"0-0","2-0",8,4,6,1,1,2,0,0,2,3,14,19,2,5,33,"2-3","Y","N","N",3,0,17
"2550","F2",2023-12-05,"Angers","Grenoble",1,0,"H",1,0,"H",2.06,3.41,3.93,"1-0","1-0",7,1,15,5,0,0,0,0,3,10,5,11,1,13,16,"3-10","N","N","N",0,0,17
"2551","F2",2023-12-05,"Concarneau","Auxerre",1,2,"A",0,2,"A",4.97,4.14,1.68,"0-2","1-2",13,4,16,7,1,2,0,0,6,5,7,11,3,11,18,"6-5","Y","Y","N",3,0,17
"2552","F2",2023-12-05,"Dunkerque","Bastia",0,5,"A",0,2,"A",2.39,3.11,3.42,"0-2","0-5",8,2,14,8,3,1,0,0,3,6,11,10,5,9,21,"3-6","Y","Y","Y",4,0,17
"2553","F2",2023-12-05,"Paris FC","Rodez",2,0,"H",2,0,"H",2.1,3.47,3.71,"2-0","2-0",9,2,12,5,2,1,0,0,2,8,10,16,2,10,26,"2-8","Y","N","N",3,0,17
"2554","F2",2023-12-05,"Pau FC","Valenciennes",3,1,"H",1,0,"H",1.93,3.5,4.31,"1-0","3-1",14,6,14,7,0,0,0,0,5,3,10,22,4,8,32,"5-3","Y","Y","Y",0,0,17
"2555","F2",2023-12-05,"Quevilly Rouen","Bordeaux",3,2,"H",2,0,"H",2.61,3.28,2.89,"2-0","3-2",24,9,26,6,1,1,0,1,4,6,22,12,5,10,34,"4-6","Y","Y","Y",2,1,17
"2556","F2",2023-12-05,"St Etienne","Guingamp",1,3,"A",1,1,"D",2.39,3.15,3.37,"1-1","1-3",10,3,14,6,2,0,0,0,6,10,21,10,4,16,31,"6-10","Y","Y","Y",2,0,17
"2557","F2",2023-12-05,"Troyes","Amiens",2,0,"H",2,0,"H",2.89,3.18,2.68,"2-0","2-0",9,3,18,3,2,3,0,0,5,9,8,16,2,14,24,"5-9","Y","N","N",5,0,17
"2558","F2",2023-12-06,"Annecy","Caen",1,2,"A",1,0,"H",2.81,3.39,2.62,"1-0","1-2",15,5,13,9,2,1,0,0,5,7,14,15,3,12,29,"5-7","Y","Y","N",3,0,17
"2559","F2",2023-12-16,"Auxerre","Ajaccio",2,0,"H",2,0,"H",1.68,3.77,5.62,"2-0","2-0",12,3,1,0,0,3,0,1,6,2,10,13,2,8,23,"6-2","Y","N","N",3,1,18
"2560","F2",2023-12-16,"Bordeaux","St Etienne",0,0,"D",0,0,"D",2.14,3.52,3.54,"0-0","0-0",20,4,10,1,0,3,0,0,9,6,15,20,0,15,35,"9-6","N","N","N",3,0,18
"2561","F2",2023-12-16,"Bastia","Quevilly Rouen",0,0,"D",0,0,"D",3.02,3.12,2.62,"0-0","0-0",4,1,13,3,0,3,0,0,2,6,12,16,0,8,28,"2-6","N","N","N",3,0,18
"2562","F2",2023-12-16,"Caen","Dunkerque",1,0,"H",1,0,"H",1.87,3.75,4.28,"1-0","1-0",13,6,13,4,2,2,0,0,6,7,12,18,1,13,30,"6-7","N","N","N",4,0,18
"2563","F2",2023-12-16,"Grenoble","Annecy",1,0,"H",0,0,"D",1.91,3.55,4.33,"0-0","1-0",16,5,6,3,1,0,0,0,8,4,8,8,1,12,16,"8-4","N","N","N",1,0,18
"2564","F2",2023-12-16,"Guingamp","Concarneau",0,1,"A",0,0,"D",1.62,3.97,5.95,"0-0","0-1",18,2,4,1,3,2,0,0,4,3,16,16,1,7,32,"4-3","N","N","N",5,0,18
"2565","F2",2023-12-16,"Laval","Pau FC",1,1,"D",0,0,"D",1.81,3.64,4.79,"0-0","1-1",15,5,11,5,2,1,0,0,11,4,17,15,2,15,32,"11-4","Y","N","N",3,0,18
"2566","F2",2023-12-16,"Rodez","Amiens",2,2,"D",0,1,"A",2.34,3.15,3.47,"0-1","2-2",19,5,8,4,3,1,0,0,10,3,13,11,4,13,24,"10-3","Y","Y","Y",4,0,18
"2567","F2",2023-12-16,"Troyes","Angers",1,4,"A",1,3,"A",4.19,3.58,1.93,"1-3","1-4",8,2,13,5,1,1,0,0,7,3,7,15,5,10,22,"7-3","Y","Y","Y",2,0,18
"2568","F2",2023-12-16,"Valenciennes","Paris FC",0,1,"A",0,1,"A",3.29,3.25,2.37,"0-1","0-1",7,1,7,3,0,0,0,0,6,5,16,13,1,11,29,"6-5","N","N","N",0,0,18
"2569","F2",2023-12-19,"Ajaccio","Valenciennes",2,1,"H",2,1,"H",2,2.99,5.01,"2-1","2-1",6,3,4,2,1,1,0,0,3,1,18,18,3,4,36,"3-1","Y","Y","N",2,0,19
"2570","F2",2023-12-19,"Amiens","Caen",0,0,"D",0,0,"D",2.45,3.22,3.18,"0-0","0-0",14,3,10,3,2,1,0,0,3,2,17,18,0,5,35,"3-2","N","N","N",3,0,19
"2571","F2",2023-12-19,"Angers","Guingamp",1,0,"H",1,0,"H",2.34,3.15,3.47,"1-0","1-0",7,2,21,5,1,3,0,0,2,6,14,19,1,8,33,"2-6","N","N","N",4,0,19
"2572","F2",2023-12-19,"Annecy","Rodez",1,2,"A",0,1,"A",2.86,3.12,2.75,"0-1","1-2",16,7,16,6,2,4,0,0,5,2,11,14,3,7,25,"5-2","Y","Y","N",6,0,19
"2573","F2",2023-12-19,"Concarneau","Grenoble",0,3,"A",0,1,"A",3.44,3.14,2.35,"0-1","0-3",19,6,11,6,0,0,0,0,6,1,11,11,3,7,22,"6-1","Y","Y","N",0,0,19
"2574","F2",2023-12-19,"Dunkerque","Bordeaux",0,2,"A",0,1,"A",3.53,3.53,2.14,"0-1","0-2",14,3,9,2,3,2,0,0,3,3,14,14,2,6,28,"3-3","Y","N","N",5,0,19
"2575","F2",2023-12-19,"Laval","Auxerre",1,3,"A",1,1,"D",3.57,3.34,2.2,"1-1","1-3",5,3,13,5,1,2,0,0,3,6,11,16,4,9,27,"3-6","Y","Y","Y",3,0,19
"2576","F2",2023-12-19,"Paris FC","Quevilly Rouen",2,2,"D",1,1,"D",2.3,3.31,3.38,"1-1","2-2",10,4,13,5,4,2,0,0,3,2,16,25,4,5,41,"3-2","Y","Y","Y",6,0,19
"2577","F2",2023-12-19,"Pau FC","Troyes",1,1,"D",0,0,"D",2.05,3.64,3.68,"0-0","1-1",19,5,11,6,3,3,0,0,6,2,14,12,2,8,26,"6-2","Y","N","N",6,0,19
"2578","F2",2023-12-19,"St Etienne","Bastia",3,2,"H",2,0,"H",1.86,3.52,4.68,"2-0","3-2",12,5,11,5,2,2,0,0,2,6,13,19,5,8,32,"2-6","Y","Y","Y",4,0,19
"2579","F2",2024-01-13,"St Etienne","Laval",0,0,"D",0,0,"D",2.19,3.31,3.65,"0-0","0-0",14,4,9,3,0,0,0,0,4,6,14,13,0,10,27,"4-6","N","N","N",0,0,20
"2580","F2",2024-01-13,"Bastia","Angers",2,0,"H",1,0,"H",3.5,3.1,2.36,"1-0","2-0",14,5,1,0,1,0,0,0,8,4,9,9,2,12,18,"8-4","Y","N","N",1,0,20
"2581","F2",2024-01-13,"Caen","Concarneau",1,0,"H",0,0,"D",1.93,3.54,4.31,"0-0","1-0",9,2,6,2,1,2,0,0,4,3,22,19,1,7,41,"4-3","N","N","N",3,0,20
"2582","F2",2024-01-13,"Grenoble","Dunkerque",2,2,"D",1,0,"H",1.7,3.83,5.3,"1-0","2-2",10,4,10,7,0,0,0,0,6,3,11,9,4,9,20,"6-3","Y","Y","Y",0,0,20
"2583","F2",2024-01-13,"Paris FC","Annecy",2,1,"H",0,0,"D",1.88,3.56,4.53,"0-0","2-1",17,5,7,3,1,3,0,1,6,4,12,18,3,10,30,"6-4","Y","Y","N",4,1,20
"2584","F2",2024-01-13,"Quevilly Rouen","Guingamp",0,1,"A",0,0,"D",2.74,3.03,2.96,"0-0","0-1",10,2,10,5,2,1,0,0,6,1,21,12,1,7,33,"6-1","N","N","N",3,0,20
"2585","F2",2024-01-13,"Rodez","Pau FC",2,1,"H",0,0,"D",1.84,3.7,4.52,"0-0","2-1",11,4,12,5,3,2,1,0,3,8,11,14,3,11,25,"3-8","Y","Y","N",5,1,20
"2586","F2",2024-01-13,"Troyes","Ajaccio",3,1,"H",1,1,"D",2.79,3.02,2.92,"1-1","3-1",12,4,9,3,1,1,0,0,3,1,14,11,4,4,25,"3-1","Y","Y","Y",2,0,20
"2587","F2",2024-01-13,"Valenciennes","Amiens",0,1,"A",0,1,"A",3.15,2.95,2.65,"0-1","0-1",11,2,13,4,4,1,0,0,8,5,21,20,1,13,41,"8-5","N","N","N",5,0,20
"2588","F2",2024-01-15,"Auxerre","Bordeaux",3,1,"H",1,1,"D",1.72,3.97,4.6,"1-1","3-1",18,10,12,5,0,3,0,0,7,5,8,12,4,12,20,"7-5","Y","Y","Y",3,0,20
"3653","G1",2023-08-18,"Volos NFC","Lamia",2,2,"D",0,0,"D",2.5,3.01,3.2,"0-0","2-2",8,4,13,8,3,2,0,0,7,0,13,16,4,7,29,"7-0","Y","Y","Y",5,0,1
"3654","G1",2023-08-20,"Giannina","Kifisia",3,0,"H",1,0,"H",2.26,2.88,3.93,"1-0","3-0",10,7,4,0,3,4,1,0,7,2,16,19,3,9,35,"7-2","Y","Y","N",7,1,1
"3655","G1",2023-08-20,"OFI Crete","Aris",3,2,"H",2,1,"H",2.45,3.17,3.02,"2-1","3-2",13,4,16,7,5,3,0,0,3,4,25,13,5,7,38,"3-4","Y","Y","Y",8,0,1
"3656","G1",2023-08-20,"PAOK","Asteras Tripolis",3,0,"H",1,0,"H",1.27,5.32,11.14,"1-0","3-0",13,6,9,2,2,1,0,0,3,1,5,12,3,4,17,"3-1","Y","Y","N",3,0,1
"3657","G1",2023-08-20,"Olympiakos","Panserraikos",2,0,"H",0,0,"D",1.17,7.06,14.52,"0-0","2-0",29,3,5,2,3,0,0,1,8,3,19,7,2,11,26,"8-3","Y","N","N",3,1,1
"3658","G1",2023-08-25,"Panetolikos","Giannina",0,0,"D",0,0,"D",2.54,2.92,3.26,"0-0","0-0",17,7,8,2,1,4,0,0,2,3,16,19,0,5,35,"2-3","N","N","N",5,0,1
"3659","G1",2023-08-26,"Asteras Tripolis","OFI Crete",3,0,"H",2,0,"H",2.28,3.29,3.3,"2-0","3-0",12,4,16,6,1,3,0,0,3,4,16,16,3,7,32,"3-4","Y","Y","N",4,0,1
"3660","G1",2023-08-26,"Panathinaikos","Volos NFC",3,0,"H",2,0,"H",1.29,5.92,9.42,"2-0","3-0",14,8,5,3,1,3,0,0,6,1,16,19,3,7,35,"6-1","Y","Y","N",4,0,2
"3661","G1",2023-08-26,"AEK","Panserraikos",1,1,"D",0,1,"A",1.14,7.98,20.36,"0-1","1-1",29,10,7,4,1,6,0,0,12,1,6,20,2,13,26,"12-1","Y","N","N",7,0,2
"3662","G1",2023-08-27,"Lamia","Aris",1,0,"H",1,0,"H",3.4,3.3,2.18,"1-0","1-0",7,4,7,3,4,4,1,0,2,2,22,16,1,4,38,"2-2","N","N","N",8,1,2
"3663","G1",2023-08-27,"PAOK","Kifisia",2,1,"H",1,0,"H",1.17,6.66,16.16,"1-0","2-1",19,8,6,3,1,5,0,0,8,5,12,14,3,13,26,"8-5","Y","Y","N",6,0,2
"3664","G1",2023-08-27,"Olympiakos","Atromitos",4,0,"H",2,0,"H",1.28,5.51,10.05,"2-0","4-0",24,9,3,1,1,5,0,1,5,2,9,9,4,7,18,"5-2","Y","Y","Y",6,1,2
"3665","G1",2023-09-01,"Kifisia","Atromitos",2,1,"H",1,0,"H",2.64,3.18,2.86,"1-0","2-1",14,7,13,9,3,1,0,1,5,8,14,12,3,13,26,"5-8","Y","Y","N",4,1,2
"3666","G1",2023-09-02,"Panserraikos","Panetolikos",1,1,"D",1,0,"H",2.31,3.22,3.25,"1-0","1-1",14,3,8,4,3,1,0,0,4,6,14,15,2,10,29,"4-6","Y","N","N",4,0,2
"3667","G1",2023-09-03,"Aris","Asteras Tripolis",3,2,"H",1,1,"D",1.52,3.88,6.81,"1-1","3-2",10,6,4,4,1,3,0,0,3,5,14,13,5,8,27,"3-5","Y","Y","Y",4,0,3
"3668","G1",2023-09-03,"OFI Crete","PAOK",1,0,"H",0,0,"D",5.24,3.85,1.64,"0-0","1-0",7,2,12,4,4,5,0,0,1,5,20,17,1,6,37,"1-5","N","N","N",9,0,3
"3669","G1",2023-09-03,"Olympiakos","Lamia",4,0,"H",2,0,"H",1.25,5.66,11.44,"2-0","4-0",17,8,8,3,2,3,0,0,5,2,14,14,4,7,28,"5-2","Y","Y","Y",5,0,3
"3670","G1",2023-09-03,"Volos NFC","AEK",2,3,"A",1,2,"A",11.46,6.13,1.22,"1-2","2-3",7,5,11,7,4,1,0,1,3,8,18,17,5,11,35,"3-8","Y","Y","Y",5,1,3
"3671","G1",2023-09-03,"Giannina","Panathinaikos",0,1,"A",0,0,"D",6.17,3.66,1.6,"0-0","0-1",11,4,11,2,6,2,0,0,2,8,11,19,1,10,30,"2-8","N","N","N",8,0,3
"3672","G1",2023-09-16,"Lamia","OFI Crete",2,2,"D",0,1,"A",2.72,3.17,2.73,"0-1","2-2",7,2,12,4,1,3,0,0,6,7,7,16,4,13,23,"6-7","Y","Y","Y",4,0,3
"3673","G1",2023-09-16,"Panetolikos","Panathinaikos",0,5,"A",0,2,"A",7.6,4.07,1.49,"0-2","0-5",11,4,18,10,2,1,0,0,3,6,10,13,5,9,23,"3-6","Y","Y","Y",3,0,3
"3674","G1",2023-09-17,"Asteras Tripolis","Giannina",2,2,"D",2,2,"D",2.13,3.07,3.82,"2-2","2-2",10,4,7,6,2,3,0,0,8,1,15,9,4,9,24,"8-1","Y","Y","Y",5,0,4
"3675","G1",2023-09-17,"Kifisia","Panserraikos",4,4,"D",0,3,"A",2.04,3.41,3.66,"0-3","4-4",19,6,9,4,3,5,0,1,3,3,16,22,8,6,38,"3-3","Y","Y","Y",8,1,4
"3676","G1",2023-09-17,"PAOK","Aris",0,0,"D",0,0,"D",1.55,4.01,5.99,"0-0","0-0",10,3,8,4,4,3,0,0,7,1,17,13,0,8,30,"7-1","N","N","N",7,0,4
"3677","G1",2023-09-17,"AEK","Olympiakos",1,1,"D",1,1,"D",2.19,3.35,3.32,"1-1","1-1",9,4,7,3,2,4,0,0,5,5,15,21,2,10,36,"5-5","Y","N","N",6,0,4
"3678","G1",2023-09-18,"Atromitos","Volos NFC",1,1,"D",1,0,"H",1.79,3.83,4.16,"1-0","1-1",8,1,10,1,3,2,0,0,4,1,13,19,2,5,32,"4-1","Y","N","N",5,0,4
"3679","G1",2023-09-23,"OFI Crete","Atromitos",1,1,"D",1,0,"H",2.08,3.41,3.59,"1-0","1-1",16,5,9,4,3,4,0,0,8,4,13,18,2,12,31,"8-4","Y","N","N",7,0,4
"3680","G1",2023-09-23,"Panserraikos","Lamia",2,0,"H",0,0,"D",2.3,3.22,3.33,"0-0","2-0",14,7,4,1,1,2,0,0,3,1,14,19,2,4,33,"3-1","Y","N","N",3,0,4
"3681","G1",2023-09-24,"Olympiakos","Kifisia",4,0,"H",2,0,"H",1.15,7.58,16.14,"2-0","4-0",13,7,8,2,1,2,0,0,7,1,18,11,4,8,29,"7-1","Y","Y","Y",3,0,5
"3682","G1",2023-09-24,"Aris","Panetolikos",3,0,"H",1,0,"H",1.5,4.06,6.79,"1-0","3-0",14,6,5,3,0,2,0,0,6,5,10,8,3,11,18,"6-5","Y","Y","N",2,0,5
"3683","G1",2023-09-24,"Volos NFC","Asteras Tripolis",1,2,"A",0,2,"A",2.63,3.14,2.81,"0-2","1-2",13,7,16,6,4,3,0,0,1,5,18,18,3,6,36,"1-5","Y","Y","N",7,0,5
"3684","G1",2023-09-24,"Giannina","PAOK",1,3,"A",1,2,"A",5.4,3.87,1.62,"1-2","1-3",10,3,10,5,4,2,0,0,8,6,10,9,4,14,19,"8-6","Y","Y","Y",6,0,5
"3685","G1",2023-09-25,"Panathinaikos","AEK",1,2,"A",1,1,"D",2.37,3.09,3.23,"1-1","1-2",10,5,15,4,3,4,0,0,6,6,13,21,3,12,34,"6-6","Y","Y","N",7,0,5
"3686","G1",2023-09-27,"Panetolikos","OFI Crete",1,1,"D",1,1,"D",2.88,3.37,2.38,"1-1","1-1",18,6,21,10,2,2,0,0,3,7,7,13,2,10,20,"3-7","Y","N","N",4,0,5
"3687","G1",2023-09-27,"Kifisia","Lamia",1,1,"D",0,0,"D",2.3,3.33,3.24,"0-0","1-1",17,4,8,4,4,3,1,0,6,8,14,12,2,14,26,"6-8","Y","N","N",7,1,5
"3688","G1",2023-09-27,"Olympiakos","Aris",4,1,"H",1,0,"H",1.36,4.85,9.26,"1-0","4-1",20,5,7,1,2,0,0,0,8,1,17,7,5,9,24,"8-1","Y","Y","Y",2,0,6
"3689","G1",2023-09-27,"PAOK","Volos NFC",3,0,"H",2,0,"H",1.18,7.46,14.45,"2-0","3-0",17,10,5,2,0,1,0,0,5,3,14,13,3,8,27,"5-3","Y","Y","N",1,0,6
"3690","G1",2023-09-28,"Panserraikos","Giannina",3,2,"H",2,1,"H",2.28,3.07,3.45,"2-1","3-2",12,6,6,3,5,3,0,1,4,4,10,11,5,8,21,"4-4","Y","Y","Y",8,1,6
"3691","G1",2023-09-28,"Asteras Tripolis","Panathinaikos",1,4,"A",1,2,"A",5.4,3.6,1.67,"1-2","1-4",9,4,9,7,3,1,0,0,2,4,7,9,5,6,16,"2-4","Y","Y","Y",4,0,6
"3692","G1",2023-09-28,"AEK","Atromitos",2,1,"H",1,0,"H",1.17,7.15,14.76,"1-0","2-1",18,8,5,2,2,4,1,0,6,1,9,10,3,7,19,"6-1","Y","Y","N",6,1,6
"3693","G1",2023-10-01,"Lamia","Panetolikos",1,0,"H",1,0,"H",1.88,3.33,4.41,"1-0","1-0",7,3,13,1,2,4,0,0,2,5,16,18,1,7,34,"2-5","N","N","N",6,0,6
"3694","G1",2023-10-01,"Aris","Kifisia",1,1,"D",1,0,"H",1.41,4.43,7.69,"1-0","1-1",12,6,10,4,2,7,0,0,5,3,13,20,2,8,33,"5-3","Y","N","N",9,0,6
"3695","G1",2023-10-01,"Panathinaikos","PAOK",2,2,"D",1,1,"D",1.9,3.33,4.33,"1-1","2-2",22,13,5,2,2,4,0,0,7,2,10,13,4,9,23,"7-2","Y","Y","Y",6,0,7
"3696","G1",2023-10-01,"Giannina","Olympiakos",0,3,"A",0,2,"A",7.93,4.46,1.4,"0-2","0-3",5,0,25,9,3,2,0,0,2,6,10,14,3,8,24,"2-6","Y","Y","N",5,0,7
"3697","G1",2023-10-02,"Atromitos","Asteras Tripolis",0,0,"D",0,0,"D",2.16,3.17,3.69,"0-0","0-0",8,1,8,4,1,5,1,0,4,5,8,22,0,9,30,"4-5","N","N","N",6,1,7
"3698","G1",2023-10-02,"OFI Crete","AEK",2,0,"H",1,0,"H",6.48,4.38,1.47,"1-0","2-0",7,5,14,4,4,3,0,0,2,4,10,17,2,6,27,"2-4","Y","N","N",7,0,7
"3699","G1",2023-10-08,"AEK","Panetolikos",3,0,"H",2,0,"H",1.06,13.71,32.27,"2-0","3-0",23,9,7,4,0,2,0,0,9,5,10,15,3,14,25,"9-5","Y","Y","N",2,0,7
"3700","G1",2023-10-08,"Panathinaikos","Atromitos",5,0,"H",3,0,"H",1.22,5.9,13.39,"3-0","5-0",14,10,5,1,0,1,1,1,2,1,15,8,5,3,23,"2-1","Y","Y","Y",1,2,7
"3701","G1",2023-10-20,"Lamia","Giannina",2,1,"H",2,1,"H",2.18,2.96,4.04,"2-1","2-1",15,7,12,2,3,3,0,0,4,3,17,13,3,7,30,"4-3","Y","Y","N",6,0,7
"3702","G1",2023-10-21,"Panetolikos","Volos NFC",2,0,"H",1,0,"H",2.1,3.23,3.83,"1-0","2-0",13,6,11,1,2,3,0,0,3,6,18,8,2,9,26,"3-6","Y","N","N",5,0,8
"3703","G1",2023-10-21,"Aris","Panserraikos",1,0,"H",0,0,"D",1.46,4.33,7.33,"0-0","1-0",20,6,5,2,3,6,0,0,8,2,15,18,1,10,33,"8-2","N","N","N",9,0,8
"3704","G1",2023-10-22,"Asteras Tripolis","AEK",0,3,"A",0,1,"A",7.11,4.48,1.44,"0-1","0-3",4,1,15,5,6,5,1,0,2,3,8,9,3,5,17,"2-3","Y","Y","N",11,1,8
"3705","G1",2023-10-22,"Kifisia","OFI Crete",0,0,"D",0,0,"D",2.9,3.36,2.45,"0-0","0-0",8,2,9,3,2,6,1,0,5,4,8,16,0,9,24,"5-4","N","N","N",8,1,8
"3706","G1",2023-10-22,"PAOK","Atromitos",2,0,"H",1,0,"H",1.28,5.46,10.2,"1-0","2-0",15,5,6,3,3,3,0,0,8,1,16,13,2,9,29,"8-1","Y","N","N",6,0,8
"3707","G1",2023-10-28,"Volos NFC","Kifisia",2,1,"H",1,0,"H",2.27,3.46,3.18,"1-0","2-1",17,6,9,2,4,6,0,2,4,8,12,17,3,12,29,"4-8","Y","Y","N",10,2,8
"3708","G1",2023-10-28,"Atromitos","Panetolikos",3,2,"H",0,1,"A",1.81,3.59,4.59,"0-1","3-2",10,5,6,3,2,2,0,1,1,2,19,16,5,3,35,"1-2","Y","Y","Y",4,1,8
"3709","G1",2023-10-29,"Asteras Tripolis","Lamia",0,1,"A",0,0,"D",1.88,3.33,4.41,"0-0","0-1",11,5,10,4,2,3,0,0,5,2,14,10,1,7,24,"5-2","N","N","N",5,0,9
"3710","G1",2023-10-29,"Panathinaikos","Panserraikos",5,0,"H",3,0,"H",1.21,6.39,12.19,"3-0","5-0",13,6,7,1,2,4,0,1,7,1,22,11,5,8,33,"7-1","Y","Y","Y",6,1,9
"3711","G1",2023-10-29,"Aris","Giannina",2,0,"H",0,0,"D",1.4,4.43,7.97,"0-0","2-0",17,7,2,0,4,2,0,1,6,1,11,9,2,7,20,"6-1","Y","N","N",6,1,9
"3712","G1",2023-10-30,"AEK","PAOK",2,0,"H",1,0,"H",1.72,3.74,4.75,"1-0","2-0",15,3,4,2,4,5,0,0,5,2,14,9,2,7,23,"5-2","Y","N","N",9,0,9
"3713","G1",2023-10-30,"OFI Crete","Olympiakos",0,2,"A",0,1,"A",5.97,4.26,1.51,"0-1","0-2",4,0,13,3,1,3,0,0,2,3,7,18,2,5,25,"2-3","Y","N","N",4,0,9
"3714","G1",2023-11-04,"Lamia","Panathinaikos",1,2,"A",0,1,"A",7.97,4.51,1.42,"0-1","1-2",13,4,9,6,3,6,0,1,3,3,17,16,3,6,33,"3-3","Y","Y","N",9,1,9
"3715","G1",2023-11-04,"Kifisia","AEK",1,1,"D",0,0,"D",14.16,8.09,1.16,"0-0","1-1",7,2,18,6,2,2,0,0,5,8,10,13,2,13,23,"5-8","Y","N","N",4,0,9
"3716","G1",2023-11-05,"Panetolikos","Asteras Tripolis",0,1,"A",0,1,"A",3.04,3.06,2.51,"0-1","0-1",15,4,4,3,6,5,0,1,8,3,23,13,1,11,36,"8-3","N","N","N",11,1,10
"3717","G1",2023-11-05,"Giannina","Volos NFC",1,1,"D",0,0,"D",1.93,3.38,4.09,"0-0","1-1",12,3,11,2,5,2,0,0,4,7,23,13,2,11,36,"4-7","Y","N","N",7,0,10
"3718","G1",2023-11-05,"Olympiakos","PAOK",2,4,"A",0,1,"A",1.48,3.9,5.84,"0-1","2-4",11,6,10,5,3,2,0,0,7,2,14,11,6,9,25,"7-2","Y","Y","Y",5,0,10
"3719","G1",2023-11-05,"Aris","Atromitos",1,3,"A",1,1,"D",1.54,4.08,5.96,"1-1","1-3",16,5,8,6,3,4,0,0,9,2,14,18,4,11,32,"9-2","Y","Y","Y",7,0,10
"3720","G1",2023-11-06,"Panserraikos","OFI Crete",2,1,"H",1,1,"D",2.66,3.14,2.78,"1-1","2-1",9,4,15,3,3,4,0,0,4,4,18,13,3,8,31,"4-4","Y","Y","N",7,0,10
"3721","G1",2023-11-11,"OFI Crete","Giannina",1,1,"D",1,0,"H",1.69,3.76,5.02,"1-0","1-1",13,5,18,7,2,2,0,0,2,4,17,14,2,6,31,"2-4","Y","N","N",4,0,10
"3722","G1",2023-11-11,"Atromitos","Panserraikos",1,1,"D",0,1,"A",1.94,3.36,4.27,"0-1","1-1",12,3,7,2,4,4,0,0,5,1,21,20,2,6,41,"5-1","Y","N","N",8,0,10
"3723","G1",2023-11-11,"Volos NFC","Aris",0,2,"A",0,0,"D",4.44,3.8,1.79,"0-0","0-2",14,5,7,3,4,2,0,0,5,7,10,18,2,12,28,"5-7","Y","N","N",6,0,11
"3724","G1",2023-11-12,"PAOK","Panetolikos",2,1,"H",2,1,"H",1.17,7.07,13.77,"2-1","2-1",9,2,8,2,2,3,0,0,4,1,7,14,3,5,21,"4-1","Y","Y","N",5,0,11
"3725","G1",2023-11-12,"AEK","Lamia",3,0,"H",2,0,"H",1.2,6.85,11.31,"2-0","3-0",12,5,5,1,3,3,0,0,4,4,15,15,3,8,30,"4-4","Y","Y","N",6,0,11
"3726","G1",2023-11-12,"Asteras Tripolis","Olympiakos",0,2,"A",0,0,"D",7.05,4.47,1.43,"0-0","0-2",5,2,13,4,3,0,0,0,2,5,7,16,2,7,23,"2-5","Y","N","N",3,0,11
"3727","G1",2023-11-12,"Kifisia","Panathinaikos",0,1,"A",0,0,"D",10.43,5.94,1.24,"0-0","0-1",4,2,14,6,1,3,0,0,0,9,13,14,1,9,27,"0-9","N","N","N",4,0,11
"3728","G1",2023-11-24,"OFI Crete","Volos NFC",1,1,"D",0,1,"A",1.75,3.77,4.77,"0-1","1-1",16,6,10,3,3,5,0,1,6,2,10,17,2,8,27,"6-2","Y","N","N",8,1,11
"3729","G1",2023-11-25,"Olympiakos","Panetolikos",3,1,"H",2,1,"H",1.13,9.49,17.72,"2-1","3-1",9,4,8,4,3,1,0,0,3,2,20,15,4,5,35,"3-2","Y","Y","Y",4,0,11
"3730","G1",2023-11-25,"PAOK","Panserraikos",5,0,"H",2,0,"H",1.24,6.37,11,"2-0","5-0",16,11,7,2,0,0,0,0,8,3,3,7,5,11,10,"8-3","Y","Y","Y",0,0,12
"3731","G1",2023-11-26,"Kifisia","Asteras Tripolis",1,3,"A",0,2,"A",2.45,3.16,3.03,"0-2","1-3",17,6,5,4,2,2,0,0,7,2,17,15,4,9,32,"7-2","Y","Y","Y",4,0,12
"3732","G1",2023-11-26,"Giannina","AEK",0,1,"A",0,1,"A",8.9,5.28,1.31,"0-1","0-1",8,4,20,7,3,1,0,0,3,6,12,13,1,9,25,"3-6","N","N","N",4,0,12
"3733","G1",2023-11-26,"Lamia","Atromitos",3,3,"D",2,2,"D",2.41,3.25,3.02,"2-2","3-3",12,7,11,6,4,3,0,0,3,8,11,18,6,11,29,"3-8","Y","Y","Y",7,0,12
"3734","G1",2023-11-26,"Aris","Panathinaikos",2,0,"H",1,0,"H",3.41,3.42,2.13,"1-0","2-0",8,4,14,8,3,1,0,0,1,9,19,11,2,10,30,"1-9","Y","N","N",4,0,12
"3735","G1",2023-11-29,"Volos NFC","Panserraikos",1,0,"H",0,0,"D",2.43,3.27,3.06,"0-0","1-0",11,5,11,4,2,4,0,0,3,5,21,16,1,8,37,"3-5","N","N","N",6,0,12
"3736","G1",2023-12-02,"Panetolikos","Kifisia",3,0,"H",1,0,"H",2.2,3.26,3.53,"1-0","3-0",14,7,8,4,2,5,0,0,5,6,17,17,3,11,34,"5-6","Y","Y","N",7,0,12
"3737","G1",2023-12-02,"Asteras Tripolis","Panserraikos",1,0,"H",0,0,"D",2,3.36,4.05,"0-0","1-0",9,2,16,4,4,4,0,0,5,3,17,12,1,8,29,"5-3","N","N","N",8,0,13
"3738","G1",2023-12-03,"Volos NFC","Olympiakos",2,2,"D",1,1,"D",12.69,6.38,1.2,"1-1","2-2",10,4,11,3,7,3,1,1,2,6,16,8,4,8,24,"2-6","Y","Y","Y",10,2,13
"3739","G1",2023-12-03,"Atromitos","Giannina",1,1,"D",0,0,"D",2.2,3.28,3.38,"0-0","1-1",12,4,9,3,4,2,0,0,2,2,16,7,2,4,23,"2-2","Y","N","N",6,0,13
"3740","G1",2023-12-03,"Panathinaikos","OFI Crete",4,0,"H",1,0,"H",1.22,6,11.75,"1-0","4-0",16,9,5,3,1,6,0,0,2,3,18,21,4,5,39,"2-3","Y","Y","Y",7,0,13
"3741","G1",2023-12-04,"PAOK","Lamia",3,0,"H",2,0,"H",1.2,6.39,12.52,"2-0","3-0",17,8,11,6,0,1,0,0,5,5,7,9,3,10,16,"5-5","Y","Y","N",1,0,13
"3742","G1",2023-12-04,"AEK","Aris",1,0,"H",0,0,"D",1.39,4.8,7.45,"0-0","1-0",17,4,7,1,1,1,0,0,9,2,15,9,1,11,24,"9-2","N","N","N",2,0,13
"3743","G1",2023-12-16,"Kifisia","Giannina",4,2,"H",3,2,"H",2.39,3.05,3.36,"3-2","4-2",12,10,9,5,3,5,0,1,3,7,13,19,6,10,32,"3-7","Y","Y","Y",8,1,13
"3744","G1",2023-12-17,"Aris","OFI Crete",1,0,"H",1,0,"H",1.64,3.94,5.45,"1-0","1-0",17,7,6,1,1,1,0,0,6,5,12,18,1,11,30,"6-5","N","N","N",2,0,14
"3745","G1",2023-12-17,"Asteras Tripolis","PAOK",1,4,"A",0,1,"A",6.02,3.86,1.57,"0-1","1-4",10,3,13,8,2,1,0,0,7,4,16,17,5,11,33,"7-4","Y","Y","Y",3,0,14
"3746","G1",2023-12-17,"Lamia","Volos NFC",1,2,"A",0,0,"D",1.89,3.44,4.17,"0-0","1-2",10,4,8,4,3,4,0,0,6,2,12,24,3,8,36,"6-2","Y","Y","N",7,0,14
"3747","G1",2023-12-17,"Atromitos","Panathinaikos",3,2,"H",1,1,"D",6.79,4.21,1.47,"1-1","3-2",9,4,12,4,3,2,0,0,1,7,14,16,5,8,30,"1-7","Y","Y","Y",5,0,14
"3748","G1",2023-12-18,"Panetolikos","AEK",2,2,"D",1,2,"A",9.34,5.39,1.3,"1-2","2-2",6,3,19,7,4,1,0,0,2,9,17,10,4,11,27,"2-9","Y","Y","Y",5,0,14
"3749","G1",2023-12-18,"Panserraikos","Olympiakos",0,1,"A",0,0,"D",8.79,4.98,1.34,"0-0","0-1",5,2,13,3,1,4,0,0,3,5,7,16,1,8,23,"3-5","N","N","N",5,0,14
"3750","G1",2023-12-20,"Aris","Lamia",2,2,"D",0,0,"D",1.52,4.23,6.44,"0-0","2-2",22,11,8,3,1,4,0,0,10,3,17,14,4,13,31,"10-3","Y","Y","Y",5,0,14
"3751","G1",2023-12-20,"Volos NFC","Panathinaikos",0,3,"A",0,0,"D",8.4,5.02,1.36,"0-0","0-3",3,0,14,6,1,2,0,0,3,4,14,16,3,7,30,"3-4","Y","Y","N",3,0,15
"3752","G1",2023-12-21,"Giannina","Panetolikos",0,0,"D",0,0,"D",2.06,3.27,3.81,"0-0","0-0",11,3,4,1,1,4,0,1,7,6,16,17,0,13,33,"7-6","N","N","N",5,1,15
"3753","G1",2023-12-21,"Panserraikos","AEK",2,2,"D",1,2,"A",10.99,5.6,1.26,"1-2","2-2",10,7,14,6,5,4,1,0,5,3,18,14,4,8,32,"5-3","Y","Y","Y",9,1,15
"3754","G1",2023-12-21,"OFI Crete","Asteras Tripolis",0,2,"A",0,1,"A",2.02,3.29,3.87,"0-1","0-2",19,5,14,6,3,1,0,0,9,4,15,7,2,13,22,"9-4","Y","N","N",4,0,15
"3755","G1",2023-12-21,"Kifisia","PAOK",0,6,"A",0,3,"A",7.7,4.82,1.38,"0-3","0-6",7,2,14,10,1,0,0,0,1,4,15,15,6,5,30,"1-4","Y","Y","Y",1,0,15
"3756","G1",2023-12-21,"Atromitos","Olympiakos",0,0,"D",0,0,"D",7.93,4.69,1.38,"0-0","0-0",3,1,18,4,3,1,0,0,0,9,13,11,0,9,24,"0-9","N","N","N",4,0,15
"3757","G1",2024-01-03,"Asteras Tripolis","Aris",3,2,"H",1,2,"A",3.13,3.22,2.42,"1-2","3-2",10,3,8,3,1,2,0,0,5,1,18,14,5,6,32,"5-1","Y","Y","Y",3,0,15
"3758","G1",2024-01-03,"Lamia","Olympiakos",1,0,"H",1,0,"H",8.2,4.98,1.37,"1-0","1-0",14,7,13,5,4,1,0,0,7,5,14,12,1,12,26,"7-5","N","N","N",5,0,16
"3759","G1",2024-01-03,"AEK","Volos NFC",3,0,"H",1,0,"H",1.12,9.25,19.94,"1-0","3-0",10,4,4,2,2,5,0,0,9,3,11,21,3,12,32,"9-3","Y","Y","N",7,0,16
"3760","G1",2024-01-03,"Panathinaikos","Giannina",2,0,"H",1,0,"H",1.17,7.38,16.57,"1-0","2-0",13,7,7,3,1,1,0,0,8,3,15,12,2,11,27,"8-3","Y","N","N",2,0,16
"3761","G1",2024-01-03,"PAOK","OFI Crete",4,0,"H",2,0,"H",1.22,6.6,11.67,"2-0","4-0",15,10,14,7,1,3,0,0,6,2,11,14,4,8,25,"6-2","Y","Y","Y",4,0,16
"3762","G1",2024-01-04,"Panetolikos","Panserraikos",3,2,"H",1,1,"D",2.26,3.16,3.38,"1-1","3-2",18,6,9,3,2,2,0,0,4,3,20,15,5,7,35,"4-3","Y","Y","Y",4,0,16
"3763","G1",2024-01-04,"Atromitos","Kifisia",3,0,"H",1,0,"H",1.82,3.67,4.24,"1-0","3-0",12,7,11,2,2,4,0,0,1,10,14,11,3,11,25,"1-10","Y","Y","N",6,0,16
"3764","G1",2024-01-07,"Panserraikos","Kifisia",1,1,"D",0,1,"A",2.05,3.38,3.66,"0-1","1-1",8,1,13,5,2,4,0,0,3,3,9,19,2,6,28,"3-3","Y","N","N",6,0,16
"3765","G1",2024-01-07,"Volos NFC","Atromitos",1,2,"A",0,1,"A",2.54,3.23,2.85,"0-1","1-2",7,4,14,6,4,3,0,0,2,8,16,18,3,10,34,"2-8","Y","Y","N",7,0,17
"3766","G1",2024-01-07,"Panathinaikos","Panetolikos",2,1,"H",0,0,"D",1.17,7.2,14.39,"0-0","2-1",12,5,8,5,2,2,0,0,4,3,18,11,3,7,29,"4-3","Y","Y","N",4,0,17
"3767","G1",2024-01-07,"Giannina","Asteras Tripolis",2,1,"H",2,1,"H",2.46,3.06,3.1,"2-1","2-1",14,5,9,3,2,0,0,0,7,3,12,17,3,10,29,"7-3","Y","Y","N",2,0,17
"3768","G1",2024-01-07,"Aris","PAOK",2,1,"H",0,0,"D",4.03,3.36,1.95,"0-0","2-1",13,4,9,2,2,4,0,0,4,5,21,11,3,9,32,"4-5","Y","Y","N",6,0,17
"3769","G1",2024-01-07,"Olympiakos","AEK",1,2,"A",1,2,"A",2.68,3.2,2.71,"1-2","1-2",7,3,10,3,3,3,0,0,5,9,9,16,3,14,25,"5-9","Y","Y","N",6,0,17
"3770","G1",2024-01-08,"OFI Crete","Lamia",1,1,"D",1,1,"D",1.86,3.4,4.39,"1-1","1-1",18,7,4,3,4,3,0,0,7,1,22,20,2,8,42,"7-1","Y","N","N",7,0,17
"3771","G1",2024-01-13,"Atromitos","OFI Crete",1,1,"D",0,0,"D",2.26,3.36,3.29,"0-0","1-1",10,2,12,4,2,4,0,0,5,7,8,20,2,12,28,"5-7","Y","N","N",6,0,17
"3772","G1",2024-01-13,"Lamia","Panserraikos",0,2,"A",0,1,"A",2.08,3.19,4,"0-1","0-2",9,3,7,4,2,2,0,0,2,1,14,20,2,3,34,"2-1","Y","N","N",4,0,18
"3773","G1",2024-01-14,"Panetolikos","Aris",0,4,"A",0,1,"A",2.71,3.09,2.86,"0-1","0-4",13,4,15,7,3,1,0,0,4,6,15,18,4,10,33,"4-6","Y","Y","Y",4,0,18
"3774","G1",2024-01-14,"Kifisia","Olympiakos",2,3,"A",1,2,"A",8.7,5.18,1.32,"1-2","2-3",6,4,13,9,6,2,1,1,2,4,13,10,5,6,23,"2-4","Y","Y","Y",8,2,18
"3775","G1",2024-01-14,"Asteras Tripolis","Volos NFC",1,0,"H",0,0,"D",2.04,3.14,4.04,"0-0","1-0",10,2,11,2,2,1,0,0,6,4,18,16,1,10,34,"6-4","N","N","N",3,0,18
"3776","G1",2024-01-14,"AEK","Panathinaikos",2,2,"D",1,1,"D",1.88,3.37,4.36,"1-1","2-2",15,5,8,2,3,2,0,0,7,2,17,11,4,9,28,"7-2","Y","Y","Y",5,0,18
"3777","G1",2024-01-14,"PAOK","Giannina",4,0,"H",1,0,"H",1.17,6.89,14.82,"1-0","4-0",19,9,4,0,0,0,0,0,9,2,11,10,4,11,21,"9-2","Y","Y","Y",0,0,18
"2589","I1",2023-08-19,"Empoli","Verona",0,1,"A",0,0,"D",2.3,3.3,3.44,"0-0","0-1",10,4,10,4,2,2,0,0,2,4,17,18,1,6,35,"2-4","N","N","N",4,0,1
"2590","I1",2023-08-19,"Frosinone","Napoli",1,3,"A",1,2,"A",8.85,5.25,1.37,"1-2","1-3",4,1,19,8,3,3,0,0,4,6,14,17,4,10,31,"4-6","Y","Y","Y",6,0,1
"2591","I1",2023-08-19,"Genoa","Fiorentina",1,4,"A",0,3,"A",3.54,3.36,2.23,"0-3","1-4",4,2,9,5,2,3,0,0,3,4,14,13,5,7,27,"3-4","Y","Y","Y",5,0,1
"2592","I1",2023-08-19,"Inter","Monza",2,0,"H",1,0,"H",1.39,5.1,8.76,"1-0","2-0",22,3,12,2,1,1,0,0,8,3,8,13,2,11,21,"8-3","Y","N","N",2,0,1
"2593","I1",2023-08-20,"Roma","Salernitana",2,2,"D",1,1,"D",1.53,4.18,7.16,"1-1","2-2",13,3,3,2,0,4,0,0,9,1,12,9,4,10,21,"9-1","Y","Y","Y",4,0,1
"2594","I1",2023-08-20,"Sassuolo","Atalanta",0,2,"A",0,0,"D",3.39,3.63,2.18,"0-0","0-2",11,3,16,6,0,0,0,0,7,7,9,13,2,14,22,"7-7","Y","N","N",0,0,1
"2595","I1",2023-08-20,"Lecce","Lazio",2,1,"H",0,1,"A",3.87,3.31,2.14,"0-1","2-1",23,7,10,4,3,2,0,0,5,2,12,16,3,7,28,"5-2","Y","Y","N",5,0,1
"2596","I1",2023-08-20,"Udinese","Juventus",0,3,"A",0,3,"A",4.64,3.66,1.85,"0-3","0-3",18,5,9,4,1,3,0,0,7,3,12,10,3,10,22,"7-3","Y","Y","N",4,0,1
"2597","I1",2023-08-21,"Torino","Cagliari",0,0,"D",0,0,"D",1.67,3.86,5.78,"0-0","0-0",11,2,8,2,1,1,0,0,8,3,8,12,0,11,20,"8-3","N","N","N",2,0,1
"2598","I1",2023-08-21,"Bologna","Milan",0,2,"A",0,2,"A",4.02,3.52,2.01,"0-2","0-2",17,5,10,6,2,2,0,0,3,6,10,4,2,9,14,"3-6","Y","N","N",4,0,1
"2599","I1",2023-08-26,"Frosinone","Atalanta",2,1,"H",2,0,"H",5.04,4.16,1.69,"2-0","2-1",13,5,18,6,1,2,0,0,3,7,10,10,3,10,20,"3-7","Y","Y","N",3,0,2
"2600","I1",2023-08-26,"Monza","Empoli",2,0,"H",1,0,"H",1.95,3.59,4.18,"1-0","2-0",20,5,18,6,1,2,0,0,6,5,14,7,2,11,21,"6-5","Y","N","N",3,0,2
"2601","I1",2023-08-26,"Milan","Torino",4,1,"H",3,1,"H",1.69,3.8,5.71,"3-1","4-1",17,7,8,1,2,3,0,0,2,1,13,16,5,3,29,"2-1","Y","Y","Y",5,0,2
"2602","I1",2023-08-26,"Verona","Roma",2,1,"H",2,0,"H",4.83,3.49,1.87,"2-0","2-1",5,3,23,7,1,3,1,0,1,12,17,12,3,13,29,"1-12","Y","Y","N",4,1,2
"2603","I1",2023-08-27,"Fiorentina","Lecce",2,2,"D",2,0,"H",1.64,4,5.86,"2-0","2-2",9,4,6,2,1,3,0,0,3,3,13,12,4,6,25,"3-3","Y","Y","Y",4,0,2
"2604","I1",2023-08-27,"Juventus","Bologna",1,1,"D",0,1,"A",1.51,4.42,7.08,"0-1","1-1",14,3,9,4,2,1,0,0,5,1,14,13,2,6,27,"5-1","Y","N","N",3,0,2
"2605","I1",2023-08-27,"Lazio","Genoa",0,1,"A",0,1,"A",1.61,4.23,5.75,"0-1","0-1",16,2,5,3,4,2,0,0,15,1,9,16,1,16,25,"15-1","N","N","N",6,0,2
"2606","I1",2023-08-27,"Napoli","Sassuolo",2,0,"H",1,0,"H",1.34,5.87,8.45,"1-0","2-0",25,5,6,1,0,1,0,1,12,4,9,10,2,16,19,"12-4","Y","N","N",1,1,2
"2607","I1",2023-08-28,"Salernitana","Udinese",1,1,"D",0,0,"D",2.8,3.34,2.69,"0-0","1-1",9,4,14,6,4,4,0,0,7,5,12,19,2,12,31,"7-5","Y","N","N",8,0,2
"2608","I1",2023-08-28,"Cagliari","Inter",0,2,"A",0,2,"A",6.7,5.01,1.47,"0-2","0-2",12,2,17,3,1,1,0,0,4,7,9,10,2,11,19,"4-7","Y","N","N",2,0,2
"2609","I1",2023-09-01,"Sassuolo","Verona",3,1,"H",1,0,"H",2.04,3.66,3.84,"1-0","3-1",16,7,11,3,1,3,0,0,10,1,8,13,4,11,21,"10-1","Y","Y","Y",4,0,3
"2610","I1",2023-09-01,"Roma","Milan",1,2,"A",0,1,"A",2.88,3.2,2.76,"0-1","1-2",13,2,9,4,2,4,0,1,3,5,14,15,3,8,29,"3-5","Y","Y","N",6,1,3
"2611","I1",2023-09-02,"Bologna","Cagliari",2,1,"H",0,1,"A",1.75,3.63,5.47,"0-1","2-1",16,7,7,1,1,2,0,0,5,2,9,13,3,7,22,"5-2","Y","Y","N",3,0,3
"2612","I1",2023-09-02,"Udinese","Frosinone",0,0,"D",0,0,"D",1.82,3.72,4.74,"0-0","0-0",12,6,12,2,2,2,0,0,3,5,14,9,0,8,23,"3-5","N","N","N",4,0,3
"2613","I1",2023-09-02,"Atalanta","Monza",3,0,"H",2,0,"H",1.64,4.27,5.32,"2-0","3-0",18,8,8,2,0,3,0,0,7,3,11,9,3,10,20,"7-3","Y","Y","N",3,0,3
"2614","I1",2023-09-02,"Napoli","Lazio",1,2,"A",1,1,"D",1.62,4.19,5.73,"1-1","1-2",22,4,6,2,1,2,0,0,7,2,8,9,3,9,17,"7-2","Y","Y","N",3,0,3
"2615","I1",2023-09-03,"Inter","Fiorentina",4,0,"H",1,0,"H",1.66,4.16,5.29,"1-0","4-0",21,11,6,2,1,1,0,0,1,1,13,12,4,2,25,"1-1","Y","Y","Y",2,0,3
"2616","I1",2023-09-03,"Torino","Genoa",1,0,"H",0,0,"D",2.09,3.31,4.03,"0-0","1-0",10,3,7,2,2,5,0,0,4,0,13,7,1,4,20,"4-0","N","N","N",7,0,3
"2617","I1",2023-09-03,"Empoli","Juventus",0,2,"A",0,1,"A",5.43,3.98,1.68,"0-1","0-2",7,0,18,5,3,3,0,0,3,7,14,13,2,10,27,"3-7","Y","N","N",6,0,3
"2618","I1",2023-09-03,"Lecce","Salernitana",2,0,"H",1,0,"H",2.06,3.4,4,"1-0","2-0",20,6,11,4,3,3,0,0,6,5,17,15,2,11,32,"6-5","Y","N","N",6,0,3
"2619","I1",2023-09-16,"Juventus","Lazio",3,1,"H",2,0,"H",1.94,3.47,4.41,"2-0","3-1",17,7,16,5,5,1,0,0,7,9,13,13,4,16,26,"7-9","Y","Y","Y",6,0,4
"2620","I1",2023-09-16,"Inter","Milan",5,1,"H",2,0,"H",2.15,3.57,3.53,"2-0","5-1",14,7,9,2,2,2,0,0,5,0,16,13,6,5,29,"5-0","Y","Y","Y",4,0,4
"2621","I1",2023-09-16,"Genoa","Napoli",2,2,"D",1,0,"H",5.41,4.1,1.66,"1-0","2-2",8,3,12,4,3,2,0,0,3,1,14,8,4,4,22,"3-1","Y","Y","Y",5,0,4
"2622","I1",2023-09-17,"Cagliari","Udinese",0,0,"D",0,0,"D",2.9,3.27,2.65,"0-0","0-0",10,1,11,1,2,1,1,0,4,6,12,11,0,10,23,"4-6","N","N","N",3,1,4
"2623","I1",2023-09-17,"Frosinone","Sassuolo",4,2,"H",1,2,"A",2.83,3.52,2.57,"1-2","4-2",16,6,18,7,4,2,0,0,5,6,10,9,6,11,19,"5-6","Y","Y","Y",6,0,4
"2624","I1",2023-09-17,"Monza","Lecce",1,1,"D",1,1,"D",2.13,3.5,3.66,"1-1","1-1",25,6,4,3,6,1,1,1,10,1,17,11,2,11,28,"10-1","Y","N","N",7,2,4
"2625","I1",2023-09-17,"Fiorentina","Atalanta",3,2,"H",2,1,"H",2.54,3.55,2.84,"2-1","3-2",15,8,11,4,1,2,0,0,3,4,8,14,5,7,22,"3-4","Y","Y","Y",3,0,4
"2626","I1",2023-09-17,"Roma","Empoli",7,0,"H",3,0,"H",1.43,4.66,8.61,"3-0","7-0",14,9,8,2,2,2,0,0,2,6,15,5,7,8,20,"2-6","Y","Y","Y",4,0,4
"2627","I1",2023-09-18,"Salernitana","Torino",0,3,"A",0,2,"A",3.73,3.27,2.2,"0-2","0-3",14,4,11,3,2,2,0,0,1,2,12,16,3,3,28,"1-2","Y","Y","N",4,0,4
"2628","I1",2023-09-18,"Verona","Bologna",0,0,"D",0,0,"D",3.15,3.39,2.41,"0-0","0-0",9,1,11,4,4,2,0,0,3,4,18,10,0,7,28,"3-4","N","N","N",6,0,4
"2629","I1",2023-09-22,"Salernitana","Frosinone",1,1,"D",0,1,"A",2.59,3.3,3.01,"0-1","1-1",19,6,9,3,2,2,0,0,8,6,12,12,2,14,24,"8-6","Y","N","N",4,0,5
"2630","I1",2023-09-22,"Lecce","Genoa",1,0,"H",0,0,"D",2.49,3.22,3.23,"0-0","1-0",18,3,8,1,1,3,0,1,4,3,12,10,1,7,22,"4-3","N","N","N",4,1,5
"2631","I1",2023-09-23,"Milan","Verona",1,0,"H",1,0,"H",1.39,4.95,9.16,"1-0","1-0",9,4,10,2,4,2,0,0,2,3,13,9,1,5,22,"2-3","N","N","N",6,0,5
"2632","I1",2023-09-23,"Sassuolo","Juventus",4,2,"H",2,1,"H",4.35,4.03,1.81,"2-1","4-2",18,7,15,2,4,2,0,0,6,3,13,8,6,9,21,"6-3","Y","Y","Y",6,0,5
"2633","I1",2023-09-23,"Lazio","Monza",1,1,"D",1,1,"D",1.8,3.94,4.52,"1-1","1-1",8,1,16,4,2,2,0,0,1,3,13,7,2,4,20,"1-3","Y","N","N",4,0,5
"2634","I1",2023-09-24,"Empoli","Inter",0,1,"A",0,0,"D",9.73,5.6,1.33,"0-0","0-1",7,1,23,6,2,2,0,0,3,6,15,11,1,9,26,"3-6","N","N","N",4,0,5
"2635","I1",2023-09-24,"Atalanta","Cagliari",2,0,"H",1,0,"H",1.41,5.11,7.79,"1-0","2-0",10,6,11,1,1,2,0,0,7,7,6,11,2,14,17,"7-7","Y","N","N",3,0,5
"2636","I1",2023-09-24,"Udinese","Fiorentina",0,2,"A",0,1,"A",3.17,3.45,2.37,"0-1","0-2",20,8,6,2,0,1,0,0,10,3,13,11,2,13,24,"10-3","Y","N","N",1,0,5
"2637","I1",2023-09-24,"Bologna","Napoli",0,0,"D",0,0,"D",3.72,3.66,2.06,"0-0","0-0",5,2,12,4,4,5,0,0,5,5,16,12,0,10,28,"5-5","N","N","N",9,0,5
"2638","I1",2023-09-24,"Torino","Roma",1,1,"D",0,0,"D",3.09,3.1,2.62,"0-0","1-1",13,4,11,3,0,2,0,0,7,1,4,5,2,8,9,"7-1","Y","N","N",2,0,5
"2639","I1",2023-09-26,"Juventus","Lecce",1,0,"H",0,0,"D",1.52,4.31,7.27,"0-0","1-0",14,5,2,0,2,5,0,1,5,1,14,15,1,6,29,"5-1","N","N","N",7,1,6
"2640","I1",2023-09-27,"Cagliari","Milan",1,3,"A",1,2,"A",5.46,3.96,1.68,"1-2","1-3",16,6,17,6,3,1,0,0,3,5,13,6,4,8,19,"3-5","Y","Y","Y",4,0,6
"2641","I1",2023-09-27,"Empoli","Salernitana",1,0,"H",1,0,"H",2.41,3.22,3.31,"1-0","1-0",13,6,14,2,2,1,0,0,10,2,18,13,1,12,31,"10-2","N","N","N",3,0,6
"2642","I1",2023-09-27,"Verona","Atalanta",0,1,"A",0,1,"A",4.63,3.78,1.82,"0-1","0-1",11,2,8,2,2,3,0,0,4,1,10,25,1,5,35,"4-1","N","N","N",5,0,6
"2643","I1",2023-09-27,"Inter","Sassuolo",1,2,"A",1,0,"H",1.32,5.99,9.3,"1-0","1-2",13,3,13,6,0,1,0,0,8,6,10,8,3,14,18,"8-6","Y","Y","N",1,0,6
"2644","I1",2023-09-27,"Lazio","Torino",2,0,"H",0,0,"D",2.17,3.37,3.7,"0-0","2-0",6,3,7,2,1,4,0,0,4,2,12,13,2,6,25,"4-2","Y","N","N",5,0,6
"2645","I1",2023-09-27,"Napoli","Udinese",4,1,"H",2,0,"H",1.39,5.16,8.46,"2-0","4-1",23,10,13,3,1,1,0,0,8,4,11,10,5,12,21,"8-4","Y","Y","Y",2,0,6
"2646","I1",2023-09-28,"Frosinone","Fiorentina",1,1,"D",0,1,"A",3.78,3.67,2.03,"0-1","1-1",11,3,19,6,3,3,0,0,8,10,6,11,2,18,17,"8-10","Y","N","N",6,0,6
"2647","I1",2023-09-28,"Monza","Bologna",0,0,"D",0,0,"D",2.49,3.35,3.06,"0-0","0-0",12,3,7,5,5,3,0,1,7,5,9,13,0,12,22,"7-5","N","N","N",8,1,6
"2648","I1",2023-09-28,"Genoa","Roma",4,1,"H",2,1,"H",3.85,3.31,2.14,"2-1","4-1",8,4,13,3,4,3,0,0,1,7,7,12,5,8,19,"1-7","Y","Y","Y",7,0,6
"2649","I1",2023-09-30,"Lecce","Napoli",0,4,"A",0,1,"A",4.84,3.9,1.76,"0-1","0-4",9,4,15,6,3,2,0,0,3,7,11,11,4,10,22,"3-7","Y","Y","Y",5,0,7
"2650","I1",2023-09-30,"Milan","Lazio",2,0,"H",0,0,"D",1.78,3.72,5.04,"0-0","2-0",14,7,13,4,3,2,0,0,7,1,15,5,2,8,20,"7-1","Y","N","N",5,0,7
"2651","I1",2023-09-30,"Salernitana","Inter",0,4,"A",0,0,"D",8.16,4.81,1.43,"0-0","0-4",12,3,16,6,2,1,0,0,3,3,12,10,4,6,22,"3-3","Y","Y","Y",3,0,7
"2652","I1",2023-10-01,"Bologna","Empoli",3,0,"H",1,0,"H",1.66,3.97,5.17,"1-0","3-0",21,9,12,4,2,4,0,0,2,6,11,16,3,8,27,"2-6","Y","Y","N",6,0,7
"2653","I1",2023-10-01,"Udinese","Genoa",2,2,"D",1,2,"A",2.38,3.07,3.35,"1-2","2-2",11,2,8,4,2,2,1,0,5,0,12,12,4,5,24,"5-0","Y","Y","Y",4,1,7
"2654","I1",2023-10-01,"Atalanta","Juventus",0,0,"D",0,0,"D",2.53,3.48,2.77,"0-0","0-0",15,2,5,3,1,2,0,0,5,2,13,7,0,7,20,"5-2","N","N","N",3,0,7
"2655","I1",2023-10-01,"Roma","Frosinone",2,0,"H",1,0,"H",1.45,4.36,7.55,"1-0","2-0",11,5,8,0,1,2,0,0,7,3,12,11,2,10,23,"7-3","Y","N","N",3,0,7
"2656","I1",2023-10-02,"Sassuolo","Monza",0,1,"A",0,0,"D",2.16,3.87,3.04,"0-0","0-1",19,7,13,4,0,0,0,0,7,4,8,10,1,11,18,"7-4","N","N","N",0,0,7
"2657","I1",2023-10-02,"Torino","Verona",0,0,"D",0,0,"D",1.83,3.37,4.73,"0-0","0-0",8,2,5,2,1,1,0,0,10,1,6,11,0,11,17,"10-1","N","N","N",2,0,7
"2658","I1",2023-10-02,"Fiorentina","Cagliari",3,0,"H",2,0,"H",1.48,4.17,6.98,"2-0","3-0",14,2,6,4,1,1,0,0,4,2,10,10,3,6,20,"4-2","Y","Y","N",2,0,7
"2659","I1",2023-10-06,"Empoli","Udinese",0,0,"D",0,0,"D",3.24,3.31,2.43,"0-0","0-0",18,3,11,1,1,2,0,0,5,7,11,15,0,12,26,"5-7","N","N","N",3,0,8
"2660","I1",2023-10-06,"Lecce","Sassuolo",1,1,"D",0,1,"A",2.6,3.56,2.8,"0-1","1-1",13,4,14,1,2,3,0,0,5,3,9,15,2,8,24,"5-3","Y","N","N",5,0,8
"2661","I1",2023-10-07,"Inter","Bologna",2,2,"D",2,1,"H",1.4,5.17,8.08,"2-1","2-2",14,5,8,3,2,3,0,0,7,7,11,9,4,14,20,"7-7","Y","Y","Y",5,0,8
"2662","I1",2023-10-07,"Juventus","Torino",2,0,"H",0,0,"D",1.94,3.39,4.58,"0-0","2-0",17,6,10,1,1,1,0,0,7,3,10,8,2,10,18,"7-3","Y","N","N",2,0,8
"2663","I1",2023-10-07,"Genoa","Milan",0,1,"A",0,0,"D",4.24,3.57,1.95,"0-0","0-1",7,1,12,3,3,5,1,1,3,2,10,13,1,5,23,"3-2","N","N","N",8,2,8
"2664","I1",2023-10-08,"Monza","Salernitana",3,0,"H",2,0,"H",1.68,3.97,5.48,"2-0","3-0",16,7,8,5,1,2,0,0,7,7,8,16,3,14,24,"7-7","Y","Y","N",3,0,8
"2665","I1",2023-10-08,"Frosinone","Verona",2,1,"H",1,0,"H",2.45,3.22,3.23,"1-0","2-1",11,2,16,4,1,4,0,0,2,4,9,12,3,6,21,"2-4","Y","Y","N",5,0,8
"2666","I1",2023-10-08,"Lazio","Atalanta",3,2,"H",2,1,"H",2.93,3.26,2.63,"2-1","3-2",12,4,12,4,1,1,0,0,4,6,7,10,5,10,17,"4-6","Y","Y","Y",2,0,8
"2667","I1",2023-10-08,"Cagliari","Roma",1,4,"A",0,2,"A",4.96,3.46,1.85,"0-2","1-4",16,2,11,5,2,3,0,0,4,3,15,13,5,7,28,"4-3","Y","Y","Y",5,0,8
"2668","I1",2023-10-08,"Napoli","Fiorentina",1,3,"A",1,1,"D",1.62,4.26,5.6,"1-1","1-3",16,4,12,3,2,4,0,0,6,4,4,14,4,10,18,"6-4","Y","Y","Y",6,0,8
"2669","I1",2023-10-21,"Verona","Napoli",1,3,"A",0,2,"A",5.71,3.96,1.66,"0-2","1-3",15,9,22,10,3,2,0,0,5,8,12,9,4,13,21,"5-8","Y","Y","Y",5,0,9
"2670","I1",2023-10-21,"Torino","Inter",0,3,"A",0,0,"D",5.39,3.72,1.74,"0-0","0-3",7,3,14,4,1,2,0,0,2,4,13,8,3,6,21,"2-4","Y","Y","N",3,0,9
"2671","I1",2023-10-21,"Sassuolo","Lazio",0,2,"A",0,2,"A",2.71,3.72,2.57,"0-2","0-2",9,2,18,6,1,5,0,0,5,7,6,10,2,12,16,"5-7","Y","N","N",6,0,9
"2672","I1",2023-10-22,"Roma","Monza",1,0,"H",0,0,"D",1.74,3.87,5.08,"0-0","1-0",21,4,11,4,2,4,0,1,8,5,11,11,1,13,22,"8-5","N","N","N",6,1,9
"2673","I1",2023-10-22,"Bologna","Frosinone",2,1,"H",2,0,"H",1.76,3.86,4.95,"2-0","2-1",12,6,12,5,2,2,0,1,4,5,10,14,3,9,24,"4-5","Y","Y","N",4,1,9
"2674","I1",2023-10-22,"Salernitana","Cagliari",2,2,"D",0,0,"D",2.35,3.18,3.46,"0-0","2-2",13,2,13,6,3,4,0,0,8,5,11,12,4,13,23,"8-5","Y","Y","Y",7,0,9
"2675","I1",2023-10-22,"Atalanta","Genoa",2,0,"H",0,0,"D",1.56,4.19,6.61,"0-0","2-0",13,8,15,4,4,2,0,0,8,4,17,9,2,12,26,"8-4","Y","N","N",6,0,9
"2676","I1",2023-10-22,"Milan","Juventus",0,1,"A",0,0,"D",2.32,3.29,3.42,"0-0","0-1",7,1,14,4,1,4,1,0,6,3,12,16,1,9,28,"6-3","N","N","N",5,1,9
"2677","I1",2023-10-23,"Udinese","Lecce",1,1,"D",0,0,"D",2.21,3.19,3.81,"0-0","1-1",12,6,12,1,3,5,0,0,2,7,11,15,2,9,26,"2-7","Y","N","N",8,0,9
"2678","I1",2023-10-23,"Fiorentina","Empoli",0,2,"A",0,1,"A",1.43,4.89,7.67,"0-1","0-2",19,7,7,3,1,3,0,0,13,3,13,17,2,16,30,"13-3","Y","N","N",4,0,9
"2679","I1",2023-10-27,"Genoa","Salernitana",1,0,"H",1,0,"H",1.76,3.72,5.17,"1-0","1-0",8,4,7,2,3,4,0,0,7,0,11,19,1,7,30,"7-0","N","N","N",7,0,10
"2680","I1",2023-10-28,"Sassuolo","Bologna",1,1,"D",1,1,"D",2.76,3.41,2.69,"1-1","1-1",17,6,9,5,1,4,0,0,6,2,11,10,2,8,21,"6-2","Y","N","N",5,0,10
"2681","I1",2023-10-28,"Lecce","Torino",0,1,"A",0,1,"A",2.8,3.03,2.94,"0-1","0-1",11,6,10,2,3,5,0,0,3,0,17,19,1,3,36,"3-0","N","N","N",8,0,10
"2682","I1",2023-10-28,"Juventus","Verona",1,0,"H",0,0,"D",1.36,5.17,9.54,"0-0","1-0",30,6,7,1,3,2,0,0,5,1,13,8,1,6,21,"5-1","N","N","N",5,0,10
"2683","I1",2023-10-29,"Cagliari","Frosinone",4,3,"H",0,2,"A",2.37,3.42,3.2,"0-2","4-3",24,6,10,6,1,4,0,0,5,7,8,7,7,12,15,"5-7","Y","Y","Y",5,0,10
"2684","I1",2023-10-29,"Monza","Udinese",1,1,"D",1,0,"H",2.14,3.54,3.58,"1-0","1-1",10,4,10,3,2,1,0,0,10,3,15,11,2,13,26,"10-3","Y","N","N",3,0,10
"2685","I1",2023-10-29,"Inter","Roma",1,0,"H",0,0,"D",1.65,4,5.78,"0-0","1-0",19,3,3,1,3,4,0,0,8,0,14,9,1,8,23,"8-0","N","N","N",7,0,10
"2686","I1",2023-10-29,"Napoli","Milan",2,2,"D",0,2,"A",2.3,3.37,3.38,"0-2","2-2",17,4,20,6,4,3,1,0,6,4,14,10,4,10,24,"6-4","Y","Y","Y",7,1,10
"2687","I1",2023-10-30,"Empoli","Atalanta",0,3,"A",0,2,"A",5.03,4.08,1.7,"0-2","0-3",9,2,18,6,4,0,0,0,3,6,10,13,3,9,23,"3-6","Y","Y","N",4,0,10
"2688","I1",2023-10-30,"Lazio","Fiorentina",1,0,"H",0,0,"D",2.31,3.48,3.24,"0-0","1-0",11,4,9,5,3,3,0,0,0,4,12,17,1,4,29,"0-4","N","N","N",6,0,10
"2689","I1",2023-11-03,"Bologna","Lazio",1,0,"H",0,0,"D",2.76,3.17,2.86,"0-0","1-0",6,2,11,1,2,5,0,0,2,6,12,8,1,8,20,"2-6","N","N","N",7,0,11
"2690","I1",2023-11-04,"Salernitana","Napoli",0,2,"A",0,1,"A",7.02,4.99,1.44,"0-1","0-2",10,3,21,8,1,1,0,0,8,9,15,10,2,17,25,"8-9","Y","N","N",2,0,11
"2691","I1",2023-11-04,"Atalanta","Inter",1,2,"A",0,1,"A",3.46,3.47,2.19,"0-1","1-2",14,4,10,4,4,1,1,0,6,1,13,9,3,7,22,"6-1","Y","Y","N",5,1,11
"2692","I1",2023-11-04,"Milan","Udinese",0,1,"A",0,0,"D",1.46,4.66,7.3,"0-0","0-1",14,5,12,2,1,2,0,0,11,5,13,14,1,16,27,"11-5","N","N","N",3,0,11
"2693","I1",2023-11-05,"Verona","Monza",1,3,"A",0,1,"A",3.22,3.29,2.39,"0-1","1-3",16,5,12,6,1,2,0,0,2,6,6,12,4,8,18,"2-6","Y","Y","Y",3,0,11
"2694","I1",2023-11-05,"Cagliari","Genoa",2,1,"H",0,0,"D",2.8,3.18,2.77,"0-0","2-1",12,4,8,2,4,2,0,0,1,1,14,11,3,2,25,"1-1","Y","Y","N",6,0,11
"2695","I1",2023-11-05,"Roma","Lecce",2,1,"H",0,0,"D",1.57,3.99,6.63,"0-0","2-1",15,5,15,4,3,5,0,0,5,2,18,11,3,7,29,"5-2","Y","Y","N",8,0,11
"2696","I1",2023-11-05,"Fiorentina","Juventus",0,1,"A",0,1,"A",2.92,3.3,2.58,"0-1","0-1",25,4,4,3,1,3,0,0,9,2,12,21,1,11,33,"9-2","N","N","N",4,0,11
"2697","I1",2023-11-06,"Frosinone","Empoli",2,1,"H",0,0,"D",2.13,3.58,3.52,"0-0","2-1",17,5,10,2,3,2,0,0,9,2,7,9,3,11,16,"9-2","Y","Y","N",5,0,11
"2698","I1",2023-11-06,"Torino","Sassuolo",2,1,"H",1,1,"D",2.19,3.39,3.54,"1-1","2-1",21,9,5,2,1,1,0,0,9,2,9,6,3,11,15,"9-2","Y","Y","N",2,0,11
"2699","I1",2023-11-10,"Sassuolo","Salernitana",2,2,"D",1,2,"A",1.7,4.17,4.92,"1-2","2-2",29,9,9,2,2,1,0,0,11,0,12,14,4,11,26,"11-0","Y","Y","Y",3,0,12
"2700","I1",2023-11-10,"Genoa","Verona",1,0,"H",1,0,"H",1.93,3.32,4.74,"1-0","1-0",16,6,7,1,1,4,0,0,6,7,9,16,1,13,25,"6-7","N","N","N",5,0,12
"2701","I1",2023-11-11,"Lecce","Milan",2,2,"D",0,2,"A",5.21,3.74,1.74,"0-2","2-2",14,5,10,6,4,6,0,1,3,1,12,16,4,4,28,"3-1","Y","Y","Y",10,1,12
"2702","I1",2023-11-11,"Juventus","Cagliari",2,1,"H",0,0,"D",1.38,5.01,8.82,"0-0","2-1",18,4,11,2,3,1,0,0,12,4,14,8,3,16,22,"12-4","Y","Y","N",4,0,12
"2703","I1",2023-11-11,"Monza","Torino",1,1,"D",0,0,"D",2.51,3.17,3.13,"0-0","1-1",12,5,12,5,2,2,0,0,3,1,11,11,2,4,22,"3-1","Y","N","N",4,0,12
"2704","I1",2023-11-12,"Napoli","Empoli",0,1,"A",0,0,"D",1.22,7.07,11.78,"0-0","0-1",18,7,8,3,1,1,0,0,8,3,11,13,1,11,24,"8-3","N","N","N",2,0,12
"2705","I1",2023-11-12,"Fiorentina","Bologna",2,1,"H",1,1,"D",2.09,3.51,3.69,"1-1","2-1",12,4,11,4,2,2,0,0,0,3,19,15,3,3,34,"0-3","Y","Y","N",4,0,12
"2706","I1",2023-11-12,"Udinese","Atalanta",1,1,"D",1,0,"H",3.8,3.53,2.05,"1-0","1-1",13,4,8,2,2,3,0,0,7,7,13,13,2,14,26,"7-7","Y","N","N",5,0,12
"2707","I1",2023-11-12,"Lazio","Roma",0,0,"D",0,0,"D",3,3.16,2.61,"0-0","0-0",7,2,8,1,3,4,0,0,4,1,12,13,0,5,25,"4-1","N","N","N",7,0,12
"2708","I1",2023-11-12,"Inter","Frosinone",2,0,"H",1,0,"H",1.19,7.86,13.84,"1-0","2-0",21,6,12,3,0,1,0,0,9,4,7,16,2,13,23,"9-4","Y","N","N",1,0,12
"2709","I1",2023-11-25,"Salernitana","Lazio",2,1,"H",0,1,"A",4.82,3.69,1.79,"0-1","2-1",13,6,13,2,5,3,0,0,4,9,11,12,3,13,23,"4-9","Y","Y","N",8,0,13
"2710","I1",2023-11-25,"Atalanta","Napoli",1,2,"A",0,1,"A",2.72,3.42,2.68,"0-1","1-2",16,5,11,4,2,2,0,0,5,4,15,9,3,9,24,"5-4","Y","Y","N",4,0,13
"2711","I1",2023-11-25,"Milan","Fiorentina",1,0,"H",1,0,"H",2.15,3.46,3.59,"1-0","1-0",9,6,20,4,1,2,0,0,3,11,9,10,1,14,19,"3-11","N","N","N",3,0,13
"2712","I1",2023-11-26,"Cagliari","Monza",1,1,"D",1,0,"H",2.9,3.25,2.63,"1-0","1-1",17,6,12,4,1,2,0,0,10,11,10,15,2,21,25,"10-11","Y","N","N",3,0,13
"2713","I1",2023-11-26,"Empoli","Sassuolo",3,4,"A",2,2,"D",2.8,3.6,2.51,"2-2","3-4",11,9,17,9,4,2,0,0,6,5,20,15,7,11,35,"6-5","Y","Y","Y",6,0,13
"2714","I1",2023-11-26,"Frosinone","Genoa",2,1,"H",1,1,"D",2.52,3.2,3.09,"1-1","2-1",9,5,13,3,2,4,0,0,4,2,5,14,3,6,19,"4-2","Y","Y","N",6,0,13
"2715","I1",2023-11-26,"Roma","Udinese",3,1,"H",1,0,"H",1.63,3.89,5.99,"1-0","3-1",12,5,6,2,1,3,0,0,7,1,8,15,4,8,23,"7-1","Y","Y","Y",4,0,13
"2716","I1",2023-11-26,"Juventus","Inter",1,1,"D",1,1,"D",3.5,3.21,2.29,"1-1","1-1",4,1,8,4,2,1,0,0,1,0,12,13,2,1,25,"1-0","Y","N","N",3,0,13
"2717","I1",2023-11-27,"Verona","Lecce",2,2,"D",1,1,"D",2.76,3,2.97,"1-1","2-2",19,11,14,5,1,2,0,0,4,2,15,17,4,6,32,"4-2","Y","Y","Y",3,0,13
"2718","I1",2023-11-27,"Bologna","Torino",2,0,"H",0,0,"D",2.39,3.16,3.34,"0-0","2-0",13,2,9,3,3,4,0,0,3,2,16,15,2,5,31,"3-2","Y","N","N",7,0,13
"2719","I1",2023-12-01,"Monza","Juventus",1,2,"A",0,1,"A",4.12,3.42,2.03,"0-1","1-2",16,1,18,7,1,2,0,0,7,3,12,8,3,10,20,"7-3","Y","Y","N",3,0,14
"2720","I1",2023-12-02,"Genoa","Empoli",1,1,"D",1,0,"H",1.98,3.37,4.28,"1-0","1-1",21,1,9,1,3,1,0,0,5,3,15,19,2,8,34,"5-3","Y","N","N",4,0,14
"2721","I1",2023-12-02,"Lazio","Cagliari",1,0,"H",1,0,"H",1.65,4.02,5.56,"1-0","1-0",10,5,9,2,0,2,0,1,4,3,11,12,1,7,23,"4-3","N","N","N",2,1,14
"2722","I1",2023-12-02,"Milan","Frosinone",3,1,"H",1,0,"H",1.45,4.85,6.94,"1-0","3-1",10,3,15,3,1,1,0,0,6,7,11,6,4,13,17,"6-7","Y","Y","Y",2,0,14
"2723","I1",2023-12-03,"Lecce","Bologna",1,1,"D",0,0,"D",3.16,3.09,2.55,"0-0","1-1",14,4,11,4,3,2,0,0,6,3,12,18,2,9,30,"6-3","Y","N","N",5,0,14
"2724","I1",2023-12-03,"Fiorentina","Salernitana",3,0,"H",2,0,"H",1.45,4.79,7.14,"2-0","3-0",22,9,11,1,1,0,0,0,3,2,13,12,3,5,25,"3-2","Y","Y","N",1,0,14
"2725","I1",2023-12-03,"Udinese","Verona",3,3,"D",2,1,"H",1.72,3.69,5.38,"2-1","3-3",12,6,13,4,2,5,0,0,5,3,16,13,6,8,29,"5-3","Y","Y","Y",7,0,14
"2726","I1",2023-12-03,"Sassuolo","Roma",1,2,"A",1,0,"H",3.91,3.75,1.95,"1-0","1-2",8,2,15,7,4,1,1,0,1,11,10,11,3,12,21,"1-11","Y","Y","N",5,1,14
"2727","I1",2023-12-03,"Napoli","Inter",0,3,"A",0,1,"A",2.95,3.51,2.44,"0-1","0-3",15,4,11,4,2,2,0,0,6,4,2,13,3,10,15,"6-4","Y","Y","N",4,0,14
"2728","I1",2023-12-04,"Torino","Atalanta",3,0,"H",1,0,"H",3.14,3.18,2.5,"1-0","3-0",9,5,10,4,2,2,0,0,4,3,12,14,3,7,26,"4-3","Y","Y","N",4,0,14
"2729","I1",2023-12-08,"Juventus","Napoli",1,0,"H",0,0,"D",2.31,3.32,3.4,"0-0","1-0",11,2,13,1,2,4,0,0,3,6,11,12,1,9,23,"3-6","N","N","N",6,0,15
"2730","I1",2023-12-09,"Verona","Lazio",1,1,"D",0,1,"A",4.04,3.45,2.01,"0-1","1-1",5,1,14,5,2,4,1,0,1,7,16,11,2,8,27,"1-7","Y","N","N",6,1,15
"2731","I1",2023-12-09,"Atalanta","Milan",3,2,"H",1,1,"D",2.61,3.29,2.89,"1-1","3-2",19,7,14,4,1,5,0,1,6,4,11,11,5,10,22,"6-4","Y","Y","Y",6,1,15
"2732","I1",2023-12-09,"Inter","Udinese",4,0,"H",3,0,"H",1.27,6.14,10.46,"3-0","4-0",17,8,11,1,0,1,0,0,6,1,9,6,4,7,15,"6-1","Y","Y","Y",1,0,15
"2733","I1",2023-12-10,"Frosinone","Torino",0,0,"D",0,0,"D",3.53,3.29,2.24,"0-0","0-0",11,5,16,3,3,3,0,0,3,8,13,17,0,11,30,"3-8","N","N","N",6,0,15
"2734","I1",2023-12-10,"Monza","Genoa",1,0,"H",0,0,"D",2.21,3.2,3.72,"0-0","1-0",6,3,16,1,1,2,0,0,2,3,11,13,1,5,24,"2-3","N","N","N",3,0,15
"2735","I1",2023-12-10,"Salernitana","Bologna",1,2,"A",0,2,"A",3.87,3.29,2.12,"0-2","1-2",9,2,10,5,7,2,0,0,5,1,20,15,3,6,35,"5-1","Y","Y","N",9,0,15
"2736","I1",2023-12-10,"Roma","Fiorentina",1,1,"D",1,0,"H",2.16,3.33,3.71,"1-0","1-1",4,1,14,8,5,3,2,1,1,6,14,14,2,7,28,"1-6","Y","N","N",8,3,15
"2737","I1",2023-12-11,"Empoli","Lecce",1,1,"D",0,0,"D",2.57,3.26,2.97,"0-0","1-1",18,6,14,5,2,2,0,0,8,3,14,18,2,11,32,"8-3","Y","N","N",4,0,15
"2738","I1",2023-12-11,"Cagliari","Sassuolo",2,1,"H",0,1,"A",2.35,3.56,3.06,"0-1","2-1",18,6,8,4,1,7,0,1,10,4,15,15,3,14,30,"10-4","Y","Y","N",8,1,15
"2739","I1",2023-12-15,"Genoa","Juventus",1,1,"D",0,1,"A",4.97,3.23,1.93,"0-1","1-1",11,3,11,4,2,3,0,0,6,8,14,12,2,14,26,"6-8","Y","N","N",5,0,16
"2740","I1",2023-12-16,"Lecce","Frosinone",2,1,"H",1,1,"D",2.18,3.39,3.56,"1-1","2-1",18,6,11,5,1,4,0,0,5,4,8,14,3,9,22,"5-4","Y","Y","N",5,0,16
"2741","I1",2023-12-16,"Napoli","Cagliari",2,1,"H",0,0,"D",1.33,5.63,9.17,"0-0","2-1",21,5,9,3,5,3,0,0,5,3,9,10,3,8,19,"5-3","Y","Y","N",8,0,16
"2742","I1",2023-12-16,"Torino","Empoli",1,0,"H",1,0,"H",1.61,3.96,6.07,"1-0","1-0",10,3,7,2,4,2,0,0,6,4,15,10,1,10,25,"6-4","N","N","N",6,0,16
"2743","I1",2023-12-17,"Milan","Monza",3,0,"H",2,0,"H",1.63,4.18,5.41,"2-0","3-0",17,9,21,4,1,2,0,0,4,5,8,8,3,9,16,"4-5","Y","Y","N",3,0,16
"2744","I1",2023-12-17,"Fiorentina","Verona",1,0,"H",0,0,"D",1.43,4.83,7.67,"0-0","1-0",5,3,19,7,3,1,0,0,1,6,11,12,1,7,23,"1-6","N","N","N",4,0,16
"2745","I1",2023-12-17,"Udinese","Sassuolo",2,2,"D",1,0,"H",2.27,3.6,3.17,"1-0","2-2",9,7,21,7,3,1,1,0,1,13,13,6,4,14,19,"1-13","Y","Y","Y",4,1,16
"2746","I1",2023-12-17,"Bologna","Roma",2,0,"H",1,0,"H",2.46,3.05,3.35,"1-0","2-0",8,2,8,3,4,4,0,0,0,4,16,16,2,4,32,"0-4","Y","N","N",8,0,16
"2747","I1",2023-12-17,"Lazio","Inter",0,2,"A",0,1,"A",4.91,3.73,1.78,"0-1","0-2",13,4,12,4,1,2,1,0,8,7,13,15,2,15,28,"8-7","Y","N","N",3,1,16
"2748","I1",2023-12-18,"Atalanta","Salernitana",4,1,"H",0,1,"A",1.3,5.82,9.99,"0-1","4-1",20,11,10,3,1,2,0,0,10,7,9,11,5,17,20,"10-7","Y","Y","Y",3,0,16
"2749","I1",2023-12-22,"Empoli","Lazio",0,2,"A",0,1,"A",4.27,3.46,1.98,"0-1","0-2",21,7,14,7,3,2,0,0,8,9,6,17,2,17,23,"8-9","Y","N","N",5,0,17
"2750","I1",2023-12-22,"Sassuolo","Genoa",1,2,"A",1,0,"H",2.3,3.44,3.3,"1-0","1-2",12,3,14,5,2,1,0,0,3,6,11,9,3,9,20,"3-6","Y","Y","N",3,0,17
"2751","I1",2023-12-22,"Monza","Fiorentina",0,1,"A",0,1,"A",2.96,3.26,2.61,"0-1","0-1",7,2,14,5,3,4,0,0,1,4,12,16,1,5,28,"1-4","N","N","N",7,0,17
"2752","I1",2023-12-22,"Salernitana","Milan",2,2,"D",1,1,"D",7.4,4.98,1.44,"1-1","2-2",19,7,21,9,3,1,1,0,6,6,16,11,4,12,27,"6-6","Y","Y","Y",4,1,17
"2753","I1",2023-12-23,"Frosinone","Juventus",1,2,"A",0,1,"A",5.87,3.76,1.67,"0-1","1-2",10,3,13,3,0,2,0,0,8,8,6,12,3,16,18,"8-8","Y","Y","N",2,0,17
"2754","I1",2023-12-23,"Bologna","Atalanta",1,0,"H",0,0,"D",2.78,3.1,2.85,"0-0","1-0",9,1,12,2,2,4,0,0,2,3,10,14,1,5,24,"2-3","N","N","N",6,0,17
"2755","I1",2023-12-23,"Torino","Udinese",1,1,"D",0,0,"D",1.78,3.57,5.16,"0-0","1-1",14,4,10,4,2,2,0,0,8,2,10,11,2,10,21,"8-2","Y","N","N",4,0,17
"2756","I1",2023-12-23,"Inter","Lecce",2,0,"H",1,0,"H",1.23,6.54,12.85,"1-0","2-0",20,8,11,5,1,3,0,1,16,2,8,14,2,18,22,"16-2","Y","N","N",4,1,17
"2757","I1",2023-12-23,"Verona","Cagliari",2,0,"H",0,0,"D",2.4,3.29,3.2,"0-0","2-0",13,5,12,3,3,4,0,1,11,7,8,19,2,18,27,"11-7","Y","N","N",7,1,17
"2758","I1",2023-12-23,"Roma","Napoli",2,0,"H",0,0,"D",3.05,3.17,2.57,"0-0","2-0",17,4,7,2,7,4,0,2,4,0,19,12,2,4,31,"4-0","Y","N","N",11,2,17
"2759","I1",2023-12-29,"Fiorentina","Torino",1,0,"H",0,0,"D",2.19,3.22,3.74,"0-0","1-0",12,3,6,3,4,2,0,0,4,2,11,15,1,6,26,"4-2","N","N","N",6,0,18
"2760","I1",2023-12-29,"Napoli","Monza",0,0,"D",0,0,"D",1.62,4.18,5.52,"0-0","0-0",25,9,8,3,4,4,0,0,10,1,10,21,0,11,31,"10-1","N","N","N",8,0,18
"2761","I1",2023-12-29,"Genoa","Inter",1,1,"D",1,1,"D",5.92,3.67,1.68,"1-1","1-1",13,4,16,6,2,2,0,0,8,2,13,15,2,10,28,"8-2","Y","N","N",4,0,18
"2762","I1",2023-12-29,"Lazio","Frosinone",3,1,"H",0,0,"D",1.67,3.93,5.5,"0-0","3-1",13,5,11,2,3,2,0,0,6,2,18,15,4,8,33,"6-2","Y","Y","Y",5,0,18
"2763","I1",2023-12-30,"Atalanta","Lecce",1,0,"H",0,0,"D",1.44,4.61,7.93,"0-0","1-0",17,4,15,2,2,2,0,0,5,6,10,16,1,11,26,"5-6","N","N","N",4,0,18
"2764","I1",2023-12-30,"Cagliari","Empoli",0,0,"D",0,0,"D",2.09,3.49,3.7,"0-0","0-0",15,3,5,1,1,3,0,0,8,6,18,18,0,14,36,"8-6","N","N","N",4,0,18
"2765","I1",2023-12-30,"Udinese","Bologna",3,0,"H",1,0,"H",3.64,3.12,2.28,"1-0","3-0",15,7,14,5,2,5,0,0,7,7,15,14,3,14,29,"7-7","Y","Y","N",7,0,18
"2766","I1",2023-12-30,"Milan","Sassuolo",1,0,"H",0,0,"D",1.45,4.99,6.64,"0-0","1-0",20,2,12,6,0,1,0,0,6,5,8,7,1,11,15,"6-5","N","N","N",1,0,18
"2767","I1",2023-12-30,"Verona","Salernitana",0,1,"A",0,0,"D",1.96,3.47,4.22,"0-0","0-1",11,0,9,3,2,2,0,0,7,6,14,13,1,13,27,"7-6","N","N","N",4,0,18
"2768","I1",2023-12-30,"Juventus","Roma",1,0,"H",0,0,"D",2.12,3.1,4.18,"0-0","1-0",13,4,11,2,1,1,0,0,2,2,15,14,1,4,29,"2-2","N","N","N",2,0,18
"2769","I1",2024-01-05,"Bologna","Genoa",1,1,"D",0,1,"A",2.09,3.09,4.29,"0-1","1-1",21,8,3,1,3,3,0,0,11,2,8,10,2,13,18,"11-2","Y","N","N",6,0,19
"2770","I1",2024-01-06,"Inter","Verona",2,1,"H",1,0,"H",1.17,7.94,16.21,"1-0","2-1",15,6,8,3,0,2,0,1,7,0,16,15,3,7,31,"7-0","Y","Y","N",2,1,19
"2771","I1",2024-01-06,"Frosinone","Monza",2,3,"A",0,2,"A",2.71,3.36,2.73,"0-2","2-3",10,5,7,2,3,5,0,0,5,1,11,16,5,6,27,"5-1","Y","Y","Y",8,0,19
"2772","I1",2024-01-06,"Lecce","Cagliari",1,1,"D",1,0,"H",2.24,3.31,3.51,"1-0","1-1",15,2,14,2,1,1,0,0,7,6,20,14,2,13,34,"7-6","Y","N","N",2,0,19
"2773","I1",2024-01-06,"Sassuolo","Fiorentina",1,0,"H",1,0,"H",3.37,3.49,2.22,"1-0","1-0",7,1,9,3,3,2,0,0,1,8,10,14,1,9,24,"1-8","N","N","N",5,0,19
"2774","I1",2024-01-07,"Empoli","Milan",0,3,"A",0,2,"A",5.3,4.13,1.65,"0-2","0-3",17,2,13,6,1,2,0,0,6,6,9,13,3,12,22,"6-6","Y","Y","N",3,0,19
"2775","I1",2024-01-07,"Torino","Napoli",3,0,"H",1,0,"H",2.98,3.19,2.61,"1-0","3-0",10,6,10,3,0,2,0,1,2,5,7,10,3,7,17,"2-5","Y","Y","N",2,1,19
"2776","I1",2024-01-07,"Udinese","Lazio",1,2,"A",0,1,"A",3.62,3.25,2.22,"0-1","1-2",13,2,7,2,5,3,0,0,4,4,16,22,3,8,38,"4-4","Y","Y","N",8,0,19
"2777","I1",2024-01-07,"Salernitana","Juventus",1,2,"A",1,0,"H",8.77,4.78,1.4,"1-0","1-2",8,3,18,3,3,5,1,0,2,8,9,15,3,10,24,"2-8","Y","Y","N",8,1,19
"2778","I1",2024-01-07,"Roma","Atalanta",1,1,"D",1,1,"D",2.42,3.18,3.27,"1-1","1-1",16,6,8,2,1,6,0,0,6,5,14,14,2,11,28,"6-5","Y","N","N",7,0,19
"2779","I1",2024-01-13,"Genoa","Torino",0,0,"D",0,0,"D",3.06,2.95,2.72,"0-0","0-0",11,6,6,0,3,2,0,0,8,4,11,11,0,12,22,"8-4","N","N","N",5,0,20
"2780","I1",2024-01-13,"Napoli","Salernitana",2,1,"H",1,1,"D",1.32,5.65,9.39,"1-1","2-1",20,7,6,2,3,2,0,0,8,3,15,10,3,11,25,"8-3","Y","Y","N",5,0,20
"2781","I1",2024-01-13,"Verona","Empoli",2,1,"H",1,0,"H",2.26,3.2,3.58,"1-0","2-1",12,7,14,1,4,3,1,0,5,9,20,17,3,14,37,"5-9","Y","Y","N",7,1,20
"2782","I1",2024-01-13,"Monza","Inter",1,5,"A",0,2,"A",6.57,4.57,1.5,"0-2","1-5",9,2,20,7,2,2,0,0,4,5,6,12,6,9,18,"4-5","Y","Y","Y",4,0,20
"2783","I1",2024-01-14,"Lazio","Lecce",1,0,"H",0,0,"D",1.68,3.8,5.67,"0-0","1-0",8,2,11,3,4,4,0,0,2,5,14,12,1,7,26,"2-5","N","N","N",8,0,20
"2784","I1",2024-01-14,"Cagliari","Bologna",2,1,"H",1,1,"D",3.12,3.11,2.55,"1-1","2-1",4,2,11,4,3,2,0,0,2,5,12,8,3,7,20,"2-5","Y","Y","N",5,0,20
"2785","I1",2024-01-14,"Fiorentina","Udinese",2,2,"D",0,1,"A",1.67,3.89,5.57,"0-1","2-2",10,3,12,6,1,1,0,0,4,4,14,13,4,8,27,"4-4","Y","Y","Y",2,0,20
"2786","I1",2024-01-14,"Milan","Roma",3,1,"H",1,0,"H",2.19,3.21,3.76,"1-0","3-1",17,5,12,5,2,3,0,0,2,5,12,9,4,7,21,"2-5","Y","Y","Y",5,0,20
"2787","I1",2024-01-15,"Atalanta","Frosinone",5,0,"H",3,0,"H",1.45,4.86,7.03,"3-0","5-0",21,9,8,5,0,1,0,0,8,2,11,8,5,10,19,"8-2","Y","Y","Y",1,0,20
"2788","I2",2023-08-18,"Bari","Palermo",0,0,"D",0,0,"D",2.83,3.12,2.83,"0-0","0-0",11,3,16,2,7,4,2,0,3,5,13,15,0,8,28,"3-5","N","N","N",11,2,1
"2789","I2",2023-08-19,"Cosenza","Ascoli",3,0,"H",1,0,"H",2.84,2.96,2.97,"1-0","3-0",22,6,4,0,1,4,0,3,7,0,11,12,3,7,23,"7-0","Y","Y","N",5,3,1
"2790","I2",2023-08-19,"Cremonese","Catanzaro",0,0,"D",0,0,"D",1.98,3.37,4.41,"0-0","0-0",17,3,6,2,3,1,0,0,6,2,7,18,0,8,25,"6-2","N","N","N",4,0,1
"2791","I2",2023-08-19,"Ternana","Sampdoria",1,2,"A",0,1,"A",3.3,3.55,2.26,"0-1","1-2",14,3,13,6,4,1,0,0,5,4,11,10,3,9,21,"5-4","Y","Y","N",5,0,1
"2792","I2",2023-08-20,"Sudtirol","Spezia",3,3,"D",1,2,"A",3.75,3.07,2.3,"1-2","3-3",10,4,17,5,3,3,0,0,2,1,17,20,6,3,37,"2-1","Y","Y","Y",6,0,1
"2793","I2",2023-08-20,"Cittadella","Reggiana",1,0,"H",1,0,"H",2.15,3.28,3.87,"1-0","1-0",13,3,8,1,3,3,0,0,6,2,20,17,1,8,37,"6-2","N","N","N",6,0,1
"2794","I2",2023-08-20,"Parma","FeralpiSalo",2,0,"H",1,0,"H",1.54,4.06,7.38,"1-0","2-0",15,4,13,2,1,4,0,0,7,7,11,11,2,14,22,"7-7","Y","N","N",5,0,1
"2795","I2",2023-08-20,"Venezia","Como",3,0,"H",2,0,"H",2.1,3.41,3.87,"2-0","3-0",18,6,12,3,0,0,0,0,9,3,17,9,3,12,26,"9-3","Y","Y","N",0,0,1
"2796","I2",2023-08-25,"Sampdoria","Pisa",0,2,"A",0,1,"A",1.97,3.35,4.47,"0-1","0-2",12,2,8,3,1,4,0,0,5,3,16,16,2,8,32,"5-3","Y","N","N",5,0,1
"2797","I2",2023-08-26,"Venezia","Cosenza",1,1,"D",0,1,"A",1.78,3.64,5.16,"0-1","1-1",20,4,4,1,1,1,0,0,8,2,6,9,2,10,15,"8-2","Y","N","N",2,0,1
"2798","I2",2023-08-26,"Como","Reggiana",2,2,"D",1,0,"H",2.09,3.46,3.82,"1-0","2-2",10,4,12,5,3,2,0,0,3,4,18,14,4,7,32,"3-4","Y","Y","Y",5,0,2
"2799","I2",2023-08-26,"Cremonese","Bari",0,1,"A",0,1,"A",2.04,3.41,4.08,"0-1","0-1",25,5,7,1,1,3,0,0,5,4,9,10,1,9,19,"5-4","N","N","N",4,0,2
"2800","I2",2023-08-26,"FeralpiSalo","Sudtirol",0,2,"A",0,1,"A",2.71,3.07,3,"0-1","0-2",7,1,9,4,2,3,0,0,6,1,16,12,2,7,28,"6-1","Y","N","N",5,0,2
"2801","I2",2023-08-26,"Modena","Ascoli",1,0,"H",0,0,"D",1.95,3.25,4.78,"0-0","1-0",13,3,8,5,1,1,0,1,9,1,12,17,1,10,29,"9-1","N","N","N",2,1,2
"2802","I2",2023-08-26,"Parma","Cittadella",2,0,"H",1,0,"H",1.89,3.42,4.77,"1-0","2-0",10,3,19,0,1,2,0,0,2,11,16,14,2,13,30,"2-11","Y","N","N",3,0,2
"2803","I2",2023-08-27,"Catanzaro","Ternana",2,1,"H",1,1,"D",2.31,3.34,3.38,"1-1","2-1",15,5,25,7,1,2,0,0,4,7,16,9,3,11,25,"4-7","Y","Y","N",3,0,2
"2804","I2",2023-08-29,"Ascoli","FeralpiSalo",3,0,"H",2,0,"H",1.95,3.53,4.28,"2-0","3-0",19,5,5,4,0,3,0,0,7,3,12,14,3,10,26,"7-3","Y","Y","N",3,0,2
"2805","I2",2023-08-29,"Cosenza","Modena",1,2,"A",1,1,"D",2.55,3.24,3.06,"1-1","1-2",12,2,10,5,4,2,0,0,6,4,12,10,3,10,22,"6-4","Y","Y","N",6,0,2
"2806","I2",2023-08-29,"Pisa","Parma",1,2,"A",0,1,"A",2.6,2.98,3.25,"0-1","1-2",16,2,9,2,1,3,1,1,7,4,11,15,3,11,26,"7-4","Y","Y","N",4,2,2
"2807","I2",2023-08-29,"Reggiana","Palermo",1,3,"A",0,1,"A",3.22,3.29,2.42,"0-1","1-3",15,2,18,9,3,0,1,0,7,3,18,9,4,10,27,"7-3","Y","Y","Y",3,1,2
"2808","I2",2023-08-30,"Bari","Cittadella",1,1,"D",1,0,"H",2.37,3.13,3.51,"1-0","1-1",14,4,17,5,1,1,0,0,1,8,12,12,2,9,24,"1-8","Y","N","N",2,0,3
"2809","I2",2023-08-30,"Catanzaro","Spezia",3,0,"H",0,0,"D",3.09,3.4,2.44,"0-0","3-0",10,5,8,2,2,3,1,0,6,5,21,14,3,11,35,"6-5","Y","Y","N",5,1,3
"2810","I2",2023-08-30,"Sampdoria","Venezia",1,2,"A",0,0,"D",2.21,3.55,3.39,"0-0","1-2",17,5,13,5,5,0,0,0,7,4,7,10,3,11,17,"7-4","Y","Y","N",5,0,3
"2811","I2",2023-08-30,"Ternana","Cremonese",0,1,"A",0,0,"D",3.36,3.28,2.35,"0-0","0-1",10,4,17,4,2,3,0,1,8,5,10,8,1,13,18,"8-5","N","N","N",5,1,3
"2812","I2",2023-09-02,"Modena","Pisa",2,0,"H",1,0,"H",2.53,2.95,3.41,"1-0","2-0",14,4,6,2,2,2,0,1,7,7,10,13,2,14,23,"7-7","Y","N","N",4,1,3
"2813","I2",2023-09-02,"Palermo","FeralpiSalo",3,0,"H",1,0,"H",1.67,3.91,5.68,"1-0","3-0",16,6,8,0,1,1,0,0,5,6,8,14,3,11,22,"5-6","Y","Y","N",2,0,3
"2814","I2",2023-09-02,"Parma","Reggiana",0,0,"D",0,0,"D",1.7,3.77,5.59,"0-0","0-0",18,4,8,1,2,2,0,0,6,2,7,15,0,8,22,"6-2","N","N","N",4,0,3
"2815","I2",2023-09-02,"Sudtirol","Ascoli",3,1,"H",0,1,"A",2.33,2.9,3.95,"0-1","3-1",7,4,14,4,2,4,0,0,0,8,11,16,4,8,27,"0-8","Y","Y","Y",6,0,3
"2816","I2",2023-09-03,"Brescia","Cosenza",1,0,"H",0,0,"D",2.17,3.28,3.8,"0-0","1-0",7,1,13,1,4,2,0,1,5,7,18,18,1,12,36,"5-7","N","N","N",6,1,3
"2817","I2",2023-09-03,"Cremonese","Sampdoria",1,1,"D",1,0,"H",2.07,3.43,3.88,"1-0","1-1",19,11,8,4,2,4,0,0,3,2,12,14,2,5,26,"3-2","Y","N","N",6,0,3
"2818","I2",2023-09-03,"Lecco","Catanzaro",3,4,"A",0,1,"A",NA,NA,NA,"0-1","3-4",17,7,20,8,2,1,0,0,3,6,10,7,7,9,17,"3-6","Y","Y","Y",3,0,4
"2819","I2",2023-09-03,"Spezia","Como",0,1,"A",0,1,"A",1.81,3.42,5.44,"0-1","0-1",9,1,12,5,5,4,0,0,6,6,19,14,1,12,33,"6-6","N","N","N",9,0,4
"2820","I2",2023-09-03,"Ternana","Bari",0,0,"D",0,0,"D",2.76,3.1,2.92,"0-0","0-0",13,2,10,1,3,2,0,0,3,3,14,16,0,6,30,"3-3","N","N","N",5,0,4
"2821","I2",2023-09-03,"Cittadella","Venezia",0,0,"D",0,0,"D",2.57,3.15,3.12,"0-0","0-0",8,4,10,3,3,2,0,0,5,5,13,12,0,10,25,"5-5","N","N","N",5,0,4
"2822","I2",2023-09-15,"Venezia","Spezia",1,0,"H",0,0,"D",2.2,3.51,3.48,"0-0","1-0",9,3,23,7,2,3,0,0,3,5,17,15,1,8,32,"3-5","N","N","N",5,0,4
"2823","I2",2023-09-16,"Ascoli","Palermo",0,1,"A",0,0,"D",3.56,3.3,2.25,"0-0","0-1",16,1,11,4,0,2,0,0,8,10,21,7,1,18,28,"8-10","N","N","N",2,0,4
"2824","I2",2023-09-16,"Cosenza","Sudtirol",2,2,"D",1,0,"H",2.33,3.08,3.66,"1-0","2-2",12,5,6,2,4,1,0,0,5,2,10,13,4,7,23,"5-2","Y","Y","Y",5,0,4
"2825","I2",2023-09-16,"FeralpiSalo","Modena",1,1,"D",1,1,"D",3.59,3.28,2.25,"1-1","1-1",10,1,17,6,4,4,1,0,4,7,15,7,2,11,22,"4-7","Y","N","N",8,1,4
"2826","I2",2023-09-16,"Lecco","Brescia",0,2,"A",0,1,"A",2.91,3.23,2.67,"0-1","0-2",24,7,11,5,3,2,0,0,7,5,16,19,2,12,35,"7-5","Y","N","N",5,0,4
"2827","I2",2023-09-16,"Pisa","Bari",1,1,"D",1,0,"H",2.17,3.23,3.87,"1-0","1-1",7,1,10,3,4,2,1,0,3,5,10,17,2,8,27,"3-5","Y","N","N",6,1,4
"2828","I2",2023-09-16,"Reggiana","Cremonese",2,2,"D",2,0,"H",3.35,3.22,2.39,"2-0","2-2",7,5,37,8,0,1,0,0,0,14,10,5,4,14,15,"0-14","Y","Y","Y",1,0,5
"2829","I2",2023-09-17,"Catanzaro","Parma",0,5,"A",0,3,"A",2.25,3.39,3.47,"0-3","0-5",12,2,10,7,1,4,0,0,8,3,13,5,5,11,18,"8-3","Y","Y","Y",5,0,5
"2830","I2",2023-09-17,"Como","Ternana",2,1,"H",0,0,"D",2.1,3.45,3.76,"0-0","2-1",19,5,10,4,2,2,0,0,1,3,13,16,3,4,29,"1-3","Y","Y","N",4,0,5
"2831","I2",2023-09-18,"Sampdoria","Cittadella",1,2,"A",1,0,"H",2.33,3.33,3.29,"1-0","1-2",12,5,11,6,3,3,0,0,2,4,22,13,3,6,35,"2-4","Y","Y","N",6,0,5
"2832","I2",2023-09-22,"Palermo","Cosenza",0,1,"A",0,0,"D",1.77,3.6,5.36,"0-0","0-1",19,6,14,4,1,3,0,0,4,2,11,11,1,6,22,"4-2","N","N","N",4,0,5
"2833","I2",2023-09-23,"Brescia","Venezia",0,0,"D",0,0,"D",3.31,3.1,2.48,"0-0","0-0",11,3,15,0,3,2,0,0,3,8,12,7,0,11,19,"3-8","N","N","N",5,0,5
"2834","I2",2023-09-23,"Cremonese","Ascoli",2,2,"D",1,1,"D",1.7,3.82,5.54,"1-1","2-2",13,4,17,8,3,4,1,1,6,5,16,11,4,11,27,"6-5","Y","Y","Y",7,2,5
"2835","I2",2023-09-23,"FeralpiSalo","Pisa",0,1,"A",0,0,"D",3.29,3.16,2.46,"0-0","0-1",12,3,16,4,3,4,0,0,4,4,19,11,1,8,30,"4-4","N","N","N",7,0,5
"2836","I2",2023-09-23,"Modena","Lecco",0,0,"D",0,0,"D",1.6,3.86,6.89,"0-0","0-0",17,5,14,4,3,1,0,0,8,8,15,7,0,16,22,"8-8","N","N","N",4,0,5
"2837","I2",2023-09-23,"Ternana","Sudtirol",1,1,"D",1,0,"H",2.19,3.22,3.83,"1-0","1-1",10,3,10,3,3,1,0,0,5,7,10,17,2,12,27,"5-7","Y","N","N",4,0,5
"2838","I2",2023-09-23,"Spezia","Reggiana",1,2,"A",0,0,"D",1.93,3.56,4.38,"0-0","1-2",15,3,11,4,3,5,0,0,7,5,13,16,3,12,29,"7-5","Y","Y","N",8,0,6
"2839","I2",2023-09-24,"Bari","Catanzaro",2,2,"D",1,2,"A",2.45,3.14,3.32,"1-2","2-2",12,4,11,5,1,4,0,1,2,4,13,17,4,6,30,"2-4","Y","Y","Y",5,1,6
"2840","I2",2023-09-24,"Cittadella","Como",0,3,"A",0,2,"A",2.12,3.31,3.95,"0-2","0-3",12,3,9,4,1,2,0,0,5,2,21,13,3,7,34,"5-2","Y","Y","N",3,0,6
"2841","I2",2023-09-24,"Parma","Sampdoria",1,1,"D",0,1,"A",2.15,3.45,3.66,"0-1","1-1",12,7,8,3,3,5,0,0,9,1,11,15,2,10,26,"9-1","Y","N","N",8,0,6
"2842","I2",2023-09-26,"Cosenza","Cremonese",1,2,"A",0,0,"D",3.31,3.24,2.4,"0-0","1-2",9,4,20,4,2,1,0,0,4,7,9,15,3,11,24,"4-7","Y","Y","N",3,0,6
"2843","I2",2023-09-26,"Lecco","FeralpiSalo",1,2,"A",0,0,"D",2.56,3.12,3.17,"0-0","1-2",13,3,12,4,2,3,0,0,4,1,10,13,3,5,23,"4-1","Y","Y","N",5,0,6
"2844","I2",2023-09-26,"Ascoli","Ternana",2,0,"H",1,0,"H",2.4,3.22,3.34,"1-0","2-0",13,5,17,3,2,3,0,0,2,8,20,13,2,10,33,"2-8","Y","N","N",5,0,6
"2845","I2",2023-09-26,"Reggiana","Pisa",0,0,"D",0,0,"D",2.61,3.13,3.08,"0-0","0-0",13,2,12,5,4,4,0,0,3,2,16,12,0,5,28,"3-2","N","N","N",8,0,6
"2846","I2",2023-09-26,"Spezia","Brescia",0,0,"D",0,0,"D",1.84,3.68,4.65,"0-0","0-0",12,5,11,3,1,2,0,0,7,5,8,16,0,12,24,"7-5","N","N","N",3,0,6
"2847","I2",2023-09-26,"Sudtirol","Modena",0,0,"D",0,0,"D",3.11,2.83,2.83,"0-0","0-0",7,1,25,2,1,2,0,0,5,3,13,6,0,8,19,"5-3","N","N","N",3,0,6
"2848","I2",2023-09-26,"Venezia","Palermo",1,3,"A",1,1,"D",2.49,3.27,3.13,"1-1","1-3",17,1,7,4,1,2,0,0,8,1,10,10,4,9,20,"8-1","Y","Y","Y",3,0,7
"2849","I2",2023-09-27,"Catanzaro","Cittadella",1,1,"D",1,1,"D",2.34,3.13,3.54,"1-1","1-1",14,8,10,3,0,3,0,0,5,2,12,14,2,7,26,"5-2","Y","N","N",3,0,7
"2850","I2",2023-09-27,"Como","Sampdoria",1,0,"H",0,0,"D",2.43,3.4,3.1,"0-0","1-0",8,4,13,5,2,5,0,0,2,5,17,15,1,7,32,"2-5","N","N","N",7,0,7
"2851","I2",2023-09-27,"Parma","Bari",2,1,"H",1,0,"H",1.94,3.45,4.44,"1-0","2-1",12,5,14,4,1,3,0,0,5,3,16,12,3,8,28,"5-3","Y","Y","N",4,0,7
"2852","I2",2023-09-30,"Brescia","Ascoli",1,1,"D",0,1,"A",2.23,3.28,3.63,"0-1","1-1",21,3,9,3,2,3,0,0,7,2,13,11,2,9,24,"7-2","Y","N","N",5,0,7
"2853","I2",2023-09-30,"FeralpiSalo","Spezia",1,2,"A",0,2,"A",3.53,3.27,2.28,"0-2","1-2",9,3,13,5,1,6,0,0,2,5,16,17,3,7,33,"2-5","Y","Y","N",7,0,7
"2854","I2",2023-09-30,"Modena","Venezia",1,3,"A",0,0,"D",2.53,3.32,3.02,"0-0","1-3",14,4,9,4,2,2,0,0,7,3,9,5,4,10,14,"7-3","Y","Y","Y",4,0,7
"2855","I2",2023-09-30,"Pisa","Cosenza",1,2,"A",0,1,"A",1.88,3.63,4.45,"0-1","1-2",8,6,15,5,3,6,1,0,2,3,13,13,3,5,26,"2-3","Y","Y","N",9,1,7
"2856","I2",2023-09-30,"Ternana","Reggiana",3,0,"H",2,0,"H",2.17,3.37,3.7,"2-0","3-0",13,7,10,3,6,3,0,0,3,2,13,9,3,5,22,"3-2","Y","Y","N",9,0,7
"2857","I2",2023-10-01,"Bari","Como",1,1,"D",0,0,"D",2.44,3.2,3.28,"0-0","1-1",18,5,9,6,3,4,0,1,6,4,18,16,2,10,34,"6-4","Y","N","N",7,1,7
"2858","I2",2023-10-01,"Cittadella","Lecco",2,1,"H",0,1,"A",1.66,4.02,5.52,"0-1","2-1",15,5,16,6,4,4,0,0,4,5,26,10,3,9,36,"4-5","Y","Y","N",8,0,8
"2859","I2",2023-10-01,"Palermo","Sudtirol",2,1,"H",0,1,"A",1.64,3.91,5.96,"0-1","2-1",24,6,8,2,5,3,0,0,13,1,15,17,3,14,32,"13-1","Y","Y","N",8,0,8
"2860","I2",2023-10-01,"Sampdoria","Catanzaro",1,2,"A",1,2,"A",2.19,3.55,3.46,"1-2","1-2",17,6,4,3,1,4,0,0,11,2,12,23,3,13,35,"11-2","Y","Y","N",5,0,8
"2861","I2",2023-10-01,"Cremonese","Parma",1,2,"A",0,0,"D",2.19,3.4,3.61,"0-0","1-2",15,3,9,3,1,1,0,0,2,4,12,13,3,6,25,"2-4","Y","Y","N",2,0,8
"2862","I2",2023-10-06,"Brescia","FeralpiSalo",1,1,"D",0,1,"A",1.93,3.32,4.76,"0-1","1-1",19,4,16,6,2,3,0,0,2,5,13,11,2,7,24,"2-5","Y","N","N",5,0,8
"2863","I2",2023-10-07,"Cosenza","Lecco",3,0,"H",2,0,"H",1.8,3.44,5.42,"2-0","3-0",22,8,15,6,2,3,0,0,4,3,11,7,3,7,18,"4-3","Y","Y","N",5,0,8
"2864","I2",2023-10-07,"Modena","Palermo",0,2,"A",0,0,"D",2.64,3.07,3.09,"0-0","0-2",11,2,11,4,2,3,1,0,7,2,11,11,2,9,22,"7-2","Y","N","N",5,1,8
"2865","I2",2023-10-07,"Reggiana","Bari",1,1,"D",1,1,"D",2.75,3.15,2.89,"1-1","1-1",14,3,10,2,2,1,0,0,6,9,11,18,2,15,29,"6-9","Y","N","N",3,0,8
"2866","I2",2023-10-07,"Sudtirol","Catanzaro",0,1,"A",0,1,"A",2.64,2.99,3.18,"0-1","0-1",9,3,13,6,1,3,0,0,4,4,11,10,1,8,21,"4-4","N","N","N",4,0,8
"2867","I2",2023-10-07,"Ascoli","Sampdoria",1,1,"D",1,0,"H",2.64,3.24,2.95,"1-0","1-1",14,4,12,4,2,4,0,0,6,1,20,14,2,7,34,"6-1","Y","N","N",6,0,8
"2868","I2",2023-10-07,"Cittadella","Ternana",2,2,"D",2,1,"H",2.27,3.27,3.56,"2-1","2-2",12,4,17,5,2,1,0,0,3,4,10,11,4,7,21,"3-4","Y","Y","Y",3,0,9
"2869","I2",2023-10-07,"Venezia","Parma",3,2,"H",0,0,"D",2.55,3.35,2.97,"0-0","3-2",12,5,15,4,0,2,0,0,5,8,5,8,5,13,13,"5-8","Y","Y","Y",2,0,9
"2870","I2",2023-10-08,"Como","Cremonese",1,3,"A",0,2,"A",2.82,3.26,2.73,"0-2","1-3",16,5,10,3,0,3,0,1,10,6,7,12,4,16,19,"10-6","Y","Y","Y",3,1,9
"2871","I2",2023-10-08,"Spezia","Pisa",0,0,"D",0,0,"D",1.92,3.32,4.84,"0-0","0-0",20,6,10,3,3,2,1,0,6,3,11,12,0,9,23,"6-3","N","N","N",5,1,9
"2872","I2",2023-10-20,"Parma","Como",2,1,"H",1,0,"H",1.99,3.42,4.28,"1-0","2-1",14,4,18,6,2,2,0,0,3,4,11,10,3,7,21,"3-4","Y","Y","N",4,0,9
"2873","I2",2023-10-21,"Bari","Modena",1,1,"D",0,0,"D",2.3,3.19,3.58,"0-0","1-1",11,3,10,4,3,5,0,0,8,4,26,11,2,12,37,"8-4","Y","N","N",8,0,9
"2874","I2",2023-10-21,"Cremonese","Sudtirol",0,1,"A",0,0,"D",1.67,3.8,5.89,"0-0","0-1",20,6,9,4,3,2,0,0,11,8,11,8,1,19,19,"11-8","N","N","N",5,0,9
"2875","I2",2023-10-21,"Lecco","Ascoli",0,2,"A",0,1,"A",2.7,3.41,2.75,"0-1","0-2",12,4,14,5,3,2,0,0,5,2,15,14,2,7,29,"5-2","Y","N","N",5,0,9
"2876","I2",2023-10-21,"Pisa","Cittadella",2,1,"H",1,0,"H",2.29,2.94,3.28,"1-0","2-1",13,6,15,4,3,3,0,0,6,7,14,14,3,13,28,"6-7","Y","Y","N",6,0,9
"2877","I2",2023-10-21,"Ternana","Brescia",0,1,"A",0,0,"D",2.45,3.24,3.21,"0-0","0-1",9,0,14,5,3,1,1,0,4,4,7,9,1,8,16,"4-4","N","N","N",4,1,9
"2878","I2",2023-10-21,"Catanzaro","FeralpiSalo",3,0,"H",0,0,"D",1.64,4.17,5.48,"0-0","3-0",11,6,7,2,3,2,0,0,5,4,13,11,3,9,24,"5-4","Y","Y","N",5,0,10
"2879","I2",2023-10-22,"Sampdoria","Cosenza",2,0,"H",0,0,"D",2.07,3.45,3.93,"0-0","2-0",17,5,14,5,3,5,0,0,4,4,15,16,2,8,31,"4-4","Y","N","N",8,0,10
"2880","I2",2023-10-22,"Reggiana","Venezia",1,0,"H",0,0,"D",2.9,3.37,2.59,"0-0","1-0",11,2,15,5,3,5,0,1,5,9,13,15,1,14,28,"5-9","N","N","N",8,1,10
"2881","I2",2023-10-23,"Palermo","Spezia",2,2,"D",0,1,"A",2.02,3.36,3.39,"0-1","2-2",16,7,10,5,3,6,0,1,4,5,14,12,4,9,26,"4-5","Y","Y","Y",9,1,10
"2882","I2",2023-10-24,"Brescia","Modena",0,1,"A",0,0,"D",2.79,3.08,2.91,"0-0","0-1",6,0,14,3,3,3,0,0,2,7,13,20,1,9,33,"2-7","N","N","N",6,0,10
"2883","I2",2023-10-24,"Pisa","Lecco",1,2,"A",0,1,"A",1.67,3.78,5.95,"0-1","1-2",24,4,10,2,3,4,0,0,8,1,11,13,3,9,24,"8-1","Y","Y","N",7,0,10
"2884","I2",2023-10-27,"Cittadella","Cremonese",1,2,"A",0,0,"D",3.35,3.3,2.35,"0-0","1-2",8,3,20,4,4,1,0,0,4,8,15,13,3,12,28,"4-8","Y","Y","N",5,0,10
"2885","I2",2023-10-28,"Como","Catanzaro",1,0,"H",1,0,"H",2.26,3.34,3.49,"1-0","1-0",15,2,9,4,4,0,0,0,4,4,6,21,1,8,27,"4-4","N","N","N",4,0,10
"2886","I2",2023-10-28,"FeralpiSalo","Reggiana",0,3,"A",0,2,"A",2.58,3.04,3.22,"0-2","0-3",19,4,9,9,2,1,0,0,6,3,15,14,3,9,29,"6-3","Y","Y","N",3,0,10
"2887","I2",2023-10-28,"Spezia","Cosenza",0,0,"D",0,0,"D",1.96,3.49,4.32,"0-0","0-0",19,5,13,3,3,5,0,0,8,4,11,14,0,12,25,"8-4","N","N","N",8,0,10
"2888","I2",2023-10-28,"Sudtirol","Sampdoria",3,1,"H",0,0,"D",2.74,3.26,2.81,"0-0","3-1",9,3,16,4,3,3,0,0,2,9,15,14,4,11,29,"2-9","Y","Y","Y",6,0,11
"2889","I2",2023-10-28,"Ascoli","Parma",1,3,"A",1,2,"A",3.6,3.13,2.32,"1-2","1-3",13,4,9,4,7,2,1,0,9,8,12,12,4,17,24,"9-8","Y","Y","Y",9,1,11
"2890","I2",2023-10-29,"Brescia","Bari",1,2,"A",1,0,"H",2.94,3.05,2.78,"1-0","1-2",16,3,19,6,3,3,0,0,2,5,16,21,3,7,37,"2-5","Y","Y","N",6,0,11
"2891","I2",2023-10-29,"Modena","Ternana",2,1,"H",1,0,"H",2.07,3.48,3.87,"1-0","2-1",19,5,13,3,3,2,0,0,5,5,13,9,3,10,22,"5-5","Y","Y","N",5,0,11
"2892","I2",2023-10-29,"Palermo","Lecco",1,2,"A",0,2,"A",1.47,4.72,7.28,"0-2","1-2",26,9,12,7,2,2,0,0,6,5,10,15,3,11,25,"6-5","Y","Y","N",4,0,11
"2893","I2",2023-10-29,"Venezia","Pisa",2,1,"H",1,1,"D",2.18,3.27,3.78,"1-1","2-1",13,3,8,3,2,4,0,0,6,4,8,11,3,10,19,"6-4","Y","Y","N",6,0,11
"2894","I2",2023-11-04,"Bari","Ascoli",1,0,"H",0,0,"D",2.04,3.18,4.45,"0-0","1-0",18,3,7,3,3,4,0,0,10,7,15,17,1,17,32,"10-7","N","N","N",7,0,11
"2895","I2",2023-11-04,"Catanzaro","Modena",1,2,"A",1,1,"D",2.35,3.46,3.19,"1-1","1-2",10,5,9,4,2,4,0,0,2,2,27,13,3,4,40,"2-2","Y","Y","N",6,0,11
"2896","I2",2023-11-04,"Cittadella","Brescia",3,2,"H",2,1,"H",2.59,2.99,3.26,"2-1","3-2",16,5,16,4,2,3,0,0,5,4,12,14,5,9,26,"5-4","Y","Y","Y",5,0,11
"2897","I2",2023-11-04,"Cosenza","FeralpiSalo",1,1,"D",1,0,"H",1.85,3.57,4.74,"1-0","1-1",8,3,19,5,2,4,0,0,6,8,12,13,2,14,25,"6-8","Y","N","N",6,0,11
"2898","I2",2023-11-04,"Pisa","Como",1,1,"D",0,1,"A",2.28,3.26,3.54,"0-1","1-1",15,4,12,2,3,3,0,0,4,6,11,10,2,10,21,"4-6","Y","N","N",6,0,12
"2899","I2",2023-11-04,"Ternana","Venezia",0,1,"A",0,0,"D",2.73,3.19,2.67,"0-0","0-1",11,2,8,2,1,2,0,0,4,4,14,8,1,8,22,"4-4","N","N","N",3,0,12
"2900","I2",2023-11-04,"Sampdoria","Palermo",1,0,"H",1,0,"H",3.01,3.33,2.53,"1-0","1-0",16,6,9,4,4,1,0,0,2,8,16,17,1,10,33,"2-8","N","N","N",5,0,12
"2901","I2",2023-11-05,"Cremonese","Spezia",3,0,"H",2,0,"H",2.04,3.48,4,"2-0","3-0",21,12,17,5,3,1,0,1,5,7,10,15,3,12,25,"5-7","Y","Y","N",4,1,12
"2902","I2",2023-11-05,"Parma","Sudtirol",2,0,"H",1,0,"H",1.64,3.9,6.05,"1-0","2-0",10,3,10,2,0,5,0,0,4,3,13,14,2,7,27,"4-3","Y","N","N",5,0,12
"2903","I2",2023-11-05,"Reggiana","Lecco",1,1,"D",1,0,"H",1.81,3.76,4.71,"1-0","1-1",16,6,16,4,4,3,0,0,2,7,15,10,2,9,25,"2-7","Y","N","N",7,0,12
"2904","I2",2023-11-08,"Lecco","Spezia",0,0,"D",0,0,"D",3.85,3.56,2.05,"0-0","0-0",20,4,17,4,3,6,0,0,5,2,17,14,0,7,31,"5-2","N","N","N",9,0,12
"2905","I2",2023-11-08,"Palermo","Brescia",1,0,"H",1,0,"H",1.69,3.87,5.56,"1-0","1-0",9,3,18,4,3,4,0,0,2,4,19,8,1,6,27,"2-4","N","N","N",7,0,12
"2906","I2",2023-11-10,"Venezia","Catanzaro",2,1,"H",2,1,"H",2.06,3.4,4.02,"2-1","2-1",10,5,6,2,2,1,1,0,1,3,8,17,3,4,25,"1-3","Y","Y","N",3,1,12
"2907","I2",2023-11-11,"Ascoli","Como",0,1,"A",0,1,"A",3.04,3.01,2.73,"0-1","0-1",8,4,9,3,3,5,0,0,3,3,19,19,1,6,38,"3-3","N","N","N",8,0,12
"2908","I2",2023-11-11,"Cosenza","Reggiana",2,0,"H",1,0,"H",2.16,3.35,3.75,"1-0","2-0",12,5,6,2,4,3,0,0,3,2,16,9,2,5,25,"3-2","Y","N","N",7,0,13
"2909","I2",2023-11-11,"FeralpiSalo","Bari",3,3,"D",0,1,"A",3.5,3.07,2.4,"0-1","3-3",11,5,15,5,4,5,0,0,1,3,19,18,6,4,37,"1-3","Y","Y","Y",9,0,13
"2910","I2",2023-11-11,"Sudtirol","Pisa",1,2,"A",0,1,"A",2.73,2.95,3.11,"0-1","1-2",10,2,8,5,2,6,0,0,3,0,20,15,3,3,35,"3-0","Y","Y","N",8,0,13
"2911","I2",2023-11-11,"Modena","Sampdoria",0,2,"A",0,1,"A",2.15,3.16,4.04,"0-1","0-2",8,2,14,4,5,3,1,0,5,2,13,13,2,7,26,"5-2","Y","N","N",8,1,13
"2912","I2",2023-11-12,"Brescia","Cremonese",0,3,"A",0,2,"A",3.79,3.39,2.11,"0-2","0-3",15,1,25,5,3,3,0,0,4,9,11,13,3,13,24,"4-9","Y","Y","N",6,0,13
"2913","I2",2023-11-12,"Lecco","Parma",3,2,"H",2,1,"H",4.54,3.9,1.81,"2-1","3-2",16,7,12,7,3,4,0,1,5,3,10,13,5,8,23,"5-3","Y","Y","Y",7,1,13
"2914","I2",2023-11-12,"Palermo","Cittadella",0,1,"A",0,0,"D",1.73,3.92,5.06,"0-0","0-1",10,0,15,3,1,4,0,0,2,4,15,11,1,6,26,"2-4","N","N","N",5,0,13
"2915","I2",2023-11-12,"Spezia","Ternana",2,2,"D",1,1,"D",1.85,3.61,4.62,"1-1","2-2",22,9,13,5,2,3,0,0,4,5,19,16,4,9,35,"4-5","Y","Y","Y",5,0,13
"2916","I2",2023-11-24,"Sampdoria","Spezia",2,1,"H",1,1,"D",2.31,3.29,3.44,"1-1","2-1",14,4,9,2,5,4,0,0,2,6,19,19,3,8,38,"2-6","Y","Y","N",9,0,13
"2917","I2",2023-11-25,"Bari","Venezia",0,3,"A",0,1,"A",2.63,3.01,2.92,"0-1","0-3",17,4,13,6,3,0,0,0,8,2,7,14,3,10,21,"8-2","Y","Y","N",3,0,13
"2918","I2",2023-11-25,"Cittadella","Sudtirol",2,1,"H",1,0,"H",1.94,3.14,4.44,"1-0","2-1",14,6,5,2,3,5,0,0,5,2,14,13,3,7,27,"5-2","Y","Y","N",8,0,14
"2919","I2",2023-11-25,"Como","FeralpiSalo",2,1,"H",1,0,"H",1.65,3.77,5.24,"1-0","2-1",14,7,11,3,2,2,1,1,3,5,8,12,3,8,20,"3-5","Y","Y","N",4,2,14
"2920","I2",2023-11-25,"Cremonese","Lecco",1,0,"H",1,0,"H",1.38,4.85,7.42,"1-0","1-0",16,2,11,3,4,2,0,0,6,7,11,19,1,13,30,"6-7","N","N","N",6,0,14
"2921","I2",2023-11-25,"Parma","Modena",1,1,"D",0,0,"D",2.03,3.26,3.87,"0-0","1-1",18,7,6,1,3,2,1,0,10,5,9,16,2,15,25,"10-5","Y","N","N",5,1,14
"2922","I2",2023-11-25,"Reggiana","Ascoli",1,1,"D",0,1,"A",2.32,3.13,3.3,"0-1","1-1",18,3,6,3,2,4,0,0,9,5,11,11,2,14,22,"9-5","Y","N","N",6,0,14
"2923","I2",2023-11-25,"Pisa","Brescia",1,1,"D",1,1,"D",2.08,3.08,4,"1-1","1-1",12,2,18,7,2,2,0,0,3,6,9,8,2,9,17,"3-6","Y","N","N",4,0,14
"2924","I2",2023-11-26,"Catanzaro","Cosenza",2,0,"H",1,0,"H",1.88,3.43,4.19,"1-0","2-0",12,3,14,4,3,4,0,0,6,8,21,16,2,14,37,"6-8","Y","N","N",7,0,14
"2925","I2",2023-11-26,"Ternana","Palermo",1,1,"D",0,1,"A",3.19,3.26,2.28,"0-1","1-1",16,4,16,5,3,2,1,0,7,8,8,10,2,15,18,"7-8","Y","N","N",5,1,14
"2926","I2",2023-11-28,"Como","Lecco",0,0,"D",0,0,"D",1.69,3.97,5.35,"0-0","0-0",16,3,11,4,2,3,0,0,3,2,11,14,0,5,25,"3-2","N","N","N",5,0,14
"2927","I2",2023-11-28,"Sudtirol","Brescia",1,1,"D",1,0,"H",2.55,2.91,3.44,"1-0","1-1",10,4,8,3,1,4,0,1,5,5,18,15,2,10,33,"5-5","Y","N","N",5,1,14
"2928","I2",2023-12-01,"Palermo","Catanzaro",1,2,"A",0,1,"A",1.98,3.44,4.27,"0-1","1-2",14,8,17,7,4,5,0,0,8,4,9,19,3,12,28,"8-4","Y","Y","N",9,0,15
"2929","I2",2023-12-02,"Cosenza","Ternana",1,3,"A",0,0,"D",2.19,3.44,3.55,"0-0","1-3",18,6,16,7,2,4,1,0,11,4,14,9,4,15,23,"11-4","Y","Y","Y",6,1,15
"2930","I2",2023-12-02,"FeralpiSalo","Cittadella",0,1,"A",0,1,"A",3.22,3.09,2.54,"0-1","0-1",14,4,9,5,2,2,0,0,6,2,18,11,1,8,29,"6-2","N","N","N",4,0,15
"2931","I2",2023-12-02,"Modena","Reggiana",2,1,"H",1,0,"H",1.9,3.64,4.38,"1-0","2-1",12,7,8,3,2,4,0,1,6,6,17,20,3,12,37,"6-6","Y","Y","N",6,1,15
"2932","I2",2023-12-02,"Pisa","Cremonese",0,0,"D",0,0,"D",3.54,3.43,2.2,"0-0","0-0",15,4,10,2,3,4,0,0,5,4,16,9,0,9,25,"5-4","N","N","N",7,0,15
"2933","I2",2023-12-02,"Venezia","Ascoli",3,1,"H",2,0,"H",1.83,3.59,4.92,"2-0","3-1",23,6,17,4,1,3,0,0,6,4,13,12,4,10,25,"6-4","Y","Y","Y",4,0,15
"2934","I2",2023-12-02,"Spezia","Parma",0,1,"A",0,0,"D",2.62,3.35,2.87,"0-0","0-1",6,1,13,6,1,2,0,0,3,7,15,6,1,10,21,"3-7","N","N","N",3,0,15
"2935","I2",2023-12-03,"Brescia","Sampdoria",3,1,"H",3,0,"H",2.94,3.17,2.69,"3-0","3-1",13,4,9,3,4,3,0,0,4,7,15,19,4,11,34,"4-7","Y","Y","Y",7,0,15
"2936","I2",2023-12-03,"Lecco","Bari",1,0,"H",0,0,"D",2.99,3.44,2.48,"0-0","1-0",10,5,13,1,5,3,0,0,3,4,12,13,1,7,25,"3-4","N","N","N",8,0,15
"2937","I2",2023-12-03,"Sudtirol","Como",0,1,"A",0,0,"D",3.26,3.05,2.55,"0-0","0-1",8,1,16,4,1,3,0,0,6,2,8,17,1,8,25,"6-2","N","N","N",4,0,15
"2938","I2",2023-12-09,"Ascoli","Spezia",1,2,"A",0,1,"A",3.11,3.14,2.58,"0-1","1-2",12,4,7,5,3,3,0,0,7,3,12,17,3,10,29,"7-3","Y","Y","N",6,0,16
"2939","I2",2023-12-09,"Bari","Sudtirol",2,1,"H",1,1,"D",1.93,3.19,5.02,"1-1","2-1",17,3,10,5,3,4,0,1,10,5,16,11,3,15,27,"10-5","Y","Y","N",7,1,16
"2940","I2",2023-12-09,"Cittadella","Cosenza",2,0,"H",2,0,"H",2.11,3.26,4.03,"2-0","2-0",13,3,11,5,3,5,0,0,3,1,16,15,2,4,31,"3-1","Y","N","N",8,0,16
"2941","I2",2023-12-09,"Cremonese","Venezia",1,0,"H",0,0,"D",1.89,3.47,4.13,"0-0","1-0",9,2,13,4,4,2,1,0,3,6,12,13,1,9,25,"3-6","N","N","N",6,1,16
"2942","I2",2023-12-09,"Sampdoria","Lecco",2,0,"H",1,0,"H",1.78,3.68,5.11,"1-0","2-0",20,5,13,5,5,3,0,0,4,10,15,12,2,14,27,"4-10","Y","N","N",8,0,16
"2943","I2",2023-12-09,"Ternana","FeralpiSalo",2,1,"H",1,0,"H",1.92,3.56,4.39,"1-0","2-1",16,4,16,2,2,3,0,0,7,3,9,12,3,10,21,"7-3","Y","Y","N",5,0,16
"2944","I2",2023-12-09,"Catanzaro","Pisa",2,0,"H",0,0,"D",2.34,3.25,3.42,"0-0","2-0",8,5,14,5,3,2,0,0,2,6,10,6,2,8,16,"2-6","Y","N","N",5,0,16
"2945","I2",2023-12-10,"Como","Modena",2,1,"H",1,0,"H",2.19,3.22,3.47,"1-0","2-1",7,4,22,7,1,4,1,0,2,7,12,10,3,9,22,"2-7","Y","Y","N",5,1,16
"2946","I2",2023-12-10,"Parma","Palermo",3,3,"D",0,2,"A",2.15,3.48,3.63,"0-2","3-3",24,7,8,3,4,3,0,0,10,1,16,13,6,11,29,"10-1","Y","Y","Y",7,0,16
"2947","I2",2023-12-10,"Reggiana","Brescia",1,1,"D",0,0,"D",2.32,3.12,3.3,"0-0","1-1",8,2,12,4,5,4,1,0,0,5,13,15,2,5,28,"0-5","Y","N","N",9,1,16
"2948","I2",2023-12-15,"Spezia","Bari",1,0,"H",0,0,"D",2.1,3.16,4.22,"0-0","1-0",18,2,12,4,5,4,1,0,10,7,14,15,1,17,29,"10-7","N","N","N",9,1,17
"2949","I2",2023-12-16,"Brescia","Como",2,0,"H",0,0,"D",2.61,2.96,3.27,"0-0","2-0",11,5,21,5,2,2,0,0,2,5,13,14,2,7,27,"2-5","Y","N","N",4,0,17
"2950","I2",2023-12-16,"FeralpiSalo","Cremonese",1,0,"H",1,0,"H",5.38,4.08,1.67,"1-0","1-0",7,4,18,6,0,4,0,0,1,6,10,12,1,7,22,"1-6","N","N","N",4,0,17
"2951","I2",2023-12-16,"Modena","Cittadella",1,1,"D",1,1,"D",2.11,3.18,4.16,"1-1","1-1",9,2,11,4,2,4,0,0,5,6,21,17,2,11,38,"5-6","Y","N","N",6,0,17
"2952","I2",2023-12-16,"Reggiana","Sampdoria",1,2,"A",0,1,"A",2.93,3.12,2.74,"0-1","1-2",8,3,14,6,4,4,0,1,3,7,16,15,3,10,31,"3-7","Y","Y","N",8,1,17
"2953","I2",2023-12-16,"Venezia","Sudtirol",2,3,"A",2,1,"H",1.68,3.69,5.98,"2-1","2-3",9,3,10,3,3,3,1,0,6,2,9,12,5,8,21,"6-2","Y","Y","Y",6,1,17
"2954","I2",2023-12-16,"Ascoli","Catanzaro",1,0,"H",1,0,"H",2.84,3.12,2.82,"1-0","1-0",10,5,6,2,6,5,0,0,3,2,15,19,1,5,34,"3-2","N","N","N",11,0,17
"2955","I2",2023-12-16,"Cosenza","Parma",0,0,"D",0,0,"D",3.94,3.56,2.02,"0-0","0-0",13,1,11,2,6,4,0,1,5,4,7,18,0,9,25,"5-4","N","N","N",10,1,17
"2956","I2",2023-12-16,"Palermo","Pisa",3,2,"H",2,0,"H",1.89,3.46,4.73,"2-0","3-2",17,7,15,7,4,1,0,1,2,9,10,10,5,11,20,"2-9","Y","Y","Y",5,1,17
"2957","I2",2023-12-17,"Lecco","Ternana",2,3,"A",2,0,"H",2.52,3.38,2.99,"2-0","2-3",20,7,13,5,0,4,0,1,5,1,12,8,5,6,20,"5-1","Y","Y","Y",4,1,17
"2958","I2",2023-12-23,"Cittadella","Spezia",4,1,"H",1,0,"H",2.47,3.03,3.42,"1-0","4-1",24,7,16,5,2,4,0,0,7,3,12,13,5,10,25,"7-3","Y","Y","Y",6,0,18
"2959","I2",2023-12-23,"Como","Palermo",3,3,"D",0,1,"A",2.32,3.29,3.42,"0-1","3-3",12,8,12,6,4,2,0,1,4,6,13,10,6,10,23,"4-6","Y","Y","Y",6,1,18
"2960","I2",2023-12-23,"Cremonese","Modena",4,0,"H",4,0,"H",1.84,3.65,4.7,"4-0","4-0",15,7,8,4,2,1,0,0,1,4,18,13,4,5,31,"1-4","Y","Y","Y",3,0,18
"2961","I2",2023-12-23,"Parma","Ternana",3,1,"H",1,1,"D",1.64,4.08,5.68,"1-1","3-1",21,8,12,2,0,3,0,0,5,8,10,7,4,13,17,"5-8","Y","Y","Y",3,0,18
"2962","I2",2023-12-23,"Venezia","Lecco",2,2,"D",0,1,"A",1.64,4.13,5.65,"0-1","2-2",10,5,6,2,2,3,0,1,3,1,12,12,4,4,24,"3-1","Y","Y","Y",5,1,18
"2963","I2",2023-12-23,"Catanzaro","Brescia",2,3,"A",2,0,"H",2.26,3.18,3.69,"2-0","2-3",10,5,8,6,1,3,0,0,6,3,17,11,5,9,28,"6-3","Y","Y","Y",4,0,18
"2964","I2",2023-12-23,"Bari","Cosenza",0,0,"D",0,0,"D",2.22,3.08,3.95,"0-0","0-0",16,4,14,2,5,4,0,1,7,7,15,19,0,14,34,"7-7","N","N","N",9,1,18
"2965","I2",2023-12-23,"Pisa","Ascoli",1,0,"H",1,0,"H",2.02,3.19,4.05,"1-0","1-0",6,2,10,1,5,3,0,0,3,1,13,10,1,4,23,"3-1","N","N","N",8,0,18
"2966","I2",2023-12-23,"Sampdoria","FeralpiSalo",2,3,"A",1,2,"A",1.63,3.97,6.04,"1-2","2-3",15,5,21,7,1,5,1,0,3,5,17,9,5,8,26,"3-5","Y","Y","Y",6,1,18
"2967","I2",2023-12-23,"Sudtirol","Reggiana",2,3,"A",1,1,"D",2.51,2.97,3.43,"1-1","2-3",13,4,7,4,3,3,0,1,0,1,16,14,5,1,30,"0-1","Y","Y","Y",6,1,18
"2968","I2",2023-12-26,"Reggiana","Catanzaro",1,0,"H",1,0,"H",2.93,3.09,2.76,"1-0","1-0",8,2,7,4,2,5,0,0,2,5,20,8,1,7,28,"2-5","N","N","N",7,0,19
"2969","I2",2023-12-26,"Ascoli","Cittadella",0,0,"D",0,0,"D",2.88,3.01,2.88,"0-0","0-0",12,5,11,3,3,4,0,0,6,2,17,16,0,8,33,"6-2","N","N","N",7,0,19
"2970","I2",2023-12-26,"Brescia","Parma",0,2,"A",0,2,"A",3.45,3.24,2.33,"0-2","0-2",8,0,10,6,5,4,0,0,2,6,13,12,2,8,25,"2-6","Y","N","N",9,0,19
"2971","I2",2023-12-26,"Cosenza","Como",1,2,"A",1,1,"D",2.82,3.13,2.83,"1-1","1-2",4,2,10,6,3,2,0,0,6,3,16,17,3,9,33,"6-3","Y","Y","N",5,0,19
"2972","I2",2023-12-26,"FeralpiSalo","Venezia",2,2,"D",1,1,"D",4.17,3.5,1.99,"1-1","2-2",8,3,11,4,2,2,0,0,3,4,12,13,4,7,25,"3-4","Y","Y","Y",4,0,19
"2973","I2",2023-12-26,"Lecco","Sudtirol",2,1,"H",0,0,"D",2.52,3.13,3.21,"0-0","2-1",10,4,12,5,5,3,0,0,1,2,18,16,3,3,34,"1-2","Y","Y","N",8,0,19
"2974","I2",2023-12-26,"Spezia","Modena",1,1,"D",0,0,"D",2.38,3.23,3.35,"0-0","1-1",19,2,12,6,2,3,0,0,6,4,15,12,2,10,27,"6-4","Y","N","N",5,0,19
"2975","I2",2023-12-26,"Ternana","Pisa",1,1,"D",0,1,"A",2.54,3.33,3,"0-1","1-1",12,7,14,2,5,3,0,0,4,10,7,15,2,14,22,"4-10","Y","N","N",8,0,19
"2976","I2",2023-12-26,"Palermo","Cremonese",3,2,"H",1,2,"A",2.62,3.49,2.79,"1-2","3-2",11,6,17,5,2,2,0,0,6,4,17,5,5,10,22,"6-4","Y","Y","Y",4,0,19
"2977","I2",2023-12-26,"Sampdoria","Bari",1,1,"D",0,0,"D",2.22,3.18,3.81,"0-0","1-1",23,4,11,2,1,5,0,1,5,2,12,20,2,7,32,"5-2","Y","N","N",6,1,19
"2978","I2",2024-01-12,"Catanzaro","Lecco",5,3,"H",1,2,"A",1.86,3.46,4.92,"1-2","5-3",20,9,14,4,3,2,0,0,9,4,13,12,8,13,25,"9-4","Y","Y","Y",5,0,20
"2979","I2",2024-01-13,"Bari","Ternana",3,1,"H",2,0,"H",2.29,3.22,3.57,"2-0","3-1",16,6,11,1,1,3,0,0,5,6,15,9,4,11,24,"5-6","Y","Y","Y",4,0,20
"2980","I2",2024-01-13,"Cittadella","Palermo",2,0,"H",1,0,"H",2.44,3.15,3.34,"1-0","2-0",16,6,8,3,1,2,0,1,2,4,10,17,2,6,27,"2-4","Y","N","N",3,1,20
"2981","I2",2024-01-13,"Como","Spezia",4,0,"H",2,0,"H",2,3.46,4.19,"2-0","4-0",26,8,13,4,1,1,0,0,5,6,9,21,4,11,30,"5-6","Y","Y","Y",2,0,20
"2982","I2",2024-01-13,"Modena","Brescia",1,2,"A",0,2,"A",2.1,3.13,4.29,"0-2","1-2",14,2,11,5,4,5,0,0,10,5,18,13,3,15,31,"10-5","Y","Y","N",9,0,20
"2983","I2",2024-01-13,"Sudtirol","FeralpiSalo",1,0,"H",0,0,"D",2.32,3.07,3.7,"0-0","1-0",13,2,17,5,2,3,0,0,6,6,12,11,1,12,23,"6-6","N","N","N",5,0,20
"2984","I2",2024-01-13,"Pisa","Reggiana",2,2,"D",1,2,"A",2.05,3.09,4.6,"1-2","2-2",17,8,7,2,7,2,0,0,6,3,14,19,4,9,33,"6-3","Y","Y","Y",9,0,20
"2985","I2",2024-01-14,"Cremonese","Cosenza",1,0,"H",0,0,"D",1.63,3.98,6.02,"0-0","1-0",12,6,7,4,3,5,0,0,11,2,7,14,1,13,21,"11-2","N","N","N",8,0,20
"2986","I2",2024-01-14,"Parma","Ascoli",1,1,"D",0,0,"D",1.69,3.77,5.72,"0-0","1-1",19,5,9,3,2,4,0,1,3,1,16,14,2,4,30,"3-1","Y","N","N",6,1,20
"2987","I2",2024-01-14,"Venezia","Sampdoria",5,3,"H",2,1,"H",2.14,3.35,3.58,"2-1","5-3",17,8,7,3,3,4,0,1,1,2,15,11,8,3,26,"1-2","Y","Y","Y",7,1,20
"3141","N1",2023-08-11,"Volendam","Vitesse",1,2,"A",1,0,"H",3.47,3.88,2.07,"1-0","1-2",4,4,13,9,3,1,1,0,3,7,12,10,3,10,22,"3-7","Y","Y","N",4,1,1
"3142","N1",2023-08-12,"PSV Eindhoven","Utrecht",2,0,"H",1,0,"H",1.37,5.75,7.93,"1-0","2-0",23,8,7,1,2,1,0,0,4,2,15,14,2,6,29,"4-2","Y","N","N",3,0,1
"3143","N1",2023-08-12,"Heerenveen","Waalwijk",3,1,"H",3,0,"H",1.78,4.1,4.46,"3-0","3-1",19,9,13,5,0,1,0,0,7,2,9,8,4,9,17,"7-2","Y","Y","Y",1,0,1
"3144","N1",2023-08-12,"Ajax","Heracles",4,1,"H",1,1,"D",1.19,8.58,12.96,"1-1","4-1",31,13,7,2,2,5,0,0,13,4,11,14,5,17,25,"13-4","Y","Y","Y",7,0,1
"3145","N1",2023-08-12,"Zwolle","Sparta Rotterdam",1,2,"A",0,1,"A",2.51,3.51,2.91,"0-1","1-2",20,7,9,4,2,4,0,0,7,1,8,15,3,8,23,"7-1","Y","Y","N",6,0,1
"3146","N1",2023-08-13,"Nijmegen","Excelsior",3,4,"A",2,1,"H",1.53,4.76,6,"2-1","3-4",8,6,6,6,1,2,0,0,2,7,4,10,7,9,14,"2-7","Y","Y","Y",3,0,1
"3147","N1",2023-08-13,"AZ Alkmaar","Go Ahead Eagles",5,1,"H",2,0,"H",1.35,5.34,9.01,"2-0","5-1",13,8,9,4,2,3,0,0,5,4,8,13,6,9,21,"5-4","Y","Y","Y",5,0,1
"3148","N1",2023-08-13,"Feyenoord","For Sittard",0,0,"D",0,0,"D",1.17,8.25,16.82,"0-0","0-0",22,6,14,5,0,6,1,0,8,3,4,21,0,11,25,"8-3","N","N","N",6,1,1
"3149","N1",2023-08-13,"Almere City","Twente",1,4,"A",0,0,"D",5.67,4.35,1.6,"0-0","1-4",12,4,20,8,4,0,1,0,2,11,15,10,5,13,25,"2-11","Y","Y","Y",4,1,1
"3150","N1",2023-08-18,"Heracles","Nijmegen",2,1,"H",0,1,"A",2.5,3.68,2.81,"0-1","2-1",16,7,17,4,2,2,0,0,5,9,10,10,3,14,20,"5-9","Y","Y","N",4,0,2
"3151","N1",2023-08-19,"Excelsior","Ajax",2,2,"D",1,1,"D",10.04,6.56,1.27,"1-1","2-2",13,2,15,8,0,0,0,0,4,10,7,7,4,14,14,"4-10","Y","Y","Y",0,0,2
"3152","N1",2023-08-19,"Vitesse","PSV Eindhoven",1,3,"A",1,0,"H",5.98,4.62,1.54,"1-0","1-3",12,2,19,7,0,1,0,0,4,7,7,2,4,11,9,"4-7","Y","Y","Y",1,0,2
"3153","N1",2023-08-19,"For Sittard","Almere City",2,1,"H",2,1,"H",1.97,3.97,3.72,"2-1","2-1",21,7,8,5,3,2,0,0,5,6,8,13,3,11,21,"5-6","Y","Y","N",5,0,2
"3154","N1",2023-08-19,"Go Ahead Eagles","Volendam",4,1,"H",3,0,"H",1.65,4.48,4.94,"3-0","4-1",8,6,19,5,1,3,1,0,4,12,3,8,5,16,11,"4-12","Y","Y","Y",4,1,2
"3155","N1",2023-08-20,"Utrecht","Heerenveen",0,2,"A",0,0,"D",1.83,3.83,4.47,"0-0","0-2",12,6,12,6,0,1,0,0,9,2,11,10,2,11,21,"9-2","Y","N","N",1,0,2
"3156","N1",2023-08-20,"Sparta Rotterdam","Feyenoord",2,2,"D",1,0,"H",5.17,4.61,1.61,"1-0","2-2",10,5,24,8,2,0,0,0,3,12,9,5,4,15,14,"3-12","Y","Y","Y",2,0,2
"3157","N1",2023-08-20,"Twente","Zwolle",3,1,"H",1,1,"D",1.36,5.61,8.29,"1-1","3-1",18,3,9,4,2,5,0,0,8,3,6,15,4,11,21,"8-3","Y","Y","Y",7,0,2
"3158","N1",2023-08-20,"Waalwijk","AZ Alkmaar",1,3,"A",1,0,"H",5.06,4.39,1.65,"1-0","1-3",7,5,15,7,2,1,0,0,1,10,9,12,4,11,21,"1-10","Y","Y","Y",3,0,2
"3159","N1",2023-08-26,"Nijmegen","Waalwijk",3,0,"H",1,0,"H",1.79,4.3,4.19,"1-0","3-0",13,10,10,1,1,2,0,0,2,4,10,9,3,6,19,"2-4","Y","Y","N",3,0,3
"3160","N1",2023-08-26,"Excelsior","For Sittard",2,2,"D",1,0,"H",2.46,3.75,2.82,"1-0","2-2",9,6,13,5,1,1,0,0,0,6,5,9,4,6,14,"0-6","Y","Y","Y",2,0,3
"3161","N1",2023-08-27,"Zwolle","Utrecht",1,0,"H",0,0,"D",2.86,3.83,2.4,"0-0","1-0",9,2,10,1,2,3,0,0,2,8,13,8,1,10,21,"2-8","N","N","N",5,0,3
"3162","N1",2023-08-27,"Feyenoord","Almere City",6,1,"H",3,0,"H",1.16,9.16,16.46,"3-0","6-1",31,18,6,1,0,1,0,0,8,2,8,15,7,10,23,"8-2","Y","Y","Y",1,0,3
"3163","N1",2023-08-27,"Heerenveen","Sparta Rotterdam",1,3,"A",0,1,"A",2.35,3.79,2.95,"0-1","1-3",19,6,16,7,0,0,1,0,6,7,4,8,4,13,12,"6-7","Y","Y","Y",0,1,3
"3164","N1",2023-09-01,"Sparta Rotterdam","Nijmegen",1,1,"D",0,0,"D",1.9,3.83,4.11,"0-0","1-1",15,6,13,6,1,4,0,0,10,1,11,10,2,11,21,"10-1","Y","N","N",5,0,3
"3165","N1",2023-09-02,"Almere City","Zwolle",1,2,"A",0,1,"A",3.26,3.66,2.23,"0-1","1-2",10,3,13,6,3,4,0,1,7,4,12,10,3,11,22,"7-4","Y","Y","N",7,1,3
"3166","N1",2023-09-02,"Go Ahead Eagles","Heerenveen",3,2,"H",2,1,"H",2.21,3.76,3.24,"2-1","3-2",21,7,13,3,3,0,0,1,9,8,10,9,5,17,19,"9-8","Y","Y","Y",3,1,3
"3167","N1",2023-09-02,"Waalwijk","PSV Eindhoven",0,4,"A",0,1,"A",8.33,5.63,1.36,"0-1","0-4",10,3,22,9,0,0,0,0,4,8,1,13,4,12,14,"4-8","Y","Y","Y",0,0,3
"3168","N1",2023-09-02,"Heracles","Excelsior",3,1,"H",0,1,"A",1.84,3.92,4.34,"0-1","3-1",15,5,9,3,1,4,0,1,8,1,6,11,4,9,17,"8-1","Y","Y","Y",5,1,4
"3169","N1",2023-09-03,"Utrecht","Feyenoord",1,5,"A",1,2,"A",4.89,4.55,1.65,"1-2","1-5",5,1,21,11,1,0,0,0,5,8,13,13,6,13,26,"5-8","Y","Y","Y",1,0,4
"3170","N1",2023-09-03,"For Sittard","Ajax",0,0,"D",0,0,"D",7.39,5.51,1.4,"0-0","0-0",12,4,12,4,3,2,0,0,3,7,20,7,0,10,27,"3-7","N","N","N",5,0,4
"3171","N1",2023-09-03,"Volendam","Twente",0,2,"A",0,1,"A",5.22,4.57,1.61,"0-1","0-2",7,2,12,4,1,2,0,0,1,5,10,7,2,6,17,"1-5","Y","N","N",3,0,4
"3172","N1",2023-09-03,"Vitesse","AZ Alkmaar",0,2,"A",0,0,"D",3.62,3.83,2.04,"0-0","0-2",4,2,16,7,3,0,0,0,0,9,12,10,2,9,22,"0-9","Y","N","N",3,0,4
"3173","N1",2023-09-16,"Feyenoord","Heerenveen",6,1,"H",3,1,"H",1.24,6.83,12.31,"3-1","6-1",21,9,7,1,1,0,0,0,6,3,8,9,7,9,17,"6-3","Y","Y","Y",1,0,4
"3174","N1",2023-09-16,"Vitesse","Waalwijk",0,2,"A",0,1,"A",1.53,4.75,5.99,"0-1","0-2",16,2,18,9,1,5,1,0,8,6,9,9,2,14,18,"8-6","Y","N","N",6,1,4
"3175","N1",2023-09-16,"For Sittard","Volendam",3,1,"H",0,1,"A",1.66,4.4,4.99,"0-1","3-1",27,11,7,2,1,0,0,0,15,3,9,6,4,18,15,"15-3","Y","Y","Y",1,0,4
"3176","N1",2023-09-16,"PSV Eindhoven","Nijmegen",4,0,"H",2,0,"H",1.17,8.54,15.69,"2-0","4-0",28,11,3,0,1,2,0,0,8,3,11,11,4,11,22,"8-3","Y","Y","Y",3,0,4
"3177","N1",2023-09-16,"Heracles","Utrecht",1,3,"A",0,2,"A",2.56,3.62,2.78,"0-2","1-3",11,1,11,7,3,3,0,0,4,4,12,13,4,8,25,"4-4","Y","Y","Y",6,0,5
"3178","N1",2023-09-17,"Zwolle","Go Ahead Eagles",1,1,"D",0,0,"D",2.45,3.59,2.93,"0-0","1-1",27,11,9,2,1,4,0,1,11,4,9,6,2,15,15,"11-4","Y","N","N",5,1,5
"3179","N1",2023-09-17,"Excelsior","Almere City",0,0,"D",0,0,"D",2.1,4.05,3.23,"0-0","0-0",14,2,16,3,2,3,0,0,4,5,7,13,0,9,20,"4-5","N","N","N",5,0,5
"3180","N1",2023-09-17,"Twente","Ajax",3,1,"H",2,1,"H",2.58,3.72,2.7,"2-1","3-1",24,9,11,2,1,2,0,0,5,9,13,9,4,14,22,"5-9","Y","Y","Y",3,0,5
"3181","N1",2023-09-17,"AZ Alkmaar","Sparta Rotterdam",2,0,"H",2,0,"H",1.53,4.6,6.13,"2-0","2-0",18,7,10,3,0,3,0,0,9,4,8,5,2,13,13,"9-4","Y","N","N",3,0,5
"3182","N1",2023-09-22,"Go Ahead Eagles","For Sittard",3,0,"H",1,0,"H",2.26,3.7,3.17,"1-0","3-0",20,9,21,2,0,4,0,0,2,5,2,14,3,7,16,"2-5","Y","Y","N",4,0,5
"3183","N1",2023-09-23,"Volendam","Heracles",2,2,"D",0,0,"D",2.86,3.81,2.4,"0-0","2-2",16,6,15,5,1,1,0,0,5,7,14,14,4,12,28,"5-7","Y","Y","Y",2,0,5
"3184","N1",2023-09-23,"Nijmegen","Utrecht",3,0,"H",2,0,"H",2.67,3.67,2.63,"2-0","3-0",9,5,17,4,1,2,0,0,4,4,8,11,3,8,19,"4-4","Y","Y","N",3,0,5
"3185","N1",2023-09-23,"Almere City","PSV Eindhoven",0,4,"A",0,2,"A",13.47,7.38,1.21,"0-2","0-4",9,2,20,9,1,1,0,0,5,8,15,6,4,13,21,"5-8","Y","Y","Y",2,0,5
"3186","N1",2023-09-23,"Heerenveen","Excelsior",0,3,"A",0,2,"A",1.67,4.45,4.82,"0-2","0-3",9,2,7,4,4,2,0,0,3,2,10,11,3,5,21,"3-2","Y","Y","N",6,0,6
"3187","N1",2023-09-24,"Sparta Rotterdam","Vitesse",1,0,"H",1,0,"H",1.91,3.91,3.99,"1-0","1-0",17,5,6,0,1,2,0,0,5,3,13,19,1,8,32,"5-3","N","N","N",3,0,6
"3188","N1",2023-09-24,"Waalwijk","Twente",1,0,"H",0,0,"D",5.91,4.58,1.55,"0-0","1-0",9,3,7,2,1,1,0,0,1,6,12,13,1,7,25,"1-6","N","N","N",2,0,6
"3189","N1",2023-09-24,"Zwolle","AZ Alkmaar",0,3,"A",0,1,"A",4.78,3.99,1.75,"0-1","0-3",7,3,15,5,3,3,0,0,2,6,13,8,3,8,21,"2-6","Y","Y","N",6,0,6
"3190","N1",2023-09-27,"Ajax","Feyenoord",0,4,"A",0,3,"A",2.85,3.86,2.39,"0-3","0-4",9,2,14,7,3,2,0,0,4,0,15,14,4,4,29,"4-0","Y","Y","Y",5,0,6
"3191","N1",2023-09-27,"PSV Eindhoven","Go Ahead Eagles",3,0,"H",1,0,"H",1.17,8.61,14.81,"1-0","3-0",23,11,9,2,0,2,0,0,9,2,10,7,3,11,17,"9-2","Y","Y","N",2,0,6
"3192","N1",2023-09-27,"Twente","Vitesse",1,0,"H",1,0,"H",1.4,5.13,8.1,"1-0","1-0",18,5,10,3,1,4,0,0,5,2,10,15,1,7,25,"5-2","N","N","N",5,0,6
"3193","N1",2023-09-28,"AZ Alkmaar","Heracles",1,1,"D",1,0,"H",1.27,6.44,10.66,"1-0","1-1",21,7,4,2,1,2,0,0,16,0,9,8,2,16,17,"16-0","Y","N","N",3,0,6
"3194","N1",2023-09-30,"Feyenoord","Go Ahead Eagles",3,1,"H",1,0,"H",1.16,9.16,15.85,"1-0","3-1",29,9,7,3,1,2,0,0,11,0,10,11,4,11,21,"11-0","Y","Y","Y",3,0,6
"3195","N1",2023-09-30,"PSV Eindhoven","Volendam",3,1,"H",1,0,"H",1.07,16,31.33,"1-0","3-1",38,17,2,1,1,2,0,1,7,0,11,8,4,7,19,"7-0","Y","Y","Y",3,1,7
"3196","N1",2023-09-30,"Utrecht","Almere City",0,2,"A",0,0,"D",1.56,4.65,5.78,"0-0","0-2",11,2,17,5,4,4,1,0,4,6,18,15,2,10,33,"4-6","Y","N","N",8,1,7
"3197","N1",2023-09-30,"Twente","Heerenveen",1,0,"H",0,0,"D",1.36,5.75,8.23,"0-0","1-0",11,3,5,1,3,1,0,0,8,1,10,12,1,9,22,"8-1","N","N","N",4,0,7
"3198","N1",2023-10-01,"Nijmegen","Vitesse",1,3,"A",1,1,"D",2.19,3.82,3.23,"1-1","1-3",9,5,10,5,2,5,0,0,6,5,9,18,4,11,27,"6-5","Y","Y","Y",7,0,7
"3199","N1",2023-10-01,"Excelsior","Sparta Rotterdam",2,1,"H",0,0,"D",3.59,3.59,2.12,"0-0","2-1",15,7,9,5,4,1,0,0,2,7,9,12,3,9,21,"2-7","Y","Y","N",5,0,7
"3200","N1",2023-10-01,"Heracles","Zwolle",2,1,"H",0,0,"D",2.29,3.82,3.03,"0-0","2-1",13,6,13,5,1,3,0,0,2,2,8,12,3,4,20,"2-2","Y","Y","N",4,0,7
"3201","N1",2023-10-01,"AZ Alkmaar","For Sittard",4,0,"H",1,0,"H",1.39,5.44,7.8,"1-0","4-0",12,7,8,1,1,3,0,0,1,3,14,12,4,4,26,"1-3","Y","Y","Y",4,0,7
"3202","N1",2023-10-06,"Volendam","Utrecht",1,0,"H",0,0,"D",3.93,4.23,1.85,"0-0","1-0",15,5,7,3,3,2,0,1,6,0,20,11,1,6,31,"6-0","N","N","N",5,1,7
"3203","N1",2023-10-07,"Heerenveen","Nijmegen",1,1,"D",1,1,"D",2.18,3.7,3.34,"1-1","1-1",18,7,9,3,1,0,0,0,7,1,4,12,2,8,16,"7-1","Y","N","N",1,0,7
"3204","N1",2023-10-07,"Almere City","Waalwijk",1,0,"H",1,0,"H",2.37,3.92,2.85,"1-0","1-0",18,6,13,4,1,1,0,0,4,3,12,8,1,7,20,"4-3","N","N","N",2,0,8
"3205","N1",2023-10-07,"Go Ahead Eagles","Heracles",4,0,"H",2,0,"H",1.84,4.12,4.11,"2-0","4-0",22,13,17,8,0,2,0,0,9,5,10,11,4,14,21,"9-5","Y","Y","Y",2,0,8
"3206","N1",2023-10-07,"Vitesse","Excelsior",0,0,"D",0,0,"D",1.78,4.2,4.38,"0-0","0-0",21,7,11,5,2,0,0,0,11,5,9,10,0,16,19,"11-5","N","N","N",2,0,8
"3207","N1",2023-10-08,"Zwolle","Feyenoord",0,2,"A",0,1,"A",9.24,6,1.31,"0-1","0-2",4,1,13,5,1,0,0,0,3,4,11,6,2,7,17,"3-4","Y","N","N",1,0,8
"3208","N1",2023-10-08,"Ajax","AZ Alkmaar",1,2,"A",0,1,"A",2.26,3.98,2.98,"0-1","1-2",6,1,12,4,2,1,0,0,6,4,7,12,3,10,19,"6-4","Y","Y","N",3,0,8
"3209","N1",2023-10-08,"For Sittard","Twente",0,3,"A",0,1,"A",3.95,3.83,1.94,"0-1","0-3",3,1,15,6,2,2,1,0,3,7,13,16,3,10,29,"3-7","Y","Y","N",4,1,8
"3210","N1",2023-10-08,"Sparta Rotterdam","PSV Eindhoven",0,4,"A",0,0,"D",8.72,5.45,1.36,"0-0","0-4",8,3,30,11,3,1,0,0,1,8,12,14,4,9,26,"1-8","Y","Y","Y",4,0,8
"3211","N1",2023-10-21,"PSV Eindhoven","For Sittard",3,1,"H",1,0,"H",1.11,12.4,21.49,"1-0","3-1",18,6,2,1,0,1,0,0,10,1,8,5,4,11,13,"10-1","Y","Y","Y",1,0,8
"3212","N1",2023-10-21,"Waalwijk","Volendam",2,1,"H",1,0,"H",1.72,4.63,4.3,"1-0","2-1",10,4,11,3,3,2,0,0,3,4,6,10,3,7,16,"3-4","Y","Y","N",5,0,8
"3213","N1",2023-10-21,"Nijmegen","Almere City",1,1,"D",0,1,"A",1.89,3.86,4.15,"0-1","1-1",12,4,14,2,2,2,1,0,6,5,11,19,2,11,30,"6-5","Y","N","N",4,1,9
"3214","N1",2023-10-21,"AZ Alkmaar","Heerenveen",3,0,"H",1,0,"H",1.29,6.16,10.42,"1-0","3-0",11,3,9,3,1,1,0,0,6,3,3,10,3,9,13,"6-3","Y","Y","N",2,0,9
"3215","N1",2023-10-21,"Feyenoord","Vitesse",4,0,"H",2,0,"H",1.15,9.03,17.56,"2-0","4-0",23,8,4,1,0,1,0,0,9,2,9,6,4,11,15,"9-2","Y","Y","Y",1,0,9
"3216","N1",2023-10-22,"Utrecht","Ajax",4,3,"H",1,0,"H",3.69,4.1,1.94,"1-0","4-3",14,8,11,6,1,2,0,0,6,5,11,9,7,11,20,"6-5","Y","Y","Y",3,0,9
"3217","N1",2023-10-22,"Excelsior","Zwolle",2,4,"A",1,0,"H",2.45,3.69,2.84,"1-0","2-4",18,6,11,6,0,2,0,0,2,4,8,10,6,6,18,"2-4","Y","Y","Y",2,0,9
"3218","N1",2023-10-22,"Heracles","Twente",2,2,"D",0,2,"A",5.38,4.34,1.63,"0-2","2-2",16,3,17,5,1,4,0,0,6,6,21,14,4,12,35,"6-6","Y","Y","Y",5,0,9
"3219","N1",2023-10-22,"Go Ahead Eagles","Sparta Rotterdam",0,0,"D",0,0,"D",2.2,3.71,3.28,"0-0","0-0",16,6,15,6,0,0,0,0,3,6,4,10,0,9,14,"3-6","N","N","N",0,0,9
"3220","N1",2023-10-27,"Vitesse","Zwolle",1,1,"D",0,1,"A",2.05,3.72,3.68,"0-1","1-1",29,12,5,2,0,1,0,0,18,2,7,12,2,20,19,"18-2","Y","N","N",1,0,9
"3221","N1",2023-10-28,"Heerenveen","Heracles",3,0,"H",2,0,"H",1.98,3.93,3.72,"2-0","3-0",18,9,9,3,2,2,0,0,10,4,11,9,3,14,20,"10-4","Y","Y","N",4,0,9
"3222","N1",2023-10-28,"Almere City","Go Ahead Eagles",0,0,"D",0,0,"D",2.8,3.59,2.55,"0-0","0-0",12,1,9,3,1,0,0,0,6,5,19,7,0,11,26,"6-5","N","N","N",1,0,10
"3223","N1",2023-10-28,"Sparta Rotterdam","Waalwijk",2,0,"H",0,0,"D",1.75,4,4.79,"0-0","2-0",15,4,11,3,2,1,1,0,8,4,7,7,2,12,14,"8-4","Y","N","N",3,1,10
"3224","N1",2023-10-28,"For Sittard","Utrecht",0,0,"D",0,0,"D",2.51,3.68,2.79,"0-0","0-0",12,6,12,3,1,1,0,0,5,5,7,5,0,10,12,"5-5","N","N","N",2,0,10
"3225","N1",2023-10-29,"Twente","Feyenoord",2,1,"H",1,0,"H",3.17,3.73,2.25,"1-0","2-1",12,5,11,6,5,1,0,0,2,5,12,16,3,7,28,"2-5","Y","Y","N",6,0,10
"3226","N1",2023-10-29,"PSV Eindhoven","Ajax",5,2,"H",1,2,"A",1.31,6.24,8.94,"1-2","5-2",26,9,16,7,1,2,0,0,5,5,9,8,7,10,17,"5-5","Y","Y","Y",3,0,10
"3227","N1",2023-10-29,"Volendam","Excelsior",3,1,"H",0,1,"A",2.77,3.9,2.44,"0-1","3-1",20,12,10,2,1,2,0,0,8,6,5,13,4,14,18,"8-6","Y","Y","Y",3,0,10
"3228","N1",2023-11-02,"Ajax","Volendam",2,0,"H",0,0,"D",1.31,6.42,8.49,"0-0","2-0",30,10,7,3,0,1,0,0,9,4,6,6,2,13,12,"9-4","Y","N","N",1,0,10
"3229","N1",2023-11-04,"Heracles","PSV Eindhoven",0,6,"A",0,2,"A",12.28,7.36,1.22,"0-2","0-6",7,1,34,11,1,0,1,0,1,7,9,7,6,8,16,"1-7","Y","Y","Y",1,1,10
"3230","N1",2023-11-04,"Excelsior","AZ Alkmaar",1,1,"D",0,0,"D",7.81,5.17,1.41,"0-0","1-1",15,5,11,4,2,3,0,0,3,7,11,9,2,10,20,"3-7","Y","N","N",5,0,10
"3231","N1",2023-11-04,"Waalwijk","Feyenoord",1,2,"A",1,1,"D",13.32,7.51,1.21,"1-1","1-2",5,1,27,12,0,2,1,0,2,10,6,5,3,12,11,"2-10","Y","Y","N",2,1,11
"3232","N1",2023-11-04,"Go Ahead Eagles","Vitesse",5,1,"H",1,0,"H",1.96,3.91,3.81,"1-0","5-1",22,14,13,3,0,4,0,0,4,6,5,13,6,10,18,"4-6","Y","Y","Y",4,0,11
"3233","N1",2023-11-05,"Utrecht","Twente",1,1,"D",1,1,"D",4.98,4.06,1.71,"1-1","1-1",14,6,10,1,3,4,0,1,5,2,6,10,2,7,16,"5-2","Y","N","N",7,1,11
"3234","N1",2023-11-05,"Nijmegen","Volendam",3,3,"D",1,1,"D",1.63,4.42,5.21,"1-1","3-3",13,7,15,7,4,2,1,0,8,4,6,11,6,12,17,"8-4","Y","Y","Y",6,1,11
"3235","N1",2023-11-05,"Zwolle","For Sittard",2,0,"H",1,0,"H",2.23,3.68,3.25,"1-0","2-0",15,6,8,2,3,1,0,0,2,2,11,9,2,4,20,"2-2","Y","N","N",4,0,11
"3236","N1",2023-11-05,"Ajax","Heerenveen",4,1,"H",2,1,"H",1.5,5.4,5.64,"2-1","4-1",14,8,12,3,1,2,0,0,5,8,10,8,5,13,18,"5-8","Y","Y","Y",3,0,11
"3237","N1",2023-11-05,"Sparta Rotterdam","Almere City",1,2,"A",0,1,"A",1.71,4.27,4.71,"0-1","1-2",24,6,11,4,0,0,0,0,10,3,2,13,3,13,15,"10-3","Y","Y","N",0,0,11
"3238","N1",2023-11-10,"For Sittard","Heracles",4,1,"H",4,0,"H",1.76,4.06,4.61,"4-0","4-1",15,8,7,3,0,4,0,0,9,7,10,10,5,16,20,"9-7","Y","Y","Y",4,0,11
"3239","N1",2023-11-11,"Waalwijk","Go Ahead Eagles",0,1,"A",0,1,"A",2.89,3.74,2.42,"0-1","0-1",19,5,9,2,1,0,0,0,7,0,8,5,1,7,13,"7-0","N","N","N",1,0,11
"3240","N1",2023-11-11,"Twente","Nijmegen",3,3,"D",1,0,"H",1.32,5.81,9.83,"1-0","3-3",35,7,14,8,1,3,0,0,13,3,9,14,6,16,23,"13-3","Y","Y","Y",4,0,12
"3241","N1",2023-11-11,"Vitesse","Heerenveen",1,3,"A",1,1,"D",2.38,3.7,2.97,"1-1","1-3",9,5,19,7,2,1,1,0,4,7,10,3,4,11,13,"4-7","Y","Y","Y",3,1,12
"3242","N1",2023-11-12,"PSV Eindhoven","Zwolle",4,0,"H",2,0,"H",1.1,12.68,22.26,"2-0","4-0",21,6,3,2,0,2,0,0,12,0,8,7,4,12,15,"12-0","Y","Y","Y",2,0,12
"3243","N1",2023-11-12,"Almere City","Ajax",2,2,"D",0,0,"D",5.43,4.87,1.56,"0-0","2-2",13,5,22,13,5,2,0,0,4,6,12,10,4,10,22,"4-6","Y","Y","Y",7,0,12
"3244","N1",2023-11-12,"Volendam","Sparta Rotterdam",1,4,"A",1,2,"A",3.28,3.9,2.14,"1-2","1-4",17,1,16,7,0,1,0,0,3,5,4,10,5,8,14,"3-5","Y","Y","Y",1,0,12
"3245","N1",2023-11-12,"Feyenoord","AZ Alkmaar",1,0,"H",1,0,"H",1.57,4.62,5.58,"1-0","1-0",10,5,7,1,2,1,0,0,2,0,8,13,1,2,21,"2-0","N","N","N",3,0,12
"3246","N1",2023-11-12,"Utrecht","Excelsior",2,2,"D",0,0,"D",1.73,3.84,4,"0-0","2-2",13,6,12,6,0,1,0,0,13,2,6,11,4,15,17,"13-2","Y","Y","Y",1,0,12
"3247","N1",2023-11-25,"Excelsior","Feyenoord",2,4,"A",1,1,"D",12.46,7.59,1.21,"1-1","2-4",13,3,20,9,1,1,0,0,2,5,5,9,6,7,14,"2-5","Y","Y","Y",2,0,12
"3248","N1",2023-11-25,"Heerenveen","For Sittard",3,0,"H",1,0,"H",2.09,3.63,3.64,"1-0","3-0",16,5,10,4,1,2,0,0,3,7,8,6,3,10,14,"3-7","Y","Y","N",3,0,12
"3249","N1",2023-11-25,"Twente","PSV Eindhoven",0,3,"A",0,1,"A",3.75,3.9,1.98,"0-1","0-3",12,1,17,7,1,2,1,0,3,4,9,8,3,7,17,"3-4","Y","Y","N",3,1,13
"3250","N1",2023-11-25,"Ajax","Vitesse",5,0,"H",2,0,"H",1.31,6.35,8.36,"2-0","5-0",19,12,9,4,1,2,0,0,7,4,9,5,5,11,14,"7-4","Y","Y","Y",3,0,13
"3251","N1",2023-11-25,"Zwolle","Waalwijk",1,2,"A",1,1,"D",1.82,4.01,4.34,"1-1","1-2",17,6,13,4,1,2,0,0,5,8,7,12,3,13,19,"5-8","Y","Y","N",3,0,13
"3252","N1",2023-11-26,"Almere City","Heracles",0,5,"A",0,1,"A",2.01,3.85,3.68,"0-1","0-5",17,3,17,6,0,3,0,0,6,4,6,15,5,10,21,"6-4","Y","Y","Y",3,0,13
"3253","N1",2023-11-26,"AZ Alkmaar","Volendam",3,0,"H",1,0,"H",1.15,9.34,16.26,"1-0","3-0",19,8,7,1,0,0,0,0,5,4,6,8,3,9,14,"5-4","Y","Y","N",0,0,13
"3254","N1",2023-11-26,"Nijmegen","Go Ahead Eagles",1,1,"D",0,0,"D",2.42,3.81,2.82,"0-0","1-1",15,5,13,4,0,3,0,0,4,10,9,11,2,14,20,"4-10","Y","N","N",3,0,13
"3255","N1",2023-11-26,"Sparta Rotterdam","Utrecht",1,2,"A",1,1,"D",2.45,3.42,3.06,"1-1","1-2",19,6,7,2,0,3,0,0,5,4,9,6,3,9,15,"5-4","Y","Y","N",3,0,13
"3256","N1",2023-12-01,"Heerenveen","Almere City",3,0,"H",2,0,"H",1.68,4.05,5.25,"2-0","3-0",15,8,13,2,1,2,0,0,7,8,6,12,3,15,18,"7-8","Y","Y","N",3,0,13
"3257","N1",2023-12-02,"Volendam","Zwolle",0,5,"A",0,0,"D",2.68,3.72,2.59,"0-0","0-5",9,3,20,10,2,0,0,0,6,5,5,4,5,11,9,"6-5","Y","Y","Y",2,0,13
"3258","N1",2023-12-02,"For Sittard","Vitesse",3,1,"H",2,0,"H",2.02,3.63,3.86,"2-0","3-1",15,11,8,4,1,3,0,1,5,4,16,14,4,9,30,"5-4","Y","Y","Y",4,1,14
"3259","N1",2023-12-02,"Waalwijk","Excelsior",2,2,"D",1,0,"H",2.12,3.92,3.31,"1-0","2-2",17,8,13,6,0,0,0,0,2,2,4,4,4,4,8,"2-2","Y","Y","Y",0,0,14
"3260","N1",2023-12-02,"Heracles","Sparta Rotterdam",0,1,"A",0,0,"D",2.68,3.75,2.58,"0-0","0-1",13,3,10,4,1,0,0,0,6,3,11,7,1,9,18,"6-3","N","N","N",1,0,14
"3261","N1",2023-12-03,"Feyenoord","PSV Eindhoven",1,2,"A",0,0,"D",2.22,3.93,3.1,"0-0","1-2",14,3,14,7,1,3,0,0,10,5,10,13,3,15,23,"10-5","Y","Y","N",4,0,14
"3262","N1",2023-12-03,"Go Ahead Eagles","Twente",1,3,"A",0,2,"A",3.87,3.82,1.96,"0-2","1-3",15,9,13,5,1,0,0,0,4,4,7,17,4,8,24,"4-4","Y","Y","Y",1,0,14
"3263","N1",2023-12-03,"Nijmegen","Ajax",1,2,"A",0,0,"D",4.32,4.39,1.75,"0-0","1-2",7,3,22,10,0,0,0,0,2,6,4,7,3,8,11,"2-6","Y","Y","N",0,0,14
"3264","N1",2023-12-03,"Utrecht","AZ Alkmaar",1,1,"D",0,1,"A",4.24,3.75,1.9,"0-1","1-1",15,4,20,9,0,1,0,0,7,5,10,13,2,12,23,"7-5","Y","N","N",1,0,14
"3265","N1",2023-12-06,"AZ Alkmaar","Nijmegen",1,2,"A",0,2,"A",1.28,6.15,10.59,"0-2","1-2",26,4,4,2,0,1,0,0,13,1,4,6,3,14,10,"13-1","Y","Y","N",1,0,14
"3266","N1",2023-12-06,"Waalwijk","Ajax",2,3,"A",1,2,"A",5.15,4.57,1.62,"1-2","2-3",10,2,16,6,2,0,0,0,8,9,12,9,5,17,21,"8-9","Y","Y","Y",2,0,14
"3267","N1",2023-12-07,"PSV Eindhoven","Heerenveen",2,0,"H",1,0,"H",1.17,9.01,14.21,"1-0","2-0",30,8,12,1,2,1,0,0,11,2,4,10,2,13,14,"11-2","Y","N","N",3,0,15
"3268","N1",2023-12-07,"Feyenoord","Volendam",3,1,"H",1,1,"D",1.06,17.73,29.18,"1-1","3-1",30,10,2,2,1,1,0,0,12,3,4,5,4,15,9,"12-3","Y","Y","Y",2,0,15
"3269","N1",2023-12-08,"Twente","Excelsior",4,2,"H",1,2,"A",1.26,6.73,10.6,"1-2","4-2",31,9,5,4,2,4,0,1,10,2,5,7,6,12,12,"10-2","Y","Y","Y",6,1,15
"3270","N1",2023-12-09,"Ajax","Sparta Rotterdam",2,1,"H",2,0,"H",1.4,5.68,7.01,"2-0","2-1",23,6,10,2,0,1,0,0,7,7,6,7,3,14,13,"7-7","Y","Y","N",1,0,15
"3271","N1",2023-12-09,"Zwolle","Nijmegen",1,3,"A",0,1,"A",2.34,3.69,3.04,"0-1","1-3",16,3,17,9,1,0,0,0,1,6,12,3,4,7,15,"1-6","Y","Y","Y",1,0,15
"3272","N1",2023-12-09,"AZ Alkmaar","Almere City",4,1,"H",1,0,"H",1.19,7.88,14.68,"1-0","4-1",13,7,13,6,2,5,0,0,6,5,9,17,5,11,26,"6-5","Y","Y","Y",7,0,15
"3273","N1",2023-12-10,"Go Ahead Eagles","Utrecht",0,2,"A",0,2,"A",2.22,3.62,3.32,"0-2","0-2",22,7,12,3,0,0,0,0,11,1,8,7,2,12,15,"11-1","Y","N","N",0,0,15
"3274","N1",2023-12-10,"For Sittard","Waalwijk",1,0,"H",0,0,"D",1.95,3.82,3.91,"0-0","1-0",11,3,13,2,2,2,0,0,9,6,9,10,1,15,19,"9-6","N","N","N",4,0,15
"3275","N1",2023-12-10,"Vitesse","Heracles",2,0,"H",1,0,"H",2.04,3.78,3.65,"1-0","2-0",12,2,12,3,2,1,0,0,3,5,12,7,2,8,19,"3-5","Y","N","N",3,0,15
"3276","N1",2023-12-15,"Nijmegen","For Sittard",4,1,"H",2,0,"H",2.03,3.59,3.9,"2-0","4-1",16,7,11,4,3,2,1,1,5,7,11,12,5,12,23,"5-7","Y","Y","Y",5,2,16
"3277","N1",2023-12-16,"Utrecht","Waalwijk",1,1,"D",1,1,"D",1.66,4.21,5.26,"1-1","1-1",17,6,12,4,0,4,0,0,10,4,13,13,2,14,26,"10-4","Y","N","N",4,0,16
"3278","N1",2023-12-16,"Excelsior","Go Ahead Eagles",1,1,"D",0,0,"D",3.04,3.85,2.28,"0-0","1-1",11,3,11,5,0,2,0,0,1,4,6,7,2,5,13,"1-4","Y","N","N",2,0,16
"3279","N1",2023-12-16,"Heerenveen","Volendam",1,2,"A",0,1,"A",1.38,5.43,8.25,"0-1","1-2",20,7,3,2,1,2,0,0,19,2,7,10,3,21,17,"19-2","Y","Y","N",3,0,16
"3280","N1",2023-12-17,"Almere City","Vitesse",5,0,"H",2,0,"H",2.43,3.69,2.9,"2-0","5-0",11,7,7,4,0,0,0,0,6,2,16,16,5,8,32,"6-2","Y","Y","Y",0,0,16
"3281","N1",2023-12-17,"Heracles","Feyenoord",0,4,"A",0,2,"A",11.93,7.62,1.22,"0-2","0-4",2,0,26,12,3,0,0,0,3,10,12,10,4,13,22,"3-10","Y","Y","Y",3,0,16
"3282","N1",2023-12-17,"Sparta Rotterdam","Twente",2,2,"D",0,1,"A",4.4,3.81,1.85,"0-1","2-2",12,8,39,9,2,1,1,0,3,14,11,7,4,17,18,"3-14","Y","Y","Y",3,1,16
"3283","N1",2023-12-17,"Ajax","Zwolle",2,2,"D",1,0,"H",1.28,6.57,9.45,"1-0","2-2",16,5,11,4,1,3,0,0,5,0,5,10,4,5,15,"5-0","Y","Y","Y",4,0,16
"3284","N1",2023-12-17,"AZ Alkmaar","PSV Eindhoven",0,4,"A",0,3,"A",4.16,4,1.85,"0-3","0-4",1,0,23,8,2,0,0,0,1,5,11,12,4,6,23,"1-5","Y","Y","Y",2,0,16
"3285","N1",2024-01-12,"Waalwijk","Heracles",1,2,"A",0,1,"A",1.88,3.7,4.39,"0-1","1-2",18,8,9,2,1,1,0,0,7,4,13,8,3,11,21,"7-4","Y","Y","N",2,0,17
"3286","N1",2024-01-13,"For Sittard","Sparta Rotterdam",0,2,"A",0,1,"A",2.42,3.49,3.06,"0-1","0-2",25,6,10,7,3,1,0,0,7,2,8,8,2,9,16,"7-2","Y","N","N",4,0,17
"3287","N1",2024-01-13,"Twente","AZ Alkmaar",2,1,"H",1,1,"D",2.25,3.5,3.35,"1-1","2-1",19,8,5,2,3,2,0,0,5,3,9,12,3,8,21,"5-3","Y","Y","N",5,0,17
"3288","N1",2024-01-13,"Zwolle","Heerenveen",2,2,"D",0,1,"A",2.67,3.74,2.59,"0-1","2-2",13,5,20,10,1,2,0,0,4,6,13,10,4,10,23,"4-6","Y","Y","Y",3,0,17
"3289","N1",2024-01-13,"PSV Eindhoven","Excelsior",3,1,"H",2,0,"H",1.08,13.45,27.67,"2-0","3-1",27,15,8,3,0,0,0,0,12,2,2,3,4,14,5,"12-2","Y","Y","Y",0,0,17
"3290","N1",2024-01-14,"Volendam","Almere City",0,1,"A",0,1,"A",2.69,3.66,2.61,"0-1","0-1",5,2,10,2,1,1,0,0,5,4,11,12,1,9,23,"5-4","N","N","N",2,0,17
"3291","N1",2024-01-14,"Go Ahead Eagles","Ajax",2,3,"A",1,2,"A",3.74,4.28,1.89,"1-2","2-3",24,12,17,6,0,2,0,0,6,4,7,10,5,10,17,"6-4","Y","Y","Y",2,0,17
"3292","N1",2024-01-14,"Vitesse","Utrecht",0,0,"D",0,0,"D",3.07,3.61,2.36,"0-0","0-0",12,6,20,4,1,1,0,0,1,14,11,12,0,15,23,"1-14","N","N","N",2,0,17
"3293","N1",2024-01-14,"Feyenoord","Nijmegen",2,2,"D",2,1,"H",1.15,9.41,16.2,"2-1","2-2",25,5,2,2,2,2,0,0,9,0,8,13,4,9,21,"9-0","Y","Y","Y",4,0,17
"2988","P1",2023-08-11,"Sp Braga","Famalicao",1,2,"A",1,0,"H",1.45,4.86,7.21,"1-0","1-2",13,2,12,4,4,4,0,0,3,4,17,12,3,7,29,"3-4","Y","Y","N",8,0,1
"2989","P1",2023-08-12,"Gil Vicente","Portimonense",5,0,"H",2,0,"H",2.05,3.38,4.07,"2-0","5-0",8,5,9,3,0,0,0,0,1,1,11,14,5,2,25,"1-1","Y","Y","Y",0,0,1
"2990","P1",2023-08-12,"Farense","Casa Pia",0,3,"A",0,1,"A",2.59,3.07,3.17,"0-1","0-3",12,5,14,5,2,4,0,0,5,6,13,13,3,11,26,"5-6","Y","Y","N",6,0,1
"2991","P1",2023-08-12,"Sp Lisbon","Vizela",3,2,"H",2,0,"H",1.18,7.76,16.94,"2-0","3-2",19,6,10,4,4,0,0,0,8,3,16,9,5,11,25,"8-3","Y","Y","Y",4,0,1
"2992","P1",2023-08-13,"Rio Ave","Chaves",2,0,"H",0,0,"D",2.14,3.37,3.79,"0-0","2-0",21,8,6,1,3,4,0,1,14,3,12,20,2,17,32,"14-3","Y","N","N",7,1,1
"2993","P1",2023-08-13,"Estrela","Guimaraes",0,1,"A",0,1,"A",NA,NA,NA,"0-1","0-1",5,0,11,3,3,3,1,0,3,10,13,18,1,13,31,"3-10","N","N","N",6,1,1
"2994","P1",2023-08-13,"Arouca","Estoril",4,3,"H",1,1,"D",2.22,3.13,3.89,"1-1","4-3",11,5,12,8,4,2,1,0,2,6,11,17,7,8,28,"2-6","Y","Y","Y",6,1,1
"2995","P1",2023-08-14,"Moreirense","Porto",1,2,"A",0,0,"D",8.32,5.36,1.37,"0-0","1-2",8,1,18,7,4,7,0,1,5,10,22,15,3,15,37,"5-10","Y","Y","N",11,1,1
"2996","P1",2023-08-14,"Boavista","Benfica",3,2,"H",0,1,"A",11.02,5.89,1.29,"0-1","3-2",11,3,15,5,6,4,1,1,3,3,18,15,5,6,33,"3-3","Y","Y","Y",10,2,1
"2997","P1",2023-08-18,"Casa Pia","Sp Lisbon",1,2,"A",0,1,"A",7.6,4.77,1.45,"0-1","1-2",13,3,17,5,4,1,0,0,4,5,14,11,3,9,25,"4-5","Y","Y","N",5,0,2
"2998","P1",2023-08-19,"Guimaraes","Gil Vicente",2,1,"H",0,0,"D",2.11,3.39,3.86,"0-0","2-1",15,3,11,3,3,3,0,0,6,4,14,14,3,10,28,"6-4","Y","Y","N",6,0,2
"2999","P1",2023-08-19,"Chaves","Sp Braga",2,4,"A",1,1,"D",4.98,4.2,1.69,"1-1","2-4",15,4,13,6,2,2,1,0,5,6,12,12,6,11,24,"5-6","Y","Y","Y",4,1,2
"3000","P1",2023-08-19,"Benfica","Estrela",2,0,"H",0,0,"D",1.09,13.06,27.99,"0-0","2-0",27,10,6,1,3,3,0,0,9,4,8,14,2,13,22,"9-4","Y","N","N",6,0,2
"3001","P1",2023-08-19,"Portimonense","Boavista",1,4,"A",0,3,"A",2.81,3.18,2.8,"0-3","1-4",10,5,9,6,3,2,0,0,11,2,19,13,5,13,32,"11-2","Y","Y","Y",5,0,2
"3002","P1",2023-08-20,"Estoril","Rio Ave",2,0,"H",0,0,"D",2.54,3.24,3.07,"0-0","2-0",5,4,9,3,4,2,0,0,3,3,14,13,2,6,27,"3-3","Y","N","N",6,0,2
"3003","P1",2023-08-20,"Porto","Farense",2,1,"H",1,1,"D",1.13,9.69,19.53,"1-1","2-1",26,8,7,1,2,3,0,0,17,3,9,11,3,20,20,"17-3","Y","Y","N",5,0,2
"3004","P1",2023-08-20,"Vizela","Arouca",2,2,"D",1,1,"D",2.17,3.31,3.78,"1-1","2-2",13,7,9,2,6,6,1,1,6,3,24,11,4,9,35,"6-3","Y","Y","Y",12,2,2
"3005","P1",2023-08-21,"Famalicao","Moreirense",0,0,"D",0,0,"D",1.95,3.55,4.14,"0-0","0-0",4,2,12,3,4,3,1,0,3,6,15,10,0,9,25,"3-6","N","N","N",7,1,2
"3006","P1",2023-08-25,"Estrela","Estoril",2,1,"H",0,0,"D",2.37,3.19,3.43,"0-0","2-1",15,3,11,4,1,1,0,0,8,8,8,6,3,16,14,"8-8","Y","Y","N",2,0,3
"3007","P1",2023-08-26,"Arouca","Portimonense",1,1,"D",0,1,"A",1.66,4,5.64,"0-1","1-1",21,4,5,2,1,2,0,0,16,2,12,19,2,18,31,"16-2","Y","N","N",3,0,3
"3008","P1",2023-08-26,"Farense","Chaves",5,0,"H",4,0,"H",2.36,3.37,3.25,"4-0","5-0",18,10,19,7,2,1,0,0,7,4,24,15,5,11,39,"7-4","Y","Y","Y",3,0,3
"3009","P1",2023-08-26,"Gil Vicente","Benfica",2,3,"A",0,1,"A",9.93,6.01,1.31,"0-1","2-3",11,7,14,7,3,3,0,0,1,5,15,14,5,6,29,"1-5","Y","Y","Y",6,0,3
"3010","P1",2023-08-27,"Boavista","Casa Pia",1,1,"D",0,1,"A",2.3,3.29,3.45,"0-1","1-1",10,5,10,7,1,0,0,0,11,4,18,14,2,15,32,"11-4","Y","N","N",1,0,3
"3011","P1",2023-08-27,"Guimaraes","Vizela",2,0,"H",0,0,"D",1.93,3.58,4.35,"0-0","2-0",6,3,9,4,1,3,1,0,3,4,11,9,2,7,20,"3-4","Y","N","N",4,1,3
"3012","P1",2023-08-27,"Sp Lisbon","Famalicao",1,0,"H",0,0,"D",1.25,6.56,11.91,"0-0","1-0",10,6,7,1,3,2,0,0,8,1,17,13,1,9,30,"8-1","N","N","N",5,0,3
"3013","P1",2023-08-28,"Rio Ave","Porto",1,2,"A",0,0,"D",7.11,4.83,1.45,"0-0","1-2",4,1,9,5,4,3,0,0,1,7,22,17,3,8,39,"1-7","Y","Y","N",7,0,3
"3014","P1",2023-09-01,"Vizela","Gil Vicente",1,0,"H",0,0,"D",2.27,3.4,3.42,"0-0","1-0",13,5,5,1,0,3,0,0,4,3,20,16,1,7,36,"4-3","N","N","N",3,0,3
"3015","P1",2023-09-02,"Casa Pia","Rio Ave",1,1,"D",1,0,"H",2.22,3.39,3.53,"1-0","1-1",10,5,11,5,1,2,0,0,12,0,18,15,2,12,33,"12-0","Y","N","N",3,0,4
"3016","P1",2023-09-02,"Famalicao","Farense",1,0,"H",0,0,"D",1.79,3.72,4.92,"0-0","1-0",21,4,6,1,1,3,0,1,12,4,16,14,1,16,30,"12-4","N","N","N",4,1,4
"3017","P1",2023-09-02,"Portimonense","Estrela",1,1,"D",1,1,"D",2.7,3.22,2.89,"1-1","1-1",15,4,10,1,3,6,0,0,3,7,12,16,2,10,28,"3-7","Y","N","N",9,0,4
"3018","P1",2023-09-02,"Benfica","Guimaraes",4,0,"H",3,0,"H",1.21,7.46,13.1,"3-0","4-0",20,9,7,1,2,4,0,1,11,2,9,14,4,13,23,"11-2","Y","Y","Y",6,1,4
"3019","P1",2023-09-03,"Chaves","Moreirense",1,2,"A",0,1,"A",2.54,3.34,2.99,"0-1","1-2",13,3,9,2,3,4,0,0,3,4,14,21,3,7,35,"3-4","Y","Y","N",7,0,4
"3020","P1",2023-09-03,"Estoril","Boavista",1,2,"A",1,2,"A",2.48,3.37,3.01,"1-2","1-2",13,4,14,8,3,1,0,0,10,5,21,12,3,15,33,"10-5","Y","Y","N",4,0,4
"3021","P1",2023-09-03,"Porto","Arouca",1,1,"D",0,0,"D",1.26,6.43,11.28,"0-0","1-1",12,3,10,2,3,2,0,0,5,2,9,14,2,7,23,"5-2","Y","N","N",5,0,4
"3022","P1",2023-09-03,"Sp Braga","Sp Lisbon",1,1,"D",0,1,"A",3.04,3.63,2.36,"0-1","1-1",6,2,4,2,2,5,0,0,4,2,16,9,2,6,25,"4-2","Y","N","N",7,0,4
"3023","P1",2023-09-09,"Moreirense","Sp Braga",2,3,"A",2,1,"H",4.28,3.97,1.84,"2-1","2-3",11,3,12,5,2,2,0,0,4,5,12,11,5,9,23,"4-5","Y","Y","Y",4,0,4
"3024","P1",2023-09-15,"Estrela","Porto",0,1,"A",0,1,"A",9.42,5.38,1.35,"0-1","0-1",9,1,10,4,3,5,0,0,10,6,12,21,1,16,33,"10-6","N","N","N",8,0,5
"3025","P1",2023-09-16,"Rio Ave","Famalicao",1,1,"D",0,1,"A",2.66,3.15,3,"0-1","1-1",5,0,12,4,1,3,0,0,3,3,15,20,2,6,35,"3-3","Y","N","N",4,0,5
"3026","P1",2023-09-16,"Farense","Sp Braga",3,1,"H",2,0,"H",4.72,4.26,1.71,"2-0","3-1",16,4,17,7,4,5,0,0,7,3,16,10,4,10,26,"7-3","Y","Y","Y",9,0,5
"3027","P1",2023-09-16,"Vizela","Benfica",1,2,"A",0,2,"A",8.67,5.89,1.34,"0-2","1-2",12,2,17,7,2,1,0,0,2,3,15,6,3,5,21,"2-3","Y","Y","N",3,0,5
"3028","P1",2023-09-17,"Arouca","Casa Pia",0,1,"A",0,0,"D",2.46,3.25,3.19,"0-0","0-1",11,5,12,2,2,3,0,0,2,7,12,7,1,9,19,"2-7","N","N","N",5,0,5
"3029","P1",2023-09-17,"Gil Vicente","Estoril",5,3,"H",3,0,"H",2.18,3.55,3.49,"3-0","5-3",12,7,14,6,3,2,0,0,5,8,11,15,8,13,26,"5-8","Y","Y","Y",5,0,5
"3030","P1",2023-09-17,"Guimaraes","Portimonense",1,2,"A",1,0,"H",1.58,4.21,6.2,"1-0","1-2",11,3,9,2,2,4,0,0,10,3,16,13,3,13,29,"10-3","Y","Y","N",6,0,5
"3031","P1",2023-09-17,"Sp Lisbon","Moreirense",3,0,"H",0,0,"D",1.23,7.02,12.49,"0-0","3-0",20,9,7,1,3,3,0,1,8,2,10,16,3,10,26,"8-2","Y","Y","N",6,1,5
"3032","P1",2023-09-18,"Boavista","Chaves",4,1,"H",4,0,"H",1.74,4.1,4.64,"4-0","4-1",7,4,21,10,1,3,0,0,3,12,12,15,5,15,27,"3-12","Y","Y","Y",4,0,5
"3033","P1",2023-09-22,"Famalicao","Arouca",1,0,"H",1,0,"H",2.04,3.4,4.1,"1-0","1-0",7,4,13,6,5,2,1,1,6,8,15,23,1,14,38,"6-8","N","N","N",7,2,6
"3034","P1",2023-09-23,"Estoril","Vizela",2,2,"D",0,0,"D",2.56,3.48,2.87,"0-0","2-2",16,6,11,7,1,2,0,0,5,3,13,15,4,8,28,"5-3","Y","Y","Y",3,0,6
"3035","P1",2023-09-23,"Moreirense","Farense",1,0,"H",1,0,"H",2.23,3.52,3.39,"1-0","1-0",15,3,10,2,1,2,0,0,11,3,10,17,1,14,27,"11-3","N","N","N",3,0,6
"3036","P1",2023-09-23,"Casa Pia","Guimaraes",0,0,"D",0,0,"D",2.43,3.26,3.23,"0-0","0-0",10,2,14,3,3,2,0,0,8,9,16,11,0,17,27,"8-9","N","N","N",5,0,6
"3037","P1",2023-09-23,"Porto","Gil Vicente",2,1,"H",1,1,"D",1.22,7.32,11.96,"1-1","2-1",20,7,12,4,1,3,0,0,6,3,15,12,3,9,27,"6-3","Y","Y","N",4,0,6
"3038","P1",2023-09-24,"Chaves","Estrela",2,2,"D",0,1,"A",2.73,3.55,2.64,"0-1","2-2",17,8,10,3,4,4,0,1,9,5,11,11,4,14,22,"9-5","Y","Y","Y",8,1,6
"3039","P1",2023-09-24,"Portimonense","Benfica",1,3,"A",0,2,"A",11.17,6.7,1.25,"0-2","1-3",9,2,13,7,1,0,0,0,3,4,7,7,4,7,14,"3-4","Y","Y","Y",1,0,6
"3040","P1",2023-09-24,"Sp Braga","Boavista",4,1,"H",2,1,"H",1.55,4.78,5.69,"2-1","4-1",24,9,6,2,2,3,0,1,6,2,8,9,5,8,17,"6-2","Y","Y","Y",5,1,6
"3041","P1",2023-09-25,"Sp Lisbon","Rio Ave",2,0,"H",2,0,"H",1.2,7.3,13.69,"2-0","2-0",10,6,7,2,1,5,0,0,4,2,14,12,2,6,26,"4-2","Y","N","N",6,0,6
"3042","P1",2023-09-28,"Estrela","Sp Braga",2,4,"A",0,1,"A",4.72,4.16,1.71,"0-1","2-4",17,9,17,9,1,3,0,0,8,6,9,13,6,14,22,"8-6","Y","Y","Y",4,0,7
"3043","P1",2023-09-29,"Benfica","Porto",1,0,"H",0,0,"D",1.93,3.69,4.14,"0-0","1-0",12,2,6,3,4,5,0,1,9,5,18,10,1,14,28,"9-5","N","N","N",9,1,7
"3044","P1",2023-09-30,"Vizela","Portimonense",2,3,"A",0,2,"A",1.83,3.76,4.62,"0-2","2-3",14,4,9,7,3,3,0,0,13,2,11,16,5,15,27,"13-2","Y","Y","Y",6,0,7
"3045","P1",2023-09-30,"Boavista","Famalicao",2,2,"D",1,1,"D",2.21,3.51,3.44,"1-1","2-2",10,6,7,3,5,4,1,2,2,4,23,21,4,6,44,"2-4","Y","Y","Y",9,3,7
"3046","P1",2023-09-30,"Farense","Sp Lisbon",2,3,"A",1,2,"A",6.17,4.58,1.44,"1-2","2-3",9,4,23,10,5,6,1,0,2,8,13,12,5,10,25,"2-8","Y","Y","Y",11,1,7
"3047","P1",2023-10-01,"Arouca","Chaves",0,2,"A",0,0,"D",1.85,3.76,4.39,"0-0","0-2",11,2,5,3,3,5,1,0,5,3,16,10,2,8,26,"5-3","Y","N","N",8,1,7
"3048","P1",2023-10-01,"Guimaraes","Estoril",3,2,"H",0,2,"A",1.85,3.79,4.45,"0-2","3-2",25,8,10,5,4,4,0,1,11,2,16,13,5,13,29,"11-2","Y","Y","Y",8,1,7
"3049","P1",2023-10-01,"Rio Ave","Moreirense",0,4,"A",0,2,"A",2.38,3.46,3.13,"0-2","0-4",10,4,11,6,3,5,0,0,4,2,13,26,4,6,39,"4-2","Y","Y","Y",8,0,7
"3050","P1",2023-10-02,"Gil Vicente","Casa Pia",2,0,"H",0,0,"D",2.41,3.34,3.14,"0-0","2-0",16,9,8,1,3,3,0,1,5,5,10,15,2,10,25,"5-5","Y","N","N",6,1,7
"3051","P1",2023-10-06,"Moreirense","Boavista",1,1,"D",1,1,"D",1.94,3.72,4.07,"1-1","1-1",11,6,8,1,0,3,0,0,6,1,13,13,2,7,26,"6-1","Y","N","N",3,0,8
"3052","P1",2023-10-07,"Chaves","Gil Vicente",4,2,"H",1,2,"A",2.65,3.61,2.68,"1-2","4-2",15,9,9,5,3,3,1,0,6,1,17,14,6,7,31,"6-1","Y","Y","Y",6,1,8
"3053","P1",2023-10-07,"Farense","Vizela",0,0,"D",0,0,"D",2.19,3.58,3.43,"0-0","0-0",20,6,17,6,1,1,0,0,14,6,21,11,0,20,32,"14-6","N","N","N",2,0,8
"3054","P1",2023-10-07,"Sp Braga","Rio Ave",2,1,"H",0,1,"A",1.32,5.88,9.83,"0-1","2-1",33,11,9,3,1,2,0,0,16,1,8,11,3,17,19,"16-1","Y","Y","N",3,0,8
"3055","P1",2023-10-07,"Estoril","Benfica",0,1,"A",0,0,"D",10.21,6.4,1.28,"0-0","0-1",16,4,21,5,3,2,0,0,4,7,15,8,1,11,23,"4-7","N","N","N",5,0,8
"3056","P1",2023-10-08,"Casa Pia","Estrela",0,1,"A",0,0,"D",2.09,3.4,3.9,"0-0","0-1",7,2,11,6,1,1,0,0,3,6,16,8,1,9,24,"3-6","N","N","N",2,0,8
"3057","P1",2023-10-08,"Famalicao","Guimaraes",1,3,"A",0,2,"A",2.71,3.17,2.92,"0-2","1-3",13,6,12,4,4,3,0,0,11,3,15,20,4,14,35,"11-3","Y","Y","Y",7,0,8
"3058","P1",2023-10-08,"Porto","Portimonense",1,0,"H",1,0,"H",1.16,8.85,16.19,"1-0","1-0",18,7,4,2,4,6,1,0,10,5,12,19,1,15,31,"10-5","N","N","N",10,1,8
"3059","P1",2023-10-08,"Sp Lisbon","Arouca",2,1,"H",1,0,"H",1.25,6.6,11.63,"1-0","2-1",10,5,11,5,4,7,1,1,5,2,7,18,3,7,25,"5-2","Y","Y","N",11,2,8
"3060","P1",2023-10-27,"Arouca","Moreirense",0,1,"A",0,1,"A",2.61,3.28,2.94,"0-1","0-1",13,3,12,5,2,2,0,1,7,5,11,14,1,12,25,"7-5","N","N","N",4,1,9
"3061","P1",2023-10-28,"Portimonense","Estoril",1,0,"H",1,0,"H",2.52,3.5,2.9,"1-0","1-0",14,8,14,4,6,1,0,0,6,4,14,8,1,10,22,"6-4","N","N","N",7,0,9
"3062","P1",2023-10-28,"Benfica","Casa Pia",1,1,"D",1,0,"H",1.19,7.53,15.99,"1-0","1-1",13,7,6,3,1,2,0,0,10,2,12,20,2,12,32,"10-2","Y","N","N",3,0,9
"3063","P1",2023-10-28,"Guimaraes","Chaves",5,0,"H",3,0,"H",1.62,4.22,5.63,"3-0","5-0",13,6,7,3,0,3,0,1,4,3,16,6,5,7,22,"4-3","Y","Y","Y",3,1,9
"3064","P1",2023-10-28,"Gil Vicente","Sp Braga",3,3,"D",1,0,"H",4.16,4.28,1.8,"1-0","3-3",13,6,18,7,4,2,0,1,4,9,14,21,6,13,35,"4-9","Y","Y","Y",6,1,9
"3065","P1",2023-10-29,"Rio Ave","Farense",3,4,"A",2,2,"D",2.37,3.45,3.17,"2-2","3-4",11,4,13,7,3,3,0,0,5,6,19,12,7,11,31,"5-6","Y","Y","Y",6,0,9
"3066","P1",2023-10-29,"Estrela","Famalicao",1,0,"H",0,0,"D",2.58,3.29,2.98,"0-0","1-0",12,4,9,1,3,3,0,1,3,2,18,15,1,5,33,"3-2","N","N","N",6,1,9
"3067","P1",2023-10-29,"Vizela","Porto",0,2,"A",0,2,"A",7.81,4.73,1.44,"0-2","0-2",8,1,13,3,3,4,0,0,4,4,16,17,2,8,33,"4-4","Y","N","N",7,0,9
"3068","P1",2023-10-30,"Boavista","Sp Lisbon",0,2,"A",0,1,"A",6.59,4.69,1.49,"0-1","0-2",7,2,14,6,3,2,0,0,4,8,16,13,2,12,29,"4-8","Y","N","N",5,0,9
"3069","P1",2023-11-03,"Porto","Estoril",0,1,"A",0,0,"D",1.17,8.39,15.51,"0-0","0-1",16,4,7,3,5,7,0,0,9,6,16,16,1,15,32,"9-6","N","N","N",12,0,10
"3070","P1",2023-11-04,"Chaves","Benfica",0,2,"A",0,0,"D",9.53,6.19,1.3,"0-0","0-2",8,0,14,5,5,2,0,0,3,8,13,11,2,11,24,"3-8","Y","N","N",7,0,10
"3071","P1",2023-11-04,"Famalicao","Gil Vicente",3,1,"H",2,0,"H",2.09,3.6,3.68,"2-0","3-1",12,5,9,4,3,3,0,0,7,2,11,10,4,9,21,"7-2","Y","Y","Y",6,0,10
"3072","P1",2023-11-04,"Sp Braga","Portimonense",6,1,"H",0,1,"A",1.25,6.8,11,"0-1","6-1",19,10,8,3,1,2,0,0,5,5,10,10,7,10,20,"5-5","Y","Y","Y",3,0,10
"3073","P1",2023-11-05,"Casa Pia","Vizela",0,1,"A",0,0,"D",2.2,3.39,3.6,"0-0","0-1",11,2,14,4,3,3,0,0,6,6,16,17,1,12,33,"6-6","N","N","N",6,0,10
"3074","P1",2023-11-05,"Moreirense","Guimaraes",1,0,"H",0,0,"D",2.75,3.25,2.8,"0-0","1-0",12,3,10,2,1,2,0,0,4,12,10,11,1,16,21,"4-12","N","N","N",3,0,10
"3075","P1",2023-11-05,"Rio Ave","Boavista",2,0,"H",1,0,"H",2.66,3.45,2.74,"1-0","2-0",9,3,10,2,3,2,0,0,3,3,17,15,2,6,32,"3-3","Y","N","N",5,0,10
"3076","P1",2023-11-05,"Sp Lisbon","Estrela",3,2,"H",1,0,"H",1.24,7.12,11.43,"1-0","3-2",23,8,6,4,1,1,0,0,6,1,7,5,5,7,12,"6-1","Y","Y","Y",2,0,10
"3077","P1",2023-11-06,"Farense","Arouca",2,0,"H",2,0,"H",2.25,3.4,3.38,"2-0","2-0",7,2,15,5,1,1,0,0,6,6,16,14,2,12,30,"6-6","Y","N","N",2,0,10
"3078","P1",2023-11-10,"Estoril","Casa Pia",4,0,"H",2,0,"H",2.59,3.26,2.98,"2-0","4-0",18,6,12,3,3,4,0,0,4,7,15,16,4,11,31,"4-7","Y","Y","Y",7,0,11
"3079","P1",2023-11-11,"Portimonense","Chaves",2,1,"H",2,0,"H",2.34,3.44,3.23,"2-0","2-1",12,7,19,8,4,2,0,0,3,8,15,12,3,11,27,"3-8","Y","Y","N",6,0,11
"3080","P1",2023-11-11,"Estrela","Moreirense",0,1,"A",0,0,"D",2.65,3.41,2.8,"0-0","0-1",8,3,12,2,3,6,0,1,2,5,22,17,1,7,39,"2-5","N","N","N",9,1,11
"3081","P1",2023-11-11,"Vizela","Famalicao",0,0,"D",0,0,"D",2.72,3.31,2.8,"0-0","0-0",9,4,13,2,1,3,0,0,5,7,17,17,0,12,34,"5-7","N","N","N",4,0,11
"3082","P1",2023-11-11,"Guimaraes","Porto",1,2,"A",1,1,"D",5.16,3.98,1.71,"1-1","1-2",14,8,7,4,3,3,0,0,10,6,19,17,3,16,36,"10-6","Y","Y","N",6,0,11
"3083","P1",2023-11-12,"Boavista","Farense",1,3,"A",0,1,"A",2.05,3.7,3.7,"0-1","1-3",15,2,13,7,3,1,0,0,9,2,19,9,4,11,28,"9-2","Y","Y","Y",4,0,11
"3084","P1",2023-11-12,"Gil Vicente","Rio Ave",1,1,"D",0,0,"D",2.02,3.64,3.8,"0-0","1-1",8,2,16,5,1,1,0,0,4,7,10,18,2,11,28,"4-7","Y","N","N",2,0,11
"3085","P1",2023-11-12,"Arouca","Sp Braga",0,1,"A",0,1,"A",5.32,4.36,1.63,"0-1","0-1",12,7,17,5,2,4,0,0,3,8,14,14,1,11,28,"3-8","N","N","N",6,0,11
"3086","P1",2023-11-12,"Benfica","Sp Lisbon",2,1,"H",0,1,"A",2.34,3.58,3.11,"0-1","2-1",11,4,8,3,2,5,0,1,6,4,10,12,3,10,22,"6-4","Y","Y","N",7,1,11
"3087","P1",2023-12-01,"Chaves","Vizela",2,1,"H",1,1,"D",2.73,3.23,2.73,"1-1","2-1",15,5,8,2,5,3,0,0,2,1,14,16,3,3,30,"2-1","Y","Y","N",8,0,12
"3088","P1",2023-12-02,"Farense","Guimaraes",1,2,"A",0,1,"A",3.15,3.46,2.28,"0-1","1-2",5,2,16,5,3,3,1,0,1,7,12,14,3,8,26,"1-7","Y","Y","N",6,1,12
"3089","P1",2023-12-02,"Rio Ave","Estrela",1,1,"D",0,0,"D",2.2,3.46,3.31,"0-0","1-1",13,3,8,0,4,1,0,0,7,0,15,13,2,7,28,"7-0","Y","N","N",5,0,12
"3090","P1",2023-12-02,"Famalicao","Porto",0,3,"A",0,2,"A",5.17,3.84,1.64,"0-2","0-3",12,0,9,5,4,5,1,0,7,2,16,22,3,9,38,"7-2","Y","Y","N",9,1,12
"3091","P1",2023-12-02,"Casa Pia","Portimonense",1,0,"H",0,0,"D",1.95,3.51,4.02,"0-0","1-0",11,3,10,2,3,3,0,1,5,5,20,15,1,10,35,"5-5","N","N","N",6,1,12
"3092","P1",2023-12-03,"Sp Braga","Estoril",3,1,"H",1,1,"D",1.34,5.77,7.59,"1-1","3-1",18,6,4,1,2,2,0,0,5,2,13,14,4,7,27,"5-2","Y","Y","Y",4,0,12
"3093","P1",2023-12-03,"Moreirense","Benfica",0,0,"D",0,0,"D",6.42,4.41,1.5,"0-0","0-0",11,4,12,3,4,1,0,0,2,7,13,13,0,9,26,"2-7","N","N","N",5,0,12
"3094","P1",2023-12-03,"Boavista","Arouca",0,4,"A",0,3,"A",2.17,3.31,3.55,"0-3","0-4",8,2,12,7,5,4,1,1,8,1,12,10,4,9,22,"8-1","Y","Y","Y",9,2,12
"3095","P1",2023-12-04,"Sp Lisbon","Gil Vicente",3,1,"H",1,1,"D",1.16,7.91,13.5,"1-1","3-1",12,4,5,1,4,1,0,0,9,0,14,9,4,9,23,"9-0","Y","Y","Y",5,0,12
"3096","P1",2023-12-08,"Vizela","Sp Braga",1,3,"A",0,1,"A",5.87,4.32,1.59,"0-1","1-3",11,5,13,4,3,1,0,0,7,6,19,9,4,13,28,"7-6","Y","Y","Y",4,0,13
"3097","P1",2023-12-08,"Benfica","Farense",1,1,"D",0,0,"D",1.18,8.23,15.33,"0-0","1-1",37,13,8,5,2,3,0,0,15,3,10,11,2,18,21,"15-3","Y","N","N",5,0,13
"3098","P1",2023-12-09,"Portimonense","Famalicao",1,1,"D",0,1,"A",2.98,3.4,2.51,"0-1","1-1",8,4,16,8,4,1,1,0,2,5,14,19,2,7,33,"2-5","Y","N","N",5,1,13
"3099","P1",2023-12-09,"Guimaraes","Sp Lisbon",3,2,"H",1,1,"D",5.42,4.2,1.65,"1-1","3-2",7,5,11,4,4,1,0,0,1,6,14,5,5,7,19,"1-6","Y","Y","Y",5,0,13
"3100","P1",2023-12-09,"Porto","Casa Pia",3,1,"H",1,0,"H",1.23,6.36,14.69,"1-0","3-1",16,6,7,3,3,1,0,0,4,1,11,9,4,5,20,"4-1","Y","Y","Y",4,0,13
"3101","P1",2023-12-10,"Estrela","Boavista",3,1,"H",0,0,"D",2.32,3.49,3.23,"0-0","3-1",4,2,9,6,4,2,0,0,2,4,18,11,4,6,29,"2-4","Y","Y","Y",6,0,13
"3102","P1",2023-12-10,"Arouca","Rio Ave",2,2,"D",0,2,"A",2.19,3.32,3.69,"0-2","2-2",16,5,12,9,1,5,0,0,5,3,11,14,4,8,25,"5-3","Y","Y","Y",6,0,13
"3103","P1",2023-12-10,"Estoril","Chaves",4,0,"H",1,0,"H",2.01,3.8,3.75,"1-0","4-0",14,10,7,2,4,3,0,0,3,6,16,11,4,9,27,"3-6","Y","Y","Y",7,0,13
"3104","P1",2023-12-11,"Gil Vicente","Moreirense",1,1,"D",1,0,"H",2.87,3.54,2.49,"1-0","1-1",11,4,11,4,5,3,0,0,3,6,15,19,2,9,34,"3-6","Y","N","N",8,0,13
"3105","P1",2023-12-15,"Farense","Estrela",0,0,"D",0,0,"D",2.18,3.54,3.48,"0-0","0-0",12,1,9,2,2,1,0,0,6,9,11,8,0,15,19,"6-9","N","N","N",3,0,14
"3106","P1",2023-12-16,"Rio Ave","Vizela",1,1,"D",0,0,"D",2.21,3.4,3.56,"0-0","1-1",13,4,6,4,3,3,0,1,7,2,16,15,2,9,31,"7-2","Y","N","N",6,1,14
"3107","P1",2023-12-16,"Arouca","Gil Vicente",3,0,"H",1,0,"H",1.99,3.62,4,"1-0","3-0",10,7,9,5,2,0,0,0,4,6,11,8,3,10,19,"4-6","Y","Y","N",2,0,14
"3108","P1",2023-12-16,"Boavista","Guimaraes",1,1,"D",0,1,"A",3.74,3.6,2.07,"0-1","1-1",10,4,14,3,6,2,0,0,7,8,17,9,2,15,26,"7-8","Y","N","N",8,0,14
"3109","P1",2023-12-17,"Chaves","Casa Pia",1,3,"A",1,2,"A",2.81,3.2,2.79,"1-2","1-3",15,5,9,6,1,1,0,0,4,2,16,14,4,6,30,"4-2","Y","Y","Y",2,0,14
"3110","P1",2023-12-17,"Moreirense","Portimonense",5,2,"H",2,1,"H",1.76,3.89,4.92,"2-1","5-2",16,5,9,3,2,2,0,0,7,7,12,12,7,14,24,"7-7","Y","Y","Y",4,0,14
"3111","P1",2023-12-17,"Famalicao","Estoril",1,1,"D",1,1,"D",2.26,3.56,3.28,"1-1","1-1",10,3,12,5,3,1,0,0,1,7,9,19,2,8,28,"1-7","Y","N","N",4,0,14
"3112","P1",2023-12-17,"Sp Braga","Benfica",0,1,"A",0,1,"A",2.87,3.9,2.37,"0-1","0-1",16,6,11,6,3,3,0,0,5,2,11,9,1,7,20,"5-2","N","N","N",6,0,14
"3113","P1",2023-12-18,"Sp Lisbon","Porto",2,0,"H",1,0,"H",2.13,3.6,3.49,"1-0","2-0",11,6,5,3,4,4,0,1,2,2,21,15,2,4,36,"2-2","Y","N","N",8,1,14
"3114","P1",2023-12-23,"Guimaraes","Rio Ave",1,0,"H",0,0,"D",1.69,3.93,5.43,"0-0","1-0",5,3,9,4,4,3,0,0,4,8,13,18,1,12,31,"4-8","N","N","N",7,0,15
"3115","P1",2023-12-23,"Vizela","Moreirense",0,0,"D",0,0,"D",2.91,3.24,2.67,"0-0","0-0",9,3,10,5,3,1,0,0,3,9,16,8,0,12,24,"3-9","N","N","N",4,0,15
"3116","P1",2023-12-28,"Estrela","Arouca",1,4,"A",1,0,"H",2.63,3.38,2.8,"1-0","1-4",6,2,18,5,0,2,1,0,3,5,6,12,5,8,18,"3-5","Y","Y","Y",2,1,15
"3117","P1",2023-12-29,"Benfica","Famalicao",3,0,"H",1,0,"H",1.25,6.36,12.42,"1-0","3-0",17,10,12,3,2,3,0,0,6,4,21,14,3,10,35,"6-4","Y","Y","N",5,0,15
"3118","P1",2023-12-29,"Porto","Chaves",1,0,"H",0,0,"D",1.16,8.57,17.28,"0-0","1-0",17,10,5,2,3,5,0,0,8,3,20,11,1,11,31,"8-3","N","N","N",8,0,15
"3119","P1",2023-12-30,"Estoril","Farense",4,0,"H",2,0,"H",2.06,3.87,3.52,"2-0","4-0",12,7,14,4,2,2,0,0,10,8,8,18,4,18,26,"10-8","Y","Y","Y",4,0,15
"3120","P1",2023-12-30,"Gil Vicente","Boavista",1,0,"H",0,0,"D",2.29,3.46,3.32,"0-0","1-0",11,3,8,1,0,1,0,0,4,3,15,15,1,7,30,"4-3","N","N","N",1,0,15
"3121","P1",2023-12-30,"Casa Pia","Sp Braga",1,3,"A",0,0,"D",5.49,4.25,1.63,"0-0","1-3",7,3,11,6,1,0,0,0,2,3,9,7,4,5,16,"2-3","Y","Y","Y",1,0,15
"3122","P1",2023-12-30,"Portimonense","Sp Lisbon",1,2,"A",0,0,"D",9.47,5.99,1.32,"0-0","1-2",7,3,14,6,4,3,0,0,0,12,11,12,3,12,23,"0-12","Y","Y","N",7,0,15
"3123","P1",2024-01-05,"Sp Lisbon","Estoril",5,1,"H",2,0,"H",1.23,6.97,12.24,"2-0","5-1",21,8,11,3,1,3,0,0,5,7,6,10,6,12,16,"5-7","Y","Y","Y",4,0,16
"3124","P1",2024-01-05,"Boavista","Porto",1,1,"D",1,1,"D",7.55,5.09,1.42,"1-1","1-1",7,2,24,7,5,1,1,0,1,6,18,14,2,7,32,"1-6","Y","N","N",6,1,16
"3125","P1",2024-01-06,"Estrela","Vizela",1,1,"D",1,0,"H",2.61,3.34,2.9,"1-0","1-1",12,4,16,7,0,1,0,0,6,4,14,13,2,10,27,"6-4","Y","N","N",1,0,16
"3126","P1",2024-01-06,"Farense","Gil Vicente",1,0,"H",0,0,"D",2.19,3.67,3.35,"0-0","1-0",11,5,14,6,2,2,0,0,6,5,9,7,1,11,16,"6-5","N","N","N",4,0,16
"3127","P1",2024-01-06,"Arouca","Benfica",0,3,"A",0,1,"A",6.3,4.85,1.5,"0-1","0-3",11,1,11,5,2,2,0,0,1,3,12,5,3,4,17,"1-3","Y","Y","N",4,0,16
"3128","P1",2024-01-06,"Sp Braga","Guimaraes",1,1,"D",0,0,"D",1.58,4.52,5.58,"0-0","1-1",11,4,13,4,2,0,0,0,5,6,7,9,2,11,16,"5-6","Y","N","N",2,0,16
"3129","P1",2024-01-07,"Rio Ave","Portimonense",2,0,"H",0,0,"D",1.81,3.79,4.68,"0-0","2-0",9,3,7,3,1,3,0,0,3,6,9,13,2,9,22,"3-6","Y","N","N",4,0,16
"3130","P1",2024-01-07,"Famalicao","Chaves",2,2,"D",2,1,"H",1.79,3.8,4.79,"2-1","2-2",17,7,10,5,3,2,0,0,5,8,17,23,4,13,40,"5-8","Y","Y","Y",5,0,16
"3131","P1",2024-01-08,"Moreirense","Casa Pia",1,4,"A",1,3,"A",1.92,3.4,4.53,"1-3","1-4",13,4,10,7,2,2,0,0,4,3,15,24,5,7,39,"4-3","Y","Y","Y",4,0,16
"3132","P1",2024-01-12,"Portimonense","Farense",1,0,"H",0,0,"D",2.72,3.36,2.76,"0-0","1-0",12,4,8,3,2,3,0,0,4,4,19,9,1,8,28,"4-4","N","N","N",5,0,17
"3133","P1",2024-01-13,"Casa Pia","Famalicao",0,2,"A",0,1,"A",2.58,3.1,3.16,"0-1","0-2",8,1,13,4,1,1,1,0,6,3,13,15,2,9,28,"6-3","Y","N","N",2,1,17
"3134","P1",2024-01-13,"Chaves","Sp Lisbon",0,3,"A",0,1,"A",11.36,6.63,1.25,"0-1","0-3",5,0,17,10,1,2,0,0,2,5,11,14,3,7,25,"2-5","Y","Y","N",3,0,17
"3135","P1",2024-01-13,"Estoril","Moreirense",1,3,"A",0,2,"A",2.46,3.55,2.95,"0-2","1-3",9,5,12,7,2,3,0,0,8,1,15,11,4,9,26,"8-1","Y","Y","Y",5,0,17
"3136","P1",2024-01-14,"Gil Vicente","Estrela",1,1,"D",1,0,"H",2.18,3.57,3.45,"1-0","1-1",9,2,15,6,2,4,0,0,7,5,14,10,2,12,24,"7-5","Y","N","N",6,0,17
"3137","P1",2024-01-14,"Benfica","Rio Ave",4,1,"H",1,1,"D",1.19,7.68,14.49,"1-1","4-1",15,12,9,5,1,3,0,1,5,3,12,11,5,8,23,"5-3","Y","Y","Y",4,1,17
"3138","P1",2024-01-14,"Vizela","Boavista",1,4,"A",0,2,"A",2.22,3.35,3.58,"0-2","1-4",27,7,10,7,2,2,0,0,11,1,19,4,5,12,23,"11-1","Y","Y","Y",4,0,17
"3139","P1",2024-01-14,"Porto","Sp Braga",2,0,"H",1,0,"H",1.82,3.99,4.37,"1-0","2-0",8,4,10,5,3,5,0,0,5,5,12,15,2,10,27,"5-5","Y","N","N",8,0,17
"3140","P1",2024-01-15,"Guimaraes","Arouca",2,1,"H",1,1,"D",1.89,3.61,4.33,"1-1","2-1",15,6,9,2,0,3,0,0,10,1,8,7,3,11,15,"10-1","Y","Y","N",3,0,17
"3778","SC0",2023-08-05,"Celtic","Ross County",4,2,"H",3,0,"H",1.12,11.1,20.81,"3-0","4-2",18,12,7,2,0,4,0,0,4,8,6,14,6,12,20,"4-8","Y","Y","Y",4,0,1
"3779","SC0",2023-08-05,"Dundee","Motherwell",1,1,"D",0,1,"A",2.65,3.38,2.82,"0-1","1-1",17,2,13,3,0,2,0,0,7,12,12,12,2,19,24,"7-12","Y","N","N",2,0,1
"3780","SC0",2023-08-05,"Livingston","Aberdeen",0,0,"D",0,0,"D",2.99,3.32,2.55,"0-0","0-0",12,2,11,0,3,4,0,0,7,7,22,13,0,14,35,"7-7","N","N","N",7,0,1
"3781","SC0",2023-08-05,"St Johnstone","Hearts",0,2,"A",0,0,"D",3.27,3.68,2.22,"0-0","0-2",9,3,16,9,2,3,0,0,6,9,14,13,2,15,27,"6-9","Y","N","N",5,0,1
"3782","SC0",2023-08-05,"Kilmarnock","Rangers",1,0,"H",0,0,"D",7.25,4.98,1.44,"0-0","1-0",10,3,18,4,0,0,0,0,2,8,7,10,1,10,17,"2-8","N","N","N",0,0,1
"3783","SC0",2023-08-06,"Hibernian","St Mirren",2,3,"A",0,2,"A",1.93,3.65,4.17,"0-2","2-3",14,7,8,4,2,2,0,0,2,7,14,7,5,9,21,"2-7","Y","Y","Y",4,0,1
"3784","SC0",2023-08-12,"Rangers","Livingston",4,0,"H",1,0,"H",1.28,6.16,10.41,"1-0","4-0",21,9,6,2,1,1,0,0,5,4,9,9,4,9,18,"5-4","Y","Y","Y",2,0,2
"3785","SC0",2023-08-12,"Ross County","St Johnstone",2,0,"H",1,0,"H",2.2,3.34,3.64,"1-0","2-0",19,8,12,3,2,2,0,0,6,7,11,14,2,13,25,"6-7","Y","N","N",4,0,2
"3786","SC0",2023-08-12,"St Mirren","Dundee",2,1,"H",2,0,"H",2.09,3.45,3.83,"2-0","2-1",15,2,7,4,2,3,0,0,4,3,8,8,3,7,16,"4-3","Y","Y","N",5,0,2
"3787","SC0",2023-08-13,"Aberdeen","Celtic",1,3,"A",1,2,"A",8.1,5.6,1.37,"1-2","1-3",11,2,15,10,0,2,0,0,9,9,12,11,4,18,23,"9-9","Y","Y","Y",2,0,2
"3788","SC0",2023-08-13,"Hearts","Kilmarnock",0,0,"D",0,0,"D",1.89,3.73,4.31,"0-0","0-0",8,1,15,5,3,4,0,0,6,5,12,15,0,11,27,"6-5","N","N","N",7,0,2
"3789","SC0",2023-08-13,"Motherwell","Hibernian",2,1,"H",0,0,"D",2.69,3.32,2.82,"0-0","2-1",10,3,4,1,1,4,0,0,5,2,14,16,3,7,30,"5-2","Y","Y","N",5,0,2
"3790","SC0",2023-08-26,"Ross County","Rangers",0,2,"A",0,2,"A",8.67,5.53,1.36,"0-2","0-2",8,2,24,9,3,1,0,0,4,8,10,11,2,12,21,"4-8","Y","N","N",4,0,3
"3791","SC0",2023-08-26,"Celtic","St Johnstone",0,0,"D",0,0,"D",1.05,19.42,39.84,"0-0","0-0",19,5,5,2,1,3,0,0,19,1,9,12,0,20,21,"19-1","N","N","N",4,0,3
"3792","SC0",2023-08-26,"Hibernian","Livingston",2,3,"A",0,1,"A",1.88,3.82,4.25,"0-1","2-3",13,3,8,4,2,4,0,0,9,3,12,10,5,12,22,"9-3","Y","Y","Y",6,0,3
"3793","SC0",2023-08-26,"Motherwell","Kilmarnock",2,1,"H",0,1,"A",2.52,3.28,3.07,"0-1","2-1",13,7,12,3,6,3,0,0,1,6,15,19,3,7,34,"1-6","Y","Y","N",9,0,3
"3794","SC0",2023-08-27,"Dundee","Hearts",1,0,"H",0,0,"D",2.93,3.49,2.47,"0-0","1-0",12,4,10,5,1,1,0,0,3,8,16,10,1,11,26,"3-8","N","N","N",2,0,3
"3795","SC0",2023-08-27,"St Mirren","Aberdeen",2,2,"D",0,1,"A",2.35,3.33,3.32,"0-1","2-2",13,6,4,2,2,2,0,0,4,3,9,14,4,7,23,"4-3","Y","Y","Y",4,0,3
"3796","SC0",2023-09-02,"Kilmarnock","Ross County",0,1,"A",0,0,"D",1.93,3.6,4.33,"0-0","0-1",15,4,9,4,0,5,0,0,14,2,9,17,1,16,26,"14-2","N","N","N",5,0,4
"3797","SC0",2023-09-02,"Livingston","St Mirren",1,1,"D",0,0,"D",2.97,3.06,2.75,"0-0","1-1",13,2,8,4,3,1,0,0,6,2,17,13,2,8,30,"6-2","Y","N","N",4,0,4
"3798","SC0",2023-09-02,"St Johnstone","Dundee",2,2,"D",0,1,"A",2.72,3.34,2.77,"0-1","2-2",8,3,12,4,3,0,0,0,4,6,13,11,4,10,24,"4-6","Y","Y","Y",3,0,4
"3799","SC0",2023-09-03,"Rangers","Celtic",0,1,"A",0,1,"A",2.43,3.78,2.84,"0-1","0-1",17,3,7,5,1,1,0,0,6,2,15,15,1,8,30,"6-2","N","N","N",2,0,4
"3800","SC0",2023-09-03,"Aberdeen","Hibernian",0,2,"A",0,0,"D",2.34,3.47,3.19,"0-0","0-2",10,3,15,7,2,4,0,0,7,5,15,11,2,12,26,"7-5","Y","N","N",6,0,4
"3801","SC0",2023-09-03,"Hearts","Motherwell",0,1,"A",0,1,"A",2.01,3.69,3.8,"0-1","0-1",18,1,8,4,1,2,0,1,16,5,10,16,1,21,26,"16-5","N","N","N",3,1,4
"3802","SC0",2023-09-16,"St Johnstone","Rangers",0,2,"A",0,1,"A",12.28,6.42,1.25,"0-1","0-2",3,0,20,6,5,2,0,0,3,5,13,13,2,8,26,"3-5","Y","N","N",7,0,5
"3803","SC0",2023-09-16,"Celtic","Dundee",3,0,"H",0,0,"D",1.13,10.55,19.28,"0-0","3-0",19,7,4,1,0,0,0,0,9,1,6,7,3,10,13,"9-1","Y","Y","N",0,0,5
"3804","SC0",2023-09-16,"Hearts","Aberdeen",2,0,"H",1,0,"H",2.15,3.65,3.45,"1-0","2-0",12,4,11,5,4,2,0,0,9,3,11,12,2,12,23,"9-3","Y","N","N",6,0,5
"3805","SC0",2023-09-16,"Kilmarnock","Hibernian",2,2,"D",0,1,"A",2.65,3.27,2.91,"0-1","2-2",16,5,11,4,5,4,0,0,4,4,16,8,4,8,24,"4-4","Y","Y","Y",9,0,5
"3806","SC0",2023-09-16,"Motherwell","St Mirren",0,1,"A",0,0,"D",2.41,3.19,3.34,"0-0","0-1",20,7,9,3,0,5,0,0,8,3,6,18,1,11,24,"8-3","N","N","N",5,0,5
"3807","SC0",2023-09-16,"Ross County","Livingston",1,1,"D",0,0,"D",2.44,3.34,3.14,"0-0","1-1",16,5,5,2,0,3,0,0,6,2,14,13,2,8,27,"6-2","Y","N","N",3,0,5
"3808","SC0",2023-09-23,"Livingston","Celtic",0,3,"A",0,1,"A",10.91,6.27,1.27,"0-1","0-3",15,4,14,7,5,2,0,1,2,4,17,6,3,6,23,"2-4","Y","Y","N",7,1,6
"3809","SC0",2023-09-23,"Dundee","Kilmarnock",2,2,"D",1,1,"D",2.56,3.29,3.01,"1-1","2-2",10,3,23,3,1,3,1,0,4,7,8,12,4,11,20,"4-7","Y","Y","Y",4,1,6
"3810","SC0",2023-09-23,"Hibernian","St Johnstone",2,0,"H",1,0,"H",1.61,4.29,5.5,"1-0","2-0",17,8,12,1,1,3,0,0,4,4,9,10,2,8,19,"4-4","Y","N","N",4,0,6
"3811","SC0",2023-09-23,"St Mirren","Hearts",1,0,"H",1,0,"H",2.74,3.2,2.86,"1-0","1-0",13,5,11,3,2,1,0,0,4,8,13,12,1,12,25,"4-8","N","N","N",3,0,6
"3812","SC0",2023-09-24,"Aberdeen","Ross County",4,0,"H",2,0,"H",2,3.49,4.04,"2-0","4-0",13,6,11,2,0,4,0,0,5,5,9,10,4,10,19,"5-5","Y","Y","Y",4,0,6
"3813","SC0",2023-09-24,"Rangers","Motherwell",1,0,"H",1,0,"H",1.24,6.72,12.04,"1-0","1-0",17,7,9,4,2,2,0,0,2,2,14,15,1,4,29,"2-2","N","N","N",4,0,6
"3814","SC0",2023-09-30,"Motherwell","Celtic",1,2,"A",0,0,"D",10.22,5.91,1.31,"0-0","1-2",10,4,24,6,3,1,0,0,4,6,12,11,3,10,23,"4-6","Y","Y","N",4,0,7
"3815","SC0",2023-09-30,"Hibernian","Dundee",0,0,"D",0,0,"D",1.79,4.05,4.44,"0-0","0-0",23,9,11,2,1,4,0,0,14,1,7,10,0,15,17,"14-1","N","N","N",5,0,7
"3816","SC0",2023-09-30,"Kilmarnock","St Mirren",1,1,"D",1,1,"D",2.44,3.31,3.17,"1-1","1-1",12,2,8,3,2,3,0,0,7,6,15,16,2,13,31,"7-6","Y","N","N",5,0,7
"3817","SC0",2023-09-30,"Rangers","Aberdeen",1,3,"A",0,1,"A",1.28,6.23,10.73,"0-1","1-3",18,5,14,6,2,1,1,0,5,8,18,4,4,13,22,"5-8","Y","Y","Y",3,1,7
"3818","SC0",2023-09-30,"Ross County","Hearts",0,1,"A",0,0,"D",3.25,3.6,2.26,"0-0","0-1",9,1,17,3,3,2,0,0,5,5,15,10,1,10,25,"5-5","N","N","N",5,0,7
"3819","SC0",2023-09-30,"St Johnstone","Livingston",1,1,"D",1,0,"H",2.71,3.1,2.96,"1-0","1-1",12,2,7,3,2,2,1,0,5,2,14,14,2,7,28,"5-2","Y","N","N",4,1,7
"3820","SC0",2023-10-07,"Celtic","Kilmarnock",3,1,"H",2,0,"H",1.19,7.92,13.83,"2-0","3-1",27,12,6,1,2,2,0,0,11,1,9,7,4,12,16,"11-1","Y","Y","Y",4,0,8
"3821","SC0",2023-10-07,"Hearts","Hibernian",2,2,"D",1,0,"H",2.35,3.52,3.14,"1-0","2-2",21,5,17,3,2,1,0,0,7,4,12,9,4,11,21,"7-4","Y","Y","Y",3,0,8
"3822","SC0",2023-10-07,"Livingston","Motherwell",2,0,"H",0,0,"D",2.88,3.14,2.77,"0-0","2-0",11,3,3,2,1,3,0,1,3,5,12,15,2,8,27,"3-5","Y","N","N",4,1,8
"3823","SC0",2023-10-08,"St Mirren","Rangers",0,3,"A",0,1,"A",6.31,4.62,1.52,"0-1","0-3",3,0,13,8,1,2,1,0,3,10,8,16,3,13,24,"3-10","Y","Y","N",3,1,8
"3824","SC0",2023-10-08,"Aberdeen","St Johnstone",0,0,"D",0,0,"D",1.62,4.1,5.86,"0-0","0-0",10,3,9,0,0,2,0,0,5,3,11,11,0,8,22,"5-3","N","N","N",2,0,8
"3825","SC0",2023-10-21,"Kilmarnock","Livingston",3,1,"H",2,1,"H",1.93,3.54,4.38,"2-1","3-1",13,5,8,1,2,1,0,0,5,4,9,10,4,9,19,"5-4","Y","Y","Y",3,0,8
"3826","SC0",2023-10-21,"Rangers","Hibernian",4,0,"H",2,0,"H",1.36,5.38,8.91,"2-0","4-0",23,8,7,1,1,2,0,0,5,4,12,5,4,9,17,"5-4","Y","Y","Y",3,0,9
"3827","SC0",2023-10-22,"Hearts","Celtic",1,4,"A",0,2,"A",6.55,4.85,1.49,"0-2","1-4",13,6,19,7,2,1,0,0,3,5,16,11,5,8,27,"3-5","Y","Y","Y",3,0,9
"3828","SC0",2023-10-24,"Dundee","Ross County",0,0,"D",0,0,"D",2.04,3.56,3.88,"0-0","0-0",15,9,6,4,1,6,0,0,7,4,7,13,0,11,20,"7-4","N","N","N",7,0,9
"3829","SC0",2023-10-28,"Hibernian","Celtic",0,0,"D",0,0,"D",6.55,4.82,1.49,"0-0","0-0",6,1,21,4,0,2,0,0,3,6,4,12,0,9,16,"3-6","N","N","N",2,0,9
"3830","SC0",2023-10-28,"Livingston","Dundee",0,2,"A",0,0,"D",2.52,3.25,3.1,"0-0","0-2",4,0,18,7,0,0,1,0,1,5,13,15,2,6,28,"1-5","Y","N","N",0,1,9
"3831","SC0",2023-10-28,"Motherwell","Ross County",3,3,"D",0,0,"D",1.93,3.68,4.17,"0-0","3-3",13,3,13,6,2,2,0,0,6,4,10,9,6,10,19,"6-4","Y","Y","Y",4,0,9
"3832","SC0",2023-10-28,"St Mirren","St Johnstone",4,0,"H",1,0,"H",1.57,4.15,6.5,"1-0","4-0",9,5,14,3,2,0,0,0,4,8,9,5,4,12,14,"4-8","Y","Y","Y",2,0,10
"3833","SC0",2023-10-29,"Kilmarnock","Aberdeen",2,0,"H",1,0,"H",2.56,3.32,2.98,"1-0","2-0",19,8,5,1,1,3,0,0,9,3,12,14,2,12,26,"9-3","Y","N","N",4,0,10
"3834","SC0",2023-10-29,"Rangers","Hearts",2,1,"H",0,1,"A",1.31,5.92,10.1,"0-1","2-1",28,5,5,1,1,5,0,0,11,2,6,13,3,13,19,"11-2","Y","Y","N",6,0,10
"3835","SC0",2023-10-31,"Hibernian","Ross County",2,2,"D",1,0,"H",1.58,4.19,6.25,"1-0","2-2",7,2,8,3,1,2,0,0,5,5,12,16,4,10,28,"5-5","Y","Y","Y",3,0,10
"3836","SC0",2023-11-01,"Celtic","St Mirren",2,1,"H",1,1,"D",1.21,7.58,13.12,"1-1","2-1",23,8,6,2,2,2,0,0,12,2,9,12,3,14,21,"12-2","Y","Y","N",4,0,10
"3837","SC0",2023-11-01,"Dundee","Rangers",0,5,"A",0,1,"A",7.93,5.08,1.41,"0-1","0-5",9,4,32,11,4,1,0,0,6,7,13,3,5,13,16,"6-7","Y","Y","Y",5,0,10
"3838","SC0",2023-11-01,"Hearts","Livingston",1,0,"H",0,0,"D",1.65,3.92,5.86,"0-0","1-0",25,10,3,0,2,4,0,0,12,1,9,12,1,13,21,"12-1","N","N","N",6,0,11
"3839","SC0",2023-11-01,"Motherwell","Aberdeen",2,4,"A",0,2,"A",2.55,3.42,2.92,"0-2","2-4",9,2,15,6,6,1,0,0,1,4,14,6,6,5,20,"1-4","Y","Y","Y",7,0,11
"3840","SC0",2023-11-01,"St Johnstone","Kilmarnock",2,1,"H",2,0,"H",3.39,3.3,2.33,"2-0","2-1",15,4,23,5,2,2,1,0,5,12,13,9,3,17,22,"5-12","Y","Y","N",4,1,11
"3841","SC0",2023-11-04,"Ross County","Celtic",0,3,"A",0,1,"A",13.53,7.01,1.22,"0-1","0-3",3,0,39,16,0,1,1,0,2,13,9,10,3,15,19,"2-13","Y","Y","N",1,1,11
"3842","SC0",2023-11-04,"Kilmarnock","Motherwell",1,0,"H",0,0,"D",2.18,3.54,3.48,"0-0","1-0",20,8,11,1,2,1,0,0,9,3,9,12,1,12,21,"9-3","N","N","N",3,0,11
"3843","SC0",2023-11-05,"Dundee","Livingston",1,0,"H",0,0,"D",2.1,3.41,3.88,"0-0","1-0",10,3,16,3,2,3,0,0,5,12,14,14,1,17,28,"5-12","N","N","N",5,0,11
"3844","SC0",2023-11-07,"St Johnstone","Motherwell",2,2,"D",2,0,"H",2.91,3.1,2.77,"2-0","2-2",10,3,11,5,1,2,0,0,6,7,11,18,4,13,29,"6-7","Y","Y","Y",3,0,12
"3845","SC0",2023-11-08,"St Mirren","Hibernian",2,2,"D",0,1,"A",2.55,3.28,3.02,"0-1","2-2",18,4,9,4,3,2,0,0,3,1,9,9,4,4,18,"3-1","Y","Y","Y",5,0,12
"3846","SC0",2023-11-11,"Dundee","St Mirren",4,0,"H",2,0,"H",2.33,3.36,3.31,"2-0","4-0",11,7,5,0,1,1,0,0,7,4,6,12,4,11,18,"7-4","Y","Y","Y",2,0,12
"3847","SC0",2023-11-11,"Hibernian","Kilmarnock",1,0,"H",1,0,"H",2.17,3.6,3.47,"1-0","1-0",7,5,9,1,2,5,0,0,5,10,6,14,1,15,20,"5-10","N","N","N",7,0,12
"3848","SC0",2023-11-11,"Motherwell","Hearts",1,2,"A",0,1,"A",2.99,3.51,2.45,"0-1","1-2",8,1,14,3,4,2,0,0,4,10,13,12,3,14,25,"4-10","Y","Y","N",6,0,12
"3849","SC0",2023-11-11,"St Johnstone","Ross County",1,0,"H",0,0,"D",2.71,3.39,2.76,"0-0","1-0",10,3,8,2,4,3,0,0,3,4,11,13,1,7,24,"3-4","N","N","N",7,0,12
"3850","SC0",2023-11-12,"Livingston","Rangers",0,2,"A",0,1,"A",10.93,5.89,1.29,"0-1","0-2",4,1,18,6,1,1,0,0,3,9,14,7,2,12,21,"3-9","Y","N","N",2,0,13
"3851","SC0",2023-11-12,"Celtic","Aberdeen",6,0,"H",2,0,"H",1.23,7.21,12.14,"2-0","6-0",21,10,3,1,0,3,0,0,11,0,5,8,6,11,13,"11-0","Y","Y","Y",3,0,13
"3852","SC0",2023-11-25,"Celtic","Motherwell",1,1,"D",0,0,"D",1.14,9.94,18.23,"0-0","1-1",20,4,6,2,1,4,0,0,13,2,8,9,2,15,17,"13-2","Y","N","N",5,0,13
"3853","SC0",2023-11-25,"Dundee","Hibernian",1,2,"A",0,1,"A",2.74,3.33,2.76,"0-1","1-2",19,7,10,3,2,1,0,1,7,3,6,9,3,10,15,"7-3","Y","Y","N",3,1,13
"3854","SC0",2023-11-25,"Hearts","St Johnstone",1,0,"H",0,0,"D",1.58,4.17,6.31,"0-0","1-0",18,4,10,3,2,2,0,0,6,5,5,17,1,11,22,"6-5","N","N","N",4,0,13
"3855","SC0",2023-11-25,"Ross County","Kilmarnock",0,0,"D",0,0,"D",2.9,3.33,2.61,"0-0","0-0",15,5,13,1,1,0,0,0,9,5,10,9,0,14,19,"9-5","N","N","N",1,0,13
"3856","SC0",2023-11-25,"St Mirren","Livingston",1,0,"H",1,0,"H",1.8,3.71,4.89,"1-0","1-0",15,1,11,1,1,0,0,0,7,3,13,10,1,10,23,"7-3","N","N","N",1,0,14
"3857","SC0",2023-11-26,"Aberdeen","Rangers",1,1,"D",1,0,"H",6.19,4.59,1.53,"1-0","1-1",5,4,22,10,4,1,0,0,0,5,16,11,2,5,27,"0-5","Y","N","N",5,0,14
"3858","SC0",2023-11-28,"Ross County","St Mirren",1,0,"H",0,0,"D",2.81,3.04,2.91,"0-0","1-0",6,2,6,1,0,2,0,0,7,5,11,14,1,12,25,"7-5","N","N","N",2,0,14
"3859","SC0",2023-12-02,"Kilmarnock","Hearts",0,1,"A",0,1,"A",3.03,3.39,2.48,"0-1","0-1",17,3,11,1,2,1,0,0,7,3,14,12,1,10,26,"7-3","N","N","N",3,0,14
"3860","SC0",2023-12-02,"Motherwell","Dundee",3,3,"D",1,2,"A",2.34,3.41,3.25,"1-2","3-3",9,4,16,4,3,2,1,0,4,4,6,9,6,8,15,"4-4","Y","Y","Y",5,1,14
"3861","SC0",2023-12-03,"St Johnstone","Celtic",1,3,"A",1,0,"H",11.88,7.19,1.23,"1-0","1-3",5,3,25,7,2,1,0,0,2,12,8,7,4,14,15,"2-12","Y","Y","Y",3,0,14
"3862","SC0",2023-12-03,"Hibernian","Aberdeen",2,0,"H",1,0,"H",2.07,3.59,3.74,"1-0","2-0",11,3,23,5,3,2,0,0,6,6,13,13,2,12,26,"6-6","Y","N","N",5,0,15
"3863","SC0",2023-12-03,"Rangers","St Mirren",2,0,"H",1,0,"H",1.21,7.05,15.15,"1-0","2-0",21,6,4,3,1,3,0,0,8,5,9,8,2,13,17,"8-5","Y","N","N",4,0,15
"3864","SC0",2023-12-05,"Ross County","Motherwell",3,0,"H",2,0,"H",2.35,3.15,3.52,"2-0","3-0",13,6,14,4,1,2,1,0,6,3,14,9,3,9,23,"6-3","Y","Y","N",3,1,15
"3865","SC0",2023-12-06,"Aberdeen","Kilmarnock",0,1,"A",0,0,"D",2.37,3.38,3.23,"0-0","0-1",18,3,8,2,3,1,0,0,4,5,11,21,1,9,32,"4-5","N","N","N",4,0,15
"3866","SC0",2023-12-06,"Celtic","Hibernian",4,1,"H",2,0,"H",1.22,7.23,12.83,"2-0","4-1",26,12,6,3,2,2,0,0,11,4,10,8,5,15,18,"11-4","Y","Y","Y",4,0,15
"3867","SC0",2023-12-06,"St Johnstone","St Mirren",1,0,"H",0,0,"D",3.18,3.12,2.55,"0-0","1-0",11,5,13,5,2,1,0,0,0,7,9,10,1,7,19,"0-7","N","N","N",3,0,15
"3868","SC0",2023-12-06,"Hearts","Rangers",0,1,"A",0,1,"A",6.16,4.47,1.55,"0-1","0-1",12,5,22,5,3,1,0,0,6,5,13,11,1,11,24,"6-5","N","N","N",4,0,16
"3869","SC0",2023-12-09,"Aberdeen","Hearts",2,1,"H",0,1,"A",2.65,3.48,2.76,"0-1","2-1",14,6,5,3,3,7,0,0,3,8,13,20,3,11,33,"3-8","Y","Y","N",10,0,16
"3870","SC0",2023-12-09,"Livingston","Hibernian",0,1,"A",0,1,"A",3.62,3.48,2.15,"0-1","0-1",14,3,4,2,3,1,0,0,6,0,11,13,1,6,24,"6-0","N","N","N",4,0,16
"3871","SC0",2023-12-09,"Motherwell","St Johnstone",1,1,"D",0,0,"D",2.2,3.25,3.76,"0-0","1-1",17,8,11,2,0,0,0,0,3,2,11,11,2,5,22,"3-2","Y","N","N",0,0,16
"3872","SC0",2023-12-09,"Rangers","Dundee",3,1,"H",3,1,"H",1.17,8.34,16.65,"3-1","3-1",20,9,9,3,1,3,1,0,5,7,12,9,4,12,21,"5-7","Y","Y","Y",4,1,16
"3873","SC0",2023-12-09,"St Mirren","Ross County",2,0,"H",0,0,"D",2.26,3.24,3.62,"0-0","2-0",15,6,9,2,2,0,0,0,10,4,9,12,2,14,21,"10-4","Y","N","N",2,0,16
"3874","SC0",2023-12-10,"Kilmarnock","Celtic",2,1,"H",0,1,"A",8.83,5.41,1.36,"0-1","2-1",13,6,16,7,3,1,0,0,5,9,14,12,3,14,26,"5-9","Y","Y","N",4,0,17
"3875","SC0",2023-12-16,"Celtic","Hearts",0,2,"A",0,2,"A",1.25,6.59,11.28,"0-2","0-2",22,5,5,2,1,0,0,0,18,3,12,3,2,21,15,"18-3","Y","N","N",1,0,17
"3876","SC0",2023-12-16,"Livingston","Kilmarnock",0,0,"D",0,0,"D",3.64,3.26,2.24,"0-0","0-0",8,1,11,3,2,1,0,0,0,8,17,11,0,8,28,"0-8","N","N","N",3,0,17
"3877","SC0",2023-12-16,"Ross County","Dundee",0,1,"A",0,0,"D",2.36,3.3,3.33,"0-0","0-1",10,3,17,3,1,2,0,0,2,9,10,10,1,11,20,"2-9","N","N","N",3,0,17
"3878","SC0",2023-12-16,"St Johnstone","Hibernian",1,0,"H",0,0,"D",3.65,3.35,2.19,"0-0","1-0",14,7,3,0,2,3,0,0,5,5,10,8,1,10,18,"5-5","N","N","N",5,0,17
"3879","SC0",2023-12-16,"St Mirren","Motherwell",0,0,"D",0,0,"D",2.02,3.36,4.22,"0-0","0-0",11,3,8,4,1,1,0,0,6,4,11,11,0,10,22,"6-4","N","N","N",2,0,17
"3880","SC0",2023-12-20,"Aberdeen","Livingston",2,1,"H",1,1,"D",1.72,3.92,5.14,"1-1","2-1",11,6,11,4,0,3,0,0,1,3,8,15,3,4,23,"1-3","Y","Y","N",3,0,18
"3881","SC0",2023-12-20,"Rangers","St Johnstone",2,0,"H",1,0,"H",1.13,9.84,21.17,"1-0","2-0",28,8,2,0,2,2,0,1,10,2,7,11,2,12,18,"10-2","Y","N","N",4,1,18
"3882","SC0",2023-12-23,"Celtic","Livingston",2,0,"H",0,0,"D",1.1,11.68,25.45,"0-0","2-0",22,7,0,0,0,1,0,0,14,0,5,4,2,14,9,"14-0","Y","N","N",1,0,18
"3883","SC0",2023-12-23,"Hearts","St Mirren",2,0,"H",1,0,"H",2,3.49,4.11,"1-0","2-0",12,6,11,4,2,3,0,0,8,6,16,9,2,14,25,"8-6","Y","N","N",5,0,18
"3884","SC0",2023-12-23,"Kilmarnock","St Johnstone",2,1,"H",2,0,"H",1.75,3.67,5.4,"2-0","2-1",14,5,9,4,0,1,0,0,5,1,12,8,3,6,20,"5-1","Y","Y","N",1,0,18
"3885","SC0",2023-12-24,"Motherwell","Rangers",0,2,"A",0,2,"A",9.66,5.57,1.34,"0-2","0-2",7,0,14,6,3,1,0,0,3,5,16,10,2,8,26,"3-5","Y","N","N",4,0,18
"3886","SC0",2023-12-26,"Dundee","Celtic",0,3,"A",0,0,"D",9.98,6.14,1.3,"0-0","0-3",5,1,38,7,1,1,0,0,1,23,3,9,3,24,12,"1-23","Y","Y","N",2,0,19
"3887","SC0",2023-12-27,"Livingston","St Johnstone",0,0,"D",0,0,"D",2.38,3.13,3.41,"0-0","0-0",14,3,4,2,2,2,0,0,6,3,12,12,0,9,24,"6-3","N","N","N",4,0,19
"3888","SC0",2023-12-27,"St Mirren","Kilmarnock",0,1,"A",0,1,"A",2.71,3.08,2.94,"0-1","0-1",11,6,12,3,3,2,0,0,4,4,7,10,1,8,17,"4-4","N","N","N",5,0,19
"3889","SC0",2023-12-27,"Hibernian","Hearts",0,1,"A",0,0,"D",2.59,3.39,2.84,"0-0","0-1",16,3,10,3,2,3,0,0,6,5,11,10,1,11,21,"6-5","N","N","N",5,0,19
"3890","SC0",2023-12-30,"Celtic","Rangers",2,1,"H",1,0,"H",2.21,3.56,3.39,"1-0","2-1",12,5,14,3,7,3,0,1,4,2,18,14,3,6,32,"4-2","Y","Y","N",10,1,19
"3891","SC0",2023-12-30,"Aberdeen","St Mirren",0,3,"A",0,1,"A",1.99,3.47,4.17,"0-1","0-3",18,3,10,5,1,0,0,0,13,2,9,11,3,15,20,"13-2","Y","Y","N",1,0,19
"3892","SC0",2023-12-30,"Hearts","Ross County",2,2,"D",0,0,"D",1.72,3.84,5.3,"0-0","2-2",20,7,14,2,2,2,0,0,9,5,14,14,4,14,28,"9-5","Y","Y","Y",4,0,20
"3893","SC0",2023-12-30,"Kilmarnock","Dundee",2,2,"D",0,1,"A",1.86,3.63,4.63,"0-1","2-2",11,4,7,2,2,1,0,0,7,8,12,10,4,15,22,"7-8","Y","Y","Y",3,0,20
"3894","SC0",2023-12-30,"Motherwell","Livingston",3,1,"H",3,1,"H",2.03,3.37,4.18,"3-1","3-1",7,4,10,1,4,3,0,0,4,3,12,14,4,7,26,"4-3","Y","Y","Y",7,0,20
"3895","SC0",2024-01-02,"Hibernian","Motherwell",2,2,"D",1,1,"D",2.03,3.52,3.99,"1-1","2-2",12,3,9,4,2,2,0,0,7,3,10,10,4,10,20,"7-3","Y","Y","Y",4,0,20
"3896","SC0",2024-01-02,"Livingston","Hearts",1,2,"A",0,0,"D",4.35,3.6,1.92,"0-0","1-2",10,3,10,5,1,3,0,0,2,3,12,16,3,5,28,"2-3","Y","Y","N",4,0,20
"3897","SC0",2024-01-02,"Rangers","Kilmarnock",3,1,"H",2,0,"H",1.24,6.52,13.01,"2-0","3-1",18,6,6,2,1,3,0,0,7,5,10,13,4,12,23,"7-5","Y","Y","Y",4,0,20
"3898","SC0",2024-01-02,"Ross County","Aberdeen",0,3,"A",0,2,"A",3.34,3.37,2.31,"0-2","0-3",5,3,16,7,4,3,1,0,4,5,14,9,3,9,23,"4-5","Y","Y","N",7,1,21
"3899","SC0",2024-01-02,"St Mirren","Celtic",0,3,"A",0,2,"A",12.95,6.28,1.25,"0-2","0-3",3,0,24,11,0,0,1,0,1,12,9,8,3,13,17,"1-12","Y","Y","N",0,1,21
"3900","SC1",2023-08-04,"Arbroath","Dundee United",0,4,"A",0,4,"A",3.88,3.26,2.08,"0-4","0-4",3,1,15,7,2,0,0,0,6,10,13,3,4,16,16,"6-10","Y","Y","Y",2,0,1
"3901","SC1",2023-08-05,"Dunfermline","Airdrie Utd",2,1,"H",1,1,"D",1.96,3.69,3.78,"1-1","2-1",13,5,12,3,1,1,1,0,4,5,11,9,3,9,20,"4-5","Y","Y","N",2,1,1
"3902","SC1",2023-08-05,"Inverness C","Queens Park",1,2,"A",0,1,"A",2.21,3.63,3.16,"0-1","1-2",12,6,12,7,1,3,0,0,5,4,9,10,3,9,19,"5-4","Y","Y","N",4,0,1
"3903","SC1",2023-08-05,"Morton","Ayr",3,1,"H",0,0,"D",2.6,3.29,2.81,"0-0","3-1",19,6,7,4,3,5,0,0,3,4,9,16,4,7,25,"3-4","Y","Y","Y",8,0,1
"3904","SC1",2023-08-05,"Partick","Raith Rvs",2,2,"D",2,0,"H",1.75,3.87,4.59,"2-0","2-2",14,5,14,6,1,2,0,0,7,4,8,9,4,11,17,"7-4","Y","Y","Y",3,0,1
"3905","SC1",2023-08-12,"Airdrie Utd","Partick",2,1,"H",0,1,"A",3,3.61,2.21,"0-1","2-1",11,2,7,2,0,0,0,0,6,4,6,9,3,10,15,"6-4","Y","Y","N",0,0,2
"3906","SC1",2023-08-12,"Ayr","Inverness C",1,0,"H",1,0,"H",2.01,3.63,3.66,"1-0","1-0",7,3,10,4,2,2,0,0,5,3,10,13,1,8,23,"5-3","N","N","N",4,0,2
"3907","SC1",2023-08-12,"Dundee United","Dunfermline",1,1,"D",0,0,"D",1.65,4.24,4.79,"0-0","1-1",16,4,5,2,0,2,0,0,10,4,14,3,2,14,17,"10-4","Y","N","N",2,0,2
"3908","SC1",2023-08-12,"Queens Park","Arbroath",2,1,"H",1,0,"H",1.69,3.99,4.68,"1-0","2-1",14,5,6,1,3,1,0,0,15,2,8,7,3,17,15,"15-2","Y","Y","N",4,0,2
"3909","SC1",2023-08-12,"Raith Rvs","Morton",3,2,"H",2,1,"H",2.52,3.46,2.79,"2-1","3-2",4,4,3,2,5,8,0,0,5,6,8,13,5,11,21,"5-6","Y","Y","Y",13,0,2
"3910","SC1",2023-08-19,"Arbroath","Queens Park",0,1,"A",0,0,"D",3.49,3.44,2.14,"0-0","0-1",12,3,4,3,1,2,0,0,3,6,15,9,1,9,24,"3-6","N","N","N",3,0,3
"3911","SC1",2023-08-26,"Airdrie Utd","Inverness C",2,1,"H",2,0,"H",2.17,3.58,3.28,"2-0","2-1",8,3,19,6,1,3,1,0,1,3,11,15,3,4,26,"1-3","Y","Y","N",4,1,3
"3912","SC1",2023-08-26,"Ayr","Dundee United",0,3,"A",0,0,"D",3.21,3.34,2.31,"0-0","0-3",2,2,13,8,1,2,0,0,4,11,8,9,3,15,17,"4-11","Y","Y","N",3,0,3
"3913","SC1",2023-08-26,"Dunfermline","Raith Rvs",0,1,"A",0,1,"A",2.34,3.41,3.09,"0-1","0-1",5,2,3,2,2,2,0,0,12,2,8,7,1,14,15,"12-2","N","N","N",4,0,3
"3914","SC1",2023-08-26,"Morton","Arbroath",0,3,"A",0,1,"A",1.69,3.7,5.33,"0-1","0-3",17,8,13,6,2,3,0,0,14,6,11,17,3,20,28,"14-6","Y","Y","N",5,0,3
"3915","SC1",2023-08-26,"Partick","Queens Park",3,1,"H",2,1,"H",2.01,3.82,3.5,"2-1","3-1",10,6,14,4,2,1,0,0,1,6,8,10,4,7,18,"1-6","Y","Y","Y",3,0,4
"3916","SC1",2023-09-02,"Arbroath","Ayr",2,1,"H",1,1,"D",2.8,2.96,2.87,"1-1","2-1",11,6,9,3,3,1,0,0,5,7,9,7,3,12,16,"5-7","Y","Y","N",4,0,4
"3917","SC1",2023-09-02,"Dundee United","Airdrie Utd",2,0,"H",1,0,"H",1.64,4,5.26,"1-0","2-0",9,3,9,3,2,2,0,0,5,3,14,8,2,8,22,"5-3","Y","N","N",4,0,4
"3918","SC1",2023-09-02,"Inverness C","Dunfermline",1,1,"D",1,0,"H",2.35,3.39,3.09,"1-0","1-1",7,2,10,4,2,1,0,0,2,7,10,7,2,9,17,"2-7","Y","N","N",3,0,4
"3919","SC1",2023-09-02,"Morton","Partick",1,4,"A",1,1,"D",2.56,3.61,2.66,"1-1","1-4",15,8,13,6,1,0,0,1,2,7,6,6,5,9,12,"2-7","Y","Y","Y",1,1,4
"3920","SC1",2023-09-02,"Raith Rvs","Queens Park",3,2,"H",1,0,"H",2.14,3.68,3.28,"1-0","3-2",8,7,4,2,1,0,0,1,8,1,5,10,5,9,15,"8-1","Y","Y","Y",1,1,5
"3921","SC1",2023-09-15,"Ayr","Partick",0,4,"A",0,1,"A",3.29,3.73,2.12,"0-1","0-4",13,10,11,5,3,1,0,0,9,3,6,7,4,12,13,"9-3","Y","Y","Y",4,0,5
"3922","SC1",2023-09-16,"Arbroath","Airdrie Utd",4,0,"H",2,0,"H",2.43,3.68,2.77,"2-0","4-0",11,6,6,0,0,1,1,1,2,5,13,8,4,7,21,"2-5","Y","Y","Y",1,2,5
"3923","SC1",2023-09-16,"Dundee United","Morton",1,1,"D",1,0,"H",1.67,4.02,4.94,"1-0","1-1",9,1,7,1,1,3,1,0,5,4,15,12,2,9,27,"5-4","Y","N","N",4,1,5
"3924","SC1",2023-09-16,"Queens Park","Dunfermline",0,2,"A",0,0,"D",2.31,3.52,3.05,"0-0","0-2",14,2,15,5,2,3,0,0,8,9,11,7,2,17,18,"8-9","Y","N","N",5,0,5
"3925","SC1",2023-09-16,"Raith Rvs","Inverness C",1,0,"H",0,0,"D",1.88,3.69,3.95,"0-0","1-0",7,2,8,5,2,2,0,0,3,7,9,15,1,10,24,"3-7","N","N","N",4,0,6
"3926","SC1",2023-09-22,"Queens Park","Ayr",2,5,"A",1,4,"A",2.07,3.61,3.49,"1-4","2-5",12,4,10,6,2,0,0,0,4,2,8,7,7,6,15,"4-2","Y","Y","Y",2,0,6
"3927","SC1",2023-09-23,"Airdrie Utd","Raith Rvs",1,0,"H",0,0,"D",2.41,3.57,2.86,"0-0","1-0",7,3,11,6,1,4,0,0,2,1,8,9,1,3,17,"2-1","N","N","N",5,0,6
"3928","SC1",2023-09-23,"Dunfermline","Morton",3,1,"H",2,0,"H",2.07,3.48,3.65,"2-0","3-1",10,5,9,2,0,3,0,0,10,4,8,14,4,14,22,"10-4","Y","Y","Y",3,0,6
"3929","SC1",2023-09-23,"Inverness C","Dundee United",0,1,"A",0,0,"D",3.69,3.48,2.05,"0-0","0-1",8,2,12,4,2,3,0,1,4,2,6,13,1,6,19,"4-2","N","N","N",5,1,6
"3930","SC1",2023-09-23,"Partick","Arbroath",0,3,"A",0,2,"A",1.62,4.17,5.18,"0-2","0-3",8,1,19,7,3,2,0,0,4,6,12,10,3,10,22,"4-6","Y","Y","N",5,0,7
"3931","SC1",2023-09-30,"Arbroath","Inverness C",2,3,"A",0,2,"A",2.19,3.6,3.14,"0-2","2-3",11,3,7,6,1,1,0,0,8,2,14,18,5,10,32,"8-2","Y","Y","Y",2,0,7
"3932","SC1",2023-09-30,"Ayr","Raith Rvs",1,2,"A",0,2,"A",2.78,3.45,2.5,"0-2","1-2",13,4,8,3,2,2,0,0,8,4,10,6,3,12,16,"8-4","Y","Y","N",4,0,7
"3933","SC1",2023-09-30,"Dundee United","Queens Park",4,1,"H",1,1,"D",1.56,4.24,5.82,"1-1","4-1",14,5,8,3,0,2,0,0,4,2,7,7,5,6,14,"4-2","Y","Y","Y",2,0,7
"3934","SC1",2023-09-30,"Morton","Airdrie Utd",0,1,"A",0,1,"A",2.16,3.81,3.13,"0-1","0-1",13,1,8,2,2,3,0,0,6,3,12,13,1,9,25,"6-3","N","N","N",5,0,7
"3935","SC1",2023-09-30,"Partick","Dunfermline",3,0,"H",1,0,"H",1.99,3.78,3.5,"1-0","3-0",23,12,19,4,3,1,0,0,4,9,8,5,3,13,13,"4-9","Y","Y","N",4,0,8
"3936","SC1",2023-10-07,"Airdrie Utd","Ayr",1,2,"A",0,1,"A",2.09,3.51,3.55,"0-1","1-2",8,3,11,3,1,1,0,0,7,7,5,9,3,14,14,"7-7","Y","Y","N",2,0,8
"3937","SC1",2023-10-07,"Inverness C","Partick",0,0,"D",0,0,"D",3.01,3.47,2.36,"0-0","0-0",4,1,4,3,0,1,0,0,6,4,10,8,0,10,18,"6-4","N","N","N",1,0,8
"3938","SC1",2023-10-07,"Queens Park","Morton",0,0,"D",0,0,"D",2.3,3.67,2.96,"0-0","0-0",11,4,7,2,1,3,0,0,10,3,10,8,0,13,18,"10-3","N","N","N",4,0,8
"3939","SC1",2023-10-07,"Raith Rvs","Dundee United",1,1,"D",1,0,"H",3.01,3.56,2.32,"1-0","1-1",7,6,7,4,3,4,0,0,3,3,15,13,2,6,28,"3-3","Y","N","N",7,0,8
"3940","SC1",2023-10-20,"Airdrie Utd","Queens Park",1,1,"D",1,0,"H",2.28,3.69,2.98,"1-0","1-1",10,6,13,6,0,3,0,1,1,5,12,12,2,6,24,"1-5","Y","N","N",3,1,9
"3941","SC1",2023-10-21,"Dunfermline","Ayr",0,1,"A",0,1,"A",1.94,3.5,4.08,"0-1","0-1",9,1,15,5,0,1,0,0,4,11,8,14,1,15,22,"4-11","N","N","N",1,0,9
"3942","SC1",2023-10-21,"Partick","Dundee United",0,5,"A",0,1,"A",2.81,3.58,2.4,"0-1","0-5",7,2,13,8,1,2,1,0,2,4,9,12,5,6,21,"2-4","Y","Y","Y",3,1,9
"3943","SC1",2023-10-27,"Dundee United","Arbroath",6,0,"H",3,0,"H",1.5,4.43,6.43,"3-0","6-0",18,10,5,2,0,1,0,0,10,5,5,7,6,15,12,"10-5","Y","Y","Y",1,0,9
"3944","SC1",2023-10-27,"Queens Park","Partick",2,2,"D",0,1,"A",2.82,3.66,2.4,"0-1","2-2",18,8,5,4,2,0,0,0,9,1,7,11,4,10,18,"9-1","Y","Y","Y",2,0,9
"3945","SC1",2023-10-28,"Ayr","Morton",0,1,"A",0,0,"D",2.02,3.7,3.57,"0-0","0-1",13,6,10,5,2,4,0,0,4,10,15,17,1,14,32,"4-10","N","N","N",6,0,10
"3946","SC1",2023-10-28,"Inverness C","Airdrie Utd",1,0,"H",1,0,"H",2.28,3.64,3.03,"1-0","1-0",7,2,9,4,2,2,0,0,3,5,9,12,1,8,21,"3-5","N","N","N",4,0,10
"3947","SC1",2023-10-28,"Raith Rvs","Dunfermline",1,0,"H",0,0,"D",2.19,3.44,3.36,"0-0","1-0",8,2,10,6,1,3,0,0,6,9,5,11,1,15,16,"6-9","N","N","N",4,0,10
"3948","SC1",2023-10-31,"Airdrie Utd","Dundee United",0,2,"A",0,1,"A",5.07,4.17,1.63,"0-1","0-2",10,3,10,5,0,0,0,0,9,3,8,6,2,12,14,"9-3","Y","N","N",0,0,10
"3949","SC1",2023-10-31,"Morton","Raith Rvs",1,2,"A",0,2,"A",3.01,3.08,2.58,"0-2","1-2",10,5,13,3,4,2,0,0,5,5,11,9,3,10,20,"5-5","Y","Y","N",6,0,10
"3950","SC1",2023-10-31,"Partick","Ayr",2,2,"D",1,1,"D",1.96,4,3.5,"1-1","2-2",13,6,8,4,1,0,0,0,4,3,12,13,4,7,25,"4-3","Y","Y","Y",1,0,11
"3951","SC1",2023-11-03,"Morton","Dunfermline",1,2,"A",0,2,"A",2.61,3.17,2.9,"0-2","1-2",10,7,11,5,4,2,0,0,7,6,11,9,3,13,20,"7-6","Y","Y","N",6,0,11
"3952","SC1",2023-11-04,"Arbroath","Partick",1,3,"A",0,1,"A",2.76,3.55,2.5,"0-1","1-3",7,3,10,8,2,1,0,0,7,9,13,12,4,16,25,"7-9","Y","Y","Y",3,0,11
"3953","SC1",2023-11-04,"Ayr","Queens Park",2,2,"D",2,0,"H",2.1,3.84,3.25,"2-0","2-2",10,6,7,3,0,2,0,0,2,7,5,9,4,9,14,"2-7","Y","Y","Y",2,0,11
"3954","SC1",2023-11-04,"Dundee United","Inverness C",1,1,"D",0,0,"D",1.37,5.09,7.93,"0-0","1-1",13,7,4,2,1,1,0,0,5,3,11,7,2,8,18,"5-3","Y","N","N",2,0,11
"3955","SC1",2023-11-04,"Raith Rvs","Airdrie Utd",1,1,"D",1,0,"H",1.68,4.08,4.78,"1-0","1-1",10,5,16,9,0,1,0,0,6,3,10,8,2,9,18,"6-3","Y","N","N",1,0,12
"3956","SC1",2023-11-10,"Dunfermline","Dundee United",1,2,"A",0,1,"A",4.08,3.88,1.83,"0-1","1-2",6,2,16,5,4,3,0,0,3,7,7,9,3,10,16,"3-7","Y","Y","N",7,0,12
"3957","SC1",2023-11-11,"Airdrie Utd","Arbroath",2,0,"H",1,0,"H",2.24,3.65,3.08,"1-0","2-0",6,5,8,1,0,0,0,0,5,5,10,12,2,10,22,"5-5","Y","N","N",0,0,12
"3958","SC1",2023-11-11,"Inverness C","Ayr",3,1,"H",3,0,"H",2.44,3.5,2.87,"3-0","3-1",5,5,5,1,2,0,0,0,5,4,8,9,4,9,17,"5-4","Y","Y","Y",2,0,12
"3959","SC1",2023-11-11,"Partick","Morton",2,1,"H",1,1,"D",1.79,4.12,4.06,"1-1","2-1",10,5,6,2,2,3,1,0,2,2,15,14,3,4,29,"2-2","Y","Y","N",5,1,12
"3960","SC1",2023-11-11,"Queens Park","Raith Rvs",2,3,"A",0,1,"A",3.18,3.39,2.3,"0-1","2-3",18,9,12,6,2,1,1,0,5,1,11,6,5,6,17,"5-1","Y","Y","Y",3,1,13
"3961","SC1",2023-11-18,"Dunfermline","Inverness C",1,1,"D",0,1,"A",2.31,3.37,3.18,"0-1","1-1",12,2,5,2,2,3,0,0,10,7,2,5,2,17,7,"10-7","Y","N","N",5,0,13
"3962","SC1",2023-11-28,"Dunfermline","Arbroath",3,0,"H",0,0,"D",1.96,3.7,3.74,"0-0","3-0",17,9,6,0,1,1,0,0,12,1,8,7,3,13,15,"12-1","Y","Y","N",2,0,13
"3963","SC1",2023-12-02,"Inverness C","Raith Rvs",1,2,"A",0,0,"D",3.43,3.39,2.18,"0-0","1-2",6,2,13,5,2,2,0,0,3,10,12,5,3,13,17,"3-10","Y","Y","N",4,0,13
"3964","SC1",2023-12-02,"Partick","Airdrie Utd",2,1,"H",2,0,"H",1.76,4.18,4.15,"2-0","2-1",7,3,7,4,1,0,0,0,4,8,7,7,3,12,14,"4-8","Y","Y","N",1,0,13
"3965","SC1",2023-12-08,"Raith Rvs","Partick",4,3,"H",1,0,"H",2.31,3.6,2.99,"1-0","4-3",17,9,10,3,2,3,0,0,10,9,13,11,7,19,24,"10-9","Y","Y","Y",5,0,14
"3966","SC1",2023-12-09,"Airdrie Utd","Dunfermline",1,2,"A",0,1,"A",2.69,3.33,2.69,"0-1","1-2",12,5,9,6,2,0,0,0,8,4,10,3,3,12,13,"8-4","Y","Y","N",2,0,14
"3967","SC1",2023-12-09,"Arbroath","Morton",1,2,"A",0,1,"A",2.74,3.42,2.58,"0-1","1-2",10,2,10,5,1,3,0,0,7,4,8,10,3,11,18,"7-4","Y","Y","N",4,0,14
"3968","SC1",2023-12-09,"Dundee United","Ayr",1,0,"H",0,0,"D",1.41,4.91,7.26,"0-0","1-0",14,5,5,2,0,3,0,0,13,4,1,9,1,17,10,"13-4","N","N","N",3,0,14
"3969","SC1",2023-12-09,"Queens Park","Inverness C",1,4,"A",1,1,"D",2.42,3.6,2.83,"1-1","1-4",5,3,16,11,2,0,0,0,2,3,7,4,5,5,11,"2-3","Y","Y","Y",2,0,14
"3970","SC1",2023-12-12,"Morton","Inverness C",2,1,"H",1,0,"H",2.77,3.24,2.67,"1-0","2-1",13,5,7,2,5,2,0,0,8,2,11,7,3,10,18,"8-2","Y","Y","N",7,0,15
"3971","SC1",2023-12-13,"Arbroath","Raith Rvs",1,2,"A",1,1,"D",4.42,3.9,1.78,"1-1","1-2",5,2,8,5,2,2,0,0,3,6,17,9,3,9,26,"3-6","Y","Y","N",4,0,15
"3972","SC1",2023-12-16,"Ayr","Airdrie Utd",1,0,"H",1,0,"H",2.22,3.42,3.31,"1-0","1-0",9,2,14,4,1,3,0,0,4,1,7,8,1,5,15,"4-1","N","N","N",4,0,15
"3973","SC1",2023-12-16,"Dundee United","Raith Rvs",0,1,"A",0,0,"D",1.57,4.15,5.85,"0-0","0-1",13,4,5,3,3,2,0,0,9,3,18,11,1,12,29,"9-3","N","N","N",5,0,15
"3974","SC1",2023-12-16,"Dunfermline","Partick",1,2,"A",0,2,"A",2.57,3.5,2.71,"0-2","1-2",5,3,4,3,1,3,0,0,3,5,4,10,3,8,14,"3-5","Y","Y","N",4,0,15
"3975","SC1",2023-12-16,"Inverness C","Arbroath",1,2,"A",1,2,"A",1.72,3.89,4.79,"1-2","1-2",11,2,8,6,1,4,0,0,7,4,11,15,3,11,26,"7-4","Y","Y","N",5,0,16
"3976","SC1",2023-12-16,"Morton","Queens Park",1,0,"H",1,0,"H",2.16,3.64,3.25,"1-0","1-0",8,5,14,6,3,1,1,0,3,7,9,12,1,10,21,"3-7","N","N","N",4,1,16
"3977","SC1",2023-12-22,"Queens Park","Dundee United",0,0,"D",0,0,"D",5.86,4.55,1.52,"0-0","0-0",5,1,16,5,2,1,0,0,4,8,9,8,0,12,17,"4-8","N","N","N",3,0,16
"3978","SC1",2023-12-22,"Raith Rvs","Ayr",4,4,"D",2,1,"H",1.71,3.88,4.82,"2-1","4-4",13,7,10,8,1,0,0,1,9,3,9,11,8,12,20,"9-3","Y","Y","Y",1,1,16
"3979","SC1",2023-12-23,"Airdrie Utd","Morton",0,0,"D",0,0,"D",2.28,3.37,3.23,"0-0","0-0",5,1,7,1,1,1,0,0,3,6,13,7,0,9,20,"3-6","N","N","N",2,0,16
"3980","SC1",2023-12-23,"Arbroath","Dunfermline",1,1,"D",1,0,"H",4.12,3.93,1.82,"1-0","1-1",16,4,11,2,1,1,1,0,10,8,8,7,2,18,15,"10-8","Y","N","N",2,1,17
"3981","SC1",2023-12-23,"Partick","Inverness C",1,1,"D",1,1,"D",1.78,3.98,4.24,"1-1","1-1",8,3,6,1,1,3,0,0,5,6,6,8,2,11,14,"5-6","Y","N","N",4,0,17
"3982","SC1",2023-12-29,"Dundee United","Partick",3,0,"H",1,0,"H",1.48,4.62,6.34,"1-0","3-0",21,6,5,1,1,3,0,0,9,7,11,8,3,16,19,"9-7","Y","Y","N",4,0,17
"3983","SC1",2023-12-30,"Ayr","Dunfermline",2,2,"D",1,2,"A",2.6,3.57,2.65,"1-2","2-2",12,4,11,5,1,2,0,0,9,6,7,6,4,15,13,"9-6","Y","Y","Y",3,0,17
"3984","SC1",2023-12-30,"Inverness C","Morton",0,0,"D",0,0,"D",2.28,3.32,3.27,"0-0","0-0",7,2,3,0,0,1,0,0,2,4,6,7,0,6,13,"2-4","N","N","N",1,0,17
"3985","SC1",2023-12-30,"Queens Park","Airdrie Utd",1,2,"A",1,0,"H",2.61,3.4,2.73,"1-0","1-2",5,2,10,6,2,0,0,0,6,4,15,14,3,10,29,"6-4","Y","Y","N",2,0,18
"3986","SC1",2023-12-30,"Raith Rvs","Arbroath",2,2,"D",1,0,"H",1.41,4.96,7.02,"1-0","2-2",7,4,5,5,1,1,0,0,9,7,11,3,4,16,14,"9-7","Y","Y","Y",2,0,18
"3987","SC1",2024-01-02,"Airdrie Utd","Inverness C",2,0,"H",0,0,"D",2.37,3.12,3.31,"0-0","2-0",6,5,1,0,0,1,0,0,6,5,13,7,2,11,20,"6-5","Y","N","N",1,0,18
"3988","SC1",2024-01-02,"Arbroath","Dundee United",0,3,"A",0,1,"A",12.35,6.82,1.21,"0-1","0-3",2,2,11,6,1,2,0,0,3,6,9,7,3,9,16,"3-6","Y","Y","N",3,0,18
"3989","SC1",2024-01-02,"Dunfermline","Raith Rvs",1,2,"A",1,1,"D",3.35,3.82,2.06,"1-1","1-2",8,4,11,5,4,1,0,0,3,7,11,9,3,10,20,"3-7","Y","Y","N",5,0,18
"3990","SC1",2024-01-02,"Morton","Ayr",3,0,"H",1,0,"H",2.25,3.54,3.16,"1-0","3-0",15,6,2,0,2,2,0,0,8,1,14,13,3,9,27,"8-1","Y","Y","N",4,0,19
"3991","SC1",2024-01-02,"Partick","Queens Park",3,2,"H",1,1,"D",1.56,4.79,4.98,"1-1","3-2",14,5,9,5,3,3,0,0,8,2,6,13,5,10,19,"8-2","Y","Y","Y",6,0,19
"3992","SC1",2024-01-05,"Queens Park","Dunfermline",2,1,"H",0,0,"D",3.1,3.83,2.17,"0-0","2-1",13,4,4,1,2,1,0,0,7,0,14,7,3,7,21,"7-0","Y","Y","N",3,0,19
"3993","SC1",2024-01-06,"Airdrie Utd","Raith Rvs",1,0,"H",1,0,"H",3.96,3.63,1.93,"1-0","1-0",8,4,8,3,3,5,0,1,5,6,12,10,1,11,22,"5-6","N","N","N",8,1,19
"3994","SC1",2024-01-06,"Ayr","Inverness C",1,3,"A",0,1,"A",2.55,3.47,2.75,"0-1","1-3",11,5,5,4,2,3,0,0,6,3,9,9,4,9,18,"6-3","Y","Y","Y",5,0,19
"3995","SC1",2024-01-06,"Dundee United","Morton",2,3,"A",2,2,"D",1.36,5.17,8.05,"2-2","2-3",9,3,7,4,4,4,1,0,10,2,13,11,5,12,24,"10-2","Y","Y","Y",8,1,20
"3996","SC1",2024-01-06,"Partick","Arbroath",4,0,"H",1,0,"H",1.45,4.47,5.73,"1-0","4-0",10,7,10,4,0,2,0,0,3,7,14,9,4,10,23,"3-7","Y","Y","Y",2,0,20
"3997","SC1",2024-01-12,"Inverness C","Dundee United",0,1,"A",0,0,"D",6.21,4.3,1.52,"0-0","0-1",10,4,7,2,1,2,0,0,4,1,10,7,1,5,17,"4-1","N","N","N",3,0,20
"3998","SC1",2024-01-13,"Arbroath","Ayr",0,0,"D",0,0,"D",3.04,3.88,2.18,"0-0","0-0",7,1,14,2,1,2,0,0,4,4,8,6,0,8,14,"4-4","N","N","N",3,0,20
"3999","SC1",2024-01-13,"Morton","Partick",1,1,"D",1,0,"H",2.56,3.8,2.57,"1-0","1-1",12,5,9,4,5,6,0,0,3,6,18,13,2,9,31,"3-6","Y","N","N",11,0,20
"4000","SC1",2024-01-13,"Raith Rvs","Queens Park",1,2,"A",1,1,"D",1.49,4.71,6.01,"1-1","1-2",11,6,8,7,4,3,0,0,9,2,9,11,3,11,20,"9-2","Y","Y","N",7,0,21
"4001","SC2",2023-08-05,"Falkirk","Annan Athletic",3,0,"H",0,0,"D",NA,NA,NA,"0-0","3-0",17,8,4,0,3,1,0,0,11,1,14,5,3,12,19,"11-1","Y","Y","N",4,0,1
"4002","SC2",2023-08-05,"Hamilton","Cove Rangers",1,0,"H",1,0,"H",NA,NA,NA,"1-0","1-0",9,6,4,0,2,1,0,1,7,5,8,2,1,12,10,"7-5","N","N","N",3,1,1
"4003","SC2",2023-08-05,"Montrose","Kelty Hearts",0,2,"A",0,0,"D",2.26,3.4,2.93,"0-0","0-2",11,4,11,4,3,3,0,0,12,5,17,13,2,17,30,"12-5","Y","N","N",6,0,1
"4004","SC2",2023-08-05,"Queen of Sth","Alloa",3,4,"A",2,4,"A",1.93,3.61,3.68,"2-4","3-4",9,4,10,8,3,2,0,0,8,3,9,18,7,11,27,"8-3","Y","Y","Y",5,0,1
"4005","SC2",2023-08-05,"Stirling","Edinburgh City",1,0,"H",0,0,"D",NA,NA,NA,"0-0","1-0",12,5,5,4,0,3,0,0,10,1,12,10,1,11,22,"10-1","N","N","N",3,0,1
"4006","SC2",2023-08-12,"Alloa","Stirling",0,1,"A",0,0,"D",NA,NA,NA,"0-0","0-1",3,1,4,2,3,2,1,0,3,5,11,10,1,8,21,"3-5","N","N","N",5,1,2
"4007","SC2",2023-08-12,"Annan Athletic","Montrose",1,3,"A",0,3,"A",2.51,3.43,2.67,"0-3","1-3",16,5,4,3,0,2,0,0,4,3,7,11,4,7,18,"4-3","Y","Y","Y",2,0,2
"4008","SC2",2023-08-12,"Cove Rangers","Falkirk",2,2,"D",0,0,"D",NA,NA,NA,"0-0","2-2",7,4,13,7,3,3,0,0,3,8,17,11,4,11,28,"3-8","Y","Y","Y",6,0,2
"4009","SC2",2023-08-12,"Edinburgh City","Queen of Sth",1,2,"A",1,0,"H",NA,NA,NA,"1-0","1-2",8,3,14,8,1,1,0,1,3,10,14,8,3,13,22,"3-10","Y","Y","N",2,1,2
"4010","SC2",2023-08-12,"Kelty Hearts","Hamilton",0,2,"A",0,0,"D",NA,NA,NA,"0-0","0-2",5,1,16,11,0,2,0,0,3,7,6,6,2,10,12,"3-7","Y","N","N",2,0,2
"4011","SC2",2023-08-19,"Edinburgh City","Hamilton",0,3,"A",0,1,"A",3.81,3.77,1.86,"0-1","0-3",9,1,23,9,0,2,1,0,3,8,11,6,3,11,17,"3-8","Y","Y","N",2,1,3
"4012","SC2",2023-08-19,"Kelty Hearts","Alloa",2,1,"H",1,0,"H",2.49,3.25,2.82,"1-0","2-1",7,3,9,3,2,6,0,0,2,2,16,9,3,4,25,"2-2","Y","Y","N",8,0,3
"4013","SC2",2023-08-19,"Montrose","Cove Rangers",0,3,"A",0,2,"A",2.5,3.41,2.7,"0-2","0-3",8,5,19,8,0,0,0,0,6,3,8,9,3,9,17,"6-3","Y","Y","N",0,0,3
"4014","SC2",2023-08-19,"Queen of Sth","Annan Athletic",3,1,"H",0,1,"A",1.58,4.16,5.23,"0-1","3-1",13,4,6,1,2,2,0,0,5,1,14,6,4,6,20,"5-1","Y","Y","Y",4,0,3
"4015","SC2",2023-08-22,"Falkirk","Stirling",3,0,"H",3,0,"H",1.66,3.97,4.46,"3-0","3-0",12,4,3,3,2,2,0,0,10,2,11,11,3,12,22,"10-2","Y","Y","N",4,0,3
"4016","SC2",2023-08-26,"Annan Athletic","Edinburgh City",3,2,"H",1,2,"A",2.11,3.45,3.32,"1-2","3-2",16,8,15,7,3,2,0,0,2,8,7,8,5,10,15,"2-8","Y","Y","Y",5,0,4
"4017","SC2",2023-08-26,"Cove Rangers","Queen of Sth",1,2,"A",0,2,"A",2.07,3.62,3.27,"0-2","1-2",15,3,6,2,1,2,1,1,6,5,12,14,3,11,26,"6-5","Y","Y","N",3,2,4
"4018","SC2",2023-08-26,"Hamilton","Montrose",1,0,"H",1,0,"H",1.43,4.58,6.8,"1-0","1-0",7,4,4,2,2,3,0,0,10,1,13,8,1,11,21,"10-1","N","N","N",5,0,4
"4019","SC2",2023-08-26,"Stirling","Kelty Hearts",1,0,"H",0,0,"D",1.9,3.72,3.71,"0-0","1-0",8,3,7,2,1,1,0,0,9,4,8,5,1,13,13,"9-4","N","N","N",2,0,4
"4020","SC2",2023-08-26,"Alloa","Falkirk",1,4,"A",0,2,"A",3.99,3.88,1.8,"0-2","1-4",6,4,14,7,3,2,0,0,2,9,9,13,5,11,22,"2-9","Y","Y","Y",5,0,4
"4021","SC2",2023-09-02,"Alloa","Cove Rangers",1,0,"H",1,0,"H",2.64,3.33,2.6,"1-0","1-0",10,5,9,3,3,1,0,0,5,3,10,10,1,8,20,"5-3","N","N","N",4,0,5
"4022","SC2",2023-09-02,"Edinburgh City","Falkirk",0,2,"A",0,1,"A",7.01,4.84,1.4,"0-1","0-2",2,0,28,12,4,0,0,0,4,7,12,7,2,11,19,"4-7","Y","N","N",4,0,5
"4023","SC2",2023-09-02,"Kelty Hearts","Annan Athletic",1,1,"D",0,0,"D",1.71,3.87,4.21,"0-0","1-1",6,3,11,2,1,2,0,0,2,3,8,6,2,5,14,"2-3","Y","N","N",3,0,5
"4024","SC2",2023-09-02,"Queen of Sth","Montrose",2,3,"A",0,2,"A",1.79,3.9,3.99,"0-2","2-3",10,6,6,4,1,1,0,0,4,5,6,8,5,9,14,"4-5","Y","Y","Y",2,0,5
"4025","SC2",2023-09-02,"Stirling","Hamilton",2,2,"D",1,2,"A",3.63,3.58,1.96,"1-2","2-2",8,5,17,7,2,0,0,0,1,7,15,7,4,8,22,"1-7","Y","Y","Y",2,0,5
"4026","SC2",2023-09-16,"Annan Athletic","Stirling",3,0,"H",1,0,"H",2.72,3.44,2.47,"1-0","3-0",14,8,11,3,1,3,0,0,4,9,9,14,3,13,23,"4-9","Y","Y","N",4,0,6
"4027","SC2",2023-09-16,"Cove Rangers","Kelty Hearts",2,2,"D",1,2,"A",1.94,3.61,3.65,"1-2","2-2",7,4,5,5,2,3,0,1,4,3,8,8,4,7,16,"4-3","Y","Y","Y",5,1,6
"4028","SC2",2023-09-16,"Falkirk","Queen of Sth",1,0,"H",0,0,"D",1.56,3.88,4.62,"0-0","1-0",11,4,4,0,0,2,0,0,5,1,9,9,1,6,18,"5-1","N","N","N",2,0,6
"4029","SC2",2023-09-16,"Hamilton","Alloa",2,1,"H",0,0,"D",1.56,4.2,5.4,"0-0","2-1",15,8,9,4,2,2,0,0,11,3,9,13,3,14,22,"11-3","Y","Y","N",4,0,6
"4030","SC2",2023-09-16,"Montrose","Edinburgh City",5,2,"H",4,0,"H",1.72,3.92,4.35,"4-0","5-2",15,8,14,7,2,4,0,0,7,5,9,18,7,12,27,"7-5","Y","Y","Y",6,0,6
"4031","SC2",2023-09-23,"Annan Athletic","Alloa",1,1,"D",0,1,"A",2.62,3.45,2.55,"0-1","1-1",15,8,8,2,2,1,0,0,7,0,9,15,2,7,24,"7-0","Y","N","N",3,0,7
"4032","SC2",2023-09-23,"Edinburgh City","Cove Rangers",2,2,"D",1,1,"D",4.34,4.11,1.69,"1-1","2-2",12,5,17,7,1,2,0,0,7,3,8,7,4,10,15,"7-3","Y","Y","Y",3,0,7
"4033","SC2",2023-09-23,"Montrose","Stirling",1,0,"H",0,0,"D",2.5,3.44,2.68,"0-0","1-0",5,3,4,0,3,4,0,0,5,5,11,13,1,10,24,"5-5","N","N","N",7,0,7
"4034","SC2",2023-09-23,"Queen of Sth","Hamilton",1,2,"A",1,1,"D",3.31,3.54,2.09,"1-1","1-2",7,1,16,8,5,1,0,0,1,6,21,11,3,7,32,"1-6","Y","Y","N",6,0,7
"4035","SC2",2023-09-23,"Kelty Hearts","Falkirk",1,5,"A",1,3,"A",4.9,4.02,1.64,"1-3","1-5",2,1,22,14,2,2,0,0,3,6,9,13,6,9,22,"3-6","Y","Y","Y",4,0,7
"4036","SC2",2023-09-29,"Hamilton","Annan Athletic",5,0,"H",1,0,"H",1.34,5.34,7.83,"1-0","5-0",16,6,2,1,1,1,0,0,4,4,13,7,5,8,20,"4-4","Y","Y","Y",2,0,8
"4037","SC2",2023-09-30,"Alloa","Edinburgh City",1,1,"D",0,0,"D",1.67,3.94,4.45,"0-0","1-1",14,6,6,3,2,2,0,0,7,5,11,8,2,12,19,"7-5","Y","N","N",4,0,8
"4038","SC2",2023-09-30,"Falkirk","Montrose",3,2,"H",0,0,"D",1.39,4.65,6.35,"0-0","3-2",21,7,10,3,2,3,0,0,13,5,12,8,5,18,20,"13-5","Y","Y","Y",5,0,8
"4039","SC2",2023-09-30,"Kelty Hearts","Queen of Sth",3,1,"H",1,1,"D",2.77,3.59,2.35,"1-1","3-1",8,3,14,4,3,2,0,0,5,6,18,14,4,11,32,"5-6","Y","Y","Y",5,0,8
"4040","SC2",2023-09-30,"Stirling","Cove Rangers",2,2,"D",1,0,"H",2.5,3.31,2.76,"1-0","2-2",11,7,9,4,2,0,0,1,2,4,8,7,4,6,15,"2-4","Y","Y","Y",2,1,8
"4041","SC2",2023-10-07,"Cove Rangers","Annan Athletic",3,2,"H",2,0,"H",1.63,3.97,4.41,"2-0","3-2",15,8,8,4,3,2,0,0,3,1,12,10,5,4,22,"3-1","Y","Y","Y",5,0,9
"4042","SC2",2023-10-07,"Edinburgh City","Kelty Hearts",1,4,"A",0,2,"A",3.13,3.59,2.14,"0-2","1-4",10,4,17,8,1,1,0,0,9,11,7,12,5,20,19,"9-11","Y","Y","Y",2,0,9
"4043","SC2",2023-10-07,"Montrose","Alloa",2,1,"H",1,0,"H",2.05,3.58,3.35,"1-0","2-1",7,5,12,5,1,3,0,0,4,7,11,16,3,11,27,"4-7","Y","Y","N",4,0,9
"4044","SC2",2023-10-07,"Queen of Sth","Stirling",0,1,"A",0,0,"D",1.93,3.77,3.55,"0-0","0-1",10,5,13,6,2,2,0,0,9,3,7,13,1,12,20,"9-3","N","N","N",4,0,9
"4045","SC2",2023-10-07,"Falkirk","Hamilton",0,0,"D",0,0,"D",1.96,3.56,3.64,"0-0","0-0",9,1,7,3,1,3,0,0,1,2,10,16,0,3,26,"1-2","N","N","N",4,0,9
"4046","SC2",2023-10-21,"Alloa","Kelty Hearts",3,1,"H",1,1,"D",2.3,3.66,2.8,"1-1","3-1",9,6,7,3,1,2,0,0,2,5,16,11,4,7,27,"2-5","Y","Y","Y",3,0,10
"4047","SC2",2023-10-21,"Annan Athletic","Queen of Sth",0,1,"A",0,1,"A",2.88,3.61,2.28,"0-1","0-1",16,4,9,4,3,4,0,0,5,2,12,10,1,7,22,"5-2","N","N","N",7,0,10
"4048","SC2",2023-10-21,"Hamilton","Edinburgh City",1,1,"D",1,0,"H",1.19,7.11,11.36,"1-0","1-1",16,5,7,1,3,2,0,0,13,0,6,8,2,13,14,"13-0","Y","N","N",5,0,10
"4049","SC2",2023-10-21,"Stirling","Falkirk",1,2,"A",1,1,"D",5.7,4.25,1.53,"1-1","1-2",2,1,16,7,6,5,0,0,2,6,16,16,3,8,32,"2-6","Y","Y","N",11,0,10
"4050","SC2",2023-10-28,"Edinburgh City","Annan Athletic",3,2,"H",2,1,"H",3.03,3.6,2.19,"2-1","3-2",5,4,12,6,2,2,0,0,4,2,13,13,5,6,26,"4-2","Y","Y","Y",4,0,10
"4051","SC2",2023-10-28,"Falkirk","Alloa",3,0,"H",3,0,"H",1.27,5.78,9.19,"3-0","3-0",21,8,3,0,1,3,0,0,12,1,9,12,3,13,21,"12-1","Y","Y","N",4,0,11
"4052","SC2",2023-10-28,"Kelty Hearts","Stirling",1,0,"H",0,0,"D",2.17,3.67,3.02,"0-0","1-0",7,3,6,2,1,1,0,1,9,8,8,8,1,17,16,"9-8","N","N","N",2,1,11
"4053","SC2",2023-10-28,"Queen of Sth","Cove Rangers",0,1,"A",0,0,"D",2.55,3.66,2.51,"0-0","0-1",7,2,13,5,1,0,0,0,2,4,13,8,1,6,21,"2-4","N","N","N",1,0,11
"4054","SC2",2023-10-28,"Montrose","Hamilton",0,3,"A",0,1,"A",4.48,4.09,1.68,"0-1","0-3",10,1,12,7,4,3,0,0,3,3,10,13,3,6,23,"3-3","Y","Y","N",7,0,11
"4055","SC2",2023-11-04,"Annan Athletic","Kelty Hearts",2,2,"D",1,1,"D",2.48,3.48,2.67,"1-1","2-2",7,3,8,4,3,2,0,0,4,17,13,5,4,21,18,"4-17","Y","Y","Y",5,0,11
"4056","SC2",2023-11-04,"Cove Rangers","Hamilton",1,0,"H",0,0,"D",3.4,3.63,2.02,"0-0","1-0",5,2,13,4,0,0,0,0,4,9,10,7,1,13,17,"4-9","N","N","N",0,0,12
"4057","SC2",2023-11-04,"Edinburgh City","Montrose",1,5,"A",1,2,"A",3.16,3.76,2.08,"1-2","1-5",4,1,13,8,5,2,0,0,5,7,17,15,6,12,32,"5-7","Y","Y","Y",7,0,12
"4058","SC2",2023-11-04,"Queen of Sth","Falkirk",1,1,"D",1,1,"D",6.89,4.68,1.42,"1-1","1-1",10,3,15,4,1,0,0,0,6,6,10,9,2,12,19,"6-6","Y","N","N",1,0,12
"4059","SC2",2023-11-04,"Stirling","Alloa",0,2,"A",0,1,"A",2.09,3.44,3.08,"0-1","0-2",8,2,14,6,2,1,0,0,5,6,12,7,2,11,19,"5-6","Y","N","N",3,0,12
"4060","SC2",2023-11-11,"Alloa","Queen of Sth",1,0,"H",0,0,"D",2.74,3.47,2.43,"0-0","1-0",8,4,7,2,1,3,0,0,3,7,6,7,1,10,13,"3-7","N","N","N",4,0,12
"4061","SC2",2023-11-11,"Falkirk","Edinburgh City",2,1,"H",1,1,"D",1.15,8.35,13.5,"1-1","2-1",18,7,6,1,1,7,0,0,5,2,15,14,3,7,29,"5-2","Y","Y","N",8,0,13
"4062","SC2",2023-11-11,"Hamilton","Stirling",5,0,"H",2,0,"H",1.4,4.79,7.01,"2-0","5-0",17,9,2,1,0,2,0,1,4,2,11,10,5,6,21,"4-2","Y","Y","Y",2,1,13
"4063","SC2",2023-11-11,"Kelty Hearts","Cove Rangers",0,1,"A",0,1,"A",2.7,3.54,2.43,"0-1","0-1",10,1,13,4,2,1,0,0,5,8,12,11,1,13,23,"5-8","N","N","N",3,0,13
"4064","SC2",2023-11-11,"Montrose","Annan Athletic",1,1,"D",0,1,"A",1.88,4.18,3.39,"0-1","1-1",15,2,12,4,4,3,0,0,4,4,9,10,2,8,19,"4-4","Y","N","N",7,0,13
"4065","SC2",2023-11-14,"Cove Rangers","Montrose",1,0,"H",1,0,"H",1.8,3.62,4.28,"1-0","1-0",7,4,6,3,1,3,0,0,5,7,6,12,1,12,18,"5-7","N","N","N",4,0,13
"4066","SC2",2023-11-18,"Cove Rangers","Stirling",3,1,"H",1,1,"D",1.58,4.11,5.33,"1-1","3-1",8,6,6,4,2,0,0,0,9,1,14,10,4,10,24,"9-1","Y","Y","Y",2,0,14
"4067","SC2",2023-11-18,"Edinburgh City","Alloa",3,0,"H",2,0,"H",3.89,3.83,1.83,"2-0","3-0",10,4,14,4,4,1,0,0,0,5,15,10,3,5,25,"0-5","Y","Y","N",5,0,14
"4068","SC2",2023-11-18,"Queen of Sth","Kelty Hearts",1,3,"A",1,1,"D",2.08,3.58,3.09,"1-1","1-3",11,6,11,4,2,1,0,0,7,5,9,10,4,12,19,"7-5","Y","Y","Y",3,0,14
"4069","SC2",2023-11-28,"Annan Athletic","Hamilton",1,2,"A",1,2,"A",5.24,4.3,1.56,"1-2","1-2",9,2,17,5,2,2,0,1,1,6,7,13,3,7,20,"1-6","Y","Y","N",4,1,14
"4070","SC2",2023-11-28,"Montrose","Falkirk",0,0,"D",0,0,"D",8.4,5.11,1.34,"0-0","0-0",5,1,10,3,2,4,0,0,5,7,13,16,0,12,29,"5-7","N","N","N",6,0,14
"4071","SC2",2023-12-02,"Hamilton","Queen of Sth",5,0,"H",3,0,"H",1.43,4.62,6.75,"3-0","5-0",20,11,5,1,1,3,0,1,12,2,2,8,5,14,10,"12-2","Y","Y","Y",4,1,15
"4072","SC2",2023-12-09,"Alloa","Hamilton",0,0,"D",0,0,"D",6.5,4.3,1.48,"0-0","0-0",8,3,10,3,1,3,0,0,7,5,12,9,0,12,21,"7-5","N","N","N",4,0,15
"4073","SC2",2023-12-09,"Annan Athletic","Cove Rangers",1,3,"A",1,2,"A",4.05,3.87,1.79,"1-2","1-3",11,5,8,5,1,2,0,1,4,2,17,5,4,6,22,"4-2","Y","Y","Y",3,1,15
"4074","SC2",2023-12-09,"Edinburgh City","Stirling",1,3,"A",1,2,"A",5.1,4.12,1.6,"1-2","1-3",7,5,18,8,2,3,0,0,3,9,8,8,4,12,16,"3-9","Y","Y","Y",5,0,15
"4075","SC2",2023-12-09,"Falkirk","Kelty Hearts",2,1,"H",1,0,"H",1.25,5.8,10.4,"1-0","2-1",21,11,3,2,5,2,0,0,11,0,22,10,3,11,32,"11-0","Y","Y","N",7,0,15
"4076","SC2",2023-12-09,"Montrose","Queen of Sth",1,4,"A",0,4,"A",1.93,3.76,3.59,"0-4","1-4",6,1,12,6,4,0,0,0,6,7,14,11,5,13,25,"6-7","Y","Y","Y",4,0,16
"4077","SC2",2023-12-16,"Cove Rangers","Alloa",1,2,"A",1,0,"H",1.77,3.72,4.36,"1-0","1-2",5,2,7,5,1,2,0,0,2,6,15,8,3,8,23,"2-6","Y","Y","N",3,0,16
"4078","SC2",2023-12-16,"Hamilton","Falkirk",1,3,"A",1,2,"A",2.44,3.19,2.93,"1-2","1-3",9,5,9,5,2,4,0,0,6,4,16,11,4,10,27,"6-4","Y","Y","Y",6,0,16
"4079","SC2",2023-12-16,"Kelty Hearts","Montrose",0,1,"A",0,1,"A",2.22,3.41,3.07,"0-1","0-1",6,3,7,4,1,1,0,0,2,2,9,17,1,4,26,"2-2","N","N","N",2,0,16
"4080","SC2",2023-12-16,"Queen of Sth","Edinburgh City",3,1,"H",1,0,"H",1.18,7.61,11.3,"1-0","3-1",16,6,4,2,1,3,0,0,2,3,10,14,4,5,24,"2-3","Y","Y","Y",4,0,16
"4081","SC2",2023-12-16,"Stirling","Annan Athletic",1,1,"D",1,1,"D",1.93,3.59,3.66,"1-1","1-1",12,4,8,1,2,3,0,0,3,7,17,11,2,10,28,"3-7","Y","N","N",5,0,17
"4082","SC2",2023-12-23,"Alloa","Montrose",2,2,"D",0,0,"D",2.26,3.51,2.97,"0-0","2-2",12,5,5,2,2,3,0,0,5,1,11,6,4,6,17,"5-1","Y","Y","Y",5,0,17
"4083","SC2",2023-12-23,"Annan Athletic","Falkirk",0,3,"A",0,1,"A",7.97,5.45,1.33,"0-1","0-3",2,2,16,8,3,3,0,0,1,12,7,14,3,13,21,"1-12","Y","Y","N",6,0,17
"4084","SC2",2023-12-23,"Hamilton","Kelty Hearts",1,1,"D",0,0,"D",1.34,5.2,8.11,"0-0","1-1",11,9,5,2,1,2,1,0,9,4,22,14,2,13,36,"9-4","Y","N","N",3,1,17
"4085","SC2",2023-12-23,"Stirling","Queen of Sth",1,1,"D",1,0,"H",2.37,3.41,2.86,"1-0","1-1",8,5,16,6,1,2,0,0,4,10,11,13,2,14,24,"4-10","Y","N","N",3,0,17
"4086","SC2",2023-12-23,"Cove Rangers","Edinburgh City",7,2,"H",2,1,"H",1.1,10.61,17.42,"2-1","7-2",21,13,7,5,1,0,0,1,12,1,9,12,9,13,21,"12-1","Y","Y","Y",1,1,18
"4087","SC2",2023-12-30,"Edinburgh City","Hamilton",2,5,"A",0,5,"A",NA,NA,NA,"0-5","2-5",5,3,23,9,3,0,0,0,1,13,7,10,7,14,17,"1-13","Y","Y","Y",3,0,18
"4088","SC2",2023-12-30,"Falkirk","Stirling",5,0,"H",4,0,"H",1.19,6.84,12.73,"4-0","5-0",14,8,2,2,0,1,0,0,12,2,6,6,5,14,12,"12-2","Y","Y","Y",1,0,18
"4089","SC2",2023-12-30,"Montrose","Cove Rangers",1,1,"D",1,1,"D",3.47,3.64,1.99,"1-1","1-1",9,4,11,5,1,2,0,0,10,5,5,5,2,15,10,"10-5","Y","N","N",3,0,18
"4090","SC2",2023-12-30,"Queen of Sth","Annan Athletic",2,1,"H",1,1,"D",1.68,3.99,4.54,"1-1","2-1",7,3,7,4,3,4,0,1,2,4,17,12,3,6,29,"2-4","Y","Y","N",7,1,18
"4091","SC2",2024-01-06,"Alloa","Edinburgh City",3,1,"H",1,0,"H",NA,NA,NA,"1-0","3-1",11,4,4,2,1,2,0,0,6,0,7,9,4,6,16,"6-0","Y","Y","Y",3,0,19
"4092","SC2",2024-01-06,"Annan Athletic","Montrose",2,2,"D",1,1,"D",2.45,3.62,2.63,"1-1","2-2",10,4,9,5,2,2,0,2,5,4,11,10,4,9,21,"5-4","Y","Y","Y",4,2,19
"4093","SC2",2024-01-06,"Cove Rangers","Kelty Hearts",2,2,"D",2,0,"H",1.51,4.3,5.64,"2-0","2-2",9,4,6,5,1,0,0,0,6,3,11,9,4,9,20,"6-3","Y","Y","Y",1,0,19
"4094","SC2",2024-01-06,"Falkirk","Queen of Sth",1,0,"H",0,0,"D",1.3,5.44,9.01,"0-0","1-0",15,3,1,0,2,1,0,0,3,0,7,9,1,3,16,"3-0","N","N","N",3,0,19
"4095","SC2",2024-01-09,"Falkirk","Cove Rangers",4,0,"H",1,0,"H",1.36,4.87,8.23,"1-0","4-0",16,10,2,0,1,1,0,0,9,0,12,5,4,9,17,"9-0","Y","Y","Y",2,0,19
"4096","SC2",2024-01-13,"Hamilton","Cove Rangers",2,0,"H",1,0,"H",1.56,4.17,5.46,"1-0","2-0",10,5,17,5,1,0,1,1,1,2,12,9,2,3,21,"1-2","Y","N","N",1,2,20
"4097","SC2",2024-01-13,"Kelty Hearts","Annan Athletic",1,1,"D",1,0,"H",1.92,4.06,3.36,"1-0","1-1",6,2,2,1,0,4,0,0,6,1,7,15,2,7,22,"6-1","Y","N","N",4,0,20
"4098","SC2",2024-01-13,"Montrose","Stirling",0,1,"A",0,0,"D",2.12,3.52,3.23,"0-0","0-1",9,3,9,3,2,1,0,1,8,2,6,15,1,10,21,"8-2","N","N","N",3,1,20
"4099","SC2",2024-01-13,"Queen of Sth","Alloa",1,1,"D",1,1,"D",2.34,3.57,2.8,"1-1","1-1",10,5,6,1,2,2,0,0,4,2,10,10,2,6,20,"4-2","Y","N","N",4,0,20
"4100","SC2",2024-01-13,"Edinburgh City","Falkirk",2,2,"D",2,0,"H",NA,NA,NA,"2-0","2-2",8,2,25,7,5,1,0,0,1,15,14,13,4,16,27,"1-15","Y","Y","Y",6,0,20
"4101","SC3",2023-08-05,"Bonnyrigg Rose","Dumbarton",1,1,"D",0,1,"A",2.53,3.26,2.77,"0-1","1-1",9,4,13,6,3,2,0,0,10,4,13,12,2,14,25,"10-4","Y","N","N",5,0,1
"4102","SC3",2023-08-05,"East Fife","Peterhead",0,3,"A",0,1,"A",1.78,3.66,4.39,"0-1","0-3",5,3,10,6,2,3,0,0,4,4,10,12,3,8,22,"4-4","Y","Y","N",5,0,1
"4103","SC3",2023-08-05,"Elgin","Stranraer",0,1,"A",0,1,"A",2.56,3.38,2.65,"0-1","0-1",10,3,6,2,0,1,0,0,5,6,12,18,1,11,30,"5-6","N","N","N",1,0,1
"4104","SC3",2023-08-05,"Spartans","Clyde",1,1,"D",0,1,"A",1.59,3.64,4.05,"0-1","1-1",6,2,7,3,1,1,0,0,6,2,3,7,2,8,10,"6-2","Y","N","N",2,0,1
"4105","SC3",2023-08-05,"Stenhousemuir","Forfar",0,0,"D",0,0,"D",2.2,3.55,3.04,"0-0","0-0",12,3,9,5,2,2,0,0,6,7,12,10,0,13,22,"6-7","N","N","N",4,0,1
"4106","SC3",2023-08-12,"Clyde","Bonnyrigg Rose",0,2,"A",0,1,"A",NA,NA,NA,"0-1","0-2",6,1,9,5,0,2,0,0,4,5,6,10,2,9,16,"4-5","Y","N","N",2,0,2
"4107","SC3",2023-08-12,"Dumbarton","Spartans",1,1,"D",0,0,"D",NA,NA,NA,"0-0","1-1",3,2,2,1,1,3,0,0,4,7,7,5,2,11,12,"4-7","Y","N","N",4,0,2
"4108","SC3",2023-08-12,"Forfar","Elgin",0,0,"D",0,0,"D",1.79,3.58,4.44,"0-0","0-0",11,3,7,3,1,3,0,0,4,6,15,14,0,10,29,"4-6","N","N","N",4,0,2
"4109","SC3",2023-08-12,"Peterhead","Stenhousemuir",0,0,"D",0,0,"D",NA,NA,NA,"0-0","0-0",9,2,8,1,1,2,1,0,4,6,10,14,0,10,24,"4-6","N","N","N",3,1,2
"4110","SC3",2023-08-12,"Stranraer","East Fife",1,1,"D",0,0,"D",2.44,3.29,2.85,"0-0","1-1",3,3,14,8,2,1,1,0,6,6,8,11,2,12,19,"6-6","Y","N","N",3,1,2
"4111","SC3",2023-08-19,"Bonnyrigg Rose","Stranraer",1,1,"D",1,0,"H",2.55,3.32,2.7,"1-0","1-1",5,3,5,2,2,1,0,0,2,4,12,8,2,6,20,"2-4","Y","N","N",3,0,3
"4112","SC3",2023-08-19,"Clyde","Peterhead",1,2,"A",1,2,"A",2.64,3.55,2.39,"1-2","1-2",3,3,11,5,2,1,1,1,2,1,13,4,3,3,17,"2-1","Y","Y","N",3,2,3
"4113","SC3",2023-08-19,"Dumbarton","Forfar",3,1,"H",0,1,"A",2.66,3.32,2.58,"0-1","3-1",14,4,6,3,0,1,0,0,9,5,7,9,4,14,16,"9-5","Y","Y","Y",1,0,3
"4114","SC3",2023-08-19,"East Fife","Stenhousemuir",0,2,"A",0,1,"A",2.31,3.36,2.77,"0-1","0-2",6,3,6,4,2,3,0,0,6,3,9,14,2,9,23,"6-3","Y","N","N",5,0,3
"4115","SC3",2023-08-19,"Spartans","Elgin",2,1,"H",0,0,"D",1.61,3.93,4.75,"0-0","2-1",11,6,8,3,0,0,0,0,5,3,11,8,3,8,19,"5-3","Y","Y","N",0,0,3
"4116","SC3",2023-08-26,"Elgin","East Fife",1,1,"D",1,0,"H",2.91,3.33,2.38,"1-0","1-1",8,3,10,4,4,2,0,0,2,5,12,7,2,7,19,"2-5","Y","N","N",6,0,4
"4117","SC3",2023-08-26,"Forfar","Bonnyrigg Rose",1,2,"A",0,1,"A",2.21,3.19,3.34,"0-1","1-2",9,4,8,3,2,1,1,0,3,4,21,20,3,7,41,"3-4","Y","Y","N",3,1,4
"4118","SC3",2023-08-26,"Peterhead","Spartans",0,1,"A",0,0,"D",2.29,3.34,3.04,"0-0","0-1",5,2,11,6,4,1,0,0,3,5,10,8,1,8,18,"3-5","N","N","N",5,0,4
"4119","SC3",2023-08-26,"Stenhousemuir","Dumbarton",2,4,"A",0,4,"A",2.46,3.26,2.85,"0-4","2-4",10,5,12,8,4,5,0,1,9,7,9,12,6,16,21,"9-7","Y","Y","Y",9,1,4
"4120","SC3",2023-08-26,"Stranraer","Clyde",1,0,"H",0,0,"D",1.93,3.59,3.76,"0-0","1-0",15,3,9,4,1,1,0,0,7,3,11,9,1,10,20,"7-3","N","N","N",2,0,4
"4121","SC3",2023-09-02,"Bonnyrigg Rose","Elgin",5,1,"H",2,0,"H",1.74,3.65,4.66,"2-0","5-1",13,6,11,3,1,1,0,0,6,3,22,11,6,9,33,"6-3","Y","Y","Y",2,0,5
"4122","SC3",2023-09-02,"Clyde","Forfar",0,0,"D",0,0,"D",2.66,3.25,2.63,"0-0","0-0",7,5,7,1,2,2,0,0,3,2,14,12,0,5,26,"3-2","N","N","N",4,0,5
"4123","SC3",2023-09-02,"Dumbarton","East Fife",1,0,"H",0,0,"D",1.8,3.69,4.19,"0-0","1-0",10,3,7,2,1,2,0,0,3,4,13,15,1,7,28,"3-4","N","N","N",3,0,5
"4124","SC3",2023-09-02,"Spartans","Stenhousemuir",0,1,"A",0,0,"D",1.85,3.82,3.84,"0-0","0-1",7,2,9,4,1,0,0,1,10,3,6,7,1,13,13,"10-3","N","N","N",1,1,5
"4125","SC3",2023-09-02,"Stranraer","Peterhead",2,1,"H",2,0,"H",2.18,3.42,3.19,"2-0","2-1",14,7,11,5,3,3,0,0,6,5,11,18,3,11,29,"6-5","Y","Y","N",6,0,5
"4126","SC3",2023-09-16,"East Fife","Clyde",2,0,"H",1,0,"H",1.9,3.49,3.53,"1-0","2-0",9,4,6,3,2,2,0,0,4,0,10,17,2,4,27,"4-0","Y","N","N",4,0,6
"4127","SC3",2023-09-16,"Elgin","Dumbarton",2,0,"H",1,0,"H",3.56,3.48,2.01,"1-0","2-0",11,4,11,2,1,0,0,0,7,7,9,11,2,14,20,"7-7","Y","N","N",1,0,6
"4128","SC3",2023-09-16,"Forfar","Spartans",2,2,"D",1,2,"A",2.42,3.2,2.73,"1-2","2-2",8,6,12,7,3,2,0,0,5,4,11,8,4,9,19,"5-4","Y","Y","Y",5,0,6
"4129","SC3",2023-09-16,"Peterhead","Bonnyrigg Rose",2,1,"H",0,0,"D",2.58,3.22,2.73,"0-0","2-1",10,4,8,2,5,2,0,0,2,3,21,12,3,5,33,"2-3","Y","Y","N",7,0,6
"4130","SC3",2023-09-16,"Stenhousemuir","Stranraer",5,0,"H",2,0,"H",2.24,3.34,3.13,"2-0","5-0",10,8,3,2,2,3,0,0,8,3,9,10,5,11,19,"8-3","Y","Y","Y",5,0,6
"4131","SC3",2023-09-23,"Bonnyrigg Rose","Stenhousemuir",0,1,"A",0,0,"D",2.37,3.43,2.85,"0-0","0-1",8,3,11,5,5,3,0,0,4,2,13,15,1,6,28,"4-2","N","N","N",8,0,7
"4132","SC3",2023-09-23,"Clyde","Elgin",2,1,"H",2,0,"H",2.35,3.39,2.91,"2-0","2-1",11,4,13,2,2,2,0,0,7,2,7,8,3,9,15,"7-2","Y","Y","N",4,0,7
"4133","SC3",2023-09-23,"Dumbarton","Peterhead",0,1,"A",0,0,"D",2.16,3.42,3.22,"0-0","0-1",11,3,16,5,2,2,1,0,11,7,14,9,1,18,23,"11-7","N","N","N",4,1,7
"4134","SC3",2023-09-23,"Spartans","East Fife",2,2,"D",1,0,"H",1.98,3.36,3.83,"1-0","2-2",7,2,10,8,2,2,0,0,5,2,8,10,4,7,18,"5-2","Y","Y","Y",4,0,7
"4135","SC3",2023-09-23,"Stranraer","Forfar",0,2,"A",0,2,"A",2.3,3.3,3,"0-2","0-2",9,5,11,6,1,2,0,0,9,8,7,18,2,17,25,"9-8","Y","N","N",3,0,7
"4136","SC3",2023-09-30,"Dumbarton","Stranraer",3,1,"H",2,1,"H",1.83,3.62,4.12,"2-1","3-1",10,5,6,1,2,3,0,0,8,3,11,10,4,11,21,"8-3","Y","Y","Y",5,0,8
"4137","SC3",2023-09-30,"East Fife","Forfar",1,1,"D",1,0,"H",2.33,3.26,3.05,"1-0","1-1",2,1,9,3,1,2,0,0,4,3,15,17,2,7,32,"4-3","Y","N","N",3,0,8
"4138","SC3",2023-09-30,"Peterhead","Elgin",6,0,"H",2,0,"H",1.7,3.79,4.68,"2-0","6-0",13,8,4,1,0,5,0,0,4,2,9,15,6,6,24,"4-2","Y","Y","Y",5,0,8
"4139","SC3",2023-09-30,"Spartans","Bonnyrigg Rose",2,2,"D",0,1,"A",2.17,3.37,3.25,"0-1","2-2",7,3,9,4,2,1,0,0,6,4,15,11,4,10,26,"6-4","Y","Y","Y",3,0,8
"4140","SC3",2023-09-30,"Stenhousemuir","Clyde",2,2,"D",1,0,"H",1.6,3.98,5.34,"1-0","2-2",13,8,12,4,2,4,0,0,5,4,7,12,4,9,19,"5-4","Y","Y","Y",6,0,8
"4141","SC3",2023-10-07,"Clyde","Dumbarton",0,4,"A",0,2,"A",3.98,3.55,1.88,"0-2","0-4",10,4,11,6,2,2,0,0,6,5,11,11,4,11,22,"6-5","Y","Y","Y",4,0,9
"4142","SC3",2023-10-07,"Forfar","Peterhead",1,3,"A",0,2,"A",2.52,3.2,2.82,"0-2","1-3",12,6,10,5,2,1,0,0,8,2,8,14,4,10,22,"8-2","Y","Y","Y",3,0,9
"4143","SC3",2023-10-07,"Stranraer","Spartans",3,4,"A",1,2,"A",2.78,3.37,2.45,"1-2","3-4",10,5,14,6,1,0,0,0,11,4,13,9,7,15,22,"11-4","Y","Y","Y",1,0,9
"4144","SC3",2023-10-21,"Bonnyrigg Rose","Clyde",3,2,"H",1,2,"A",1.81,3.61,4.28,"1-2","3-2",9,6,13,6,1,2,0,0,2,7,7,14,5,9,21,"2-7","Y","Y","Y",3,0,9
"4145","SC3",2023-10-21,"East Fife","Stranraer",4,0,"H",2,0,"H",1.93,3.56,3.76,"2-0","4-0",12,6,0,0,2,1,0,0,5,7,10,11,4,12,21,"5-7","Y","Y","Y",3,0,9
"4146","SC3",2023-10-21,"Spartans","Dumbarton",2,0,"H",0,0,"D",2.4,3.38,2.84,"0-0","2-0",8,3,7,1,1,1,0,0,4,11,8,8,2,15,16,"4-11","Y","N","N",2,0,10
"4147","SC3",2023-10-24,"Elgin","Stenhousemuir",1,1,"D",0,1,"A",4.77,3.87,1.68,"0-1","1-1",11,2,11,4,3,2,0,1,5,5,13,15,2,10,28,"5-5","Y","N","N",5,1,10
"4148","SC3",2023-11-04,"Clyde","Spartans",1,2,"A",0,2,"A",3.79,3.67,1.89,"0-2","1-2",10,3,7,2,3,1,0,0,5,3,13,8,3,8,21,"5-3","Y","Y","N",4,0,10
"4149","SC3",2023-11-04,"Dumbarton","Bonnyrigg Rose",4,0,"H",2,0,"H",1.89,3.71,3.73,"2-0","4-0",12,7,15,3,3,1,0,0,6,9,8,10,4,15,18,"6-9","Y","Y","Y",4,0,10
"4150","SC3",2023-11-04,"Forfar","Stenhousemuir",1,3,"A",1,1,"D",3.25,3.39,2.17,"1-1","1-3",4,2,12,7,2,1,0,0,4,5,11,8,4,9,19,"4-5","Y","Y","Y",3,0,10
"4151","SC3",2023-11-04,"Peterhead","East Fife",2,0,"H",1,0,"H",2.08,3.4,3.45,"1-0","2-0",11,6,5,2,1,3,0,0,7,6,11,14,2,13,25,"7-6","Y","N","N",4,0,11
"4152","SC3",2023-11-04,"Stranraer","Elgin",3,1,"H",2,0,"H",1.75,3.7,3.96,"2-0","3-1",8,6,6,3,2,2,0,0,8,4,12,12,4,12,24,"8-4","Y","Y","Y",4,0,11
"4153","SC3",2023-11-11,"East Fife","Dumbarton",0,1,"A",0,1,"A",2.96,3.36,2.33,"0-1","0-1",5,2,6,4,1,3,0,0,4,9,10,11,1,13,21,"4-9","N","N","N",4,0,11
"4154","SC3",2023-11-11,"Elgin","Bonnyrigg Rose",2,0,"H",0,0,"D",3.52,3.49,2.03,"0-0","2-0",12,6,9,6,5,4,0,0,1,6,12,9,2,7,21,"1-6","Y","N","N",9,0,11
"4155","SC3",2023-11-11,"Forfar","Clyde",1,1,"D",0,0,"D",1.81,3.74,4.11,"0-0","1-1",15,6,13,4,1,0,0,0,4,5,13,14,2,9,27,"4-5","Y","N","N",1,0,11
"4156","SC3",2023-11-11,"Peterhead","Stranraer",3,2,"H",2,1,"H",1.75,3.89,4.25,"2-1","3-2",9,5,8,6,4,3,0,0,3,7,14,14,5,10,28,"3-7","Y","Y","Y",7,0,12
"4157","SC3",2023-11-11,"Stenhousemuir","Spartans",3,2,"H",0,1,"A",1.97,3.58,3.61,"0-1","3-2",12,5,9,4,4,1,0,0,6,6,13,14,5,12,27,"6-6","Y","Y","Y",5,0,12
"4158","SC3",2023-11-14,"Stenhousemuir","Peterhead",2,0,"H",2,0,"H",2.12,3.48,3.27,"2-0","2-0",16,4,10,3,2,4,0,0,1,5,14,16,2,6,30,"1-5","Y","N","N",6,0,12
"4159","SC3",2023-11-18,"Bonnyrigg Rose","Forfar",0,2,"A",0,1,"A",2.29,3.37,3.02,"0-1","0-2",6,2,8,5,0,2,0,0,4,4,7,11,2,8,18,"4-4","Y","N","N",2,0,12
"4160","SC3",2023-11-18,"Clyde","East Fife",0,4,"A",0,2,"A",3.46,3.45,2.06,"0-2","0-4",7,2,10,7,1,3,0,0,5,2,8,7,4,7,15,"5-2","Y","Y","Y",4,0,12
"4161","SC3",2023-11-18,"Dumbarton","Elgin",1,0,"H",0,0,"D",1.31,5.27,9.25,"0-0","1-0",8,2,7,2,1,3,0,0,2,2,11,11,1,4,22,"2-2","N","N","N",4,0,13
"4162","SC3",2023-11-18,"Spartans","Peterhead",1,2,"A",0,1,"A",2.3,3.5,2.91,"0-1","1-2",9,5,10,4,2,4,0,0,3,1,7,17,3,4,24,"3-1","Y","Y","N",6,0,13
"4163","SC3",2023-11-18,"Stranraer","Stenhousemuir",0,3,"A",0,2,"A",3.37,3.61,2.03,"0-2","0-3",6,3,6,3,2,1,0,0,10,2,8,7,3,12,15,"10-2","Y","Y","N",3,0,13
"4164","SC3",2023-11-21,"Bonnyrigg Rose","East Fife",4,2,"H",1,1,"D",3.13,3.12,2.03,"1-1","4-2",15,10,5,2,3,2,0,0,5,4,9,18,6,9,27,"5-4","Y","Y","Y",5,0,13
"4165","SC3",2023-11-21,"Elgin","Forfar",1,0,"H",1,0,"H",3.05,3.18,2.37,"1-0","1-0",6,3,10,3,2,0,0,0,5,3,19,10,1,8,29,"5-3","N","N","N",2,0,13
"4166","SC3",2023-12-02,"Forfar","Stranraer",1,1,"D",1,0,"H",2.11,3.54,3.26,"1-0","1-1",16,5,4,1,2,3,0,0,9,3,16,12,2,12,28,"9-3","Y","N","N",5,0,14
"4167","SC3",2023-12-02,"Stenhousemuir","Bonnyrigg Rose",1,0,"H",1,0,"H",1.66,3.87,4.95,"1-0","1-0",12,6,7,2,2,2,1,1,5,3,11,17,1,8,28,"5-3","N","N","N",4,2,14
"4168","SC3",2023-12-09,"Bonnyrigg Rose","Peterhead",1,1,"D",1,0,"H",3.04,3.34,2.29,"1-0","1-1",7,3,9,2,2,3,0,0,9,4,19,15,2,13,34,"9-4","Y","N","N",5,0,14
"4169","SC3",2023-12-09,"Clyde","Stranraer",2,2,"D",2,1,"H",2.47,3.38,2.74,"2-1","2-2",5,4,5,2,2,1,0,0,4,6,6,7,4,10,13,"4-6","Y","Y","Y",3,0,14
"4170","SC3",2023-12-09,"Dumbarton","Stenhousemuir",0,1,"A",0,0,"D",2.25,3.32,3.08,"0-0","0-1",8,2,9,4,3,1,0,0,7,4,12,10,1,11,22,"7-4","N","N","N",4,0,14
"4171","SC3",2023-12-09,"East Fife","Elgin",4,0,"H",2,0,"H",1.8,3.89,3.87,"2-0","4-0",10,6,1,1,0,1,0,0,8,2,13,6,4,10,19,"8-2","Y","Y","Y",1,0,15
"4172","SC3",2023-12-09,"Spartans","Forfar",1,0,"H",0,0,"D",2.12,3.55,3.22,"0-0","1-0",5,2,7,1,5,3,0,0,2,3,15,10,1,5,25,"2-3","N","N","N",8,0,15
"4173","SC3",2023-12-16,"Elgin","Spartans",0,4,"A",0,3,"A",4.3,3.73,1.78,"0-3","0-4",13,4,9,7,1,4,0,0,3,4,12,19,4,7,31,"3-4","Y","Y","Y",5,0,15
"4174","SC3",2023-12-16,"Forfar","Dumbarton",2,4,"A",2,3,"A",3.06,3.27,2.32,"2-3","2-4",8,6,12,6,0,0,0,0,3,5,11,7,6,8,18,"3-5","Y","Y","Y",0,0,15
"4175","SC3",2023-12-16,"Peterhead","Clyde",2,1,"H",2,0,"H",1.61,4.04,5.08,"2-0","2-1",9,3,6,3,2,2,1,0,5,0,12,14,3,5,26,"5-0","Y","Y","N",4,1,15
"4176","SC3",2023-12-16,"Stenhousemuir","East Fife",2,1,"H",2,0,"H",1.93,3.52,3.8,"2-0","2-1",9,5,10,4,2,4,0,0,5,5,7,12,3,10,19,"5-5","Y","Y","N",6,0,16
"4177","SC3",2023-12-16,"Stranraer","Bonnyrigg Rose",3,1,"H",1,0,"H",2.36,3.27,2.99,"1-0","3-1",11,5,11,3,0,2,0,0,3,5,8,8,4,8,16,"3-5","Y","Y","Y",2,0,16
"4178","SC3",2023-12-22,"East Fife","Bonnyrigg Rose",0,3,"A",0,1,"A",1.88,3.66,3.76,"0-1","0-3",6,2,8,4,2,2,0,0,3,4,11,11,3,7,22,"3-4","Y","Y","N",4,0,16
"4179","SC3",2023-12-23,"Dumbarton","Clyde",4,4,"D",2,2,"D",1.41,4.68,7.08,"2-2","4-4",11,7,14,6,2,3,0,0,8,6,11,11,8,14,22,"8-6","Y","Y","Y",5,0,16
"4180","SC3",2023-12-23,"Peterhead","Forfar",1,2,"A",1,2,"A",1.93,3.4,3.97,"1-2","1-2",14,5,9,6,0,3,0,1,5,2,11,20,3,7,31,"5-2","Y","Y","N",3,1,16
"4181","SC3",2023-12-23,"Spartans","Stranraer",3,0,"H",1,0,"H",1.81,3.81,4.03,"1-0","3-0",8,3,4,0,2,0,0,0,6,3,14,7,3,9,21,"6-3","Y","Y","N",2,0,17
"4182","SC3",2023-12-23,"Stenhousemuir","Elgin",2,0,"H",1,0,"H",1.31,5.11,9.72,"1-0","2-0",8,3,5,2,0,1,0,0,6,3,13,16,2,9,29,"6-3","Y","N","N",1,0,17
"4183","SC3",2023-12-30,"Clyde","Stenhousemuir",1,2,"A",0,1,"A",5.26,3.87,1.62,"0-1","1-2",7,2,6,2,1,2,0,1,0,0,13,9,3,0,22,"0-0","Y","Y","N",3,1,17
"4184","SC3",2023-12-30,"Elgin","Peterhead",2,1,"H",1,0,"H",4.66,3.69,1.72,"1-0","2-1",11,6,13,5,6,3,0,0,1,6,18,16,3,7,34,"1-6","Y","Y","N",9,0,17
"4185","SC3",2023-12-30,"Forfar","East Fife",0,0,"D",0,0,"D",2.31,3.22,3.06,"0-0","0-0",7,2,6,4,1,2,1,0,2,5,9,13,0,7,22,"2-5","N","N","N",3,1,17
"4186","SC3",2024-01-06,"Clyde","Bonnyrigg Rose",3,2,"H",3,0,"H",3.05,3.3,2.31,"3-0","3-2",10,4,11,4,1,1,0,0,7,7,5,6,5,14,11,"7-7","Y","Y","Y",2,0,18
"4187","SC3",2024-01-06,"Dumbarton","East Fife",1,2,"A",0,1,"A",1.76,3.7,4.41,"0-1","1-2",9,3,9,3,3,3,0,0,8,5,8,9,3,13,17,"8-5","Y","Y","N",6,0,18
"4188","SC3",2024-01-06,"Elgin","Stranraer",2,1,"H",0,1,"A",2.91,3.29,2.4,"0-1","2-1",9,5,13,6,1,2,0,0,3,2,13,12,3,5,25,"3-2","Y","Y","N",3,0,18
"4189","SC3",2024-01-06,"Peterhead","Spartans",0,1,"A",0,0,"D",2.49,3.33,2.75,"0-0","0-1",4,3,4,2,3,1,0,0,5,2,11,13,1,7,24,"5-2","N","N","N",4,0,18
"4190","SC3",2024-01-06,"Stenhousemuir","Forfar",2,1,"H",1,0,"H",1.64,3.81,5.21,"1-0","2-1",7,4,4,2,2,0,0,0,8,3,10,11,3,11,21,"8-3","Y","Y","N",2,0,18
"4191","SC3",2024-01-09,"Peterhead","Dumbarton",3,1,"H",0,1,"A",2.39,3.59,2.72,"0-1","3-1",16,6,6,3,3,3,0,0,4,1,9,12,4,5,21,"4-1","Y","Y","Y",6,0,19
"4192","SC3",2024-01-13,"Bonnyrigg Rose","Dumbarton",1,1,"D",1,0,"H",2.88,3.4,2.36,"1-0","1-1",9,5,17,8,3,2,0,0,6,9,9,11,2,15,20,"6-9","Y","N","N",5,0,19
"4193","SC3",2024-01-13,"East Fife","Clyde",1,1,"D",1,1,"D",1.76,3.74,4.29,"1-1","1-1",5,1,9,5,0,2,0,0,3,4,12,9,2,7,21,"3-4","Y","N","N",2,0,19
"4194","SC3",2024-01-13,"Forfar","Elgin",2,1,"H",0,1,"A",1.76,3.61,4.54,"0-1","2-1",14,5,4,1,2,3,0,1,6,3,11,20,3,9,31,"6-3","Y","Y","N",5,1,19
"4195","SC3",2024-01-13,"Spartans","Stenhousemuir",0,2,"A",0,1,"A",2.84,3.27,2.46,"0-1","0-2",8,0,8,6,0,0,0,0,5,3,9,13,2,8,22,"5-3","Y","N","N",0,0,19
"4196","SC3",2024-01-13,"Stranraer","Peterhead",2,0,"H",1,0,"H",3.45,3.41,2.08,"1-0","2-0",7,4,6,1,2,2,0,1,3,4,13,10,2,7,23,"3-4","Y","N","N",4,1,20
"1483","SP1",2023-08-11,"Almeria","Vallecano",0,2,"A",0,2,"A",2.62,3.3,2.96,"0-2","0-2",19,5,10,4,1,3,0,0,8,3,16,25,2,11,41,"8-3","Y","N","N",4,0,1
"1484","SP1",2023-08-11,"Sevilla","Valencia",1,2,"A",0,0,"D",1.95,3.47,4.48,"0-0","1-2",9,3,10,3,3,2,1,0,8,1,15,17,3,9,32,"8-1","Y","Y","N",5,1,1
"1485","SP1",2023-08-12,"Sociedad","Girona",1,1,"D",1,0,"H",1.65,4.05,5.66,"1-0","1-1",15,2,6,1,2,5,0,0,4,1,22,9,2,5,31,"4-1","Y","N","N",7,0,1
"1486","SP1",2023-08-12,"Las Palmas","Mallorca",1,1,"D",1,0,"H",2.45,3.02,3.46,"1-0","1-1",5,2,12,2,3,2,0,0,3,6,11,21,2,9,32,"3-6","Y","N","N",5,0,1
"1487","SP1",2023-08-12,"Ath Bilbao","Real Madrid",0,2,"A",0,2,"A",3.43,3.58,2.19,"0-2","0-2",7,1,14,8,3,1,0,0,7,5,18,6,2,12,24,"7-5","Y","N","N",4,0,1
"1488","SP1",2023-08-13,"Celta","Osasuna",0,2,"A",0,1,"A",2.15,3.19,3.99,"0-1","0-2",11,1,11,5,1,1,0,0,7,2,11,15,2,9,26,"7-2","Y","N","N",2,0,1
"1489","SP1",2023-08-13,"Villarreal","Betis",1,2,"A",0,1,"A",1.81,3.98,4.43,"0-1","1-2",18,5,12,5,1,3,0,0,9,4,13,17,3,13,30,"9-4","Y","Y","N",4,0,1
"1490","SP1",2023-08-13,"Getafe","Barcelona",0,0,"D",0,0,"D",6.69,4.04,1.57,"0-0","0-0",5,2,14,4,8,2,1,1,3,4,20,11,0,7,31,"3-4","N","N","N",10,2,1
"1491","SP1",2023-08-14,"Cadiz","Alaves",1,0,"H",1,0,"H",2.25,3.08,3.86,"1-0","1-0",12,3,10,2,3,2,1,0,2,4,19,15,1,6,34,"2-4","N","N","N",5,1,1
"1492","SP1",2023-08-14,"Ath Madrid","Granada",3,1,"H",1,0,"H",1.31,5.76,10.3,"1-0","3-1",14,6,7,4,3,1,0,0,3,3,15,9,4,6,24,"3-3","Y","Y","Y",4,0,1
"1493","SP1",2023-08-18,"Mallorca","Villarreal",0,1,"A",0,0,"D",3.04,3.13,2.68,"0-0","0-1",8,1,15,3,2,4,0,0,6,5,12,11,1,11,23,"6-5","N","N","N",6,0,2
"1494","SP1",2023-08-18,"Valencia","Las Palmas",1,0,"H",0,0,"D",1.61,4.02,6.49,"0-0","1-0",9,4,7,1,0,0,0,0,6,4,12,6,1,10,18,"6-4","N","N","N",0,0,2
"1495","SP1",2023-08-19,"Sociedad","Celta",1,1,"D",1,0,"H",1.76,3.54,5.57,"1-0","1-1",11,2,17,6,2,1,0,0,9,7,12,12,2,16,24,"9-7","Y","N","N",3,0,2
"1496","SP1",2023-08-19,"Almeria","Real Madrid",1,3,"A",1,1,"D",8.15,5.11,1.4,"1-1","1-3",20,8,24,9,1,0,0,0,4,5,10,13,4,9,23,"4-5","Y","Y","Y",1,0,2
"1497","SP1",2023-08-19,"Osasuna","Ath Bilbao",0,2,"A",0,2,"A",2.89,3.1,2.79,"0-2","0-2",18,7,8,2,1,5,1,1,5,3,9,14,2,8,23,"5-3","Y","N","N",6,2,2
"1498","SP1",2023-08-20,"Girona","Getafe",3,0,"H",1,0,"H",2.06,3.22,4.31,"1-0","3-0",7,6,9,2,2,5,0,0,3,2,11,20,3,5,31,"3-2","Y","Y","N",7,0,2
"1499","SP1",2023-08-20,"Barcelona","Cadiz",2,0,"H",0,0,"D",1.21,6.9,14.96,"0-0","2-0",23,10,10,1,4,3,0,0,10,2,9,22,2,12,31,"10-2","Y","N","N",7,0,2
"1500","SP1",2023-08-20,"Betis","Ath Madrid",0,0,"D",0,0,"D",3.93,3.57,2.02,"0-0","0-0",14,0,5,1,2,1,0,0,2,7,10,8,0,9,18,"2-7","N","N","N",3,0,2
"1501","SP1",2023-08-21,"Alaves","Sevilla",4,3,"H",2,2,"D",3.45,3.1,2.41,"2-2","4-3",14,7,12,2,1,2,0,0,4,4,14,13,7,8,27,"4-4","Y","Y","Y",3,0,2
"1502","SP1",2023-08-21,"Granada","Vallecano",0,2,"A",0,0,"D",2.68,3.09,3.03,"0-0","0-2",14,7,17,9,2,1,1,0,5,6,14,11,2,11,25,"5-6","Y","N","N",3,1,2
"1503","SP1",2023-08-25,"Las Palmas","Sociedad",0,0,"D",0,0,"D",4.23,3.36,2.04,"0-0","0-0",11,5,8,1,1,4,0,0,5,7,7,29,0,12,36,"5-7","N","N","N",5,0,3
"1504","SP1",2023-08-25,"Celta","Real Madrid",0,1,"A",0,0,"D",4.93,3.97,1.75,"0-0","0-1",13,4,10,3,2,3,0,0,3,5,19,14,1,8,33,"3-5","N","N","N",5,0,3
"1505","SP1",2023-08-26,"Cadiz","Almeria",1,1,"D",0,0,"D",2.24,3.44,3.44,"0-0","1-1",11,3,5,2,0,5,1,1,7,3,16,22,2,10,38,"7-3","Y","N","N",5,2,3
"1506","SP1",2023-08-26,"Granada","Mallorca",3,2,"H",1,1,"D",2.71,3.03,3.05,"1-1","3-2",10,4,10,5,2,7,0,0,5,3,11,27,5,8,38,"5-3","Y","Y","Y",9,0,3
"1507","SP1",2023-08-26,"Sevilla","Girona",1,2,"A",1,1,"D",2.1,3.52,3.73,"1-1","1-2",21,4,8,3,2,1,0,0,6,6,11,18,3,12,29,"6-6","Y","Y","N",3,0,3
"1508","SP1",2023-08-27,"Villarreal","Barcelona",3,4,"A",2,2,"D",3.62,3.76,2.06,"2-2","3-4",13,6,21,11,3,3,0,0,2,6,12,14,7,8,26,"2-6","Y","Y","Y",6,0,3
"1509","SP1",2023-08-27,"Valencia","Osasuna",1,2,"A",0,1,"A",1.89,3.56,4.53,"0-1","1-2",16,4,7,2,3,4,0,0,6,3,13,12,3,9,25,"6-3","Y","Y","N",7,0,3
"1510","SP1",2023-08-27,"Ath Bilbao","Betis",4,2,"H",3,2,"H",1.96,3.7,4,"3-2","4-2",14,6,7,3,4,2,0,0,5,3,23,11,6,8,34,"5-3","Y","Y","Y",6,0,3
"1511","SP1",2023-08-28,"Getafe","Alaves",1,0,"H",0,0,"D",2.36,2.89,3.88,"0-0","1-0",15,4,16,2,1,2,0,0,4,5,13,15,1,9,28,"4-5","N","N","N",3,0,3
"1512","SP1",2023-08-28,"Vallecano","Ath Madrid",0,7,"A",0,3,"A",4.16,3.48,2,"0-3","0-7",12,3,17,10,4,3,0,0,8,3,19,17,7,11,36,"8-3","Y","Y","Y",7,0,3
"1513","SP1",2023-09-01,"Cadiz","Villarreal",3,1,"H",2,1,"H",3.43,3.59,2.21,"2-1","3-1",18,4,7,3,5,4,0,1,7,3,21,15,4,10,36,"7-3","Y","Y","Y",9,1,4
"1514","SP1",2023-09-01,"Almeria","Celta",2,3,"A",0,2,"A",3.04,3.33,2.55,"0-2","2-3",16,5,14,8,1,1,0,0,6,5,9,9,5,11,18,"6-5","Y","Y","Y",2,0,4
"1515","SP1",2023-09-02,"Sociedad","Granada",5,3,"H",2,1,"H",1.47,4.63,7.49,"2-1","5-3",15,6,8,5,1,5,0,0,2,5,15,14,8,7,29,"2-5","Y","Y","Y",6,0,4
"1516","SP1",2023-09-02,"Real Madrid","Getafe",2,1,"H",0,1,"A",1.34,5.13,10.76,"0-1","2-1",26,12,6,2,2,6,0,0,11,1,12,16,3,12,28,"11-1","Y","Y","N",8,0,4
"1517","SP1",2023-09-02,"Alaves","Valencia",1,0,"H",1,0,"H",2.96,2.99,2.82,"1-0","1-0",7,1,9,4,4,2,0,0,1,2,18,9,1,3,27,"1-2","N","N","N",6,0,4
"1518","SP1",2023-09-02,"Betis","Vallecano",1,0,"H",0,0,"D",1.98,3.55,4.14,"0-0","1-0",14,5,15,6,3,5,0,0,2,3,22,20,1,5,42,"2-3","N","N","N",8,0,4
"1519","SP1",2023-09-03,"Girona","Las Palmas",1,0,"H",0,0,"D",1.69,3.83,5.59,"0-0","1-0",11,6,10,5,3,3,0,0,3,5,15,10,1,8,25,"3-5","N","N","N",6,0,4
"1520","SP1",2023-09-03,"Mallorca","Ath Bilbao",0,0,"D",0,0,"D",3.3,3.11,2.49,"0-0","0-0",8,2,11,3,0,1,0,0,3,5,12,17,0,8,29,"3-5","N","N","N",1,0,4
"1521","SP1",2023-09-03,"Osasuna","Barcelona",1,2,"A",0,1,"A",5.37,4.17,1.65,"0-1","1-2",11,3,9,4,1,3,1,0,8,5,6,16,3,13,22,"8-5","Y","Y","N",4,1,4
"1522","SP1",2023-09-15,"Vallecano","Alaves",2,0,"H",1,0,"H",2.03,3.23,4.52,"1-0","2-0",20,11,9,1,2,3,0,0,5,3,15,14,2,8,29,"5-3","Y","N","N",5,0,4
"1523","SP1",2023-09-16,"Ath Bilbao","Cadiz",3,0,"H",0,0,"D",1.56,4.17,6.66,"0-0","3-0",20,9,5,4,1,4,0,0,5,4,10,20,3,9,30,"5-4","Y","Y","N",5,0,5
"1524","SP1",2023-09-16,"Valencia","Ath Madrid",3,0,"H",2,0,"H",3.93,3.41,2.08,"2-0","3-0",12,8,11,3,1,5,0,0,5,8,13,17,3,13,30,"5-8","Y","Y","N",6,0,5
"1525","SP1",2023-09-16,"Celta","Mallorca",0,1,"A",0,0,"D",2.08,3.13,4.4,"0-0","0-1",16,4,7,4,1,3,0,0,10,1,9,15,1,11,24,"10-1","N","N","N",4,0,5
"1526","SP1",2023-09-16,"Barcelona","Betis",5,0,"H",2,0,"H",1.38,5.4,8.04,"2-0","5-0",17,9,11,2,1,2,0,0,9,5,9,10,5,14,19,"9-5","Y","Y","Y",3,0,5
"1527","SP1",2023-09-17,"Getafe","Osasuna",3,2,"H",1,1,"D",2.65,2.93,3.24,"1-1","3-2",11,6,8,3,6,2,0,0,6,3,15,11,5,9,26,"6-3","Y","Y","Y",8,0,5
"1528","SP1",2023-09-17,"Villarreal","Almeria",2,1,"H",1,1,"D",1.48,4.98,6.38,"1-1","2-1",10,4,17,7,2,3,0,0,7,6,16,6,3,13,22,"7-6","Y","Y","N",5,0,5
"1529","SP1",2023-09-17,"Sevilla","Las Palmas",1,0,"H",0,0,"D",1.64,3.93,5.99,"0-0","1-0",26,9,12,2,3,5,0,0,7,3,13,12,1,10,25,"7-3","N","N","N",8,0,5
"1530","SP1",2023-09-17,"Real Madrid","Sociedad",2,1,"H",0,1,"A",1.69,3.97,5.31,"0-1","2-1",17,8,15,5,3,2,0,0,4,3,11,14,3,7,25,"4-3","Y","Y","N",5,0,5
"1531","SP1",2023-09-18,"Granada","Girona",2,4,"A",0,3,"A",2.78,3.44,2.65,"0-3","2-4",12,5,13,7,3,3,0,0,4,5,13,21,6,9,34,"4-5","Y","Y","Y",6,0,5
"1532","SP1",2023-09-22,"Alaves","Ath Bilbao",0,2,"A",0,1,"A",4.27,3.16,2.12,"0-1","0-2",15,5,11,3,2,2,0,0,3,4,13,9,2,7,22,"3-4","Y","N","N",4,0,5
"1533","SP1",2023-09-23,"Girona","Mallorca",5,3,"H",4,1,"H",1.94,3.39,4.54,"4-1","5-3",23,10,15,5,1,5,0,0,6,5,10,12,8,11,22,"6-5","Y","Y","Y",6,0,6
"1534","SP1",2023-09-23,"Osasuna","Sevilla",0,0,"D",0,0,"D",2.62,3.22,2.99,"0-0","0-0",16,2,15,3,2,3,0,0,7,4,11,7,0,11,18,"7-4","N","N","N",5,0,6
"1535","SP1",2023-09-23,"Barcelona","Celta",3,2,"H",0,1,"A",1.29,6.04,10.38,"0-1","3-2",15,6,13,7,2,1,0,0,2,3,10,11,5,5,21,"2-3","Y","Y","Y",3,0,6
"1536","SP1",2023-09-23,"Almeria","Valencia",2,2,"D",0,1,"A",3.11,3.53,2.36,"0-1","2-2",17,10,7,5,4,2,0,0,8,3,12,10,4,11,22,"8-3","Y","Y","Y",6,0,6
"1537","SP1",2023-09-24,"Sociedad","Getafe",4,3,"H",1,2,"A",1.56,3.82,7.76,"1-2","4-3",10,6,10,7,3,2,0,0,2,1,13,24,7,3,37,"2-1","Y","Y","Y",5,0,6
"1538","SP1",2023-09-24,"Vallecano","Villarreal",1,1,"D",1,1,"D",2.56,3.54,2.83,"1-1","1-1",11,6,13,6,2,3,0,1,2,8,20,18,2,10,38,"2-8","Y","N","N",5,1,6
"1539","SP1",2023-09-24,"Betis","Cadiz",1,1,"D",0,1,"A",1.86,3.62,4.64,"0-1","1-1",21,7,5,1,2,3,0,0,11,8,10,14,2,19,24,"11-8","Y","N","N",5,0,6
"1540","SP1",2023-09-24,"Las Palmas","Granada",1,0,"H",0,0,"D",2.05,3.56,3.87,"0-0","1-0",10,3,2,1,6,4,1,0,6,7,13,19,1,13,32,"6-7","N","N","N",10,1,6
"1541","SP1",2023-09-24,"Ath Madrid","Real Madrid",3,1,"H",2,1,"H",2.88,3.37,2.61,"2-1","3-1",10,4,20,5,1,3,0,0,6,11,13,10,4,17,23,"6-11","Y","Y","Y",4,0,6
"1542","SP1",2023-09-26,"Sevilla","Almeria",5,1,"H",3,0,"H",1.7,4.1,5.09,"3-0","5-1",18,9,10,1,3,2,0,0,9,4,15,16,6,13,31,"9-4","Y","Y","Y",5,0,6
"1543","SP1",2023-09-26,"Mallorca","Barcelona",2,2,"D",2,1,"H",6.98,4.53,1.51,"2-1","2-2",10,5,10,4,4,1,1,0,7,2,19,7,4,9,26,"7-2","Y","Y","Y",5,1,7
"1544","SP1",2023-09-27,"Ath Bilbao","Getafe",2,2,"D",1,0,"H",1.64,3.76,6.51,"1-0","2-2",9,4,13,5,5,6,1,0,5,4,9,19,4,9,28,"5-4","Y","Y","Y",11,1,7
"1545","SP1",2023-09-27,"Real Madrid","Las Palmas",2,0,"H",1,0,"H",1.21,7.24,13.67,"1-0","2-0",21,9,16,2,0,1,0,0,7,2,7,9,2,9,16,"7-2","Y","N","N",1,0,7
"1546","SP1",2023-09-27,"Villarreal","Girona",1,2,"A",0,0,"D",2.22,3.72,3.23,"0-0","1-2",14,3,17,5,3,2,0,0,5,6,9,11,3,11,20,"5-6","Y","Y","N",5,0,7
"1547","SP1",2023-09-27,"Cadiz","Vallecano",0,0,"D",0,0,"D",2.64,3.17,3,"0-0","0-0",9,2,9,4,5,6,0,1,1,2,16,13,0,3,29,"1-2","N","N","N",11,1,7
"1548","SP1",2023-09-27,"Valencia","Sociedad",0,1,"A",0,1,"A",2.68,3.18,2.94,"0-1","0-1",9,2,2,1,4,7,1,0,0,2,14,17,1,2,31,"0-2","N","N","N",11,1,7
"1549","SP1",2023-09-28,"Celta","Alaves",1,1,"D",1,0,"H",1.71,3.59,5.97,"1-0","1-1",8,0,21,11,5,3,1,0,2,8,9,11,2,10,20,"2-8","Y","N","N",8,1,7
"1550","SP1",2023-09-28,"Granada","Betis",1,1,"D",0,0,"D",3.11,3.53,2.36,"0-0","1-1",19,7,13,3,2,1,0,0,5,7,14,10,2,12,24,"5-7","Y","N","N",3,0,7
"1551","SP1",2023-09-28,"Osasuna","Ath Madrid",0,2,"A",0,1,"A",3.68,3.47,2.14,"0-1","0-2",13,2,4,3,3,3,1,1,7,2,14,4,2,9,18,"7-2","Y","N","N",6,2,7
"1552","SP1",2023-09-29,"Barcelona","Sevilla",1,0,"H",0,0,"D",1.39,5.36,7.97,"0-0","1-0",18,5,12,3,2,3,0,0,13,3,11,15,1,16,26,"13-3","N","N","N",5,0,7
"1553","SP1",2023-09-30,"Getafe","Villarreal",0,0,"D",0,0,"D",3,3.25,2.59,"0-0","0-0",22,9,3,0,2,4,0,1,6,4,19,11,0,10,30,"6-4","N","N","N",6,1,8
"1554","SP1",2023-09-30,"Vallecano","Mallorca",2,2,"D",1,1,"D",2.16,3.16,4.04,"1-1","2-2",19,5,9,4,2,5,0,0,5,0,12,20,4,5,32,"5-0","Y","Y","Y",7,0,8
"1555","SP1",2023-09-30,"Girona","Real Madrid",0,3,"A",0,2,"A",3.56,4.02,2,"0-2","0-3",13,3,14,7,2,2,0,1,1,4,13,14,3,5,27,"1-4","Y","Y","N",4,1,8
"1556","SP1",2023-09-30,"Sociedad","Ath Bilbao",3,0,"H",1,0,"H",2.26,3.3,3.53,"1-0","3-0",8,5,18,3,2,2,0,0,5,7,20,9,3,12,29,"5-7","Y","Y","N",4,0,8
"1557","SP1",2023-10-01,"Almeria","Granada",3,3,"D",3,0,"H",1.92,3.68,3.96,"3-0","3-3",17,5,19,4,2,1,0,0,1,5,18,14,6,6,32,"1-5","Y","Y","Y",3,0,8
"1558","SP1",2023-10-01,"Alaves","Osasuna",0,2,"A",0,1,"A",2.76,2.99,2.89,"0-1","0-2",17,3,10,3,2,3,1,0,4,2,13,13,2,6,26,"4-2","Y","N","N",5,1,8
"1559","SP1",2023-10-01,"Ath Madrid","Cadiz",3,2,"H",1,2,"A",1.35,4.99,8.91,"1-2","3-2",18,9,8,4,1,3,0,0,5,3,5,10,5,8,15,"5-3","Y","Y","Y",4,0,8
"1560","SP1",2023-10-01,"Betis","Valencia",3,0,"H",1,0,"H",2.31,3.29,3.26,"1-0","3-0",15,7,9,2,2,2,0,0,5,3,11,10,3,8,21,"5-3","Y","Y","N",4,0,8
"1561","SP1",2023-10-02,"Las Palmas","Celta",2,1,"H",0,0,"D",2.52,3.15,2.99,"0-0","2-1",16,5,11,3,2,1,0,0,4,5,13,14,3,9,27,"4-5","Y","Y","N",3,0,8
"1562","SP1",2023-10-06,"Ath Bilbao","Almeria",3,0,"H",1,0,"H",1.38,5.41,8.23,"1-0","3-0",23,9,4,1,2,0,0,0,6,2,11,7,3,8,18,"6-2","Y","Y","N",2,0,8
"1563","SP1",2023-10-07,"Cadiz","Girona",0,1,"A",0,0,"D",3.28,3.4,2.33,"0-0","0-1",8,2,20,5,1,3,1,0,5,5,12,13,1,10,25,"5-5","N","N","N",4,1,9
"1564","SP1",2023-10-07,"Real Madrid","Osasuna",4,0,"H",1,0,"H",1.3,5.95,10.38,"1-0","4-0",19,9,7,1,2,2,0,0,5,4,9,6,4,9,15,"5-4","Y","Y","Y",4,0,9
"1565","SP1",2023-10-07,"Mallorca","Valencia",1,1,"D",1,1,"D",2.54,3.05,3.26,"1-1","1-1",9,5,11,3,2,1,0,0,3,6,17,11,2,9,28,"3-6","Y","N","N",3,0,9
"1566","SP1",2023-10-07,"Sevilla","Vallecano",2,2,"D",0,2,"A",1.91,3.61,4.39,"0-2","2-2",22,6,7,4,5,2,0,0,12,2,16,19,4,14,35,"12-2","Y","Y","Y",7,0,9
"1567","SP1",2023-10-08,"Villarreal","Las Palmas",1,2,"A",0,1,"A",1.63,4.21,5.56,"0-1","1-2",9,4,8,5,4,4,0,0,7,2,17,7,3,9,24,"7-2","Y","Y","N",8,0,9
"1568","SP1",2023-10-08,"Ath Madrid","Sociedad",2,1,"H",1,0,"H",1.93,3.39,4.59,"1-0","2-1",14,5,13,4,3,3,0,0,1,4,9,12,3,5,21,"1-4","Y","Y","N",6,0,9
"1569","SP1",2023-10-08,"Alaves","Betis",1,1,"D",1,1,"D",2.93,3.2,2.68,"1-1","1-1",15,5,6,2,3,3,0,1,5,3,13,9,2,8,22,"5-3","Y","N","N",6,1,9
"1570","SP1",2023-10-08,"Celta","Getafe",2,2,"D",2,2,"D",2.07,3.23,4.23,"2-2","2-2",26,11,3,2,1,8,0,1,13,1,14,20,4,14,34,"13-1","Y","Y","Y",9,1,9
"1571","SP1",2023-10-08,"Granada","Barcelona",2,2,"D",2,1,"H",6.89,5.36,1.43,"2-1","2-2",7,2,22,10,4,1,0,0,1,11,12,7,4,12,19,"1-11","Y","Y","Y",5,0,9
"1572","SP1",2023-10-20,"Osasuna","Granada",2,0,"H",1,0,"H",1.72,3.99,5.13,"1-0","2-0",12,6,13,3,3,4,0,1,1,7,19,13,2,8,32,"1-7","Y","N","N",7,1,9
"1573","SP1",2023-10-21,"Sociedad","Mallorca",1,0,"H",0,0,"D",1.57,3.91,7.23,"0-0","1-0",14,6,18,7,3,3,0,0,2,5,14,16,1,7,30,"2-5","N","N","N",6,0,10
"1574","SP1",2023-10-21,"Getafe","Betis",1,1,"D",1,1,"D",2.51,3.11,3.25,"1-1","1-1",14,4,13,3,5,2,0,0,4,8,17,11,2,12,28,"4-8","Y","N","N",7,0,10
"1575","SP1",2023-10-21,"Sevilla","Real Madrid",1,1,"D",0,0,"D",4.18,3.91,1.87,"0-0","1-1",17,7,14,5,5,2,0,0,4,6,13,6,2,10,19,"4-6","Y","N","N",7,0,10
"1576","SP1",2023-10-21,"Celta","Ath Madrid",0,3,"A",0,1,"A",3.65,3.53,2.12,"0-1","0-3",16,3,12,7,3,2,1,0,7,5,10,10,3,12,20,"7-5","Y","Y","N",5,1,10
"1577","SP1",2023-10-22,"Las Palmas","Vallecano",0,1,"A",0,0,"D",2.71,3.12,2.96,"0-0","0-1",12,6,12,4,4,3,0,1,10,5,13,11,1,15,24,"10-5","N","N","N",7,1,10
"1578","SP1",2023-10-22,"Girona","Almeria",5,2,"H",3,2,"H",1.47,4.89,6.71,"3-2","5-2",19,8,9,5,1,2,0,0,9,6,11,14,7,15,25,"9-6","Y","Y","Y",3,0,10
"1579","SP1",2023-10-22,"Villarreal","Alaves",1,1,"D",0,0,"D",1.74,3.98,4.95,"0-0","1-1",12,3,16,7,4,3,0,0,9,3,15,10,2,12,25,"9-3","Y","N","N",7,0,10
"1580","SP1",2023-10-22,"Barcelona","Ath Bilbao",1,0,"H",0,0,"D",1.68,4.14,5.16,"0-0","1-0",12,7,10,3,3,3,0,0,4,7,11,18,1,11,29,"4-7","N","N","N",6,0,10
"1581","SP1",2023-10-23,"Valencia","Cadiz",2,0,"H",2,0,"H",1.78,3.6,5.29,"2-0","2-0",12,4,5,4,0,3,0,1,4,6,16,16,2,10,32,"4-6","Y","N","N",3,1,10
"1582","SP1",2023-10-27,"Girona","Celta",1,0,"H",0,0,"D",1.69,4.27,4.84,"0-0","1-0",12,2,4,2,3,2,0,0,10,1,15,12,1,11,27,"10-1","N","N","N",5,0,10
"1583","SP1",2023-10-28,"Almeria","Las Palmas",1,2,"A",0,1,"A",2.37,3.46,3.15,"0-1","1-2",10,4,10,3,3,1,0,0,3,2,13,19,3,5,32,"3-2","Y","Y","N",4,0,11
"1584","SP1",2023-10-28,"Barcelona","Real Madrid",1,2,"A",1,0,"H",2.55,3.66,2.76,"1-0","1-2",15,3,13,4,2,1,0,0,6,3,15,15,3,9,30,"6-3","Y","Y","N",3,0,11
"1585","SP1",2023-10-28,"Mallorca","Getafe",0,0,"D",0,0,"D",2.35,3.03,3.67,"0-0","0-0",15,4,8,0,0,1,0,0,8,3,10,25,0,11,35,"8-3","N","N","N",1,0,11
"1586","SP1",2023-10-28,"Cadiz","Sevilla",2,2,"D",2,1,"H",3.39,3.37,2.29,"2-1","2-2",10,5,20,10,6,4,0,0,2,4,17,12,4,6,29,"2-4","Y","Y","Y",10,0,11
"1587","SP1",2023-10-29,"Betis","Osasuna",2,1,"H",1,0,"H",2.1,3.4,3.89,"1-0","2-1",9,2,7,1,3,4,0,0,6,3,10,25,3,9,35,"6-3","Y","Y","N",7,0,11
"1588","SP1",2023-10-29,"Vallecano","Sociedad",2,2,"D",1,1,"D",3.34,3.11,2.46,"1-1","2-2",16,7,15,3,3,2,0,0,4,5,17,16,4,9,33,"4-5","Y","Y","Y",5,0,11
"1589","SP1",2023-10-29,"Ath Bilbao","Valencia",2,2,"D",1,0,"H",1.64,3.96,5.95,"1-0","2-2",12,7,11,5,3,1,0,0,10,4,11,10,4,14,21,"10-4","Y","Y","Y",4,0,11
"1590","SP1",2023-10-29,"Ath Madrid","Alaves",2,1,"H",2,0,"H",1.4,4.96,8.74,"2-0","2-1",11,7,8,1,3,2,0,0,4,4,10,11,3,8,21,"4-4","Y","Y","N",5,0,11
"1591","SP1",2023-10-30,"Granada","Villarreal",2,3,"A",2,3,"A",3.16,3.62,2.29,"2-3","2-3",18,8,6,5,0,4,0,0,4,1,14,15,5,5,29,"4-1","Y","Y","Y",4,0,11
"1592","SP1",2023-11-03,"Las Palmas","Ath Madrid",2,1,"H",0,0,"D",5.74,3.85,1.68,"0-0","2-1",9,3,13,5,0,3,0,0,3,4,12,9,3,7,21,"3-4","Y","Y","N",3,0,11
"1593","SP1",2023-11-04,"Osasuna","Girona",2,4,"A",1,1,"D",2.88,3.47,2.51,"1-1","2-4",15,3,11,4,5,3,0,0,2,7,14,10,6,9,24,"2-7","Y","Y","Y",8,0,12
"1594","SP1",2023-11-04,"Betis","Mallorca",2,0,"H",1,0,"H",1.93,3.37,4.52,"1-0","2-0",22,3,8,1,1,4,0,1,6,1,13,16,2,7,29,"6-1","Y","N","N",5,1,12
"1595","SP1",2023-11-04,"Celta","Sevilla",1,1,"D",1,0,"H",2.58,3.49,2.79,"1-0","1-1",15,3,13,5,2,5,1,0,4,6,14,10,2,10,24,"4-6","Y","N","N",7,1,12
"1596","SP1",2023-11-04,"Sociedad","Barcelona",0,1,"A",0,0,"D",3.37,3.55,2.2,"0-0","0-1",13,6,12,4,3,3,0,0,8,3,16,8,1,11,24,"8-3","N","N","N",6,0,12
"1597","SP1",2023-11-05,"Alaves","Almeria",1,0,"H",0,0,"D",1.78,3.8,4.75,"0-0","1-0",23,3,9,3,2,3,0,0,12,6,13,14,1,18,27,"12-6","N","N","N",5,0,12
"1598","SP1",2023-11-05,"Valencia","Granada",1,0,"H",1,0,"H",1.66,4.13,5.24,"1-0","1-0",11,2,6,1,3,5,0,0,0,4,20,15,1,4,35,"0-4","N","N","N",8,0,12
"1599","SP1",2023-11-05,"Villarreal","Ath Bilbao",2,3,"A",0,3,"A",3.06,3.58,2.34,"0-3","2-3",17,6,17,7,4,4,0,0,9,3,11,18,5,12,29,"9-3","Y","Y","Y",8,0,12
"1600","SP1",2023-11-05,"Real Madrid","Vallecano",0,0,"D",0,0,"D",1.27,6.24,10.53,"0-0","0-0",22,5,4,0,3,5,0,0,11,1,12,15,0,12,27,"11-1","N","N","N",8,0,12
"1601","SP1",2023-11-06,"Getafe","Cadiz",1,0,"H",0,0,"D",1.93,3.19,4.88,"0-0","1-0",13,3,6,2,7,1,1,0,6,3,18,12,1,9,30,"6-3","N","N","N",8,1,12
"1602","SP1",2023-11-10,"Ath Bilbao","Celta",4,3,"H",2,2,"D",1.69,4.17,5.04,"2-2","4-3",21,12,13,5,2,2,0,0,7,2,15,13,7,9,28,"7-2","Y","Y","Y",4,0,12
"1603","SP1",2023-11-11,"Vallecano","Girona",1,2,"A",1,1,"D",2.92,3.48,2.48,"1-1","1-2",22,9,19,7,1,2,0,0,8,3,15,13,3,11,28,"8-3","Y","Y","N",3,0,13
"1604","SP1",2023-11-11,"Almeria","Sociedad",1,3,"A",0,0,"D",4.83,4.01,1.72,"0-0","1-3",7,2,18,6,2,2,0,0,5,5,18,19,4,10,37,"5-5","Y","Y","Y",4,0,13
"1605","SP1",2023-11-11,"Granada","Getafe",1,1,"D",1,1,"D",2.58,3.16,3.04,"1-1","1-1",12,6,10,6,4,2,0,0,3,5,14,9,2,8,23,"3-5","Y","N","N",6,0,13
"1606","SP1",2023-11-11,"Osasuna","Las Palmas",1,1,"D",0,0,"D",2,3.25,4.42,"0-0","1-1",11,3,6,1,1,1,0,0,8,3,25,10,2,11,35,"8-3","Y","N","N",2,0,13
"1607","SP1",2023-11-11,"Real Madrid","Valencia",5,1,"H",2,0,"H",1.32,5.6,9.7,"2-0","5-1",16,7,10,4,1,3,0,0,4,4,7,26,6,8,33,"4-4","Y","Y","Y",4,0,13
"1608","SP1",2023-11-12,"Barcelona","Alaves",2,1,"H",0,1,"A",1.24,6.51,11.82,"0-1","2-1",11,6,8,1,2,1,0,0,2,1,11,10,3,3,21,"2-1","Y","Y","N",3,0,13
"1609","SP1",2023-11-12,"Sevilla","Betis",1,1,"D",0,0,"D",2.17,3.52,3.46,"0-0","1-1",13,4,14,6,1,1,0,0,9,5,18,14,2,14,32,"9-5","Y","N","N",2,0,13
"1610","SP1",2023-11-12,"Ath Madrid","Villarreal",3,1,"H",1,1,"D",1.38,5.43,7.71,"1-1","3-1",25,10,11,7,0,2,0,0,6,3,8,8,4,9,16,"6-3","Y","Y","Y",2,0,13
"1611","SP1",2023-11-24,"Alaves","Granada",3,1,"H",2,0,"H",1.76,3.74,5.15,"2-0","3-1",8,5,11,4,1,3,0,0,6,2,10,13,4,8,23,"6-2","Y","Y","Y",4,0,13
"1612","SP1",2023-11-25,"Vallecano","Barcelona",1,1,"D",1,0,"H",5.39,4.09,1.65,"1-0","1-1",10,4,15,4,3,4,0,0,1,4,23,13,2,5,36,"1-4","Y","N","N",7,0,13
"1613","SP1",2023-11-25,"Valencia","Celta",0,0,"D",0,0,"D",2.19,3.43,3.51,"0-0","0-0",8,0,13,1,3,2,0,0,5,7,13,7,0,12,20,"5-7","N","N","N",5,0,14
"1614","SP1",2023-11-25,"Getafe","Almeria",2,1,"H",2,1,"H",1.68,3.86,5.46,"2-1","2-1",18,5,13,4,2,4,0,0,3,6,12,8,3,9,20,"3-6","Y","Y","N",6,0,14
"1615","SP1",2023-11-25,"Ath Madrid","Mallorca",1,0,"H",0,0,"D",1.37,4.89,9.37,"0-0","1-0",20,3,8,1,0,0,0,0,7,3,8,19,1,10,27,"7-3","N","N","N",0,0,14
"1616","SP1",2023-11-26,"Villarreal","Osasuna",3,1,"H",0,0,"D",2.17,3.49,3.5,"0-0","3-1",10,3,15,7,0,0,0,0,2,4,9,14,4,6,23,"2-4","Y","Y","Y",0,0,14
"1617","SP1",2023-11-26,"Sociedad","Sevilla",2,1,"H",2,0,"H",1.76,3.76,4.92,"2-0","2-1",11,8,8,2,2,1,0,2,4,4,22,8,3,8,30,"4-4","Y","Y","N",3,2,14
"1618","SP1",2023-11-26,"Cadiz","Real Madrid",0,3,"A",0,1,"A",6.67,4.68,1.48,"0-1","0-3",13,4,14,5,3,3,0,0,4,4,16,16,3,8,32,"4-4","Y","Y","N",6,0,14
"1619","SP1",2023-11-26,"Betis","Las Palmas",1,0,"H",1,0,"H",1.65,3.91,5.66,"1-0","1-0",12,6,15,4,1,2,0,0,7,6,7,12,1,13,19,"7-6","N","N","N",3,0,14
"1620","SP1",2023-11-27,"Girona","Ath Bilbao",1,1,"D",0,0,"D",2.32,3.69,3.01,"0-0","1-1",12,2,13,6,1,1,0,0,2,6,8,16,2,8,24,"2-6","Y","N","N",2,0,14
"1621","SP1",2023-11-29,"Mallorca","Cadiz",1,1,"D",1,1,"D",1.99,3.21,4.56,"1-1","1-1",16,3,6,3,2,3,0,0,7,0,14,18,2,7,32,"7-0","Y","N","N",5,0,14
"1622","SP1",2023-12-01,"Las Palmas","Getafe",2,0,"H",1,0,"H",2.49,2.95,3.48,"1-0","2-0",11,6,12,4,0,5,0,1,4,4,11,9,2,8,20,"4-4","Y","N","N",5,1,14
"1623","SP1",2023-12-02,"Girona","Valencia",2,1,"H",0,0,"D",1.71,3.97,5,"0-0","2-1",9,5,9,3,2,3,0,0,3,2,6,7,3,5,13,"3-2","Y","Y","N",5,0,15
"1624","SP1",2023-12-02,"Ath Bilbao","Vallecano",4,0,"H",1,0,"H",1.57,4.32,5.92,"1-0","4-0",9,4,11,3,1,2,0,0,7,2,15,11,4,9,26,"7-2","Y","Y","Y",3,0,15
"1625","SP1",2023-12-02,"Real Madrid","Granada",2,0,"H",1,0,"H",1.16,8.84,14.66,"1-0","2-0",11,4,1,0,2,1,0,0,6,0,10,12,2,6,22,"6-0","Y","N","N",3,0,15
"1626","SP1",2023-12-02,"Osasuna","Sociedad",1,1,"D",1,1,"D",3.75,3.24,2.18,"1-1","1-1",9,3,17,5,3,3,0,0,1,8,12,10,2,9,22,"1-8","Y","N","N",6,0,15
"1627","SP1",2023-12-03,"Mallorca","Alaves",0,0,"D",0,0,"D",2.47,2.99,3.41,"0-0","0-0",7,3,7,4,4,2,0,0,5,4,16,15,0,9,31,"5-4","N","N","N",6,0,15
"1628","SP1",2023-12-03,"Almeria","Betis",0,0,"D",0,0,"D",3.36,3.66,2.16,"0-0","0-0",20,8,6,2,0,3,0,1,4,6,12,8,0,10,20,"4-6","N","N","N",3,1,15
"1629","SP1",2023-12-03,"Sevilla","Villarreal",1,1,"D",0,0,"D",2.05,3.73,3.58,"0-0","1-1",18,4,5,4,3,2,0,0,8,4,6,16,2,12,22,"8-4","Y","N","N",5,0,15
"1630","SP1",2023-12-03,"Barcelona","Ath Madrid",1,0,"H",1,0,"H",2.05,3.76,3.57,"1-0","1-0",13,2,9,4,5,4,0,0,7,2,17,12,1,9,29,"7-2","N","N","N",9,0,15
"1631","SP1",2023-12-04,"Celta","Cadiz",1,1,"D",0,1,"A",1.61,4.13,5.8,"0-1","1-1",26,7,2,1,1,6,0,1,12,1,14,18,2,13,32,"12-1","Y","N","N",7,1,15
"1632","SP1",2023-12-08,"Getafe","Valencia",1,0,"H",0,0,"D",2.76,2.88,3.14,"0-0","1-0",8,6,3,0,2,4,1,2,7,0,15,14,1,7,29,"7-0","N","N","N",6,3,15
"1633","SP1",2023-12-09,"Alaves","Las Palmas",0,1,"A",0,1,"A",2.08,3.16,4.2,"0-1","0-1",19,5,9,2,3,4,0,0,12,3,13,13,1,15,26,"12-3","N","N","N",7,0,16
"1634","SP1",2023-12-09,"Betis","Real Madrid",1,1,"D",0,0,"D",4.39,3.92,1.81,"0-0","1-1",14,6,12,2,2,1,0,0,8,6,14,7,2,14,21,"8-6","Y","N","N",3,0,16
"1635","SP1",2023-12-09,"Villarreal","Sociedad",0,3,"A",0,3,"A",3.45,3.55,2.16,"0-3","0-3",20,4,16,5,2,1,0,0,5,3,10,22,3,8,32,"5-3","Y","Y","N",3,0,16
"1636","SP1",2023-12-09,"Mallorca","Sevilla",1,0,"H",1,0,"H",2.69,3.16,2.9,"1-0","1-0",6,3,19,5,2,2,0,0,4,12,15,6,1,16,21,"4-12","N","N","N",4,0,16
"1637","SP1",2023-12-10,"Ath Madrid","Almeria",2,1,"H",2,0,"H",1.19,7.63,13.51,"2-0","2-1",13,4,19,5,1,0,0,0,3,15,13,11,3,18,24,"3-15","Y","Y","N",1,0,16
"1638","SP1",2023-12-10,"Cadiz","Osasuna",1,1,"D",1,0,"H",2.99,3.14,2.63,"1-0","1-1",12,5,13,5,1,2,0,0,2,4,15,16,2,6,31,"2-4","Y","N","N",3,0,16
"1639","SP1",2023-12-10,"Barcelona","Girona",2,4,"A",1,2,"A",1.52,4.9,5.7,"1-2","2-4",31,11,15,7,1,2,0,0,8,3,7,10,6,11,17,"8-3","Y","Y","Y",3,0,16
"1640","SP1",2023-12-11,"Granada","Ath Bilbao",1,1,"D",0,1,"A",4.85,4.16,1.69,"0-1","1-1",7,4,19,4,0,2,0,0,1,8,9,11,2,9,20,"1-8","Y","N","N",2,0,16
"1641","SP1",2023-12-11,"Vallecano","Celta",0,0,"D",0,0,"D",2.51,3.31,3.02,"0-0","0-0",17,4,4,2,3,0,0,0,8,1,15,10,0,9,25,"8-1","N","N","N",3,0,16
"1642","SP1",2023-12-15,"Osasuna","Vallecano",1,0,"H",0,0,"D",2.29,3.16,3.63,"0-0","1-0",10,4,9,3,2,3,0,0,9,1,20,13,1,10,33,"9-1","N","N","N",5,0,16
"1643","SP1",2023-12-16,"Celta","Granada",1,0,"H",1,0,"H",1.67,4.1,5.13,"1-0","1-0",11,4,7,2,6,2,1,0,7,1,20,18,1,8,38,"7-1","N","N","N",8,1,17
"1644","SP1",2023-12-16,"Ath Bilbao","Ath Madrid",2,0,"H",0,0,"D",2.45,3.52,2.94,"0-0","2-0",16,7,7,3,0,1,0,0,3,7,7,10,2,10,17,"3-7","Y","N","N",1,0,17
"1645","SP1",2023-12-16,"Sevilla","Getafe",0,3,"A",0,2,"A",1.97,3.39,4.32,"0-2","0-3",12,4,14,7,3,3,0,0,4,2,18,18,3,6,36,"4-2","Y","Y","N",6,0,17
"1646","SP1",2023-12-16,"Valencia","Barcelona",1,1,"D",0,0,"D",5.2,4.06,1.67,"0-0","1-1",11,4,16,8,1,2,0,0,4,6,9,11,2,10,20,"4-6","Y","N","N",3,0,17
"1647","SP1",2023-12-17,"Almeria","Mallorca",0,0,"D",0,0,"D",2.66,3.3,2.83,"0-0","0-0",7,1,20,2,2,1,0,0,4,4,12,9,0,8,21,"4-4","N","N","N",3,0,17
"1648","SP1",2023-12-17,"Sociedad","Betis",0,0,"D",0,0,"D",1.7,3.9,5.17,"0-0","0-0",12,4,12,3,3,4,0,0,3,7,12,12,0,10,24,"3-7","N","N","N",7,0,17
"1649","SP1",2023-12-17,"Las Palmas","Cadiz",1,1,"D",1,0,"H",1.96,3.31,4.49,"1-0","1-1",7,2,13,5,1,3,0,0,4,6,9,12,2,10,21,"4-6","Y","N","N",4,0,17
"1650","SP1",2023-12-17,"Real Madrid","Villarreal",4,1,"H",2,0,"H",1.29,6.3,9.21,"2-0","4-1",22,9,3,1,2,3,0,0,11,0,14,12,5,11,26,"11-0","Y","Y","Y",5,0,17
"1651","SP1",2023-12-18,"Girona","Alaves",3,0,"H",2,0,"H",1.57,4.38,5.79,"2-0","3-0",9,4,12,2,0,1,0,0,3,2,9,7,3,5,16,"3-2","Y","Y","N",1,0,17
"1652","SP1",2023-12-19,"Vallecano","Valencia",0,1,"A",0,0,"D",2.24,3.18,3.74,"0-0","0-1",7,1,8,3,1,5,0,1,8,1,16,18,1,9,34,"8-1","N","N","N",6,1,17
"1653","SP1",2023-12-19,"Ath Madrid","Getafe",3,3,"D",1,0,"H",1.48,4.45,7.67,"1-0","3-3",8,4,29,9,3,3,1,0,1,12,7,14,6,13,21,"1-12","Y","Y","Y",6,1,18
"1654","SP1",2023-12-19,"Granada","Sevilla",0,3,"A",0,2,"A",2.96,3.3,2.59,"0-2","0-3",12,3,12,5,2,1,0,0,6,4,10,18,3,10,28,"6-4","Y","Y","N",3,0,18
"1655","SP1",2023-12-20,"Barcelona","Almeria",3,2,"H",1,1,"D",1.13,10.49,16.19,"1-1","3-2",30,11,10,5,3,3,0,0,12,0,16,9,5,12,25,"12-0","Y","Y","Y",6,0,18
"1656","SP1",2023-12-20,"Ath Bilbao","Las Palmas",1,0,"H",0,0,"D",1.39,4.99,8.41,"0-0","1-0",19,10,5,1,1,3,0,0,5,2,12,11,1,7,23,"5-2","N","N","N",4,0,18
"1657","SP1",2023-12-20,"Villarreal","Celta",3,2,"H",2,0,"H",2.42,3.52,2.98,"2-0","3-2",12,8,15,5,2,4,0,0,4,7,16,15,5,11,31,"4-7","Y","Y","Y",6,0,18
"1658","SP1",2023-12-21,"Betis","Girona",1,1,"D",0,1,"A",2.87,3.69,2.42,"0-1","1-1",21,4,12,4,2,2,0,0,7,6,6,9,2,13,15,"7-6","Y","N","N",4,0,18
"1659","SP1",2023-12-21,"Cadiz","Sociedad",0,0,"D",0,0,"D",4.8,3.42,1.87,"0-0","0-0",10,2,8,1,3,1,0,0,7,5,16,15,0,12,31,"7-5","N","N","N",4,0,18
"1660","SP1",2023-12-21,"Alaves","Real Madrid",0,1,"A",0,0,"D",5.93,4.26,1.58,"0-0","0-1",8,2,9,4,3,1,0,1,3,3,18,13,1,6,31,"3-3","N","N","N",4,1,18
"1661","SP1",2023-12-21,"Mallorca","Osasuna",3,2,"H",1,1,"D",2.42,2.98,3.51,"1-1","3-2",15,8,12,7,3,1,0,0,6,0,11,12,5,6,23,"6-0","Y","Y","Y",4,0,18
"1662","SP1",2023-12-23,"Ath Madrid","Sevilla",1,0,"H",0,0,"D",1.54,4.51,6.05,"0-0","1-0",12,4,8,2,7,3,1,0,6,5,12,19,1,11,31,"6-5","N","N","N",10,1,18
"1663","SP1",2024-01-02,"Getafe","Vallecano",0,2,"A",0,1,"A",2.42,3,3.5,"0-1","0-2",5,0,12,8,6,3,2,0,2,3,16,16,2,5,32,"2-3","Y","N","N",9,2,19
"1664","SP1",2024-01-02,"Sociedad","Alaves",1,1,"D",0,0,"D",1.59,3.9,6.58,"0-0","1-1",16,6,7,2,4,4,1,0,6,4,9,17,2,10,26,"6-4","Y","N","N",8,1,19
"1665","SP1",2024-01-02,"Valencia","Villarreal",3,1,"H",2,0,"H",2.04,3.49,3.9,"2-0","3-1",11,8,8,4,2,5,0,0,4,3,12,15,4,7,27,"4-3","Y","Y","Y",7,0,19
"1666","SP1",2024-01-03,"Granada","Cadiz",2,0,"H",1,0,"H",2.26,3.19,3.59,"1-0","2-0",15,8,15,2,3,4,0,1,5,6,17,16,2,11,33,"5-6","Y","N","N",7,1,19
"1667","SP1",2024-01-03,"Celta","Betis",2,1,"H",1,1,"D",2.47,3.33,3.05,"1-1","2-1",19,6,14,3,0,2,0,0,8,7,10,12,3,15,22,"8-7","Y","Y","N",2,0,19
"1668","SP1",2024-01-03,"Real Madrid","Mallorca",1,0,"H",0,0,"D",1.23,6.68,12.58,"0-0","1-0",17,5,7,0,2,3,0,0,5,4,5,15,1,9,20,"5-4","N","N","N",5,0,19
"1669","SP1",2024-01-03,"Girona","Ath Madrid",4,3,"H",3,2,"H",2.61,3.55,2.71,"3-2","4-3",17,9,18,12,0,1,0,0,7,8,8,10,7,15,18,"7-8","Y","Y","Y",1,0,19
"1670","SP1",2024-01-04,"Osasuna","Almeria",1,0,"H",1,0,"H",1.71,3.94,5.03,"1-0","1-0",14,2,4,0,1,2,0,0,5,4,14,5,1,9,19,"5-4","N","N","N",3,0,19
"1671","SP1",2024-01-04,"Sevilla","Ath Bilbao",0,2,"A",0,1,"A",3.17,3.24,2.45,"0-1","0-2",11,2,15,6,3,1,0,0,5,4,9,19,2,9,28,"5-4","Y","N","N",4,0,19
"1672","SP1",2024-01-04,"Las Palmas","Barcelona",1,2,"A",1,0,"H",5.82,4.39,1.57,"1-0","1-2",12,3,15,5,5,2,1,0,5,10,14,5,3,15,19,"5-10","Y","Y","N",7,1,19
"1673","SP1",2024-01-12,"Sevilla","Alaves",2,3,"A",0,2,"A",1.95,3.4,4.52,"0-2","2-3",19,4,16,8,4,3,0,0,5,4,12,13,5,9,25,"5-4","Y","Y","Y",7,0,20
"1674","SP1",2024-01-13,"Las Palmas","Villarreal",3,0,"H",1,0,"H",2.52,3.39,2.94,"1-0","3-0",8,3,17,3,4,3,0,0,4,6,13,11,3,10,24,"4-6","Y","Y","N",7,0,20
"1675","SP1",2024-01-13,"Mallorca","Celta",1,1,"D",1,1,"D",2.57,3.02,3.2,"1-1","1-1",17,6,6,2,4,1,0,0,10,1,18,18,2,11,36,"10-1","Y","N","N",5,0,20
"1676","SP1",2024-01-13,"Ath Bilbao","Sociedad",2,1,"H",2,0,"H",2.02,3.47,4,"2-0","2-1",10,3,9,1,1,4,0,0,5,5,16,21,3,10,37,"5-5","Y","Y","N",5,0,20
"1677","SP1",2024-01-13,"Betis","Granada",1,0,"H",0,0,"D",1.65,4.04,5.49,"0-0","1-0",25,6,6,2,3,4,0,0,13,1,11,17,1,14,28,"13-1","N","N","N",7,0,20
"1678","SP1",2024-01-14,"Almeria","Girona",0,0,"D",0,0,"D",4.71,4.42,1.67,"0-0","0-0",20,3,5,1,4,4,0,1,4,3,13,8,0,7,21,"4-3","N","N","N",8,1,20
"1679","SP1",2024-01-14,"Cadiz","Valencia",1,4,"A",1,1,"D",3.02,2.96,2.75,"1-1","1-4",10,2,9,5,4,2,0,0,3,1,15,15,5,4,30,"3-1","Y","Y","Y",6,0,20
"1680","SP2",2023-08-11,"Amorebieta","Levante",1,1,"D",0,1,"A",3.32,3.1,2.48,"0-1","1-1",11,3,7,2,0,3,0,0,8,2,20,18,2,10,38,"8-2","Y","N","N",3,0,1
"1681","SP2",2023-08-11,"Valladolid","Sp Gijon",2,0,"H",1,0,"H",1.93,3.36,4.67,"1-0","2-0",17,5,11,4,5,5,0,0,8,2,12,15,2,10,27,"8-2","Y","N","N",10,0,1
"1682","SP2",2023-08-12,"Santander","Eibar",4,0,"H",3,0,"H",3.05,2.98,2.74,"3-0","4-0",11,8,14,3,2,3,0,0,4,6,10,14,4,10,24,"4-6","Y","Y","Y",5,0,1
"1683","SP2",2023-08-12,"Zaragoza","Villarreal B",2,0,"H",0,0,"D",1.71,3.54,6.06,"0-0","2-0",16,7,11,2,2,4,0,0,4,0,9,8,2,4,17,"4-0","Y","N","N",6,0,1
"1684","SP2",2023-08-12,"Elche","Ferrol",0,1,"A",0,0,"D",NA,NA,NA,"0-0","0-1",14,1,10,2,0,2,0,0,4,4,13,15,1,8,28,"4-4","N","N","N",2,0,1
"1685","SP2",2023-08-13,"Burgos","Huesca",1,1,"D",1,1,"D",2.39,2.94,3.7,"1-1","1-1",19,5,4,2,2,4,0,0,6,5,5,14,2,11,19,"6-5","Y","N","N",6,0,1
"1686","SP2",2023-08-13,"Albacete","Espanol",1,1,"D",0,1,"A",3.09,3.26,2.52,"0-1","1-1",17,6,8,3,3,3,0,0,7,4,14,19,2,11,33,"7-4","Y","N","N",6,0,1
"1687","SP2",2023-08-13,"Cartagena","Eldense",0,1,"A",0,1,"A",2.2,3.11,3.96,"0-1","0-1",12,2,8,2,1,1,0,0,6,6,9,18,1,12,27,"6-6","N","N","N",2,0,1
"1688","SP2",2023-08-13,"Leganes","Andorra",0,1,"A",0,1,"A",2.38,2.97,3.69,"0-1","0-1",12,4,13,3,5,1,0,0,2,2,25,12,1,4,37,"2-2","N","N","N",6,0,1
"1689","SP2",2023-08-14,"Mirandes","Alcorcon",4,0,"H",2,0,"H",2.66,2.96,3.13,"2-0","4-0",17,6,18,6,1,1,0,0,2,5,14,6,4,7,20,"2-5","Y","Y","Y",2,0,1
"1690","SP2",2023-08-14,"Tenerife","Oviedo",1,0,"H",1,0,"H",2.15,2.99,4.28,"1-0","1-0",10,3,7,0,6,0,0,0,6,4,17,7,1,10,24,"6-4","N","N","N",6,0,1
"1691","SP2",2023-08-18,"Andorra","Cartagena",3,2,"H",0,0,"D",1.92,3.42,4.65,"0-0","3-2",17,5,5,3,2,4,0,0,6,0,14,11,5,6,25,"6-0","Y","Y","Y",6,0,2
"1692","SP2",2023-08-18,"Zaragoza","Valladolid",1,0,"H",1,0,"H",2.39,3.08,3.51,"1-0","1-0",12,5,11,5,3,2,0,0,5,0,10,14,1,5,24,"5-0","N","N","N",5,0,2
"1693","SP2",2023-08-19,"Eibar","Elche",2,1,"H",1,0,"H",2.25,3.06,3.89,"1-0","2-1",11,5,13,3,1,2,0,0,6,4,13,8,3,10,21,"6-4","Y","Y","N",3,0,2
"1694","SP2",2023-08-19,"Espanol","Santander",2,0,"H",1,0,"H",1.85,3.35,5.22,"1-0","2-0",20,6,12,2,1,2,0,0,6,7,23,17,2,13,40,"6-7","Y","N","N",3,0,2
"1695","SP2",2023-08-19,"Levante","Burgos",3,2,"H",2,1,"H",1.72,3.47,6.13,"2-1","3-2",18,11,16,8,4,3,0,0,4,4,19,7,5,8,26,"4-4","Y","Y","Y",7,0,2
"1696","SP2",2023-08-19,"Alcorcon","Leganes",0,2,"A",0,0,"D",2.61,2.92,3.31,"0-0","0-2",15,2,7,4,3,4,0,0,8,5,12,16,2,13,28,"8-5","Y","N","N",7,0,2
"1697","SP2",2023-08-20,"Oviedo","Ferrol",1,1,"D",0,1,"A",2.08,2.96,4.75,"0-1","1-1",16,3,5,1,2,1,0,1,6,3,8,12,2,9,20,"6-3","Y","N","N",3,1,2
"1698","SP2",2023-08-20,"Sp Gijon","Mirandes",3,0,"H",3,0,"H",1.88,3.37,4.94,"3-0","3-0",12,7,22,11,2,2,0,0,7,11,11,12,3,18,23,"7-11","Y","Y","N",4,0,2
"1699","SP2",2023-08-20,"Albacete","Amorebieta",2,2,"D",1,2,"A",1.64,3.56,6.99,"1-2","2-2",18,8,13,3,3,0,0,0,4,7,11,8,4,11,19,"4-7","Y","Y","Y",3,0,2
"1700","SP2",2023-08-21,"Villarreal B","Eldense",3,1,"H",2,1,"H",2.31,3.34,3.32,"2-1","3-1",13,6,11,3,2,1,0,0,2,5,17,17,4,7,34,"2-5","Y","Y","Y",3,0,2
"1701","SP2",2023-08-21,"Huesca","Tenerife",0,2,"A",0,1,"A",2.96,2.87,2.89,"0-1","0-2",12,4,11,5,0,4,0,0,4,2,7,18,2,6,25,"4-2","Y","N","N",4,0,2
"1702","SP2",2023-08-25,"Cartagena","Levante",0,1,"A",0,1,"A",2.98,3.13,2.69,"0-1","0-1",9,3,13,5,4,6,0,0,2,12,14,15,1,14,29,"2-12","N","N","N",10,0,3
"1703","SP2",2023-08-26,"Burgos","Oviedo",1,0,"H",1,0,"H",2.74,2.8,3.28,"1-0","1-0",16,5,9,3,4,4,0,1,4,3,13,16,1,7,29,"4-3","N","N","N",8,1,3
"1704","SP2",2023-08-26,"Tenerife","Zaragoza",0,1,"A",0,0,"D",2.23,2.89,4.27,"0-0","0-1",14,2,7,4,3,3,1,0,11,3,19,10,1,14,29,"11-3","N","N","N",6,1,3
"1705","SP2",2023-08-26,"Elche","Villarreal B",1,0,"H",1,0,"H",1.63,3.86,6.33,"1-0","1-0",19,8,12,3,2,0,0,0,4,4,14,8,1,8,22,"4-4","N","N","N",2,0,3
"1706","SP2",2023-08-26,"Valladolid","Alcorcon",0,2,"A",0,1,"A",1.79,3.44,5.49,"0-1","0-2",28,2,12,5,1,4,0,0,10,3,10,20,2,13,30,"10-3","Y","N","N",5,0,3
"1707","SP2",2023-08-27,"Ferrol","Sp Gijon",2,0,"H",0,0,"D",2.53,3.04,3.29,"0-0","2-0",13,3,6,1,0,2,0,0,4,4,12,16,2,8,28,"4-4","Y","N","N",2,0,3
"1708","SP2",2023-08-27,"Amorebieta","Andorra",3,0,"H",1,0,"H",3.35,3.1,2.46,"1-0","3-0",9,4,15,5,2,1,0,0,3,7,14,8,3,10,22,"3-7","Y","Y","N",3,0,3
"1709","SP2",2023-08-27,"Mirandes","Espanol",0,1,"A",0,0,"D",3.58,3.22,2.28,"0-0","0-1",5,1,17,4,4,2,0,0,4,7,12,13,1,11,25,"4-7","N","N","N",6,0,3
"1710","SP2",2023-08-27,"Leganes","Albacete",2,0,"H",1,0,"H",2.47,3.12,3.28,"1-0","2-0",11,2,12,3,3,2,0,0,2,5,9,15,2,7,24,"2-5","Y","N","N",5,0,3
"1711","SP2",2023-08-28,"Eldense","Eibar",2,1,"H",2,0,"H",2.96,3.04,2.73,"2-0","2-1",7,4,12,2,1,4,0,0,6,4,8,11,3,10,19,"6-4","Y","Y","N",5,0,3
"1712","SP2",2023-08-28,"Santander","Huesca",0,0,"D",0,0,"D",2.12,3.13,4.12,"0-0","0-0",10,0,14,0,5,5,0,0,12,6,16,16,0,18,32,"12-6","N","N","N",10,0,3
"1713","SP2",2023-09-01,"Alcorcon","Ferrol",1,1,"D",0,0,"D",2.34,2.99,3.77,"0-0","1-1",12,3,7,2,3,1,0,0,3,1,11,9,2,4,20,"3-1","Y","N","N",4,0,4
"1714","SP2",2023-09-01,"Albacete","Valladolid",2,0,"H",1,0,"H",2.11,3.31,3.97,"1-0","2-0",9,3,7,1,1,5,0,0,5,4,19,12,2,9,31,"5-4","Y","N","N",6,0,4
"1715","SP2",2023-09-02,"Sp Gijon","Burgos",2,1,"H",1,0,"H",2.1,3.12,4.32,"1-0","2-1",17,2,5,2,1,1,0,0,10,2,12,15,3,12,27,"10-2","Y","Y","N",2,0,4
"1716","SP2",2023-09-02,"Levante","Oviedo",1,1,"D",0,0,"D",1.86,3.39,5.06,"0-0","1-1",17,4,11,2,3,3,0,1,4,2,18,11,2,6,29,"4-2","Y","N","N",6,1,4
"1717","SP2",2023-09-02,"Elche","Santander",1,1,"D",1,0,"H",1.84,3.53,4.82,"1-0","1-1",22,6,12,6,0,3,1,0,8,1,11,16,2,9,27,"8-1","Y","N","N",3,1,4
"1718","SP2",2023-09-02,"Villarreal B","Cartagena",1,2,"A",1,0,"H",2.24,3.38,3.5,"1-0","1-2",17,6,12,5,2,3,0,0,3,7,9,14,3,10,23,"3-7","Y","Y","N",5,0,4
"1719","SP2",2023-09-03,"Andorra","Tenerife",0,1,"A",0,0,"D",2.29,3.07,3.73,"0-0","0-1",16,2,10,4,0,3,0,0,8,4,7,18,1,12,25,"8-4","N","N","N",3,0,4
"1720","SP2",2023-09-03,"Eibar","Leganes",0,1,"A",0,1,"A",2.07,3.15,4.39,"0-1","0-1",20,2,2,1,2,3,0,0,8,1,11,14,1,9,25,"8-1","N","N","N",5,0,4
"1721","SP2",2023-09-03,"Espanol","Amorebieta",3,2,"H",0,2,"A",1.62,3.76,6.71,"0-2","3-2",21,7,7,4,3,1,0,0,4,3,6,15,5,7,21,"4-3","Y","Y","Y",4,0,4
"1722","SP2",2023-09-03,"Zaragoza","Eldense",2,0,"H",1,0,"H",1.77,3.45,5.68,"1-0","2-0",13,1,8,3,2,1,0,0,1,3,6,13,2,4,19,"1-3","Y","N","N",3,0,4
"1723","SP2",2023-09-03,"Huesca","Mirandes",1,1,"D",0,0,"D",2.09,3.28,4.07,"0-0","1-1",15,3,13,3,5,5,1,0,9,5,15,10,2,14,25,"9-5","Y","N","N",10,1,4
"1724","SP2",2023-09-08,"Levante","Espanol",1,4,"A",1,2,"A",2.67,3.19,2.95,"1-2","1-4",15,3,17,10,0,0,1,0,5,3,13,13,5,8,26,"5-3","Y","Y","Y",0,1,5
"1725","SP2",2023-09-09,"Burgos","Eibar",1,0,"H",0,0,"D",3.13,2.99,2.68,"0-0","1-0",6,3,14,2,2,4,0,1,5,10,10,13,1,15,23,"5-10","N","N","N",6,1,5
"1726","SP2",2023-09-09,"Oviedo","Sp Gijon",0,0,"D",0,0,"D",2.36,2.96,3.77,"0-0","0-0",6,0,7,1,2,3,0,0,7,1,12,17,0,8,29,"7-1","N","N","N",5,0,5
"1727","SP2",2023-09-09,"Leganes","Huesca",2,0,"H",1,0,"H",2.04,3.09,4.65,"1-0","2-0",11,7,8,3,0,2,0,0,2,3,18,12,2,5,30,"2-3","Y","N","N",2,0,5
"1728","SP2",2023-09-09,"Tenerife","Albacete",2,0,"H",2,0,"H",2.18,3.08,4.09,"2-0","2-0",10,4,14,4,2,1,0,0,1,7,19,9,2,8,28,"1-7","Y","N","N",3,0,5
"1729","SP2",2023-09-10,"Ferrol","Villarreal B",2,2,"D",0,1,"A",1.97,3.33,4.54,"0-1","2-2",24,8,6,3,3,2,0,0,13,0,11,12,4,13,23,"13-0","Y","Y","Y",5,0,5
"1730","SP2",2023-09-10,"Santander","Amorebieta",1,0,"H",1,0,"H",1.85,3.58,4.73,"1-0","1-0",7,4,7,2,4,2,0,0,4,4,12,17,1,8,29,"4-4","N","N","N",6,0,5
"1731","SP2",2023-09-10,"Cartagena","Zaragoza",1,3,"A",1,2,"A",3.25,2.93,2.64,"1-2","1-3",19,5,9,5,2,2,0,0,6,4,11,6,4,10,17,"6-4","Y","Y","Y",4,0,5
"1732","SP2",2023-09-10,"Mirandes","Andorra",4,3,"H",2,0,"H",3.24,3.21,2.46,"2-0","4-3",17,6,25,7,1,3,0,0,3,3,9,11,7,6,20,"3-3","Y","Y","Y",4,0,5
"1733","SP2",2023-09-10,"Valladolid","Elche",1,1,"D",1,0,"H",2.33,3.03,3.71,"1-0","1-1",14,5,8,3,6,2,1,1,7,6,15,13,2,13,28,"7-6","Y","N","N",8,2,5
"1734","SP2",2023-09-11,"Eldense","Alcorcon",2,2,"D",0,0,"D",2.4,2.99,3.53,"0-0","2-2",17,3,13,4,0,3,0,1,5,2,14,7,4,7,21,"5-2","Y","Y","Y",3,1,5
"1735","SP2",2023-09-15,"Zaragoza","Santander",1,1,"D",1,1,"D",2.06,3.11,4.5,"1-1","1-1",6,2,12,4,2,5,0,0,6,6,21,16,2,12,37,"6-6","Y","N","N",7,0,6
"1736","SP2",2023-09-16,"Huesca","Villarreal B",2,2,"D",0,2,"A",2.07,3.23,4.24,"0-2","2-2",8,2,7,3,5,3,0,0,7,0,14,14,4,7,28,"7-0","Y","Y","Y",8,0,6
"1737","SP2",2023-09-16,"Alcorcon","Levante",0,2,"A",0,1,"A",2.96,3.08,2.74,"0-1","0-2",10,1,21,5,6,3,1,0,3,6,10,16,2,9,26,"3-6","Y","N","N",9,1,6
"1738","SP2",2023-09-16,"Valladolid","Cartagena",1,0,"H",0,0,"D",1.87,3.62,4.58,"0-0","1-0",22,8,9,4,3,1,0,0,9,3,14,14,1,12,28,"9-3","N","N","N",4,0,6
"1739","SP2",2023-09-16,"Albacete","Burgos",2,1,"H",1,0,"H",1.81,3.42,5.44,"1-0","2-1",19,5,12,3,1,2,0,0,3,6,16,8,3,9,24,"3-6","Y","Y","N",3,0,6
"1740","SP2",2023-09-17,"Amorebieta","Mirandes",2,0,"H",2,0,"H",2.31,3.31,3.41,"2-0","2-0",7,2,10,2,3,2,0,0,9,4,24,10,2,13,34,"9-4","Y","N","N",5,0,6
"1741","SP2",2023-09-17,"Eibar","Ferrol",2,0,"H",1,0,"H",1.82,3.42,5.31,"1-0","2-0",13,6,8,1,0,2,0,0,4,6,10,10,2,10,20,"4-6","Y","N","N",2,0,6
"1742","SP2",2023-09-17,"Elche","Leganes",1,0,"H",1,0,"H",1.85,3.37,5.22,"1-0","1-0",18,5,9,3,5,3,0,0,8,4,14,10,1,12,24,"8-4","N","N","N",8,0,6
"1743","SP2",2023-09-17,"Espanol","Eldense",3,3,"D",0,2,"A",1.49,4.29,7.86,"0-2","3-3",23,5,6,3,3,4,0,1,12,0,14,13,6,12,27,"12-0","Y","Y","Y",7,1,6
"1744","SP2",2023-09-17,"Sp Gijon","Tenerife",2,1,"H",1,1,"D",2.81,2.95,3.01,"1-1","2-1",10,4,8,1,2,5,0,0,6,4,12,16,3,10,28,"6-4","Y","Y","N",7,0,6
"1745","SP2",2023-09-18,"Andorra","Oviedo",1,0,"H",0,0,"D",2.22,3.08,3.85,"0-0","1-0",5,1,6,2,1,4,1,1,4,3,15,16,1,7,31,"4-3","N","N","N",5,2,6
"1746","SP2",2023-09-22,"Cartagena","Eibar",1,2,"A",0,1,"A",3.53,3.19,2.32,"0-1","1-2",7,4,11,5,2,5,1,0,5,6,10,23,3,11,33,"5-6","Y","Y","N",7,1,7
"1747","SP2",2023-09-23,"Andorra","Sp Gijon",0,0,"D",0,0,"D",2.27,2.99,3.94,"0-0","0-0",13,5,6,2,0,1,0,0,4,2,10,10,0,6,20,"4-2","N","N","N",1,0,7
"1748","SP2",2023-09-23,"Levante","Eldense",2,0,"H",1,0,"H",1.83,3.53,5.02,"1-0","2-0",17,7,10,2,1,2,0,0,5,2,11,15,2,7,26,"5-2","Y","N","N",3,0,7
"1749","SP2",2023-09-23,"Burgos","Elche",4,0,"H",2,0,"H",3.15,3.19,2.52,"2-0","4-0",16,9,12,1,3,1,0,0,4,1,11,12,4,5,23,"4-1","Y","Y","Y",4,0,7
"1750","SP2",2023-09-23,"Alcorcon","Huesca",0,2,"A",0,2,"A",2.29,3.1,3.72,"0-2","0-2",19,3,6,2,2,1,0,0,4,2,15,7,2,6,22,"4-2","Y","N","N",3,0,7
"1751","SP2",2023-09-23,"Santander","Albacete",2,1,"H",2,0,"H",2.36,3.26,3.37,"2-0","2-1",8,3,18,4,2,3,0,0,0,6,13,13,3,6,26,"0-6","Y","Y","N",5,0,7
"1752","SP2",2023-09-24,"Villarreal B","Amorebieta",3,1,"H",1,0,"H",2.04,3.56,3.9,"1-0","3-1",19,8,14,4,2,4,0,0,3,6,12,18,4,9,30,"3-6","Y","Y","Y",6,0,7
"1753","SP2",2023-09-24,"Oviedo","Valladolid",0,1,"A",0,0,"D",2.68,2.89,3.24,"0-0","0-1",10,3,16,5,1,3,0,0,6,6,14,13,1,12,27,"6-6","N","N","N",4,0,7
"1754","SP2",2023-09-24,"Mirandes","Leganes",1,3,"A",1,1,"D",2.78,2.83,3.19,"1-1","1-3",12,6,10,5,1,1,0,0,0,4,11,12,4,4,23,"0-4","Y","Y","Y",2,0,7
"1755","SP2",2023-09-25,"Ferrol","Zaragoza",1,0,"H",0,0,"D",2.9,3,2.82,"0-0","1-0",7,3,6,2,1,0,0,0,4,4,7,9,1,8,16,"4-4","N","N","N",1,0,7
"1756","SP2",2023-09-25,"Tenerife","Espanol",1,0,"H",1,0,"H",NA,NA,NA,"1-0","1-0",14,6,18,2,3,3,0,0,6,10,22,9,1,16,31,"6-10","N","N","N",6,0,7
"1757","SP2",2023-09-29,"Leganes","Santander",2,1,"H",1,0,"H",2.44,2.96,3.57,"1-0","2-1",9,4,16,2,4,3,0,0,4,11,14,5,3,15,19,"4-11","Y","Y","N",7,0,8
"1758","SP2",2023-09-30,"Eibar","Tenerife",3,0,"H",0,0,"D",2.06,3.13,4.45,"0-0","3-0",14,5,8,2,3,1,0,0,4,3,16,9,3,7,25,"4-3","Y","Y","N",4,0,8
"1759","SP2",2023-09-30,"Elche","Levante",0,0,"D",0,0,"D",2.47,3.31,3.12,"0-0","0-0",28,4,10,2,1,1,0,0,8,7,8,12,0,15,20,"8-7","N","N","N",2,0,8
"1760","SP2",2023-09-30,"Albacete","Andorra",3,1,"H",2,0,"H",2.25,3.27,3.62,"2-0","3-1",12,7,11,2,2,2,0,0,4,3,12,15,4,7,27,"4-3","Y","Y","Y",4,0,8
"1761","SP2",2023-09-30,"Villarreal B","Alcorcon",2,2,"D",1,2,"A",2.51,3.26,3.1,"1-2","2-2",25,8,10,5,2,3,0,0,7,5,16,13,4,12,29,"7-5","Y","Y","Y",5,0,8
"1762","SP2",2023-10-01,"Eldense","Oviedo",1,3,"A",0,3,"A",2.85,2.95,2.97,"0-3","1-3",10,4,10,4,1,0,0,0,6,4,18,10,4,10,28,"6-4","Y","Y","Y",1,0,8
"1763","SP2",2023-10-01,"Amorebieta","Cartagena",0,0,"D",0,0,"D",2.37,3.28,3.33,"0-0","0-0",5,2,8,1,2,2,0,0,3,2,14,10,0,5,24,"3-2","N","N","N",4,0,8
"1764","SP2",2023-10-01,"Valladolid","Burgos",3,0,"H",2,0,"H",1.79,3.6,5.2,"2-0","3-0",11,6,11,2,2,2,0,0,3,6,14,10,3,9,24,"3-6","Y","Y","N",4,0,8
"1765","SP2",2023-10-01,"Zaragoza","Mirandes",0,1,"A",0,0,"D",1.79,3.56,5.19,"0-0","0-1",8,2,8,0,2,4,1,0,6,2,10,11,1,8,21,"6-2","N","N","N",6,1,8
"1766","SP2",2023-10-01,"Huesca","Sp Gijon",0,1,"A",0,0,"D",2.35,3.05,3.64,"0-0","0-1",6,2,13,6,6,5,0,0,9,8,11,15,1,17,26,"9-8","N","N","N",11,0,8
"1767","SP2",2023-10-02,"Espanol","Ferrol",3,0,"H",1,0,"H",1.63,4.01,5.76,"1-0","3-0",10,3,6,2,2,2,0,1,6,0,22,13,3,6,35,"6-0","Y","Y","N",4,1,8
"1768","SP2",2023-10-03,"Alcorcon","Albacete",1,2,"A",0,1,"A",3.16,3.11,2.57,"0-1","1-2",23,6,9,4,0,6,0,0,6,1,10,11,3,7,21,"6-1","Y","Y","N",6,0,9
"1769","SP2",2023-10-03,"Levante","Villarreal B",1,1,"D",0,0,"D",1.72,3.99,5.06,"0-0","1-1",15,4,7,1,2,2,0,0,8,2,18,9,2,10,27,"8-2","Y","N","N",4,0,9
"1770","SP2",2023-10-03,"Tenerife","Santander",2,0,"H",0,0,"D",1.93,3.34,4.69,"0-0","2-0",21,6,9,3,1,4,0,0,7,4,18,7,2,11,25,"7-4","Y","N","N",5,0,9
"1771","SP2",2023-10-04,"Eldense","Valladolid",0,1,"A",0,1,"A",3.17,3.2,2.5,"0-1","0-1",4,0,8,2,1,4,0,0,3,2,16,18,1,5,34,"3-2","N","N","N",5,0,9
"1772","SP2",2023-10-04,"Oviedo","Huesca",1,0,"H",0,0,"D",1.99,3.15,4.8,"0-0","1-0",9,6,9,3,2,2,0,0,5,4,14,18,1,9,32,"5-4","N","N","N",4,0,9
"1773","SP2",2023-10-04,"Burgos","Leganes",1,0,"H",1,0,"H",2.36,3.01,3.66,"1-0","1-0",5,3,12,2,5,3,0,1,0,8,14,11,1,8,25,"0-8","N","N","N",8,1,9
"1774","SP2",2023-10-04,"Sp Gijon","Elche",2,0,"H",2,0,"H",2.54,3.18,3.12,"2-0","2-0",20,8,10,1,0,0,0,0,6,3,9,15,2,9,24,"6-3","Y","N","N",0,0,9
"1775","SP2",2023-10-05,"Andorra","Zaragoza",0,1,"A",0,1,"A",2.3,3.13,3.67,"0-1","0-1",5,0,5,3,2,4,1,0,4,0,9,16,1,4,25,"4-0","N","N","N",6,1,9
"1776","SP2",2023-10-05,"Mirandes","Eibar",1,3,"A",1,1,"D",3.59,3.1,2.35,"1-1","1-3",7,3,13,3,2,2,0,0,0,6,8,14,4,6,22,"0-6","Y","Y","Y",4,0,9
"1777","SP2",2023-10-05,"Cartagena","Espanol",0,2,"A",0,1,"A",3.81,3.63,2.04,"0-1","0-2",10,1,8,4,4,3,0,0,6,2,17,14,2,8,31,"6-2","Y","N","N",7,0,9
"1778","SP2",2023-10-05,"Ferrol","Amorebieta",1,0,"H",1,0,"H",1.85,3.5,4.75,"1-0","1-0",11,3,4,2,1,1,0,0,5,3,12,9,1,8,21,"5-3","N","N","N",2,0,9
"1779","SP2",2023-10-06,"Albacete","Levante",0,2,"A",0,1,"A",2.2,3.12,3.96,"0-1","0-2",14,4,10,7,0,1,0,0,6,3,11,11,2,9,22,"6-3","Y","N","N",1,0,10
"1780","SP2",2023-10-07,"Huesca","Eldense",0,1,"A",0,0,"D",2.28,3.03,3.87,"0-0","0-1",17,1,15,3,1,6,1,0,4,8,8,17,1,12,25,"4-8","N","N","N",7,1,10
"1781","SP2",2023-10-07,"Santander","Sp Gijon",3,2,"H",1,1,"D",2.33,3.15,3.56,"1-1","3-2",20,7,21,8,4,4,0,0,5,7,13,7,5,12,20,"5-7","Y","Y","Y",8,0,10
"1782","SP2",2023-10-07,"Leganes","Oviedo",0,0,"D",0,0,"D",2.48,2.85,3.67,"0-0","0-0",9,3,6,2,3,1,0,0,1,4,11,13,0,5,24,"1-4","N","N","N",4,0,10
"1783","SP2",2023-10-08,"Amorebieta","Eibar",1,2,"A",1,1,"D",4.27,3.27,2.05,"1-1","1-2",10,7,12,7,3,1,0,0,5,5,12,12,3,10,24,"5-5","Y","Y","N",4,0,10
"1784","SP2",2023-10-08,"Valladolid","Mirandes",3,2,"H",0,0,"D",1.65,3.83,6.14,"0-0","3-2",23,9,6,3,2,3,0,0,7,1,10,11,5,8,21,"7-1","Y","Y","Y",5,0,10
"1785","SP2",2023-10-08,"Ferrol","Cartagena",1,1,"D",0,1,"A",1.97,3.4,4.41,"0-1","1-1",12,5,11,4,0,5,0,0,4,6,11,19,2,10,30,"4-6","Y","N","N",5,0,10
"1786","SP2",2023-10-08,"Tenerife","Burgos",2,1,"H",0,0,"D",1.84,3.29,5.45,"0-0","2-1",8,2,14,6,3,4,1,0,4,6,12,15,3,10,27,"4-6","Y","Y","N",7,1,10
"1787","SP2",2023-10-08,"Zaragoza","Alcorcon",0,2,"A",0,1,"A",1.87,3.4,4.97,"0-1","0-2",15,5,11,2,5,4,0,0,7,1,12,18,2,8,30,"7-1","Y","N","N",9,0,10
"1788","SP2",2023-10-09,"Elche","Andorra",2,1,"H",1,0,"H",1.94,3.54,4.22,"1-0","2-1",24,9,4,1,0,0,0,0,10,4,13,15,3,14,28,"10-4","Y","Y","N",0,0,10
"1789","SP2",2023-10-09,"Villarreal B","Espanol",3,1,"H",2,1,"H",4.38,3.84,1.83,"2-1","3-1",17,7,16,4,1,4,0,0,7,9,17,12,4,16,29,"7-9","Y","Y","Y",5,0,10
"1790","SP2",2023-10-13,"Oviedo","Albacete",3,0,"H",0,0,"D",2.52,3.02,3.35,"0-0","3-0",9,3,12,2,1,4,0,1,6,2,10,14,3,8,24,"6-2","Y","Y","N",5,1,11
"1791","SP2",2023-10-14,"Mirandes","Tenerife",1,1,"D",1,1,"D",3.33,2.94,2.58,"1-1","1-1",9,3,9,4,3,3,0,0,5,2,10,14,2,7,24,"5-2","Y","N","N",6,0,11
"1792","SP2",2023-10-14,"Cartagena","Santander",2,3,"A",2,2,"D",2.43,3.12,3.37,"2-2","2-3",22,6,20,10,2,4,0,0,6,4,10,18,5,10,28,"6-4","Y","Y","Y",6,0,11
"1793","SP2",2023-10-14,"Sp Gijon","Zaragoza",2,2,"D",0,1,"A",2.25,3,4,"0-1","2-2",13,4,13,3,3,2,0,0,5,3,12,10,4,8,22,"5-3","Y","Y","Y",5,0,11
"1794","SP2",2023-10-14,"Espanol","Valladolid",2,0,"H",2,0,"H",1.99,3.58,4.04,"2-0","2-0",5,3,11,3,3,3,0,0,0,5,15,14,2,5,29,"0-5","Y","N","N",6,0,11
"1795","SP2",2023-10-15,"Burgos","Villarreal B",3,2,"H",0,0,"D",2.06,3.36,4.06,"0-0","3-2",11,4,12,3,0,4,0,0,9,2,13,8,5,11,21,"9-2","Y","Y","Y",4,0,11
"1796","SP2",2023-10-15,"Andorra","Alcorcon",2,0,"H",0,0,"D",2.15,3.09,4.17,"0-0","2-0",12,3,12,3,0,1,0,0,3,2,6,15,2,5,21,"3-2","Y","N","N",1,0,11
"1797","SP2",2023-10-15,"Eldense","Elche",1,1,"D",1,0,"H",3.46,3.27,2.31,"1-0","1-1",9,2,6,2,4,3,0,0,6,5,20,16,2,11,36,"6-5","Y","N","N",7,0,11
"1798","SP2",2023-10-15,"Eibar","Huesca",1,1,"D",0,1,"A",1.54,3.92,7.94,"0-1","1-1",14,2,5,2,1,3,0,0,6,1,8,14,2,7,22,"6-1","Y","N","N",4,0,11
"1799","SP2",2023-10-15,"Leganes","Amorebieta",6,0,"H",2,0,"H",1.96,3.25,4.73,"2-0","6-0",17,10,8,1,1,2,0,0,2,5,13,11,6,7,24,"2-5","Y","Y","Y",3,0,11
"1800","SP2",2023-10-16,"Levante","Ferrol",1,0,"H",0,0,"D",1.83,3.64,4.62,"0-0","1-0",9,4,13,1,4,1,0,0,3,3,13,11,1,6,24,"3-3","N","N","N",5,0,11
"1801","SP2",2023-10-20,"Espanol","Leganes",0,1,"A",0,0,"D",1.72,3.76,5.42,"0-0","0-1",12,3,13,4,2,4,0,0,4,1,12,13,1,5,25,"4-1","N","N","N",6,0,12
"1802","SP2",2023-10-21,"Amorebieta","Oviedo",0,0,"D",0,0,"D",3.44,2.98,2.49,"0-0","0-0",9,1,15,2,3,4,1,0,2,6,17,7,0,8,24,"2-6","N","N","N",7,1,12
"1803","SP2",2023-10-21,"Villarreal B","Mirandes",0,3,"A",0,1,"A",2.14,3.64,3.5,"0-1","0-3",15,3,7,3,1,1,0,0,8,1,8,13,3,9,21,"8-1","Y","Y","N",2,0,12
"1804","SP2",2023-10-21,"Tenerife","Levante",0,0,"D",0,0,"D",2.13,3.17,4.09,"0-0","0-0",17,4,8,1,3,2,0,0,3,3,14,13,0,6,27,"3-3","N","N","N",5,0,12
"1805","SP2",2023-10-21,"Zaragoza","Eibar",2,3,"A",2,0,"H",2.82,3.02,2.92,"2-0","2-3",13,5,10,6,4,3,0,0,3,5,9,14,5,8,23,"3-5","Y","Y","Y",7,0,12
"1806","SP2",2023-10-22,"Ferrol","Eldense",1,1,"D",0,0,"D",1.9,3.33,4.9,"0-0","1-1",14,3,11,3,0,2,0,0,8,4,12,16,2,12,28,"8-4","Y","N","N",2,0,12
"1807","SP2",2023-10-22,"Huesca","Elche",0,1,"A",0,1,"A",3.39,3.1,2.44,"0-1","0-1",7,1,4,3,3,3,0,0,4,1,16,20,1,5,36,"4-1","N","N","N",6,0,12
"1808","SP2",2023-10-22,"Albacete","Sp Gijon",1,3,"A",0,1,"A",2.21,3.28,3.69,"0-1","1-3",25,6,8,4,3,3,0,0,11,0,10,11,4,11,21,"11-0","Y","Y","Y",6,0,12
"1809","SP2",2023-10-22,"Santander","Burgos",3,0,"H",1,0,"H",2.31,3.22,3.53,"1-0","3-0",17,5,12,2,1,3,0,0,4,4,8,11,3,8,19,"4-4","Y","Y","N",4,0,12
"1810","SP2",2023-10-22,"Valladolid","Andorra",2,0,"H",2,0,"H",1.77,3.73,5.11,"2-0","2-0",10,4,16,4,5,2,0,0,6,6,16,10,2,12,26,"6-6","Y","N","N",7,0,12
"1811","SP2",2023-10-23,"Alcorcon","Cartagena",1,1,"D",1,0,"H",2.28,3.28,3.44,"1-0","1-1",18,2,16,6,1,3,0,0,6,7,7,9,2,13,16,"6-7","Y","N","N",4,0,12
"1812","SP2",2023-10-27,"Eibar","Valladolid",5,1,"H",2,0,"H",2.09,3.16,4.27,"2-0","5-1",23,13,10,2,1,0,0,0,2,1,13,12,6,3,25,"2-1","Y","Y","Y",1,0,13
"1813","SP2",2023-10-28,"Eldense","Amorebieta",2,0,"H",1,0,"H",2.04,3.36,4.17,"1-0","2-0",12,4,11,3,1,2,0,0,2,7,13,14,2,9,27,"2-7","Y","N","N",3,0,13
"1814","SP2",2023-10-28,"Andorra","Levante",2,0,"H",0,0,"D",2.73,3.12,2.93,"0-0","2-0",21,10,7,1,2,3,0,0,7,6,11,8,2,13,19,"7-6","Y","N","N",5,0,13
"1815","SP2",2023-10-28,"Sp Gijon","Espanol",2,0,"H",1,0,"H",2.56,3.29,3,"1-0","2-0",9,3,17,4,6,3,0,0,4,7,13,8,2,11,21,"4-7","Y","N","N",9,0,13
"1816","SP2",2023-10-28,"Elche","Tenerife",2,1,"H",0,0,"D",2.21,3.13,3.9,"0-0","2-1",9,4,8,1,0,6,0,0,4,4,11,16,3,8,27,"4-4","Y","Y","N",6,0,13
"1817","SP2",2023-10-29,"Mirandes","Cartagena",2,1,"H",0,0,"D",2.37,3.37,3.23,"0-0","2-1",13,4,14,5,0,3,0,0,4,5,9,14,3,9,23,"4-5","Y","Y","N",3,0,13
"1818","SP2",2023-10-29,"Huesca","Albacete",0,0,"D",0,0,"D",2.96,2.96,2.85,"0-0","0-0",8,1,8,5,1,1,0,0,6,1,11,13,0,7,24,"6-1","N","N","N",2,0,13
"1819","SP2",2023-10-29,"Leganes","Villarreal B",1,0,"H",0,0,"D",1.76,3.86,4.94,"0-0","1-0",10,5,8,3,2,2,0,1,7,0,11,16,1,7,27,"7-0","N","N","N",4,1,13
"1820","SP2",2023-10-29,"Oviedo","Alcorcon",2,0,"H",1,0,"H",1.97,3.31,4.58,"1-0","2-0",12,4,6,3,1,5,0,0,6,2,9,14,2,8,23,"6-2","Y","N","N",6,0,13
"1821","SP2",2023-10-29,"Santander","Ferrol",1,3,"A",1,2,"A",2.23,3.14,3.83,"1-2","1-3",11,5,17,8,1,5,0,0,5,4,12,22,4,9,34,"5-4","Y","Y","Y",6,0,13
"1822","SP2",2023-10-30,"Burgos","Zaragoza",1,1,"D",0,1,"A",2.55,2.99,3.26,"0-1","1-1",10,2,8,5,2,2,0,0,4,1,17,16,2,5,33,"4-1","Y","N","N",4,0,13
"1823","SP2",2023-11-03,"Espanol","Eibar",2,2,"D",1,1,"D",2.42,3.26,3.25,"1-1","2-2",13,5,13,4,1,1,0,0,4,4,9,7,4,8,16,"4-4","Y","Y","Y",2,0,14
"1824","SP2",2023-11-04,"Villarreal B","Sp Gijon",0,3,"A",0,1,"A",2.82,3.41,2.63,"0-1","0-3",22,6,10,6,0,0,0,0,9,4,15,9,3,13,24,"9-4","Y","Y","N",0,0,14
"1825","SP2",2023-11-04,"Levante","Mirandes",2,2,"D",1,1,"D",1.83,3.7,4.7,"1-1","2-2",10,5,10,4,4,3,2,0,2,6,19,11,4,8,30,"2-6","Y","Y","Y",7,2,14
"1826","SP2",2023-11-04,"Valladolid","Tenerife",2,0,"H",0,0,"D",1.99,3.27,4.53,"0-0","2-0",16,6,6,1,1,3,0,0,9,4,10,13,2,13,23,"9-4","Y","N","N",4,0,14
"1827","SP2",2023-11-04,"Albacete","Elche",1,1,"D",0,0,"D",2.28,3.38,3.4,"0-0","1-1",14,5,5,3,4,6,0,1,6,3,17,17,2,9,34,"6-3","Y","N","N",10,1,14
"1828","SP2",2023-11-05,"Ferrol","Andorra",1,0,"H",1,0,"H",2.37,3.2,3.42,"1-0","1-0",11,4,12,5,4,3,0,0,3,3,19,18,1,6,37,"3-3","N","N","N",7,0,14
"1829","SP2",2023-11-05,"Amorebieta","Huesca",0,1,"A",0,0,"D",2.59,2.94,3.32,"0-0","0-1",7,0,8,3,3,2,1,0,2,4,13,12,1,6,25,"2-4","N","N","N",5,1,14
"1830","SP2",2023-11-05,"Alcorcon","Santander",3,1,"H",1,0,"H",2.27,3.35,3.45,"1-0","3-1",17,6,10,3,3,1,0,0,3,3,18,7,4,6,25,"3-3","Y","Y","Y",4,0,14
"1831","SP2",2023-11-05,"Cartagena","Leganes",0,3,"A",0,0,"D",2.72,3.25,2.84,"0-0","0-3",11,1,8,5,1,2,0,0,3,5,15,10,3,8,25,"3-5","Y","Y","N",3,0,14
"1832","SP2",2023-11-05,"Eldense","Burgos",2,0,"H",1,0,"H",2.42,2.97,3.6,"1-0","2-0",15,5,9,2,2,2,0,0,7,7,11,8,2,14,19,"7-7","Y","N","N",4,0,14
"1833","SP2",2023-11-06,"Zaragoza","Oviedo",0,0,"D",0,0,"D",2.52,2.92,3.4,"0-0","0-0",19,5,13,2,1,1,0,0,7,4,17,13,0,11,30,"7-4","N","N","N",2,0,14
"1834","SP2",2023-11-10,"Leganes","Levante",2,1,"H",0,1,"A",2.01,3.24,4.47,"0-1","2-1",10,5,9,3,2,1,0,0,8,7,20,8,3,15,28,"8-7","Y","Y","N",3,0,15
"1835","SP2",2023-11-11,"Santander","Valladolid",2,3,"A",0,1,"A",2.63,3.28,2.92,"0-1","2-3",14,6,19,9,0,2,0,0,3,3,13,11,5,6,24,"3-3","Y","Y","Y",2,0,15
"1836","SP2",2023-11-11,"Elche","Zaragoza",2,0,"H",0,0,"D",1.96,3.4,4.44,"0-0","2-0",13,4,8,3,4,2,0,0,7,5,18,12,2,12,30,"7-5","Y","N","N",6,0,15
"1837","SP2",2023-11-11,"Mirandes","Ferrol",1,2,"A",0,2,"A",2.53,3.04,3.3,"0-2","1-2",17,7,10,3,1,1,0,0,6,2,4,12,3,8,16,"6-2","Y","Y","N",2,0,15
"1838","SP2",2023-11-11,"Sp Gijon","Amorebieta",1,1,"D",0,0,"D",1.42,4.6,9.06,"0-0","1-1",16,8,10,4,1,5,0,0,4,3,12,8,2,7,20,"4-3","Y","N","N",6,0,15
"1839","SP2",2023-11-12,"Burgos","Alcorcon",4,2,"H",0,2,"A",2.14,3.16,4.1,"0-2","4-2",15,7,9,3,1,0,0,0,5,2,14,7,6,7,21,"5-2","Y","Y","Y",1,0,15
"1840","SP2",2023-11-12,"Andorra","Eldense",1,3,"A",1,1,"D",1.87,3.59,4.64,"1-1","1-3",23,6,9,5,2,3,0,0,8,1,9,12,4,9,21,"8-1","Y","Y","Y",5,0,15
"1841","SP2",2023-11-12,"Huesca","Espanol",1,1,"D",0,0,"D",3.88,3.21,2.18,"0-0","1-1",19,5,6,1,2,4,0,0,7,1,8,18,2,8,26,"7-1","Y","N","N",6,0,15
"1842","SP2",2023-11-12,"Tenerife","Villarreal B",0,1,"A",0,1,"A",1.63,3.96,5.93,"0-1","0-1",20,5,13,6,3,5,0,1,8,4,15,14,1,12,29,"8-4","N","N","N",8,1,15
"1843","SP2",2023-11-12,"Eibar","Albacete",1,1,"D",1,0,"H",1.89,3.36,4.92,"1-0","1-1",12,6,16,6,1,1,0,0,3,7,15,15,2,10,30,"3-7","Y","N","N",2,0,15
"1844","SP2",2023-11-13,"Oviedo","Cartagena",1,1,"D",0,1,"A",1.78,3.39,5.56,"0-1","1-1",18,3,2,1,4,8,0,0,4,2,11,15,2,6,26,"4-2","Y","N","N",12,0,15
"1845","SP2",2023-11-17,"Valladolid","Leganes",1,1,"D",1,0,"H",2.25,2.95,4.09,"1-0","1-1",21,3,11,3,1,3,0,0,3,6,13,12,2,9,25,"3-6","Y","N","N",4,0,16
"1846","SP2",2023-11-18,"Alcorcon","Sp Gijon",0,0,"D",0,0,"D",3.33,3.17,2.43,"0-0","0-0",15,2,16,2,2,2,0,0,5,7,14,10,0,12,24,"5-7","N","N","N",4,0,16
"1847","SP2",2023-11-18,"Amorebieta","Tenerife",2,0,"H",1,0,"H",3.75,3.15,2.25,"1-0","2-0",5,3,23,6,1,4,1,1,3,14,8,9,2,17,17,"3-14","Y","N","N",5,2,16
"1848","SP2",2023-11-18,"Zaragoza","Huesca",0,2,"A",0,1,"A",2.06,3.01,4.71,"0-1","0-2",11,3,7,3,2,3,0,0,9,4,16,21,2,13,37,"9-4","Y","N","N",5,0,16
"1849","SP2",2023-11-18,"Espanol","Elche",2,0,"H",2,0,"H",2.12,3.44,3.76,"2-0","2-0",12,5,15,3,3,2,0,0,8,5,25,11,2,13,36,"8-5","Y","N","N",5,0,16
"1850","SP2",2023-11-19,"Ferrol","Burgos",1,1,"D",0,0,"D",2.13,3.09,3.79,"0-0","1-1",13,5,9,2,1,5,0,0,3,4,13,11,2,7,24,"3-4","Y","N","N",6,0,16
"1851","SP2",2023-11-19,"Eldense","Mirandes",2,2,"D",1,1,"D",2.2,3.19,3.48,"1-1","2-2",20,6,7,3,1,1,0,0,7,1,21,14,4,8,35,"7-1","Y","Y","Y",2,0,16
"1852","SP2",2023-11-19,"Oviedo","Eibar",2,1,"H",0,1,"A",3.17,2.84,2.58,"0-1","2-1",9,3,7,2,4,3,0,0,4,4,11,15,3,8,26,"4-4","Y","Y","N",7,0,16
"1853","SP2",2023-11-19,"Cartagena","Albacete",1,1,"D",1,0,"H",2.82,3.19,2.59,"1-0","1-1",9,2,18,2,1,2,0,0,2,9,9,20,2,11,29,"2-9","Y","N","N",3,0,16
"1854","SP2",2023-11-19,"Villarreal B","Andorra",0,0,"D",0,0,"D",2.54,3.46,2.9,"0-0","0-0",12,2,15,5,2,1,0,0,2,7,12,7,0,9,19,"2-7","N","N","N",3,0,16
"1855","SP2",2023-11-20,"Levante","Santander",2,4,"A",2,1,"H",2.02,3.36,3.71,"2-1","2-4",26,5,9,5,2,1,0,0,8,5,15,11,6,13,26,"8-5","Y","Y","Y",3,0,16
"1856","SP2",2023-11-24,"Huesca","Valladolid",0,1,"A",0,0,"D",3.34,2.93,2.59,"0-0","0-1",10,2,11,5,4,4,0,0,3,4,12,15,1,7,27,"3-4","N","N","N",8,0,17
"1857","SP2",2023-11-25,"Burgos","Andorra",0,0,"D",0,0,"D",2.21,3.29,3.68,"0-0","0-0",11,2,7,1,1,1,0,0,3,3,7,13,0,6,20,"3-3","N","N","N",2,0,17
"1858","SP2",2023-11-25,"Santander","Villarreal B",2,0,"H",1,0,"H",1.75,4.03,4.77,"1-0","2-0",10,4,7,0,3,4,0,0,4,3,17,20,2,7,37,"4-3","Y","N","N",7,0,17
"1859","SP2",2023-11-25,"Albacete","Zaragoza",1,0,"H",0,0,"D",1.92,3.41,4.68,"0-0","1-0",18,5,5,2,2,2,0,0,4,5,19,5,1,9,24,"4-5","N","N","N",4,0,17
"1860","SP2",2023-11-25,"Eibar","Levante",3,1,"H",1,1,"D",1.72,3.81,5.23,"1-1","3-1",20,7,12,7,3,1,0,0,10,3,12,12,4,13,24,"10-3","Y","Y","Y",4,0,17
"1861","SP2",2023-11-26,"Leganes","Ferrol",2,2,"D",2,2,"D",1.99,3.21,4.67,"2-2","2-2",22,5,3,3,1,2,0,1,5,2,13,4,4,7,17,"5-2","Y","Y","Y",3,1,17
"1862","SP2",2023-11-26,"Elche","Amorebieta",2,0,"H",0,0,"D",1.43,4.47,9.03,"0-0","2-0",11,4,11,4,2,2,0,0,4,9,11,18,2,13,29,"4-9","Y","N","N",4,0,17
"1863","SP2",2023-11-26,"Mirandes","Oviedo",2,1,"H",1,0,"H",3.33,2.98,2.55,"1-0","2-1",10,6,8,2,3,3,0,0,5,2,7,15,3,7,22,"5-2","Y","Y","N",6,0,17
"1864","SP2",2023-11-26,"Tenerife","Cartagena",1,1,"D",0,1,"A",1.88,3.32,5.04,"0-1","1-1",15,5,7,3,3,4,0,0,6,1,14,12,2,7,26,"6-1","Y","N","N",7,0,17
"1865","SP2",2023-11-26,"Espanol","Alcorcon",2,0,"H",1,0,"H",1.48,4.55,7.34,"1-0","2-0",24,9,6,2,2,2,0,1,8,2,16,11,2,10,27,"8-2","Y","N","N",4,1,17
"1866","SP2",2023-11-27,"Sp Gijon","Eldense",2,0,"H",1,0,"H",1.67,3.82,5.73,"1-0","2-0",17,7,13,3,1,2,0,0,5,2,13,16,2,7,29,"5-2","Y","N","N",3,0,17
"1867","SP2",2023-12-01,"Oviedo","Espanol",2,0,"H",1,0,"H",2.83,2.84,3.11,"1-0","2-0",16,5,7,2,5,3,0,0,7,4,16,24,2,11,40,"7-4","Y","N","N",8,0,18
"1868","SP2",2023-12-02,"Cartagena","Sp Gijon",1,0,"H",0,0,"D",3.19,3.09,2.39,"0-0","1-0",19,10,6,1,1,3,0,0,6,3,11,11,1,9,22,"6-3","N","N","N",4,0,18
"1869","SP2",2023-12-02,"Eldense","Tenerife",0,3,"A",0,1,"A",2.51,2.95,3.15,"0-1","0-3",13,1,4,3,1,1,0,0,9,1,14,14,3,10,28,"9-1","Y","Y","N",2,0,18
"1870","SP2",2023-12-02,"Zaragoza","Leganes",1,0,"H",1,0,"H",2.72,2.86,2.98,"1-0","1-0",10,2,5,0,2,1,0,0,4,4,17,11,1,8,28,"4-4","N","N","N",3,0,18
"1871","SP2",2023-12-02,"Levante","Valladolid",2,1,"H",2,1,"H",2.59,3.19,3.05,"2-1","2-1",19,7,11,3,4,3,0,0,12,6,16,13,3,18,29,"12-6","Y","Y","N",7,0,18
"1872","SP2",2023-12-03,"Andorra","Huesca",1,0,"H",0,0,"D",2.16,3.07,4.17,"0-0","1-0",8,4,8,1,2,2,0,0,6,3,11,12,1,9,23,"6-3","N","N","N",4,0,18
"1873","SP2",2023-12-03,"Alcorcon","Elche",0,2,"A",0,1,"A",3.21,3.1,2.54,"0-1","0-2",10,2,22,9,3,1,1,0,4,4,12,11,2,8,23,"4-4","Y","N","N",4,1,18
"1874","SP2",2023-12-03,"Ferrol","Albacete",5,4,"H",1,1,"D",2.51,2.94,3.17,"1-1","5-4",17,6,18,7,2,3,0,1,2,5,12,16,9,7,28,"2-5","Y","Y","Y",5,1,18
"1875","SP2",2023-12-03,"Mirandes","Santander",0,0,"D",0,0,"D",2.53,3.33,3.02,"0-0","0-0",13,5,12,3,4,4,0,0,9,10,14,17,0,19,31,"9-10","N","N","N",8,0,18
"1876","SP2",2023-12-03,"Amorebieta","Burgos",0,1,"A",0,1,"A",2.73,2.96,2.86,"0-1","0-1",14,3,6,4,2,0,0,0,7,6,10,7,1,13,17,"7-6","N","N","N",2,0,18
"1877","SP2",2023-12-04,"Villarreal B","Eibar",1,0,"H",0,0,"D",3.86,3.69,1.98,"0-0","1-0",26,8,6,0,1,0,0,1,9,0,10,6,1,9,16,"9-0","N","N","N",1,1,18
"1878","SP2",2023-12-08,"Albacete","Villarreal B",2,0,"H",0,0,"D",1.54,4.27,6.68,"0-0","2-0",18,5,7,1,2,2,0,0,4,0,10,9,2,4,19,"4-0","Y","N","N",4,0,19
"1879","SP2",2023-12-08,"Espanol","Zaragoza",1,1,"D",0,0,"D",1.84,3.55,4.89,"0-0","1-1",8,1,10,2,2,3,1,0,4,6,15,17,2,10,32,"4-6","Y","N","N",5,1,19
"1880","SP2",2023-12-09,"Valladolid","Amorebieta",2,1,"H",0,1,"A",1.41,4.75,8.89,"0-1","2-1",12,6,7,3,1,3,0,0,4,4,7,18,3,8,25,"4-4","Y","Y","N",4,0,19
"1881","SP2",2023-12-09,"Sp Gijon","Levante",0,0,"D",0,0,"D",1.98,3.53,4.15,"0-0","0-0",12,3,8,2,7,4,1,0,5,3,9,14,0,8,23,"5-3","N","N","N",11,1,19
"1882","SP2",2023-12-09,"Burgos","Mirandes",0,0,"D",0,0,"D",2.15,3.2,4.01,"0-0","0-0",11,2,5,1,3,4,0,0,3,8,10,10,0,11,20,"3-8","N","N","N",7,0,19
"1883","SP2",2023-12-10,"Elche","Cartagena",1,2,"A",1,0,"H",1.74,3.7,5.38,"1-0","1-2",12,2,7,4,3,4,0,0,8,5,10,18,3,13,28,"8-5","Y","Y","N",7,0,19
"1884","SP2",2023-12-10,"Santander","Oviedo",2,2,"D",1,2,"A",2.5,3.1,3.29,"1-2","2-2",10,5,16,3,4,3,0,0,6,8,18,14,4,14,32,"6-8","Y","Y","Y",7,0,19
"1885","SP2",2023-12-10,"Eibar","Andorra",2,2,"D",2,1,"H",1.75,3.69,5.34,"2-1","2-2",15,4,16,5,5,3,1,0,5,1,14,13,4,6,27,"5-1","Y","Y","Y",8,1,19
"1886","SP2",2023-12-10,"Leganes","Eldense",1,1,"D",1,1,"D",1.87,3.38,5.01,"1-1","1-1",12,3,6,1,4,3,0,0,8,2,16,22,2,10,38,"8-2","Y","N","N",7,0,19
"1887","SP2",2023-12-10,"Huesca","Ferrol",1,0,"H",1,0,"H",2.34,2.99,3.74,"1-0","1-0",11,5,11,0,1,3,0,0,3,4,10,14,1,7,24,"3-4","N","N","N",4,0,19
"1888","SP2",2023-12-11,"Tenerife","Alcorcon",1,0,"H",0,0,"D",1.66,3.63,6.27,"0-0","1-0",14,5,11,2,1,5,0,0,3,3,13,19,1,6,32,"3-3","N","N","N",6,0,19
"1889","SP2",2023-12-15,"Oviedo","Elche",3,2,"H",1,2,"A",2.27,3.01,3.92,"1-2","3-2",11,6,18,5,2,4,0,0,5,2,11,16,5,7,27,"5-2","Y","Y","Y",6,0,20
"1890","SP2",2023-12-16,"Eldense","Santander",3,3,"D",0,2,"A",2.36,3.22,3.12,"0-2","3-3",13,6,8,4,2,2,0,0,8,3,11,7,6,11,18,"8-3","Y","Y","Y",4,0,20
"1891","SP2",2023-12-16,"Andorra","Espanol",1,1,"D",0,0,"D",3.21,3.13,2.52,"0-0","1-1",14,3,6,1,1,4,0,0,6,2,10,19,2,8,29,"6-2","Y","N","N",5,0,20
"1892","SP2",2023-12-16,"Cartagena","Burgos",0,3,"A",0,1,"A",2.37,3.03,3.31,"0-1","0-3",9,1,10,5,5,1,0,0,2,2,14,9,3,4,23,"2-2","Y","Y","N",6,0,20
"1893","SP2",2023-12-16,"Sp Gijon","Leganes",1,1,"D",0,1,"A",2.14,2.96,3.99,"0-1","1-1",17,3,8,2,3,3,0,0,9,4,13,8,2,13,21,"9-4","Y","N","N",6,0,20
"1894","SP2",2023-12-16,"Mirandes","Albacete",2,0,"H",1,0,"H",3.46,3.29,2.3,"1-0","2-0",12,3,11,3,2,2,0,0,2,7,9,15,2,9,24,"2-7","Y","N","N",4,0,20
"1895","SP2",2023-12-17,"Alcorcon","Eibar",1,0,"H",1,0,"H",4.04,3.35,2.07,"1-0","1-0",6,3,18,7,1,2,0,0,2,13,18,9,1,15,27,"2-13","N","N","N",3,0,20
"1896","SP2",2023-12-17,"Levante","Huesca",2,1,"H",2,0,"H",2.14,3.18,4.05,"2-0","2-1",12,6,5,1,2,3,0,1,10,0,21,14,3,10,35,"10-0","Y","Y","N",5,1,20
"1897","SP2",2023-12-17,"Amorebieta","Zaragoza",1,1,"D",1,1,"D",3.69,2.98,2.38,"1-1","1-1",18,7,10,6,5,1,0,0,3,7,9,12,2,10,21,"3-7","Y","N","N",6,0,20
"1898","SP2",2023-12-17,"Ferrol","Tenerife",3,1,"H",1,0,"H",2.46,2.92,3.59,"1-0","3-1",18,7,5,2,2,2,0,0,8,0,9,9,4,8,18,"8-0","Y","Y","Y",4,0,20
"1899","SP2",2023-12-18,"Villarreal B","Valladolid",1,0,"H",1,0,"H",3.61,3.45,2.14,"1-0","1-0",11,3,17,5,1,4,0,0,3,5,20,10,1,8,30,"3-5","N","N","N",5,0,20
"1900","SP2",2023-12-19,"Albacete","Eldense",1,1,"D",0,0,"D",1.63,3.81,6.51,"0-0","1-1",9,1,12,2,1,4,0,1,5,3,12,15,2,8,27,"5-3","Y","N","N",5,1,21
"1901","SP2",2023-12-19,"Santander","Andorra",2,0,"H",1,0,"H",2.44,3.21,3.27,"1-0","2-0",17,12,9,3,5,4,0,1,6,4,16,14,2,10,30,"6-4","Y","N","N",9,1,21
"1902","SP2",2023-12-19,"Elche","Mirandes",0,0,"D",0,0,"D",1.82,3.63,4.87,"0-0","0-0",17,1,4,0,2,3,0,0,6,1,13,12,0,7,25,"6-1","N","N","N",5,0,21
"1903","SP2",2023-12-19,"Espanol","Burgos",3,3,"D",1,2,"A",1.73,3.65,5.61,"1-2","3-3",14,7,12,6,3,2,0,0,6,6,8,12,6,12,20,"6-6","Y","Y","Y",5,0,21
"1904","SP2",2023-12-20,"Zaragoza","Levante",2,2,"D",2,0,"H",2.25,3.14,3.77,"2-0","2-2",16,4,9,5,2,2,0,0,5,2,12,9,4,7,21,"5-2","Y","Y","Y",4,0,21
"1905","SP2",2023-12-20,"Eibar","Sp Gijon",1,1,"D",0,1,"A",1.93,3.43,4.58,"0-1","1-1",15,4,7,4,3,3,0,0,6,3,8,8,2,9,16,"6-3","Y","N","N",6,0,21
"1906","SP2",2023-12-20,"Leganes","Tenerife",1,1,"D",0,0,"D",2.38,2.93,3.76,"0-0","1-1",5,3,6,3,2,3,0,0,5,5,12,12,2,10,24,"5-5","Y","N","N",5,0,21
"1907","SP2",2023-12-21,"Huesca","Cartagena",3,0,"H",3,0,"H",2.21,3.08,3.98,"3-0","3-0",7,6,12,4,0,1,0,0,4,8,11,9,3,12,20,"4-8","Y","Y","N",1,0,21
"1908","SP2",2023-12-21,"Villarreal B","Oviedo",1,1,"D",1,0,"H",3.1,3.12,2.6,"1-0","1-1",15,6,12,2,1,4,0,1,1,7,16,16,2,8,32,"1-7","Y","N","N",5,1,21
"1909","SP2",2023-12-21,"Amorebieta","Alcorcon",1,2,"A",1,1,"D",2.21,3.18,3.84,"1-1","1-2",7,2,12,5,3,4,0,0,9,3,12,19,3,12,31,"9-3","Y","Y","N",7,0,21
"1910","SP2",2023-12-21,"Valladolid","Ferrol",0,1,"A",0,1,"A",2.06,3.33,4.11,"0-1","0-1",15,3,10,2,1,3,0,0,7,4,12,12,1,11,24,"7-4","N","N","N",4,0,21
"1911","SP2",2024-01-12,"Eibar","Santander",2,0,"H",1,0,"H",1.74,3.87,5.04,"1-0","2-0",14,6,9,2,2,1,0,0,2,6,18,14,2,8,32,"2-6","Y","N","N",3,0,22
"1912","SP2",2024-01-13,"Alcorcon","Mirandes",0,0,"D",0,0,"D",2.72,3.12,2.95,"0-0","0-0",14,2,12,2,0,1,0,0,3,3,10,7,0,6,17,"3-3","N","N","N",1,0,22
"1913","SP2",2024-01-13,"Levante","Albacete",3,2,"H",2,0,"H",2.48,3.21,3.2,"2-0","3-2",13,8,11,4,1,0,0,0,5,3,19,18,5,8,37,"5-3","Y","Y","Y",1,0,22
"1914","SP2",2024-01-13,"Oviedo","Amorebieta",1,1,"D",1,1,"D",1.62,3.77,6.79,"1-1","1-1",15,3,14,4,0,1,0,0,10,5,9,11,2,15,20,"10-5","Y","N","N",1,0,22
"1915","SP2",2024-01-13,"Tenerife","Elche",0,1,"A",0,1,"A",2.29,2.96,3.92,"0-1","0-1",10,2,7,3,4,2,0,0,4,2,12,15,1,6,27,"4-2","N","N","N",6,0,22
"1916","SP2",2024-01-13,"Burgos","Valladolid",1,0,"H",1,0,"H",2.7,3.1,3,"1-0","1-0",7,2,20,2,5,2,0,0,5,9,13,10,1,14,23,"5-9","N","N","N",7,0,22
"1917","SP2",2024-01-13,"Ferrol","Espanol",0,0,"D",0,0,"D",2.55,3.22,3.08,"0-0","0-0",6,1,8,1,2,3,0,0,5,8,11,14,0,13,25,"5-8","N","N","N",5,0,22
"1918","SP2",2024-01-14,"Andorra","Leganes",2,3,"A",0,0,"D",2.54,3.02,3.31,"0-0","2-3",18,6,6,4,4,1,0,0,6,1,10,13,5,7,23,"6-1","Y","Y","Y",5,0,22
"1919","SP2",2024-01-14,"Cartagena","Villarreal B",4,1,"H",0,1,"A",2.21,3.36,3.59,"0-1","4-1",19,6,11,2,3,2,0,0,10,6,14,12,5,16,26,"10-6","Y","Y","Y",5,0,22
"1920","SP2",2024-01-14,"Sp Gijon","Huesca",0,0,"D",0,0,"D",1.93,3.09,5.28,"0-0","0-0",11,2,9,4,2,2,0,0,7,1,9,11,0,8,20,"7-1","N","N","N",4,0,22
"1921","SP2",2024-01-15,"Eldense","Zaragoza",1,1,"D",1,1,"D",2.65,2.9,3.21,"1-1","1-1",14,4,4,2,3,4,0,0,10,1,13,9,2,11,22,"10-1","Y","N","N",7,0,22
"3454","T1",2023-08-11,"Trabzonspor","Antalyaspor",1,0,"H",1,0,"H",1.92,3.81,4.06,"1-0","1-0",13,5,11,2,0,1,0,0,6,9,18,11,1,15,29,"6-9","N","N","N",1,0,1
"3455","T1",2023-08-12,"Kasimpasa","Ankaragucu",3,2,"H",1,0,"H",2.36,3.73,2.98,"1-0","3-2",15,5,9,3,1,0,0,0,3,5,8,15,5,8,23,"3-5","Y","Y","Y",1,0,1
"3456","T1",2023-08-12,"Konyaspor","Istanbulspor",1,1,"D",0,1,"A",1.8,3.93,4.55,"0-1","1-1",15,2,4,2,3,5,1,2,10,2,13,10,2,12,23,"10-2","Y","N","N",8,3,1
"3457","T1",2023-08-12,"Kayserispor","Galatasaray",0,0,"D",0,0,"D",5.15,4.41,1.64,"0-0","0-0",12,3,17,3,2,2,0,0,3,9,11,6,0,12,17,"3-9","N","N","N",4,0,1
"3458","T1",2023-08-12,"Pendikspor","Hatayspor",1,5,"A",0,2,"A",2.27,3.48,3.33,"0-2","1-5",6,4,15,9,0,1,0,0,4,2,10,18,6,6,28,"4-2","Y","Y","Y",1,0,1
"3459","T1",2023-08-13,"Sivasspor","Samsunspor",1,1,"D",1,0,"H",2.33,3.6,3.12,"1-0","1-1",6,2,11,3,2,1,0,0,4,5,11,11,2,9,22,"4-5","Y","N","N",3,0,1
"3460","T1",2023-08-13,"Ad. Demirspor","Rizespor",2,1,"H",1,0,"H",1.6,4.61,5.34,"1-0","2-1",9,6,13,4,6,6,0,0,4,5,15,14,3,9,29,"4-5","Y","Y","N",12,0,1
"3461","T1",2023-08-13,"Fenerbahce","Gaziantep",2,1,"H",2,1,"H",1.33,6.04,8.69,"2-1","2-1",21,5,4,1,0,6,0,1,3,1,13,12,3,4,25,"3-1","Y","Y","N",6,1,1
"3462","T1",2023-08-14,"Alanyaspor","Buyuksehyr",2,0,"H",1,0,"H",2.83,3.58,2.49,"1-0","2-0",11,4,8,3,5,4,0,1,4,5,15,14,2,9,29,"4-5","Y","N","N",9,1,1
"3463","T1",2023-08-14,"Karagumruk","Besiktas",0,1,"A",0,0,"D",4.53,4.58,1.67,"0-0","0-1",2,0,9,6,4,1,0,0,4,4,13,14,1,8,27,"4-4","N","N","N",5,0,1
"3464","T1",2023-08-18,"Antalyaspor","Konyaspor",1,1,"D",0,0,"D",2.3,3.61,3.16,"0-0","1-1",14,3,7,3,2,2,0,0,5,5,14,12,2,10,26,"5-5","Y","N","N",4,0,2
"3465","T1",2023-08-18,"Istanbulspor","Kayserispor",1,1,"D",0,0,"D",2.67,3.55,2.69,"0-0","1-1",7,3,9,4,1,0,0,0,4,6,11,11,2,10,22,"4-6","Y","N","N",1,0,2
"3466","T1",2023-08-19,"Rizespor","Alanyaspor",0,0,"D",0,0,"D",2.48,3.61,2.86,"0-0","0-0",10,3,8,2,3,3,0,1,3,3,12,13,0,6,25,"3-3","N","N","N",6,1,2
"3467","T1",2023-08-19,"Galatasaray","Trabzonspor",2,0,"H",1,0,"H",1.64,4.55,4.98,"1-0","2-0",15,5,5,1,4,3,0,0,7,1,21,3,2,8,24,"7-1","Y","N","N",7,0,2
"3468","T1",2023-08-19,"Hatayspor","Kasimpasa",0,0,"D",0,0,"D",2.49,3.6,2.87,"0-0","0-0",8,2,11,2,0,0,0,0,3,1,7,6,0,4,13,"3-1","N","N","N",0,0,2
"3469","T1",2023-08-20,"Buyuksehyr","Karagumruk",0,2,"A",0,2,"A",1.68,4.31,4.95,"0-2","0-2",15,5,9,2,3,4,0,0,5,4,11,14,2,9,25,"5-4","Y","N","N",7,0,2
"3470","T1",2023-08-20,"Besiktas","Pendikspor",1,1,"D",1,0,"H",1.24,6.75,11.71,"1-0","1-1",15,6,11,1,4,2,0,0,6,4,11,9,2,10,20,"6-4","Y","N","N",6,0,2
"3471","T1",2023-08-20,"Gaziantep","Sivasspor",1,3,"A",0,2,"A",2.71,3.73,2.56,"0-2","1-3",11,2,13,7,6,4,0,0,7,4,19,16,4,11,35,"7-4","Y","Y","Y",10,0,2
"3472","T1",2023-08-21,"Ankaragucu","Ad. Demirspor",1,1,"D",1,1,"D",2.72,3.63,2.56,"1-1","1-1",18,5,12,4,1,1,0,0,3,4,9,10,2,7,19,"3-4","Y","N","N",2,0,2
"3473","T1",2023-08-21,"Samsunspor","Fenerbahce",0,2,"A",0,0,"D",5.53,4.5,1.57,"0-0","0-2",5,1,13,6,1,1,0,0,2,5,11,10,2,7,21,"2-5","Y","N","N",2,0,2
"3474","T1",2023-08-25,"Konyaspor","Gaziantep",2,0,"H",0,0,"D",1.8,4.01,4.46,"0-0","2-0",17,8,8,3,1,2,0,0,10,2,9,8,2,12,17,"10-2","Y","N","N",3,0,3
"3475","T1",2023-08-26,"Kasimpasa","Pendikspor",1,1,"D",0,1,"A",1.79,3.85,4.71,"0-1","1-1",7,3,16,6,3,2,0,1,9,2,10,19,2,11,29,"9-2","Y","N","N",5,1,3
"3476","T1",2023-08-26,"Trabzonspor","Rizespor",2,3,"A",0,2,"A",1.51,4.72,6.34,"0-2","2-3",20,7,12,7,1,2,0,0,9,2,10,17,5,11,27,"9-2","Y","Y","Y",3,0,3
"3477","T1",2023-08-26,"Sivasspor","Antalyaspor",1,1,"D",1,1,"D",2.36,3.31,3.31,"1-1","1-1",6,2,8,4,3,3,0,0,3,4,11,15,2,7,26,"3-4","Y","N","N",6,0,3
"3478","T1",2023-08-27,"Karagumruk","Ankaragucu",1,1,"D",1,0,"H",2.38,3.47,3.13,"1-0","1-1",6,2,7,5,1,1,0,0,3,5,15,12,2,8,27,"3-5","Y","N","N",2,0,3
"3479","T1",2023-08-27,"Kayserispor","Samsunspor",2,1,"H",2,1,"H",2.53,3.53,2.87,"2-1","2-1",11,4,6,1,0,0,0,0,3,2,7,8,3,5,15,"3-2","Y","Y","N",0,0,3
"3480","T1",2023-08-27,"Alanyaspor","Hatayspor",0,0,"D",0,0,"D",1.99,3.84,3.77,"0-0","0-0",15,5,5,0,4,3,0,0,9,1,9,17,0,10,26,"9-1","N","N","N",7,0,3
"3481","T1",2023-09-01,"Kasimpasa","Trabzonspor",1,5,"A",0,3,"A",3.03,3.6,2.38,"0-3","1-5",19,6,7,6,3,3,0,0,9,3,10,16,6,12,26,"9-3","Y","Y","Y",6,0,3
"3482","T1",2023-09-01,"Rizespor","Karagumruk",1,0,"H",1,0,"H",1.76,4.1,3.34,"1-0","1-0",13,4,17,3,3,2,0,0,1,6,12,17,1,7,29,"1-6","N","N","N",5,0,3
"3483","T1",2023-09-02,"Buyuksehyr","Konyaspor",0,1,"A",0,0,"D",2.4,3.53,3.05,"0-0","0-1",11,2,13,5,4,2,1,0,2,4,13,13,1,6,26,"2-4","N","N","N",6,1,3
"3484","T1",2023-09-02,"Pendikspor","Alanyaspor",1,1,"D",0,0,"D",2.38,3.63,3.02,"0-0","1-1",10,3,8,4,2,2,0,0,8,4,9,14,2,12,23,"8-4","Y","N","N",4,0,4
"3485","T1",2023-09-02,"Antalyaspor","Kayserispor",1,1,"D",1,1,"D",1.94,3.87,3.91,"1-1","1-1",20,7,7,3,2,3,0,0,9,3,14,11,2,12,25,"9-3","Y","N","N",5,0,4
"3486","T1",2023-09-02,"Gaziantep","Galatasaray",0,3,"A",0,1,"A",7.45,5.13,1.42,"0-1","0-3",15,7,15,4,2,0,0,0,4,7,12,13,3,11,25,"4-7","Y","Y","N",2,0,4
"3487","T1",2023-09-03,"Besiktas","Sivasspor",2,0,"H",2,0,"H",1.45,4.72,7.56,"2-0","2-0",17,8,5,1,2,4,0,0,7,2,17,17,2,9,34,"7-2","Y","N","N",6,0,4
"3488","T1",2023-09-03,"Ankaragucu","Fenerbahce",0,1,"A",0,0,"D",5.03,4.08,1.7,"0-0","0-1",14,2,14,2,2,3,0,1,4,2,15,14,1,6,29,"4-2","N","N","N",5,1,4
"3489","T1",2023-09-03,"Hatayspor","Ad. Demirspor",3,3,"D",0,1,"A",3.45,3.62,2.16,"0-1","3-3",14,7,11,6,6,2,0,0,3,7,19,9,6,10,28,"3-7","Y","Y","Y",8,0,4
"3490","T1",2023-09-16,"Kayserispor","Gaziantep",2,0,"H",1,0,"H",1.89,3.79,4.21,"1-0","2-0",10,4,16,5,0,1,0,0,3,7,11,8,2,10,19,"3-7","Y","N","N",1,0,4
"3491","T1",2023-09-16,"Konyaspor","Rizespor",1,2,"A",1,0,"H",1.99,3.69,3.92,"1-0","1-2",6,4,11,2,2,1,0,0,2,4,12,14,3,6,26,"2-4","Y","Y","N",3,0,4
"3492","T1",2023-09-16,"Ad. Demirspor","Pendikspor",3,0,"H",2,0,"H",1.52,4.93,5.92,"2-0","3-0",18,7,15,5,0,3,0,0,6,6,8,6,3,12,14,"6-6","Y","Y","N",3,0,4
"3493","T1",2023-09-16,"Galatasaray","Samsunspor",4,2,"H",3,0,"H",1.34,5.78,8.87,"3-0","4-2",9,5,9,4,1,3,0,0,2,6,17,15,6,8,32,"2-6","Y","Y","Y",4,0,4
"3494","T1",2023-09-17,"Fenerbahce","Antalyaspor",3,2,"H",1,1,"D",1.4,5.41,7.66,"1-1","3-2",17,10,14,6,3,4,0,0,7,5,13,11,5,12,24,"7-5","Y","Y","Y",7,0,5
"3495","T1",2023-09-17,"Istanbulspor","Buyuksehyr",0,2,"A",0,0,"D",3.34,3.48,2.27,"0-0","0-2",5,0,20,8,4,0,0,0,0,7,15,9,2,7,24,"0-7","Y","N","N",4,0,5
"3496","T1",2023-09-17,"Alanyaspor","Kasimpasa",3,3,"D",2,1,"H",2.09,3.67,3.56,"2-1","3-3",13,6,17,3,0,0,0,0,5,7,9,11,6,12,20,"5-7","Y","Y","Y",0,0,5
"3497","T1",2023-09-17,"Trabzonspor","Besiktas",3,0,"H",2,0,"H",3.12,3.47,2.39,"2-0","3-0",8,5,7,1,4,1,0,0,2,7,15,11,3,9,26,"2-7","Y","Y","N",5,0,5
"3498","T1",2023-09-18,"Karagumruk","Hatayspor",0,0,"D",0,0,"D",1.99,3.63,3.89,"0-0","0-0",5,2,18,5,3,2,0,0,3,3,14,9,0,6,23,"3-3","N","N","N",5,0,5
"3499","T1",2023-09-18,"Sivasspor","Ankaragucu",1,3,"A",1,1,"D",2.42,3.4,3.08,"1-1","1-3",15,9,15,5,3,2,1,0,5,3,7,12,4,8,19,"5-3","Y","Y","Y",5,1,5
"3500","T1",2023-09-22,"Gaziantep","Istanbulspor",2,0,"H",0,0,"D",1.88,3.91,4.12,"0-0","2-0",13,2,5,0,1,5,0,0,8,4,11,13,2,12,24,"8-4","Y","N","N",6,0,5
"3501","T1",2023-09-23,"Pendikspor","Karagumruk",1,1,"D",1,0,"H",2.56,3.44,2.89,"1-0","1-1",8,4,10,4,0,1,0,0,5,4,13,10,2,9,23,"5-4","Y","N","N",1,0,5
"3502","T1",2023-09-23,"Rizespor","Sivasspor",1,1,"D",1,1,"D",2.29,3.39,3.37,"1-1","1-1",14,4,14,4,7,3,0,0,5,4,12,17,2,9,29,"5-4","Y","N","N",10,0,5
"3503","T1",2023-09-23,"Antalyaspor","Samsunspor",2,0,"H",2,0,"H",2.12,3.75,3.46,"2-0","2-0",7,3,9,1,2,1,0,0,1,4,22,11,2,5,33,"1-4","Y","N","N",3,0,5
"3504","T1",2023-09-23,"Buyuksehyr","Galatasaray",1,2,"A",0,1,"A",4.44,3.86,1.83,"0-1","1-2",6,2,17,4,3,2,0,0,2,4,18,15,3,6,33,"2-4","Y","Y","N",5,0,6
"3505","T1",2023-09-24,"Ankaragucu","Konyaspor",1,1,"D",1,1,"D",2.4,3.58,3.01,"1-1","1-1",15,1,7,1,1,1,0,0,4,2,15,8,2,6,23,"4-2","Y","N","N",2,0,6
"3506","T1",2023-09-24,"Besiktas","Kayserispor",2,1,"H",0,0,"D",1.4,5.2,8.13,"0-0","2-1",23,10,5,1,1,0,0,0,7,2,13,10,3,9,23,"7-2","Y","Y","N",1,0,6
"3507","T1",2023-09-24,"Alanyaspor","Fenerbahce",0,1,"A",0,1,"A",5.11,4.35,1.65,"0-1","0-1",2,1,14,7,2,6,0,0,4,5,15,14,1,9,29,"4-5","N","N","N",8,0,6
"3508","T1",2023-09-24,"Kasimpasa","Ad. Demirspor",2,1,"H",1,0,"H",3.2,3.83,2.2,"1-0","2-1",13,7,19,6,4,2,0,3,6,11,21,7,3,17,28,"6-11","Y","Y","N",6,3,6
"3509","T1",2023-09-25,"Hatayspor","Trabzonspor",3,2,"H",0,1,"A",3.05,3.68,2.3,"0-1","3-2",9,3,6,3,6,2,0,0,9,1,22,13,5,10,35,"9-1","Y","Y","Y",8,0,6
"3510","T1",2023-09-26,"Istanbulspor","Galatasaray",0,1,"A",0,1,"A",9.13,5.73,1.34,"0-1","0-1",4,3,17,7,1,2,0,0,3,4,12,16,1,7,28,"3-4","N","N","N",3,0,6
"3511","T1",2023-09-27,"Ad. Demirspor","Besiktas",4,2,"H",2,0,"H",3.37,3.93,2.09,"2-0","4-2",14,7,16,5,2,1,0,0,1,5,16,15,6,6,31,"1-5","Y","Y","Y",3,0,6
"3512","T1",2023-09-28,"Fenerbahce","Buyuksehyr",4,0,"H",3,0,"H",1.44,5.07,7.13,"3-0","4-0",16,8,6,0,4,1,0,0,14,2,22,9,4,16,31,"14-2","Y","Y","Y",5,0,6
"3513","T1",2023-09-29,"Samsunspor","Gaziantep",1,2,"A",0,2,"A",1.93,3.76,4.11,"0-2","1-2",18,2,4,3,2,3,0,0,9,2,13,12,3,11,25,"9-2","Y","Y","N",5,0,6
"3514","T1",2023-09-30,"Sivasspor","Hatayspor",0,0,"D",0,0,"D",2.08,3.57,3.74,"0-0","0-0",12,4,4,1,3,3,0,0,6,7,9,20,0,13,29,"6-7","N","N","N",6,0,7
"3515","T1",2023-09-30,"Istanbulspor","Antalyaspor",1,2,"A",1,0,"H",3.23,3.77,2.21,"1-0","1-2",4,3,17,5,2,3,0,0,4,8,8,17,3,12,25,"4-8","Y","Y","N",5,0,7
"3516","T1",2023-09-30,"Trabzonspor","Pendikspor",2,1,"H",2,1,"H",1.55,4.62,5.91,"2-1","2-1",11,3,9,4,2,1,1,0,4,2,19,8,3,6,27,"4-2","Y","Y","N",3,1,7
"3517","T1",2023-09-30,"Galatasaray","Ankaragucu",2,1,"H",0,0,"D",1.31,6.12,9.34,"0-0","2-1",34,13,7,2,0,3,0,0,12,3,11,10,3,15,21,"12-3","Y","Y","N",3,0,7
"3518","T1",2023-10-01,"Karagumruk","Kasimpasa",2,3,"A",1,3,"A",2.34,3.63,3.08,"1-3","2-3",13,4,4,3,3,3,0,0,8,0,9,14,5,8,23,"8-0","Y","Y","Y",6,0,7
"3519","T1",2023-10-01,"Fenerbahce","Rizespor",5,0,"H",1,0,"H",1.34,5.83,8.54,"1-0","5-0",23,11,5,1,1,3,0,0,8,2,10,15,5,10,25,"8-2","Y","Y","Y",4,0,7
"3520","T1",2023-10-01,"Ad. Demirspor","Alanyaspor",4,0,"H",1,0,"H",1.74,4.3,4.43,"1-0","4-0",15,7,9,1,2,3,0,0,7,3,11,14,4,10,25,"7-3","Y","Y","Y",5,0,7
"3521","T1",2023-10-01,"Konyaspor","Besiktas",0,2,"A",0,1,"A",3.51,3.7,2.11,"0-1","0-2",5,3,6,1,2,3,1,0,2,6,13,20,2,8,33,"2-6","Y","N","N",5,1,7
"3522","T1",2023-10-02,"Kayserispor","Buyuksehyr",0,0,"D",0,0,"D",2.6,3.39,2.83,"0-0","0-0",14,1,8,4,2,2,0,0,10,5,6,15,0,15,21,"10-5","N","N","N",4,0,7
"3523","T1",2023-10-06,"Ad. Demirspor","Trabzonspor",1,0,"H",1,0,"H",2.06,3.94,3.46,"1-0","1-0",13,8,18,3,5,3,0,0,3,3,17,9,1,6,26,"3-3","N","N","N",8,0,7
"3524","T1",2023-10-06,"Alanyaspor","Karagumruk",2,1,"H",1,0,"H",2.31,3.37,3.35,"1-0","2-1",6,3,10,4,4,1,0,0,3,6,16,16,3,9,32,"3-6","Y","Y","N",5,0,8
"3525","T1",2023-10-07,"Pendikspor","Sivasspor",2,3,"A",0,1,"A",2.74,3.47,2.67,"0-1","2-3",15,6,15,7,5,2,0,0,9,4,14,13,5,13,27,"9-4","Y","Y","Y",7,0,8
"3526","T1",2023-10-07,"Ankaragucu","Kayserispor",3,0,"H",0,0,"D",2.15,3.67,3.44,"0-0","3-0",12,8,4,1,0,0,0,0,1,3,1,10,3,4,11,"1-3","Y","Y","N",0,0,8
"3527","T1",2023-10-07,"Antalyaspor","Galatasaray",0,2,"A",0,0,"D",4.94,4.21,1.69,"0-0","0-2",12,4,11,7,1,3,0,0,3,7,15,21,2,10,36,"3-7","Y","N","N",4,0,8
"3528","T1",2023-10-07,"Buyuksehyr","Gaziantep",2,0,"H",2,0,"H",1.88,3.71,4.42,"2-0","2-0",8,3,12,1,0,0,0,0,5,7,12,10,2,12,22,"5-7","Y","N","N",0,0,8
"3529","T1",2023-10-08,"Rizespor","Samsunspor",1,0,"H",0,0,"D",2.17,3.68,3.34,"0-0","1-0",8,4,12,3,3,3,1,0,4,8,9,15,1,12,24,"4-8","N","N","N",6,1,8
"3530","T1",2023-10-08,"Besiktas","Istanbulspor",2,0,"H",1,0,"H",1.24,6.6,12.33,"1-0","2-0",17,5,4,2,2,2,0,0,4,4,12,10,2,8,22,"4-4","Y","N","N",4,0,8
"3531","T1",2023-10-08,"Hatayspor","Konyaspor",3,1,"H",1,1,"D",2.77,3.17,2.85,"1-1","3-1",10,5,8,5,2,0,0,0,3,2,19,10,4,5,29,"3-2","Y","Y","Y",2,0,8
"3532","T1",2023-10-08,"Kasimpasa","Fenerbahce",0,2,"A",0,2,"A",6.76,5.01,1.46,"0-2","0-2",6,1,20,7,5,0,0,0,1,8,13,12,2,9,25,"1-8","Y","N","N",5,0,8
"3533","T1",2023-10-21,"Kayserispor","Rizespor",3,1,"H",1,0,"H",2.28,3.33,3.17,"1-0","3-1",20,7,12,3,5,2,0,0,5,2,13,12,4,7,25,"5-2","Y","Y","Y",7,0,8
"3534","T1",2023-10-21,"Gaziantep","Antalyaspor",1,0,"H",0,0,"D",2.84,3.23,2.74,"0-0","1-0",10,2,8,2,1,2,0,0,6,4,16,14,1,10,30,"6-4","N","N","N",3,0,9
"3535","T1",2023-10-21,"Konyaspor","Pendikspor",1,2,"A",0,0,"D",1.78,3.82,4.82,"0-0","1-2",16,8,8,3,1,3,0,0,5,2,4,12,3,7,16,"5-2","Y","Y","N",4,0,9
"3536","T1",2023-10-21,"Galatasaray","Besiktas",2,1,"H",1,0,"H",1.64,4.44,5.11,"1-0","2-1",25,10,2,2,3,5,0,1,6,2,12,19,3,8,31,"6-2","Y","Y","N",8,1,9
"3537","T1",2023-10-22,"Sivasspor","Kasimpasa",0,1,"A",0,0,"D",2.28,3.57,3.24,"0-0","0-1",17,8,17,6,0,2,0,0,7,8,10,9,1,15,19,"7-8","N","N","N",2,0,9
"3538","T1",2023-10-22,"Istanbulspor","Ankaragucu",2,1,"H",1,1,"D",3.32,3.59,2.22,"1-1","2-1",7,3,9,1,0,3,0,0,2,5,14,14,3,7,28,"2-5","Y","Y","N",3,0,9
"3539","T1",2023-10-22,"Fenerbahce","Hatayspor",4,2,"H",3,0,"H",1.22,7.29,12.61,"3-0","4-2",17,6,8,5,1,4,0,0,7,5,10,14,6,12,24,"7-5","Y","Y","Y",5,0,9
"3540","T1",2023-10-22,"Samsunspor","Buyuksehyr",0,0,"D",0,0,"D",2.48,3.44,2.99,"0-0","0-0",20,5,7,0,2,2,0,0,8,0,17,8,0,8,25,"8-0","N","N","N",4,0,9
"3541","T1",2023-10-23,"Karagumruk","Ad. Demirspor",2,0,"H",0,0,"D",3.49,3.88,2.04,"0-0","2-0",10,6,11,5,0,1,0,0,5,4,18,8,2,9,26,"5-4","Y","N","N",1,0,9
"3542","T1",2023-10-23,"Trabzonspor","Alanyaspor",1,0,"H",0,0,"D",1.65,4.24,5.08,"0-0","1-0",14,3,15,3,1,2,0,0,7,5,15,4,1,12,19,"7-5","N","N","N",3,0,9
"3543","T1",2023-10-27,"Hatayspor","Kayserispor",1,2,"A",0,1,"A",2.29,3.46,3.3,"0-1","1-2",18,9,8,2,5,0,0,0,12,1,10,15,3,13,25,"12-1","Y","Y","N",5,0,9
"3544","T1",2023-10-27,"Kasimpasa","Istanbulspor",3,1,"H",1,0,"H",1.81,4.08,4.29,"1-0","3-1",19,11,17,6,2,2,0,0,8,5,13,11,4,13,24,"8-5","Y","Y","Y",4,0,10
"3545","T1",2023-10-28,"Alanyaspor","Sivasspor",1,2,"A",0,0,"D",2.17,3.63,3.43,"0-0","1-2",12,5,15,4,3,1,0,0,7,2,13,12,3,9,25,"7-2","Y","Y","N",4,0,10
"3546","T1",2023-10-28,"Ad. Demirspor","Konyaspor",3,0,"H",0,0,"D",1.7,4.34,4.69,"0-0","3-0",15,5,13,4,1,1,0,0,4,5,12,10,3,9,22,"4-5","Y","Y","N",2,0,10
"3547","T1",2023-10-28,"Rizespor","Galatasaray",0,1,"A",0,0,"D",5.88,4.68,1.54,"0-0","0-1",11,3,20,5,2,2,0,0,6,5,14,11,1,11,25,"6-5","N","N","N",4,0,10
"3548","T1",2023-10-29,"Karagumruk","Trabzonspor",0,0,"D",0,0,"D",3.07,3.51,2.4,"0-0","0-0",6,3,12,0,2,1,0,0,6,3,8,11,0,9,19,"6-3","N","N","N",3,0,10
"3549","T1",2023-10-29,"Ankaragucu","Samsunspor",2,0,"H",0,0,"D",2.39,3.51,3.07,"0-0","2-0",12,5,3,2,0,2,0,0,4,6,8,14,2,10,22,"4-6","Y","N","N",2,0,10
"3550","T1",2023-10-29,"Antalyaspor","Buyuksehyr",1,0,"H",1,0,"H",2.25,3.35,3.47,"1-0","1-0",11,1,8,3,3,5,0,0,7,5,20,19,1,12,39,"7-5","N","N","N",8,0,10
"3551","T1",2023-10-29,"Pendikspor","Fenerbahce",0,5,"A",0,2,"A",9.36,6.08,1.32,"0-2","0-5",2,0,19,10,1,2,0,0,0,7,7,11,5,7,18,"0-7","Y","Y","Y",3,0,10
"3552","T1",2023-10-30,"Besiktas","Gaziantep",2,0,"H",0,0,"D",1.38,5.21,8.18,"0-0","2-0",13,6,12,6,2,5,1,1,7,3,15,16,2,10,31,"7-3","Y","N","N",7,2,10
"3553","T1",2023-11-03,"Galatasaray","Kasimpasa",2,1,"H",1,0,"H",1.21,7.89,11.86,"1-0","2-1",13,3,12,5,2,3,0,0,5,3,11,12,3,8,23,"5-3","Y","Y","N",5,0,10
"3554","T1",2023-11-04,"Istanbulspor","Pendikspor",2,4,"A",1,2,"A",2.46,3.58,2.93,"1-2","2-4",15,4,22,11,2,3,0,0,4,7,14,8,6,11,22,"4-7","Y","Y","Y",5,0,11
"3555","T1",2023-11-04,"Samsunspor","Hatayspor",2,1,"H",0,1,"A",2.21,3.41,3.54,"0-1","2-1",15,6,10,3,3,7,0,1,12,4,7,16,3,16,23,"12-4","Y","Y","N",10,1,11
"3556","T1",2023-11-04,"Fenerbahce","Trabzonspor",2,3,"A",0,1,"A",1.35,5.58,9.05,"0-1","2-3",12,4,6,4,5,4,1,0,10,4,14,27,5,14,41,"10-4","Y","Y","Y",9,1,11
"3557","T1",2023-11-05,"Sivasspor","Ad. Demirspor",1,1,"D",1,0,"H",3.04,3.75,2.31,"1-0","1-1",19,10,14,4,1,3,0,0,5,6,14,15,2,11,29,"5-6","Y","N","N",4,0,11
"3558","T1",2023-11-05,"Buyuksehyr","Ankaragucu",3,3,"D",2,2,"D",2.2,3.41,3.58,"2-2","3-3",9,4,10,5,2,0,0,0,1,3,7,12,6,4,19,"1-3","Y","Y","Y",2,0,11
"3559","T1",2023-11-05,"Konyaspor","Karagumruk",1,1,"D",0,0,"D",2.15,3.53,3.58,"0-0","1-1",10,3,9,2,2,4,0,0,2,8,13,19,2,10,32,"2-8","Y","N","N",6,0,11
"3560","T1",2023-11-05,"Antalyaspor","Besiktas",3,2,"H",0,1,"A",3.26,3.56,2.27,"0-1","3-2",5,3,17,5,1,3,0,0,3,6,13,13,5,9,26,"3-6","Y","Y","Y",4,0,11
"3561","T1",2023-11-06,"Gaziantep","Rizespor",2,0,"H",1,0,"H",2.31,3.47,3.2,"1-0","2-0",9,5,14,2,3,1,0,0,3,5,8,8,2,8,16,"3-5","Y","N","N",4,0,11
"3562","T1",2023-11-06,"Kayserispor","Alanyaspor",1,0,"H",0,0,"D",2.16,3.49,3.52,"0-0","1-0",12,4,9,6,1,3,0,0,8,5,17,9,1,13,26,"8-5","N","N","N",4,0,11
"3563","T1",2023-11-08,"Samsunspor","Istanbulspor",2,1,"H",0,1,"A",1.9,3.81,4.1,"0-1","2-1",12,4,6,3,3,5,0,0,7,2,16,12,3,9,28,"7-2","Y","Y","N",8,0,11
"3564","T1",2023-11-10,"Ankaragucu","Antalyaspor",0,4,"A",0,2,"A",2.54,3.36,2.98,"0-2","0-4",10,2,21,9,3,0,0,0,2,5,9,11,4,7,20,"2-5","Y","Y","Y",3,0,12
"3565","T1",2023-11-10,"Trabzonspor","Konyaspor",2,1,"H",0,0,"D",1.68,3.99,5.48,"0-0","2-1",13,5,13,3,1,3,0,0,6,4,16,14,3,10,30,"6-4","Y","Y","N",4,0,12
"3566","T1",2023-11-11,"Kasimpasa","Kayserispor",3,4,"A",1,3,"A",2.32,3.66,3.09,"1-3","3-4",19,9,8,5,0,1,0,0,6,4,4,15,7,10,19,"6-4","Y","Y","Y",1,0,12
"3567","T1",2023-11-11,"Alanyaspor","Gaziantep",0,3,"A",0,2,"A",2.29,3.55,3.24,"0-2","0-3",13,3,9,5,3,1,0,0,8,1,12,10,3,9,22,"8-1","Y","Y","N",4,0,12
"3568","T1",2023-11-11,"Karagumruk","Sivasspor",3,0,"H",1,0,"H",2.25,3.4,3.44,"1-0","3-0",13,7,11,3,2,2,0,0,5,4,16,4,3,9,20,"5-4","Y","Y","N",4,0,12
"3569","T1",2023-11-11,"Hatayspor","Galatasaray",2,1,"H",1,1,"D",6.95,5.17,1.44,"1-1","2-1",6,4,18,6,2,1,0,0,2,9,16,11,3,11,27,"2-9","Y","Y","N",3,0,12
"3570","T1",2023-11-12,"Pendikspor","Samsunspor",1,0,"H",0,0,"D",3.1,3.51,2.38,"0-0","1-0",10,4,16,8,1,3,0,0,4,3,10,18,1,7,28,"4-3","N","N","N",4,0,12
"3571","T1",2023-11-12,"Besiktas","Buyuksehyr",1,0,"H",0,0,"D",1.79,3.93,4.58,"0-0","1-0",12,4,7,2,2,3,0,0,5,6,18,17,1,11,35,"5-6","N","N","N",5,0,12
"3572","T1",2023-11-12,"Rizespor","Istanbulspor",1,0,"H",1,0,"H",1.76,3.99,4.72,"1-0","1-0",8,3,7,0,1,0,0,0,6,6,17,7,1,12,24,"6-6","N","N","N",1,0,12
"3573","T1",2023-11-12,"Ad. Demirspor","Fenerbahce",0,0,"D",0,0,"D",3.6,4.21,1.94,"0-0","0-0",4,0,18,9,3,3,0,0,3,5,13,15,0,8,28,"3-5","N","N","N",6,0,12
"3574","T1",2023-11-25,"Istanbulspor","Hatayspor",2,1,"H",1,0,"H",3.26,3.61,2.25,"1-0","2-1",15,10,10,3,2,3,0,0,8,6,9,14,3,14,23,"8-6","Y","Y","N",5,0,13
"3575","T1",2023-11-25,"Gaziantep","Ankaragucu",0,1,"A",0,1,"A",2.19,3.39,3.6,"0-1","0-1",9,2,12,5,4,5,0,0,2,4,8,19,1,6,27,"2-4","N","N","N",9,0,13
"3576","T1",2023-11-25,"Konyaspor","Kasimpasa",2,0,"H",0,0,"D",2.01,3.71,3.82,"0-0","2-0",17,7,8,1,0,1,0,0,2,9,11,12,2,11,23,"2-9","Y","N","N",1,0,13
"3577","T1",2023-11-25,"Galatasaray","Alanyaspor",4,0,"H",2,0,"H",1.15,7.14,11.19,"2-0","4-0",26,11,4,1,1,1,0,0,9,3,12,8,4,12,20,"9-3","Y","Y","Y",2,0,13
"3578","T1",2023-11-26,"Kayserispor","Ad. Demirspor",1,1,"D",0,1,"A",2.67,4.03,2.47,"0-1","1-1",14,4,9,3,3,3,0,0,9,4,23,8,2,13,31,"9-4","Y","N","N",6,0,13
"3579","T1",2023-11-26,"Antalyaspor","Rizespor",0,0,"D",0,0,"D",1.86,3.7,4.5,"0-0","0-0",16,10,8,3,1,5,0,0,6,4,12,17,0,10,29,"6-4","N","N","N",6,0,13
"3580","T1",2023-11-26,"Samsunspor","Besiktas",1,2,"A",1,1,"D",3.41,3.56,2.19,"1-1","1-2",13,5,16,5,2,1,0,0,9,5,17,9,3,14,26,"9-5","Y","Y","N",3,0,13
"3581","T1",2023-11-26,"Fenerbahce","Karagumruk",2,1,"H",0,1,"A",1.24,6.94,11.63,"0-1","2-1",9,3,9,2,5,4,0,0,1,2,20,17,3,3,37,"1-2","Y","Y","N",9,0,13
"3582","T1",2023-11-27,"Buyuksehyr","Pendikspor",4,1,"H",1,1,"D",1.8,3.78,4.62,"1-1","4-1",10,5,12,3,1,2,0,0,7,4,13,14,5,11,27,"7-4","Y","Y","Y",3,0,13
"3583","T1",2023-11-27,"Sivasspor","Trabzonspor",3,3,"D",2,2,"D",3.51,3.35,2.18,"2-2","3-3",17,9,13,6,1,1,0,0,5,2,11,10,6,7,21,"5-2","Y","Y","Y",2,0,13
"3584","T1",2023-12-01,"Hatayspor","Antalyaspor",3,3,"D",1,1,"D",3.08,3.4,2.44,"1-1","3-3",14,8,13,7,2,2,0,0,6,5,14,5,6,11,19,"6-5","Y","Y","Y",4,0,14
"3585","T1",2023-12-01,"Karagumruk","Istanbulspor",3,0,"H",1,0,"H",1.7,3.89,5.36,"1-0","3-0",15,5,6,0,3,1,0,0,3,5,12,9,3,8,21,"3-5","Y","Y","N",4,0,14
"3586","T1",2023-12-02,"Alanyaspor","Konyaspor",2,2,"D",2,1,"H",2.27,3.36,3.15,"2-1","2-2",19,5,13,6,2,2,0,0,4,6,10,20,4,10,30,"4-6","Y","Y","Y",4,0,14
"3587","T1",2023-12-02,"Rizespor","Buyuksehyr",3,2,"H",2,2,"D",2.5,3.34,3.05,"2-2","3-2",19,7,16,9,2,3,0,0,6,5,10,13,5,11,23,"6-5","Y","Y","Y",5,0,14
"3588","T1",2023-12-02,"Ad. Demirspor","Samsunspor",2,3,"A",1,2,"A",1.74,4.44,4.34,"1-2","2-3",11,4,11,6,2,2,0,0,7,4,9,13,5,11,22,"7-4","Y","Y","Y",4,0,14
"3589","T1",2023-12-02,"Pendikspor","Galatasaray",0,2,"A",0,0,"D",9.28,6.01,1.32,"0-0","0-2",9,0,18,6,2,3,0,0,2,6,8,11,2,8,19,"2-6","Y","N","N",5,0,14
"3590","T1",2023-12-03,"Kasimpasa","Gaziantep",4,2,"H",3,0,"H",2.31,3.53,3.22,"3-0","4-2",24,7,15,4,5,5,1,0,5,6,19,13,6,11,32,"5-6","Y","Y","Y",10,1,14
"3591","T1",2023-12-03,"Trabzonspor","Kayserispor",0,1,"A",0,0,"D",1.79,3.92,4.58,"0-0","0-1",15,2,9,4,3,2,0,0,4,2,7,15,1,6,22,"4-2","N","N","N",5,0,14
"3592","T1",2023-12-03,"Ankaragucu","Besiktas",1,1,"D",1,0,"H",3.47,3.61,2.16,"1-0","1-1",11,4,9,4,1,1,0,0,1,5,19,10,2,6,29,"1-5","Y","N","N",2,0,14
"3593","T1",2023-12-04,"Fenerbahce","Sivasspor",4,1,"H",2,0,"H",1.23,6.95,11.81,"2-0","4-1",8,5,9,3,1,1,0,0,4,2,18,12,5,6,30,"4-2","Y","Y","Y",2,0,14
"3594","T1",2023-12-08,"Galatasaray","Ad. Demirspor",3,1,"H",2,1,"H",1.27,6.64,9.99,"2-1","3-1",22,7,13,5,2,0,0,0,7,4,15,9,4,11,24,"7-4","Y","Y","Y",2,0,15
"3595","T1",2023-12-09,"Antalyaspor","Karagumruk",2,1,"H",2,1,"H",1.85,3.81,4.4,"2-1","2-1",2,2,11,2,4,7,1,0,2,4,15,17,3,6,32,"2-4","Y","Y","N",11,1,15
"3596","T1",2023-12-09,"Samsunspor","Kasimpasa",4,2,"H",2,0,"H",2.1,3.71,3.23,"2-0","4-2",12,7,13,6,1,0,0,0,3,4,15,9,6,7,24,"3-4","Y","Y","Y",1,0,15
"3597","T1",2023-12-09,"Besiktas","Fenerbahce",1,3,"A",1,1,"D",3.95,3.61,1.89,"1-1","1-3",4,1,23,10,5,4,0,0,1,6,18,13,4,7,31,"1-6","Y","Y","Y",9,0,15
"3598","T1",2023-12-10,"Istanbulspor","Alanyaspor",0,1,"A",0,0,"D",2.76,3.5,2.63,"0-0","0-1",11,2,18,7,1,2,0,0,1,9,23,10,1,10,33,"1-9","N","N","N",3,0,15
"3599","T1",2023-12-10,"Buyuksehyr","Hatayspor",1,0,"H",1,0,"H",1.99,3.56,4.06,"1-0","1-0",9,4,16,3,3,3,1,0,1,7,19,18,1,8,37,"1-7","N","N","N",6,1,15
"3600","T1",2023-12-10,"Kayserispor","Pendikspor",2,0,"H",0,0,"D",1.89,3.93,4.05,"0-0","2-0",11,5,11,4,0,1,0,0,4,5,9,9,2,9,18,"4-5","Y","N","N",1,0,15
"3601","T1",2023-12-10,"Gaziantep","Trabzonspor",1,3,"A",0,0,"D",3.23,3.34,2.39,"0-0","1-3",8,4,20,11,1,2,0,0,2,3,6,11,4,5,17,"2-3","Y","Y","Y",3,0,15
"3602","T1",2023-12-11,"Ankaragucu","Rizespor",1,1,"D",1,0,"H",2.12,3.41,3.71,"1-0","1-1",15,7,13,2,4,6,1,1,2,1,11,19,2,3,30,"2-1","Y","N","N",10,2,15
"3603","T1",2023-12-11,"Konyaspor","Sivasspor",0,1,"A",0,1,"A",2.14,3.43,3.64,"0-1","0-1",13,1,10,3,3,4,0,0,7,2,8,13,1,9,21,"7-2","N","N","N",7,0,15
"3604","T1",2023-12-19,"Buyuksehyr","Sivasspor",3,1,"H",1,1,"D",2.29,3.48,3.29,"1-1","3-1",15,6,7,4,1,2,0,0,3,1,22,11,4,4,33,"3-1","Y","Y","Y",3,0,16
"3605","T1",2023-12-19,"Gaziantep","Ad. Demirspor",2,2,"D",1,0,"H",2.78,3.79,2.47,"1-0","2-2",15,5,15,7,0,1,0,0,5,5,15,9,4,10,24,"5-5","Y","Y","Y",1,0,16
"3606","T1",2023-12-20,"Kayserispor","Fenerbahce",3,4,"A",1,2,"A",6.76,4.95,1.47,"1-2","3-4",16,6,13,6,2,5,0,2,5,3,22,11,7,8,33,"5-3","Y","Y","Y",7,2,16
"3607","T1",2023-12-20,"Antalyaspor","Kasimpasa",0,0,"D",0,0,"D",1.77,4.07,4.57,"0-0","0-0",9,1,6,3,2,2,0,0,5,11,10,11,0,16,21,"5-11","N","N","N",4,0,16
"3608","T1",2023-12-20,"Galatasaray","Karagumruk",1,0,"H",1,0,"H",1.24,7.01,11.7,"1-0","1-0",18,8,7,3,3,3,0,0,7,4,11,11,1,11,22,"7-4","N","N","N",6,0,16
"3609","T1",2023-12-21,"Rizespor","Pendikspor",5,1,"H",3,1,"H",1.93,3.8,4.05,"3-1","5-1",8,5,12,5,2,3,0,1,5,6,9,11,6,11,20,"5-6","Y","Y","Y",5,1,16
"3610","T1",2023-12-21,"Samsunspor","Konyaspor",1,1,"D",0,1,"A",2.05,3.65,3.74,"0-1","1-1",8,3,12,2,3,0,0,0,4,8,18,11,2,12,29,"4-8","Y","N","N",3,0,16
"3611","T1",2023-12-21,"Ankaragucu","Hatayspor",0,0,"D",0,0,"D",2,3.75,3.81,"0-0","0-0",13,4,11,5,0,2,0,0,6,5,9,15,0,11,24,"6-5","N","N","N",2,0,16
"3612","T1",2023-12-21,"Besiktas","Alanyaspor",1,3,"A",1,1,"D",1.53,4.67,6.02,"1-1","1-3",16,3,10,3,3,2,0,0,10,3,16,7,4,13,23,"10-3","Y","Y","Y",5,0,16
"3613","T1",2023-12-23,"Sivasspor","Istanbulspor",1,0,"H",0,0,"D",1.68,4.22,4.99,"0-0","1-0",16,6,6,0,0,2,0,0,9,7,7,12,1,16,19,"9-7","N","N","N",2,0,16
"3614","T1",2023-12-23,"Karagumruk","Gaziantep",0,3,"A",0,1,"A",2.08,3.4,3.92,"0-1","0-3",9,3,7,3,3,1,0,0,2,3,15,9,3,5,24,"2-3","Y","Y","N",4,0,17
"3615","T1",2023-12-23,"Trabzonspor","Buyuksehyr",1,1,"D",1,1,"D",1.69,3.93,5.39,"1-1","1-1",18,4,6,1,0,2,0,0,5,6,13,18,2,11,31,"5-6","Y","N","N",2,0,17
"3616","T1",2023-12-24,"Konyaspor","Kayserispor",2,0,"H",0,0,"D",2.44,3.57,2.95,"0-0","2-0",11,4,13,4,1,4,0,0,2,5,6,19,2,7,25,"2-5","Y","N","N",5,0,17
"3617","T1",2023-12-24,"Ad. Demirspor","Antalyaspor",2,1,"H",2,0,"H",2.09,4.02,3.31,"2-0","2-1",6,2,22,3,4,2,0,0,1,10,17,10,3,11,27,"1-10","Y","Y","N",6,0,17
"3618","T1",2023-12-24,"Fenerbahce","Galatasaray",0,0,"D",0,0,"D",2.25,3.71,3.19,"0-0","0-0",6,0,8,1,3,4,0,0,2,6,19,26,0,8,45,"2-6","N","N","N",7,0,17
"3619","T1",2023-12-25,"Alanyaspor","Samsunspor",3,1,"H",2,0,"H",2.43,3.39,3.06,"2-0","3-1",15,7,17,3,1,4,0,0,3,4,9,19,4,7,28,"3-4","Y","Y","Y",5,0,17
"3620","T1",2023-12-25,"Kasimpasa","Rizespor",2,2,"D",1,1,"D",2.06,3.63,3.66,"1-1","2-2",21,9,11,3,0,1,0,0,3,4,9,16,4,7,25,"3-4","Y","Y","Y",1,0,17
"3621","T1",2023-12-25,"Hatayspor","Besiktas",1,2,"A",0,1,"A",3.18,3.67,2.24,"0-1","1-2",7,2,15,7,1,1,0,0,5,8,11,9,3,13,20,"5-8","Y","Y","N",2,0,17
"3622","T1",2023-12-25,"Pendikspor","Ankaragucu",1,1,"D",0,1,"A",3.01,3.52,2.4,"0-1","1-1",14,4,8,1,0,3,0,0,5,3,10,12,2,8,22,"5-3","Y","N","N",3,0,17
"3623","T1",2024-01-05,"Gaziantep","Pendikspor",2,2,"D",1,0,"H",2.03,3.63,3.82,"1-0","2-2",9,2,8,4,2,6,0,0,1,5,7,16,4,6,23,"1-5","Y","Y","Y",8,0,17
"3624","T1",2024-01-05,"Antalyaspor","Alanyaspor",0,0,"D",0,0,"D",2.16,3.42,3.67,"0-0","0-0",11,2,8,2,2,0,0,0,9,5,15,12,0,14,27,"9-5","N","N","N",2,0,18
"3625","T1",2024-01-05,"Besiktas","Kasimpasa",1,3,"A",1,1,"D",1.58,4.66,5.47,"1-1","1-3",10,3,14,7,2,2,0,0,4,3,20,13,4,7,33,"4-3","Y","Y","Y",4,0,18
"3626","T1",2024-01-06,"Rizespor","Hatayspor",2,0,"H",1,0,"H",2.12,3.57,3.62,"1-0","2-0",10,3,16,0,0,2,0,0,3,4,11,10,2,7,21,"3-4","Y","N","N",2,0,18
"3627","T1",2024-01-06,"Buyuksehyr","Ad. Demirspor",0,0,"D",0,0,"D",2.03,3.8,3.66,"0-0","0-0",8,1,11,4,3,0,0,0,6,6,11,12,0,12,23,"6-6","N","N","N",3,0,18
"3628","T1",2024-01-06,"Ankaragucu","Trabzonspor",0,1,"A",0,1,"A",3.4,3.5,2.23,"0-1","0-1",16,2,10,2,1,1,0,0,4,3,18,8,1,7,26,"4-3","N","N","N",2,0,18
"3629","T1",2024-01-06,"Samsunspor","Karagumruk",1,0,"H",0,0,"D",2.13,3.54,3.61,"0-0","1-0",12,4,7,1,2,3,0,0,3,5,22,14,1,8,36,"3-5","N","N","N",5,0,18
"3630","T1",2024-01-07,"Kayserispor","Sivasspor",1,3,"A",1,1,"D",2.02,3.61,3.91,"1-1","1-3",15,3,10,5,4,3,0,0,7,7,8,11,4,14,19,"7-7","Y","Y","Y",7,0,18
"3631","T1",2024-01-07,"Istanbulspor","Fenerbahce",1,5,"A",1,4,"A",12.53,7.23,1.22,"1-4","1-5",15,8,23,15,3,1,0,0,4,8,12,13,6,12,25,"4-8","Y","Y","Y",4,0,18
"3632","T1",2024-01-07,"Galatasaray","Konyaspor",3,0,"H",0,0,"D",1.26,6.42,11.68,"0-0","3-0",27,9,7,4,3,3,0,0,13,3,20,14,3,16,34,"13-3","Y","Y","N",6,0,18
"3633","T1",2024-01-09,"Alanyaspor","Ankaragucu",1,1,"D",0,0,"D",2.26,3.39,3.45,"0-0","1-1",8,3,11,3,3,2,1,1,3,3,10,10,2,6,20,"3-3","Y","N","N",5,2,18
"3634","T1",2024-01-09,"Pendikspor","Antalyaspor",0,1,"A",0,1,"A",3.02,3.54,2.42,"0-1","0-1",14,3,12,2,2,4,0,0,5,7,10,16,1,12,26,"5-7","N","N","N",6,0,19
"3635","T1",2024-01-09,"Kasimpasa","Buyuksehyr",0,3,"A",0,1,"A",2.4,3.58,3.02,"0-1","0-3",15,1,7,5,2,1,0,0,6,3,16,12,3,9,28,"6-3","Y","Y","N",3,0,19
"3636","T1",2024-01-09,"Rizespor","Besiktas",0,4,"A",0,2,"A",2.38,3.59,3.04,"0-2","0-4",28,7,15,7,3,1,0,0,10,5,10,15,4,15,25,"10-5","Y","Y","Y",4,0,19
"3637","T1",2024-01-10,"Hatayspor","Gaziantep",0,0,"D",0,0,"D",2.06,3.59,3.78,"0-0","0-0",14,7,7,2,3,0,0,0,5,5,14,4,0,10,18,"5-5","N","N","N",3,0,19
"3638","T1",2024-01-10,"Karagumruk","Kayserispor",4,1,"H",3,1,"H",2.16,3.65,3.44,"3-1","4-1",15,10,14,6,0,2,0,0,5,3,9,6,5,8,15,"5-3","Y","Y","Y",2,0,19
"3639","T1",2024-01-10,"Ad. Demirspor","Istanbulspor",2,2,"D",1,0,"H",1.35,5.8,8.56,"1-0","2-2",18,7,13,5,0,3,0,0,7,7,6,15,4,14,21,"7-7","Y","Y","Y",3,0,19
"3640","T1",2024-01-10,"Fenerbahce","Konyaspor",7,1,"H",5,0,"H",1.23,6.8,13.26,"5-0","7-1",17,11,6,1,1,2,0,0,7,0,14,8,8,7,22,"7-0","Y","Y","Y",3,0,19
"3641","T1",2024-01-11,"Sivasspor","Galatasaray",1,1,"D",0,1,"A",6.91,4.64,1.49,"0-1","1-1",14,5,21,8,0,3,0,1,4,8,9,21,2,12,30,"4-8","Y","N","N",3,1,19
"3642","T1",2024-01-11,"Trabzonspor","Samsunspor",2,1,"H",2,0,"H",1.72,3.97,5.06,"2-0","2-1",13,7,19,8,3,1,0,0,5,1,12,19,3,6,31,"5-1","Y","Y","N",4,0,19
"3643","T1",2024-01-13,"Ankaragucu","Kasimpasa",3,1,"H",1,1,"D",2.16,3.74,3.36,"1-1","3-1",12,8,16,2,1,1,0,0,2,5,14,15,4,7,29,"2-5","Y","Y","Y",2,0,19
"3644","T1",2024-01-13,"Hatayspor","Pendikspor",1,1,"D",0,0,"D",2.2,3.56,3.42,"0-0","1-1",8,4,12,2,4,1,0,0,4,6,8,10,2,10,18,"4-6","Y","N","N",5,0,20
"3645","T1",2024-01-13,"Buyuksehyr","Alanyaspor",3,2,"H",2,1,"H",1.96,3.46,4.35,"2-1","3-2",11,6,13,3,1,1,0,0,4,3,19,12,5,7,31,"4-3","Y","Y","Y",2,0,20
"3646","T1",2024-01-13,"Besiktas","Karagumruk",3,0,"H",0,0,"D",1.66,4.17,5.28,"0-0","3-0",19,6,7,3,3,0,0,0,6,4,17,9,3,10,26,"6-4","Y","Y","N",3,0,20
"3647","T1",2024-01-13,"Rizespor","Ad. Demirspor",1,0,"H",0,0,"D",2.22,3.92,3.1,"0-0","1-0",15,6,15,3,1,0,0,0,9,4,19,11,1,13,30,"9-4","N","N","N",1,0,20
"3648","T1",2024-01-14,"Istanbulspor","Konyaspor",0,0,"D",0,0,"D",3.47,3.67,2.14,"0-0","0-0",19,7,8,1,2,1,0,0,8,3,14,7,0,11,21,"8-3","N","N","N",3,0,20
"3649","T1",2024-01-14,"Antalyaspor","Trabzonspor",1,1,"D",0,1,"A",3.02,3.5,2.43,"0-1","1-1",14,3,4,2,1,0,0,0,6,2,17,9,2,8,26,"6-2","Y","N","N",1,0,20
"3650","T1",2024-01-14,"Samsunspor","Sivasspor",2,0,"H",2,0,"H",2.24,3.34,3.54,"2-0","2-0",16,10,6,2,5,0,1,1,5,2,22,10,2,7,32,"5-2","Y","N","N",5,2,20
"3651","T1",2024-01-14,"Gaziantep","Fenerbahce",0,1,"A",0,0,"D",8.7,5.57,1.36,"0-0","0-1",5,4,17,6,3,2,0,0,4,10,14,8,1,14,22,"4-10","N","N","N",5,0,20
"3652","T1",2024-01-15,"Galatasaray","Kayserispor",2,1,"H",1,0,"H",1.28,6.67,8.88,"1-0","2-1",29,8,10,3,1,6,0,0,8,5,7,17,3,13,24,"8-5","Y","Y","N",7,0,20
