"","Div","Date","HomeTeam","AwayTeam","FTHG","FTAG","FTR","HTHG","HTAG","HTR","PSH","PSD","PSA","HTCS","CS","HS","HST","AS","AST","HY","AY","HR","AR","HCO","ACO","HF","AF","TG","TC","TF","COSC","OV15","OV25","OV35","TY","TR","all_matchday"
"2522","B1",2023-07-28,"St. Gilloise","Anderlecht",2,0,"H",1,0,"H",2.22,3.63,3.24,"1-0","2-0",10,3,5,2,5,3,0,0,3,3,16,13,2,6,29,"3-3","Y","N","N",8,0,1
"2523","B1",2023-07-29,"Eupen","Westerlo",2,2,"D",1,0,"H",3.56,3.56,2.12,"1-0","2-2",13,6,22,5,1,0,0,0,1,4,14,7,4,5,21,"1-4","Y","Y","Y",1,0,1
"2524","B1",2023-07-29,"Charleroi","Oud-Heverlee Leuven",1,1,"D",1,0,"H",2.03,3.73,3.65,"1-0","1-1",4,2,19,5,3,1,1,0,2,6,7,12,2,8,19,"2-6","Y","N","N",4,1,1
"2525","B1",2023-07-29,"RWD Molenbeek","Genk",0,4,"A",0,3,"A",3.67,3.9,1.98,"0-3","0-4",10,4,28,10,1,0,0,0,2,6,11,11,4,8,22,"2-6","Y","Y","Y",1,0,1
"2526","B1",2023-07-30,"Antwerp","Cercle Brugge",1,0,"H",1,0,"H",1.85,3.6,4.36,"1-0","1-0",15,4,8,1,0,2,0,0,7,7,15,13,1,14,28,"7-7","N","N","N",2,0,1
"2527","B1",2023-07-30,"Gent","Kortrijk",3,2,"H",2,1,"H",1.33,5.51,8.63,"2-1","3-2",17,4,10,3,1,4,0,0,7,5,5,9,5,12,14,"7-5","Y","Y","Y",5,0,1
"2528","B1",2023-07-30,"Club Brugge","Mechelen",1,1,"D",0,1,"A",1.47,4.68,6.33,"0-1","1-1",21,5,9,2,2,2,1,0,4,3,8,9,2,7,17,"4-3","Y","N","N",4,1,1
"2529","B1",2023-07-30,"St Truiden","Standard",1,0,"H",0,0,"D",2.71,3.27,2.71,"0-0","1-0",11,3,7,3,1,1,0,0,3,2,13,11,1,5,24,"3-2","N","N","N",2,0,1
"2530","B1",2023-08-04,"Standard","St. Gilloise",0,1,"A",0,1,"A",3.87,3.67,1.98,"0-1","0-1",8,3,24,8,4,1,1,0,2,13,9,12,1,15,21,"2-13","N","N","N",5,1,2
"2531","B1",2023-08-05,"Genk","Eupen",0,1,"A",0,1,"A",1.29,6.28,9.53,"0-1","0-1",28,3,5,2,1,2,0,0,7,2,11,11,1,9,22,"7-2","N","N","N",3,0,2
"2532","B1",2023-08-05,"Cercle Brugge","Charleroi",2,0,"H",2,0,"H",1.92,3.8,3.98,"2-0","2-0",19,3,8,3,0,3,0,0,4,5,11,13,2,9,24,"4-5","Y","N","N",3,0,2
"2533","B1",2023-08-05,"Oud-Heverlee Leuven","RWD Molenbeek",1,2,"A",1,1,"D",1.82,4.01,4.23,"1-1","1-2",18,5,15,4,4,1,0,0,15,6,14,18,3,21,32,"15-6","Y","Y","N",5,0,2
"2534","B1",2023-08-06,"Anderlecht","Antwerp",1,0,"H",1,0,"H",2.65,3.7,2.55,"1-0","1-0",9,2,5,3,1,1,0,0,3,6,9,19,1,9,28,"3-6","N","N","N",2,0,2
"2535","B1",2023-08-06,"Mechelen","Gent",0,1,"A",0,0,"D",3.78,4.04,1.87,"0-0","0-1",14,2,12,3,2,3,0,0,7,3,14,14,1,10,28,"7-3","N","N","N",5,0,2
"2536","B1",2023-08-06,"Westerlo","Club Brugge",0,1,"A",0,1,"A",3.69,3.7,1.98,"0-1","0-1",11,3,20,8,1,0,0,0,4,5,7,9,1,9,16,"4-5","N","N","N",1,0,2
"2537","B1",2023-08-06,"Kortrijk","St Truiden",0,1,"A",0,0,"D",2.85,3.35,2.53,"0-0","0-1",8,1,14,4,1,2,0,0,0,14,10,12,1,14,22,"0-14","N","N","N",3,0,2
"2538","B1",2023-08-11,"Antwerp","Kortrijk",6,0,"H",4,0,"H",1.26,6.31,11.17,"4-0","6-0",25,9,4,1,0,2,0,0,4,1,8,11,6,5,19,"4-1","Y","Y","Y",2,0,3
"2539","B1",2023-08-12,"RWD Molenbeek","Mechelen",1,0,"H",0,0,"D",2.25,3.89,3.01,"0-0","1-0",18,8,9,4,3,1,0,0,7,4,12,11,1,11,23,"7-4","N","N","N",4,0,3
"2540","B1",2023-08-12,"St. Gilloise","Oud-Heverlee Leuven",5,1,"H",2,1,"H",1.51,4.42,6.74,"2-1","5-1",16,9,4,1,1,4,0,0,0,3,10,15,6,3,25,"0-3","Y","Y","Y",5,0,3
"2541","B1",2023-08-13,"St Truiden","Anderlecht",0,1,"A",0,0,"D",3.46,3.45,2.15,"0-0","0-1",14,5,9,3,4,5,0,1,6,1,13,15,1,7,28,"6-1","N","N","N",9,1,3
"2542","B1",2023-08-13,"Cercle Brugge","Genk",0,1,"A",0,0,"D",2.72,3.73,2.45,"0-0","0-1",13,2,10,3,2,3,0,0,5,3,8,20,1,8,28,"5-3","N","N","N",5,0,3
"2543","B1",2023-08-13,"Eupen","Club Brugge",0,5,"A",0,3,"A",5.62,4.33,1.56,"0-3","0-5",9,1,13,7,0,2,0,0,4,6,9,13,5,10,22,"4-6","Y","Y","Y",2,0,3
"2544","B1",2023-08-13,"Charleroi","Standard",1,1,"D",0,1,"A",2.07,3.64,3.47,"0-1","1-1",18,3,7,2,3,2,1,1,13,2,11,12,2,15,23,"13-2","Y","N","N",5,2,3
"2545","B1",2023-08-13,"Westerlo","Gent",1,3,"A",1,1,"D",3.56,3.96,1.95,"1-1","1-3",14,4,18,9,1,1,0,0,4,10,10,14,4,14,24,"4-10","Y","Y","Y",2,0,3
"2546","B1",2023-08-18,"Oud-Heverlee Leuven","Antwerp",1,1,"D",0,1,"A",4.93,4.24,1.67,"0-1","1-1",10,2,13,4,4,2,1,0,7,7,16,10,2,14,26,"7-7","Y","N","N",6,1,4
"2547","B1",2023-08-19,"Standard","Cercle Brugge",0,1,"A",0,0,"D",2.94,3.55,2.43,"0-0","0-1",7,3,16,4,2,2,0,0,3,2,10,11,1,5,21,"3-2","N","N","N",4,0,4
"2548","B1",2023-08-19,"Mechelen","St. Gilloise",4,0,"H",1,0,"H",4.29,4.01,1.81,"1-0","4-0",10,7,14,1,0,2,0,0,4,6,9,10,4,10,19,"4-6","Y","Y","Y",2,0,4
"2549","B1",2023-08-20,"Anderlecht","Westerlo",2,1,"H",1,0,"H",1.92,3.59,4.13,"1-0","2-1",24,7,18,3,1,3,0,0,6,2,7,13,3,8,20,"6-2","Y","Y","N",4,0,4
"2550","B1",2023-08-20,"Genk","Charleroi",0,0,"D",0,0,"D",1.59,4.53,5.02,"0-0","0-0",23,7,7,3,0,0,0,0,11,4,11,13,0,15,24,"11-4","N","N","N",0,0,4
"2551","B1",2023-08-20,"Gent","St Truiden",2,2,"D",1,2,"A",1.44,4.89,6.52,"1-2","2-2",19,5,14,3,2,2,0,0,7,2,11,9,4,9,20,"7-2","Y","Y","Y",4,0,4
"2552","B1",2023-08-20,"Club Brugge","RWD Molenbeek",7,1,"H",2,1,"H",1.29,5.77,9.29,"2-1","7-1",23,9,9,3,0,1,0,0,8,3,10,12,8,11,22,"8-3","Y","Y","Y",1,0,4
"2553","B1",2023-08-20,"Kortrijk","Eupen",1,3,"A",0,0,"D",2.33,3.77,2.85,"0-0","1-3",13,4,15,8,5,4,1,0,5,9,15,15,4,14,30,"5-9","Y","Y","Y",9,1,4
"2554","B1",2023-08-26,"Westerlo","Mechelen",2,3,"A",2,0,"H",2.25,3.83,3.04,"2-0","2-3",11,4,17,5,0,3,0,0,5,4,8,9,5,9,17,"5-4","Y","Y","Y",3,0,5
"2555","B1",2023-08-26,"Eupen","Oud-Heverlee Leuven",3,1,"H",1,0,"H",3.02,3.81,2.27,"1-0","3-1",17,4,22,5,1,2,0,0,3,5,15,9,4,8,24,"3-5","Y","Y","Y",3,0,5
"2556","B1",2023-08-26,"Kortrijk","Standard",1,1,"D",1,0,"H",3,3.65,2.35,"1-0","1-1",19,6,23,6,0,2,0,0,7,10,7,12,2,17,19,"7-10","Y","N","N",2,0,5
"2557","B1",2023-08-27,"St Truiden","Cercle Brugge",0,2,"A",0,0,"D",3.19,3.38,2.3,"0-0","0-2",20,4,25,8,1,1,0,0,8,8,8,18,2,16,26,"8-8","Y","N","N",2,0,5
"2558","B1",2023-08-27,"Anderlecht","Charleroi",2,1,"H",1,0,"H",1.72,4.11,4.43,"1-0","2-1",15,8,18,5,0,2,0,0,4,7,12,16,3,11,28,"4-7","Y","Y","N",2,0,5
"2559","B1",2023-09-01,"Oud-Heverlee Leuven","Kortrijk",3,0,"H",1,0,"H",1.63,4.61,4.83,"1-0","3-0",20,9,13,7,1,3,0,0,4,1,10,14,3,5,24,"4-1","Y","Y","N",4,0,5
"2560","B1",2023-09-02,"Cercle Brugge","Westerlo",2,1,"H",1,0,"H",1.58,4.43,5.54,"1-0","2-1",21,6,7,1,0,1,0,0,14,1,16,16,3,15,32,"14-1","Y","Y","N",1,0,5
"2561","B1",2023-09-02,"Mechelen","Eupen",1,0,"H",0,0,"D",1.78,4.13,4.21,"0-0","1-0",22,6,9,1,0,1,0,0,6,4,10,13,1,10,23,"6-4","N","N","N",1,0,5
"2562","B1",2023-09-02,"Standard","RWD Molenbeek",1,1,"D",1,1,"D",2.07,3.56,3.7,"1-1","1-1",11,4,8,3,1,3,0,0,5,0,9,22,2,5,31,"5-0","Y","N","N",4,0,6
"2563","B1",2023-09-03,"Gent","Club Brugge",2,1,"H",1,1,"D",2.41,3.77,2.79,"1-1","2-1",14,4,14,7,2,0,1,0,5,6,14,12,3,11,26,"5-6","Y","Y","N",2,1,6
"2564","B1",2023-09-03,"St. Gilloise","Antwerp",2,2,"D",1,2,"A",2.34,3.22,3.27,"1-2","2-2",24,7,8,5,1,2,0,0,8,4,9,12,4,12,21,"8-4","Y","Y","Y",3,0,6
"2565","B1",2023-09-03,"Genk","Anderlecht",1,1,"D",0,0,"D",1.97,3.56,3.87,"0-0","1-1",12,4,8,4,5,6,1,0,7,7,6,15,2,14,21,"7-7","Y","N","N",11,1,6
"2566","B1",2023-09-03,"Charleroi","St Truiden",1,1,"D",0,0,"D",2.23,3.43,3.28,"0-0","1-1",18,5,8,5,2,0,0,1,3,5,12,6,2,8,18,"3-5","Y","N","N",2,1,6
"2567","B1",2023-09-15,"Westerlo","Antwerp",0,3,"A",0,1,"A",5.39,4.45,1.6,"0-1","0-3",9,2,15,4,3,0,0,0,4,5,13,9,3,9,22,"4-5","Y","Y","N",3,0,6
"2568","B1",2023-09-16,"RWD Molenbeek","Cercle Brugge",2,1,"H",1,1,"D",4.18,4.22,1.79,"1-1","2-1",10,5,15,4,3,3,0,0,5,4,18,12,3,9,30,"5-4","Y","Y","N",6,0,6
"2569","B1",2023-09-16,"St. Gilloise","Genk",0,2,"A",0,1,"A",2,3.85,3.63,"0-1","0-2",25,4,7,2,1,6,0,0,7,3,15,15,2,10,30,"7-3","Y","N","N",7,0,6
"2570","B1",2023-09-16,"Club Brugge","Charleroi",4,2,"H",2,2,"D",1.41,5.26,7.15,"2-2","4-2",25,10,14,8,2,3,0,0,5,5,8,6,6,10,14,"5-5","Y","Y","Y",5,0,7
"2571","B1",2023-09-17,"Eupen","Standard",1,3,"A",0,2,"A",3.08,3.37,2.36,"0-2","1-3",13,3,16,6,1,4,0,1,6,6,5,12,4,12,17,"6-6","Y","Y","Y",5,1,7
"2572","B1",2023-09-17,"Kortrijk","Anderlecht",2,2,"D",1,1,"D",4.66,4.22,1.68,"1-1","2-2",9,4,18,6,5,1,1,1,3,11,13,6,4,14,19,"3-11","Y","Y","Y",6,2,7
"2573","B1",2023-09-17,"Oud-Heverlee Leuven","Gent",1,1,"D",1,1,"D",4.4,4.13,1.73,"1-1","1-1",9,2,22,4,4,3,0,0,3,16,7,11,2,19,18,"3-16","Y","N","N",7,0,7
"2574","B1",2023-09-17,"St Truiden","Mechelen",2,0,"H",1,0,"H",2.45,3.44,2.9,"1-0","2-0",16,4,13,7,1,2,0,0,1,7,8,12,2,8,20,"1-7","Y","N","N",3,0,7
"2575","B1",2023-09-22,"Standard","Westerlo",0,0,"D",0,0,"D",1.83,4.25,3.92,"0-0","0-0",14,5,3,2,0,3,0,0,5,2,6,23,0,7,29,"5-2","N","N","N",3,0,7
"2576","B1",2023-09-23,"Charleroi","Kortrijk",1,0,"H",1,0,"H",1.65,4.34,5.05,"1-0","1-0",14,5,13,3,2,1,0,0,8,7,16,13,1,15,29,"8-7","N","N","N",3,0,7
"2577","B1",2023-09-23,"Mechelen","Oud-Heverlee Leuven",1,2,"A",0,2,"A",1.93,3.81,3.9,"0-2","1-2",16,4,15,8,5,3,0,0,6,6,12,7,3,12,19,"6-6","Y","Y","N",8,0,7
"2578","B1",2023-09-23,"Antwerp","RWD Molenbeek",0,0,"D",0,0,"D",1.33,5.63,8.62,"0-0","0-0",14,3,5,1,0,1,0,0,9,1,4,14,0,10,18,"9-1","N","N","N",1,0,8
"2579","B1",2023-09-24,"Genk","St Truiden",3,3,"D",0,3,"A",1.58,4.34,5.35,"0-3","3-3",20,7,16,6,2,4,0,0,5,1,17,11,6,6,28,"5-1","Y","Y","Y",6,0,8
"2580","B1",2023-09-24,"Cercle Brugge","St. Gilloise",0,2,"A",0,1,"A",2.88,3.53,2.42,"0-1","0-2",6,1,15,7,3,3,1,0,3,2,8,17,2,5,25,"3-2","Y","N","N",6,1,8
"2581","B1",2023-09-24,"Anderlecht","Club Brugge",1,1,"D",1,0,"H",2.91,3.74,2.31,"1-0","1-1",8,1,9,3,1,1,0,0,3,3,12,11,2,6,23,"3-3","Y","N","N",2,0,8
"2582","B1",2023-09-24,"Gent","Eupen",2,1,"H",0,1,"A",1.28,5.94,9.23,"0-1","2-1",13,6,14,3,1,4,1,0,3,7,9,16,3,10,25,"3-7","Y","Y","N",5,1,8
"2583","B1",2023-09-27,"Antwerp","Gent",0,0,"D",0,0,"D",2.12,3.7,3.42,"0-0","0-0",14,4,6,2,3,1,0,0,6,0,10,4,0,6,14,"6-0","N","N","N",4,0,8
"2584","B1",2023-09-28,"RWD Molenbeek","St. Gilloise",2,3,"A",2,2,"D",4.79,4.22,1.66,"2-2","2-3",10,7,16,8,2,3,0,0,3,8,8,14,5,11,22,"3-8","Y","Y","Y",5,0,8
"2585","B1",2023-09-28,"Club Brugge","Genk",1,1,"D",0,1,"A",1.79,4.03,4.16,"0-1","1-1",18,3,15,5,4,1,0,0,10,3,16,7,2,13,23,"10-3","Y","N","N",5,0,8
"2586","B1",2023-09-29,"Kortrijk","Cercle Brugge",2,1,"H",0,0,"D",4.68,4.39,1.68,"0-0","2-1",10,4,10,2,3,1,0,0,3,7,13,19,3,10,32,"3-7","Y","Y","N",4,0,9
"2587","B1",2023-09-30,"Eupen","Anderlecht",1,3,"A",1,1,"D",4.48,3.99,1.78,"1-1","1-3",9,3,20,6,1,0,0,0,2,4,11,15,4,6,26,"2-4","Y","Y","Y",1,0,9
"2588","B1",2023-09-30,"Oud-Heverlee Leuven","Standard",1,2,"A",0,1,"A",2.38,3.69,2.92,"0-1","1-2",11,5,14,3,2,1,0,0,6,3,10,11,3,9,21,"6-3","Y","Y","N",3,0,9
"2589","B1",2023-09-30,"Mechelen","Antwerp",0,0,"D",0,0,"D",3.93,3.8,1.93,"0-0","0-0",14,3,22,4,0,1,0,0,5,13,3,5,0,18,8,"5-13","N","N","N",1,0,9
"2590","B1",2023-10-01,"St. Gilloise","Charleroi",3,1,"H",3,1,"H",1.57,4.43,5.34,"3-1","3-1",17,7,4,3,1,2,0,0,8,7,13,13,4,15,26,"8-7","Y","Y","Y",3,0,9
"2591","B1",2023-10-01,"Genk","Westerlo",3,3,"D",2,1,"H",1.45,4.87,6.35,"2-1","3-3",18,6,10,7,2,2,1,0,4,7,7,12,6,11,19,"4-7","Y","Y","Y",4,1,9
"2592","B1",2023-10-01,"Club Brugge","St Truiden",1,1,"D",0,0,"D",1.38,5.12,7.61,"0-0","1-1",20,7,12,3,3,1,0,0,11,4,12,8,2,15,20,"11-4","Y","N","N",4,0,9
"2593","B1",2023-10-01,"RWD Molenbeek","Gent",1,1,"D",1,1,"D",4.5,4.23,1.69,"1-1","1-1",9,3,19,9,3,1,0,0,4,4,9,10,2,8,19,"4-4","Y","N","N",4,0,9
"2594","B1",2023-10-06,"Charleroi","RWD Molenbeek",2,1,"H",0,0,"D",1.91,3.88,3.95,"0-0","2-1",22,7,6,3,1,3,0,1,14,2,9,7,3,16,16,"14-2","Y","Y","N",4,1,10
"2595","B1",2023-10-07,"Cercle Brugge","Oud-Heverlee Leuven",3,2,"H",2,2,"D",1.62,4.4,5.2,"2-2","3-2",18,7,13,5,2,3,0,0,6,6,9,9,5,12,18,"6-6","Y","Y","Y",5,0,10
"2596","B1",2023-10-07,"Westerlo","Kortrijk",1,0,"H",1,0,"H",1.85,4.29,3.79,"1-0","1-0",13,4,13,3,2,4,0,0,1,10,15,10,1,11,25,"1-10","N","N","N",6,0,10
"2597","B1",2023-10-07,"Anderlecht","Mechelen",3,1,"H",1,0,"H",1.75,4.05,4.58,"1-0","3-1",19,9,13,3,2,3,0,0,8,1,14,10,4,9,24,"8-1","Y","Y","Y",5,0,10
"2598","B1",2023-10-08,"Standard","Club Brugge",2,1,"H",1,0,"H",4.92,4.2,1.66,"1-0","2-1",7,5,16,7,4,1,0,0,1,6,13,14,3,7,27,"1-6","Y","Y","N",5,0,10
"2599","B1",2023-10-08,"Antwerp","Eupen",4,1,"H",2,1,"H",1.23,6.64,10.66,"2-1","4-1",27,12,5,2,0,2,0,0,8,2,8,10,5,10,18,"8-2","Y","Y","Y",2,0,10
"2600","B1",2023-10-08,"Gent","Genk",1,1,"D",0,0,"D",2.05,3.76,3.42,"0-0","1-1",18,9,20,6,1,3,0,0,4,9,9,14,2,13,23,"4-9","Y","N","N",4,0,10
"2601","B1",2023-10-08,"St Truiden","St. Gilloise",0,4,"A",0,2,"A",4.22,3.82,1.82,"0-2","0-4",9,1,12,7,1,4,0,0,3,5,3,15,4,8,18,"3-5","Y","Y","Y",5,0,10
"2602","B1",2023-10-20,"St. Gilloise","Eupen",4,1,"H",2,0,"H",1.2,7.49,13.66,"2-0","4-1",21,11,6,1,0,3,0,1,3,1,14,14,5,4,28,"3-1","Y","Y","Y",3,1,11
"2603","B1",2023-10-21,"Kortrijk","Club Brugge",1,0,"H",1,0,"H",7.22,5.36,1.4,"1-0","1-0",6,2,18,4,4,2,0,0,1,9,14,9,1,10,23,"1-9","N","N","N",6,0,11
"2604","B1",2023-10-21,"RWD Molenbeek","Westerlo",1,1,"D",0,0,"D",2.39,3.67,2.92,"0-0","1-1",12,6,9,5,2,2,0,0,7,4,10,8,2,11,18,"7-4","Y","N","N",4,0,11
"2605","B1",2023-10-21,"Charleroi","Antwerp",3,2,"H",0,0,"D",3.43,3.57,2.16,"0-0","3-2",10,5,11,5,2,2,0,0,5,2,6,12,5,7,18,"5-2","Y","Y","Y",4,0,11
"2606","B1",2023-10-22,"Genk","Mechelen",4,0,"H",2,0,"H",1.54,4.67,5.72,"2-0","4-0",19,9,10,3,1,2,0,0,4,3,6,10,4,7,16,"4-3","Y","Y","Y",3,0,11
"2607","B1",2023-10-22,"Cercle Brugge","Gent",2,0,"H",0,0,"D",2.65,3.71,2.52,"0-0","2-0",16,5,10,4,3,2,0,1,6,7,17,15,2,13,32,"6-7","Y","N","N",5,1,11
"2608","B1",2023-10-22,"Standard","Anderlecht",3,2,"H",0,2,"A",3.14,3.47,2.29,"0-2","3-2",15,8,13,7,2,3,0,0,3,8,12,14,5,11,26,"3-8","Y","Y","Y",5,0,11
"2609","B1",2023-10-22,"Oud-Heverlee Leuven","St Truiden",4,0,"H",2,0,"H",2.24,3.58,3.13,"2-0","4-0",11,4,18,3,1,3,0,0,3,7,9,12,4,10,21,"3-7","Y","Y","Y",4,0,11
"2610","B1",2023-10-27,"St Truiden","RWD Molenbeek",2,1,"H",0,0,"D",1.87,3.78,4.25,"0-0","2-1",9,5,10,3,0,0,0,0,4,0,9,7,3,4,16,"4-0","Y","Y","N",0,0,12
"2611","B1",2023-10-28,"Mechelen","Cercle Brugge",0,2,"A",0,0,"D",3.25,3.91,2.13,"0-0","0-2",11,7,22,4,1,3,0,0,8,3,13,15,2,11,28,"8-3","Y","N","N",4,0,12
"2612","B1",2023-10-28,"Eupen","Charleroi",2,0,"H",1,0,"H",3.54,3.77,2.06,"1-0","2-0",8,5,17,5,3,2,0,0,4,8,11,13,2,12,24,"4-8","Y","N","N",5,0,12
"2613","B1",2023-10-28,"Anderlecht","Oud-Heverlee Leuven",5,1,"H",2,1,"H",1.51,4.63,6.35,"2-1","5-1",18,9,13,7,1,1,0,0,5,1,13,13,6,6,26,"5-1","Y","Y","Y",2,0,12
"2614","B1",2023-10-29,"Club Brugge","Antwerp",2,1,"H",1,0,"H",1.98,3.77,3.63,"1-0","2-1",11,5,8,2,4,1,0,0,3,3,11,9,3,6,20,"3-3","Y","Y","N",5,0,12
"2615","B1",2023-10-29,"Westerlo","St. Gilloise",1,3,"A",1,1,"D",4.9,4.29,1.63,"1-1","1-3",12,4,22,7,1,1,0,0,5,8,11,10,4,13,21,"5-8","Y","Y","Y",2,0,12
"2616","B1",2023-10-29,"Gent","Standard",3,1,"H",3,0,"H",1.64,4.24,4.94,"3-0","3-1",18,9,12,7,2,2,0,0,4,4,16,15,4,8,31,"4-4","Y","Y","Y",4,0,12
"2617","B1",2023-10-29,"Kortrijk","Genk",0,3,"A",0,0,"D",5.98,4.69,1.49,"0-0","0-3",12,3,15,9,3,2,0,0,8,5,10,16,3,13,26,"8-5","Y","Y","N",5,0,12
"2618","B1",2023-11-03,"St Truiden","Eupen",1,1,"D",1,0,"H",1.65,4.2,5.18,"1-0","1-1",16,4,5,1,1,1,0,0,5,1,10,13,2,6,23,"5-1","Y","N","N",2,0,13
"2619","B1",2023-11-04,"RWD Molenbeek","Kortrijk",1,1,"D",1,1,"D",1.93,3.86,3.77,"1-1","1-1",9,5,5,2,3,1,0,0,4,2,14,7,2,6,21,"4-2","Y","N","N",4,0,13
"2620","B1",2023-11-04,"Oud-Heverlee Leuven","Westerlo",0,2,"A",0,0,"D",2.1,3.81,3.3,"0-0","0-2",10,2,10,6,3,7,0,0,7,7,11,13,2,14,24,"7-7","Y","N","N",10,0,13
"2621","B1",2023-11-04,"Antwerp","Genk",3,2,"H",3,1,"H",2.19,3.77,3.2,"3-1","3-2",14,5,17,8,3,4,0,0,5,5,13,12,5,10,25,"5-5","Y","Y","Y",7,0,13
"2622","B1",2023-11-05,"Cercle Brugge","Anderlecht",0,3,"A",0,2,"A",2.52,3.63,2.77,"0-2","0-3",16,2,7,5,2,3,0,0,7,1,14,13,3,8,27,"7-1","Y","Y","N",5,0,13
"2623","B1",2023-11-05,"Standard","Mechelen",1,1,"D",1,0,"H",1.69,4.08,4.71,"1-0","1-1",10,4,11,4,1,4,0,0,10,1,10,19,2,11,29,"10-1","Y","N","N",5,0,13
"2624","B1",2023-11-05,"St. Gilloise","Club Brugge",2,1,"H",1,0,"H",2.31,3.7,2.93,"1-0","2-1",19,6,5,2,3,4,0,0,9,4,11,6,3,13,17,"9-4","Y","Y","N",7,0,13
"2625","B1",2023-11-05,"Charleroi","Gent",1,3,"A",0,1,"A",3.39,3.68,2.09,"0-1","1-3",11,3,17,9,3,0,0,0,0,6,5,4,4,6,9,"0-6","Y","Y","Y",3,0,13
"2626","B1",2023-11-10,"Westerlo","St Truiden",3,3,"D",2,1,"H",2.65,3.52,2.69,"2-1","3-3",17,4,10,7,3,2,0,0,9,3,11,13,6,12,24,"9-3","Y","Y","Y",5,0,14
"2627","B1",2023-11-11,"Antwerp","Standard",6,0,"H",4,0,"H",1.63,4.28,5.29,"4-0","6-0",15,9,2,0,2,2,0,0,6,2,13,10,6,8,23,"6-2","Y","Y","Y",4,0,14
"2628","B1",2023-11-11,"Eupen","RWD Molenbeek",1,3,"A",1,1,"D",2.6,3.62,2.68,"1-1","1-3",11,4,20,10,1,4,0,0,8,5,12,14,4,13,26,"8-5","Y","Y","Y",5,0,14
"2629","B1",2023-11-11,"Mechelen","Charleroi",1,0,"H",0,0,"D",2.71,3.65,2.56,"0-0","1-0",19,7,6,3,2,1,0,1,8,2,11,10,1,10,21,"8-2","N","N","N",3,1,14
"2630","B1",2023-11-12,"Club Brugge","Cercle Brugge",0,0,"D",0,0,"D",1.72,4.09,4.47,"0-0","0-0",14,7,20,3,2,5,0,0,10,3,11,12,0,13,23,"10-3","N","N","N",7,0,14
"2631","B1",2023-11-12,"Genk","Oud-Heverlee Leuven",3,1,"H",1,0,"H",1.39,5.53,6.66,"1-0","3-1",18,6,6,3,2,4,0,0,3,2,14,19,4,5,33,"3-2","Y","Y","Y",6,0,14
"2632","B1",2023-11-12,"Gent","Anderlecht",1,1,"D",1,1,"D",2.19,3.63,3.2,"1-1","1-1",10,5,7,2,1,2,0,0,8,3,12,10,2,11,22,"8-3","Y","N","N",3,0,14
"2633","B1",2023-11-12,"St. Gilloise","Kortrijk",3,0,"H",2,0,"H",1.2,7.29,12.28,"2-0","3-0",18,8,11,1,2,1,0,0,6,6,10,9,3,12,19,"6-6","Y","Y","N",3,0,14
"2634","B1",2023-11-24,"St Truiden","Antwerp",1,1,"D",1,0,"H",4.1,3.67,1.93,"1-0","1-1",11,5,12,1,2,2,0,0,4,7,8,11,2,11,19,"4-7","Y","N","N",4,0,15
"2635","B1",2023-11-25,"Cercle Brugge","Eupen",2,0,"H",0,0,"D",1.38,5.15,7.14,"0-0","2-0",30,10,6,4,4,3,0,0,5,3,12,13,2,8,25,"5-3","Y","N","N",7,0,15
"2636","B1",2023-11-25,"Charleroi","Westerlo",3,2,"H",0,1,"A",1.85,3.79,4.12,"0-1","3-2",14,4,11,4,3,2,0,0,5,4,15,11,5,9,26,"5-4","Y","Y","Y",5,0,15
"2637","B1",2023-11-25,"Standard","Genk",1,0,"H",0,0,"D",3.7,3.89,1.93,"0-0","1-0",13,4,11,2,2,2,0,0,5,5,20,12,1,10,32,"5-5","N","N","N",4,0,15
"2638","B1",2023-11-26,"Gent","St. Gilloise",1,1,"D",1,0,"H",2.59,3.6,2.55,"1-0","1-1",11,3,12,4,2,3,0,0,5,8,8,14,2,13,22,"5-8","Y","N","N",5,0,15
"2639","B1",2023-11-26,"Oud-Heverlee Leuven","Club Brugge",0,1,"A",0,1,"A",4.37,4.2,1.68,"0-1","0-1",10,3,14,6,4,2,0,0,7,6,19,13,1,13,32,"7-6","N","N","N",6,0,15
"2640","B1",2023-11-26,"Anderlecht","RWD Molenbeek",2,1,"H",0,1,"A",1.39,4.87,7.22,"0-1","2-1",25,8,7,2,1,4,0,1,10,1,6,12,3,11,18,"10-1","Y","Y","N",5,1,15
"2641","B1",2023-11-26,"Kortrijk","Mechelen",0,3,"A",0,2,"A",3.01,3.4,2.34,"0-2","0-3",15,3,10,5,2,2,0,0,4,3,12,12,3,7,24,"4-3","Y","Y","N",4,0,15
"2642","B1",2023-12-01,"Westerlo","Anderlecht",1,3,"A",0,1,"A",5.13,3.88,1.71,"0-1","1-3",23,7,26,10,0,0,0,0,7,2,3,11,4,9,14,"7-2","Y","Y","Y",0,0,16
"2643","B1",2023-12-02,"RWD Molenbeek","Charleroi",0,0,"D",0,0,"D",2.88,3.4,2.55,"0-0","0-0",10,4,18,8,0,2,0,0,3,10,4,8,0,13,12,"3-10","N","N","N",2,0,16
"2644","B1",2023-12-02,"Eupen","Kortrijk",1,1,"D",0,0,"D",2.28,3.67,3.09,"0-0","1-1",14,3,14,3,1,1,0,0,7,11,14,10,2,18,24,"7-11","Y","N","N",2,0,16
"2645","B1",2023-12-02,"Antwerp","Oud-Heverlee Leuven",1,0,"H",1,0,"H",1.34,5.81,8.32,"1-0","1-0",18,5,10,4,0,3,0,0,7,6,6,9,1,13,15,"7-6","N","N","N",3,0,16
"2646","B1",2023-12-03,"Genk","Gent",2,2,"D",1,1,"D",2.21,3.75,3.19,"1-1","2-2",13,6,17,6,2,2,0,0,1,9,15,12,4,10,27,"1-9","Y","Y","Y",4,0,16
"2647","B1",2023-12-03,"Mechelen","St Truiden",0,2,"A",0,2,"A",2.22,3.38,3.36,"0-2","0-2",6,5,13,5,1,2,0,0,1,5,10,8,2,6,18,"1-5","Y","N","N",3,0,16
"2648","B1",2023-12-03,"Club Brugge","Standard",2,0,"H",1,0,"H",1.45,4.97,6.21,"1-0","2-0",13,5,7,2,2,2,0,0,4,3,13,10,2,7,23,"4-3","Y","N","N",4,0,16
"2649","B1",2023-12-03,"St. Gilloise","Cercle Brugge",2,1,"H",2,1,"H",1.65,4.06,5.14,"2-1","2-1",12,6,13,6,1,3,0,0,5,4,13,15,3,9,28,"5-4","Y","Y","N",4,0,16
"1449","D1",2023-08-18,"Werder Bremen","Bayern Munich",0,4,"A",0,1,"A",8.59,6.36,1.33,"0-1","0-4",6,1,25,10,2,1,0,0,0,6,16,11,4,6,27,"0-6","Y","Y","Y",3,0,1
"1450","D1",2023-08-19,"Augsburg","Mgladbach",4,4,"D",3,3,"D",2.74,3.78,2.51,"3-3","4-4",20,8,9,6,1,2,0,0,8,7,9,14,8,15,23,"8-7","Y","Y","Y",3,0,1
"1451","D1",2023-08-19,"Hoffenheim","Freiburg",1,2,"A",0,2,"A",2.43,3.67,2.92,"0-2","1-2",24,5,17,8,0,1,0,0,4,2,9,9,3,6,18,"4-2","Y","Y","N",1,0,1
"1452","D1",2023-08-19,"Leverkusen","RB Leipzig",3,2,"H",2,1,"H",2.5,3.61,2.85,"2-1","3-2",11,7,13,6,1,2,0,0,4,5,13,10,5,9,23,"4-5","Y","Y","Y",3,0,1
"1453","D1",2023-08-19,"Stuttgart","Bochum",5,0,"H",2,0,"H",1.7,4.25,4.78,"2-0","5-0",19,9,4,1,1,1,0,0,7,0,5,12,5,7,17,"7-0","Y","Y","Y",2,0,1
"1454","D1",2023-08-19,"Wolfsburg","Heidenheim",2,0,"H",2,0,"H",1.62,4.49,5.24,"2-0","2-0",18,8,13,1,3,0,0,0,1,7,10,9,2,8,19,"1-7","Y","N","N",3,0,1
"1455","D1",2023-08-19,"Dortmund","FC Koln",1,0,"H",0,0,"D",1.41,5.42,7.25,"0-0","1-0",12,2,11,4,1,0,0,0,6,3,13,11,1,9,24,"6-3","N","N","N",1,0,1
"1456","D1",2023-08-20,"Union Berlin","Mainz",4,1,"H",2,0,"H",2.02,3.5,4.02,"2-0","4-1",12,7,9,3,1,5,0,0,3,1,15,16,5,4,31,"3-1","Y","Y","Y",6,0,1
"1457","D1",2023-08-20,"Ein Frankfurt","Darmstadt",1,0,"H",1,0,"H",1.4,5.42,7.44,"1-0","1-0",10,4,11,2,2,3,0,0,7,3,9,14,1,10,23,"7-3","N","N","N",5,0,1
"1458","D1",2023-08-25,"RB Leipzig","Stuttgart",5,1,"H",0,1,"A",1.53,4.69,6.14,"0-1","5-1",20,11,8,3,1,1,0,0,4,4,12,10,6,8,22,"4-4","Y","Y","Y",2,0,2
"1459","D1",2023-08-26,"Bochum","Dortmund",1,1,"D",1,0,"H",6.63,5.36,1.44,"1-0","1-1",17,6,13,3,2,1,0,0,5,4,21,7,2,9,28,"5-4","Y","N","N",3,0,2
"1460","D1",2023-08-26,"Darmstadt","Union Berlin",1,4,"A",1,3,"A",3.94,3.42,2.08,"1-3","1-4",18,6,12,6,2,2,0,1,3,5,15,12,5,8,27,"3-5","Y","Y","Y",4,1,2
"1461","D1",2023-08-26,"FC Koln","Wolfsburg",1,2,"A",0,0,"D",2.41,3.53,3.04,"0-0","1-2",14,2,9,6,1,5,0,0,6,1,6,10,3,7,16,"6-1","Y","Y","N",6,0,2
"1462","D1",2023-08-26,"Freiburg","Werder Bremen",1,0,"H",0,0,"D",1.72,4.15,4.76,"0-0","1-0",23,6,16,2,2,2,0,0,5,5,9,8,1,10,17,"5-5","N","N","N",4,0,2
"1463","D1",2023-08-26,"Heidenheim","Hoffenheim",2,3,"A",1,0,"H",2.96,3.81,2.34,"1-0","2-3",19,9,16,6,1,5,0,0,10,6,13,9,5,16,22,"10-6","Y","Y","Y",6,0,2
"1464","D1",2023-08-26,"Mgladbach","Leverkusen",0,3,"A",0,2,"A",3.73,4.2,1.91,"0-2","0-3",13,2,24,10,2,3,0,0,5,8,7,8,3,13,15,"5-8","Y","Y","N",5,0,2
"1465","D1",2023-08-27,"Mainz","Ein Frankfurt",1,1,"D",1,0,"H",2.39,3.74,2.92,"1-0","1-1",13,7,8,2,3,4,0,1,5,4,23,12,2,9,35,"5-4","Y","N","N",7,1,2
"1466","D1",2023-08-27,"Bayern Munich","Augsburg",3,1,"H",2,0,"H",1.09,14.24,22.48,"2-0","3-1",19,6,11,2,1,2,0,0,10,4,13,8,4,14,21,"10-4","Y","Y","Y",3,0,2
"1467","D1",2023-09-01,"Dortmund","Heidenheim",2,2,"D",2,0,"H",1.26,7.07,10.23,"2-0","2-2",20,9,15,6,3,3,0,0,3,6,9,22,4,9,31,"3-6","Y","Y","Y",6,0,3
"1468","D1",2023-09-02,"Augsburg","Bochum",2,2,"D",1,1,"D",2.09,3.67,3.61,"1-1","2-2",11,3,22,9,2,2,0,0,3,5,15,13,4,8,28,"3-5","Y","Y","Y",4,0,3
"1469","D1",2023-09-02,"Hoffenheim","Wolfsburg",3,1,"H",1,1,"D",2.48,3.86,2.73,"1-1","3-1",11,5,14,7,2,2,0,0,3,3,12,15,4,6,27,"3-3","Y","Y","Y",4,0,3
"1470","D1",2023-09-02,"Leverkusen","Darmstadt",5,1,"H",1,1,"D",1.2,7.79,13.72,"1-1","5-1",24,13,5,1,3,2,0,0,4,2,8,11,6,6,19,"4-2","Y","Y","Y",5,0,3
"1471","D1",2023-09-02,"Stuttgart","Freiburg",5,0,"H",3,0,"H",2.18,3.79,3.28,"3-0","5-0",13,6,11,5,1,1,0,0,2,4,9,10,5,6,19,"2-4","Y","Y","Y",2,0,3
"1472","D1",2023-09-02,"Werder Bremen","Mainz",4,0,"H",1,0,"H",2.76,3.55,2.61,"1-0","4-0",12,6,12,3,2,2,0,0,1,7,18,14,4,8,32,"1-7","Y","Y","Y",4,0,3
"1473","D1",2023-09-02,"Mgladbach","Bayern Munich",1,2,"A",1,0,"H",7.93,6.61,1.31,"1-0","1-2",8,3,25,9,0,2,0,0,1,15,5,20,3,16,25,"1-15","Y","Y","N",2,0,3
"1474","D1",2023-09-03,"Ein Frankfurt","FC Koln",1,1,"D",0,1,"A",2.18,3.49,3.54,"0-1","1-1",12,4,6,2,1,3,0,0,8,1,10,10,2,9,20,"8-1","Y","N","N",4,0,3
"1475","D1",2023-09-03,"Union Berlin","RB Leipzig",0,3,"A",0,0,"D",3.24,3.48,2.31,"0-0","0-3",4,1,15,8,3,1,1,0,3,7,16,9,3,10,25,"3-7","Y","Y","N",4,1,3
"1476","D1",2023-09-15,"Bayern Munich","Leverkusen",2,2,"D",1,1,"D",1.65,4.7,4.78,"1-1","2-2",15,9,12,5,0,3,0,0,7,4,6,6,4,11,12,"7-4","Y","Y","Y",3,0,4
"1477","D1",2023-09-16,"FC Koln","Hoffenheim",1,3,"A",0,2,"A",2.26,3.87,3.06,"0-2","1-3",17,7,17,5,4,4,1,0,13,4,15,14,4,17,29,"13-4","Y","Y","Y",8,1,4
"1478","D1",2023-09-16,"Freiburg","Dortmund",2,4,"A",2,1,"H",3.16,3.86,2.21,"2-1","2-4",14,4,14,6,2,3,1,0,6,8,12,16,6,14,28,"6-8","Y","Y","Y",5,1,4
"1479","D1",2023-09-16,"Mainz","Stuttgart",1,3,"A",0,0,"D",2.57,3.71,2.71,"0-0","1-3",15,3,16,6,1,2,0,0,6,4,12,9,4,10,21,"6-4","Y","Y","Y",3,0,4
"1480","D1",2023-09-16,"RB Leipzig","Augsburg",3,0,"H",3,0,"H",1.24,7.19,11.19,"3-0","3-0",9,6,16,4,0,0,0,0,1,6,16,12,3,7,28,"1-6","Y","Y","N",0,0,4
"1481","D1",2023-09-16,"Wolfsburg","Union Berlin",2,1,"H",2,1,"H",2.27,3.55,3.27,"2-1","2-1",8,3,17,5,1,0,0,0,3,7,6,8,3,10,14,"3-7","Y","Y","N",1,0,4
"1482","D1",2023-09-16,"Bochum","Ein Frankfurt",1,1,"D",0,0,"D",2.95,3.63,2.42,"0-0","1-1",24,10,8,6,3,2,0,0,8,2,13,14,2,10,27,"8-2","Y","N","N",5,0,4
"1483","D1",2023-09-17,"Heidenheim","Werder Bremen",4,2,"H",2,0,"H",2.39,3.88,2.85,"2-0","4-2",19,4,11,4,1,1,0,0,10,1,21,9,6,11,30,"10-1","Y","Y","Y",2,0,4
"1484","D1",2023-09-17,"Darmstadt","Mgladbach",3,3,"D",3,0,"H",3.01,3.74,2.34,"3-0","3-3",15,8,21,10,1,1,1,0,6,6,12,8,6,12,20,"6-6","Y","Y","Y",2,1,4
"1485","D1",2023-09-22,"Stuttgart","Darmstadt",3,1,"H",2,1,"H",1.4,5.24,8.18,"2-1","3-1",18,11,3,0,1,6,0,0,5,4,7,12,4,9,19,"5-4","Y","Y","Y",7,0,5
"1486","D1",2023-09-23,"Augsburg","Mainz",2,1,"H",2,1,"H",2.61,3.7,2.68,"2-1","2-1",6,3,13,3,2,3,1,0,3,4,16,14,3,7,30,"3-4","Y","Y","N",5,1,5
"1487","D1",2023-09-23,"Bayern Munich","Bochum",7,0,"H",4,0,"H",1.1,12.85,20.11,"4-0","7-0",26,16,4,1,0,1,0,0,8,1,8,10,7,9,18,"8-1","Y","Y","Y",1,0,5
"1488","D1",2023-09-23,"Dortmund","Wolfsburg",1,0,"H",0,0,"D",1.71,4.47,4.48,"0-0","1-0",18,4,8,2,0,1,0,0,5,3,9,14,1,8,23,"5-3","N","N","N",1,0,5
"1489","D1",2023-09-23,"Mgladbach","RB Leipzig",0,1,"A",0,0,"D",5.26,4.74,1.59,"0-0","0-1",13,1,8,4,1,1,0,0,11,6,14,7,1,17,21,"11-6","N","N","N",2,0,5
"1490","D1",2023-09-23,"Union Berlin","Hoffenheim",0,2,"A",0,2,"A",2.15,3.72,3.39,"0-2","0-2",22,6,11,4,1,3,0,0,11,6,11,13,2,17,24,"11-6","Y","N","N",4,0,5
"1491","D1",2023-09-23,"Werder Bremen","FC Koln",2,1,"H",1,1,"D",2.56,3.69,2.74,"1-1","2-1",17,6,13,5,2,1,0,0,9,8,18,16,3,17,34,"9-8","Y","Y","N",3,0,5
"1492","D1",2023-09-24,"Leverkusen","Heidenheim",4,1,"H",1,0,"H",1.23,7.35,11.42,"1-0","4-1",20,10,1,1,1,1,0,0,7,2,9,10,5,9,19,"7-2","Y","Y","Y",2,0,5
"1493","D1",2023-09-24,"Ein Frankfurt","Freiburg",0,0,"D",0,0,"D",2.16,3.66,3.42,"0-0","0-0",13,5,9,2,4,2,0,0,7,3,12,5,0,10,17,"7-3","N","N","N",6,0,5
"1494","D1",2023-09-29,"Hoffenheim","Dortmund",1,3,"A",1,2,"A",3.15,4.16,2.12,"1-2","1-3",15,5,6,5,3,4,0,1,4,3,14,16,4,7,30,"4-3","Y","Y","Y",7,1,6
"1495","D1",2023-09-30,"Bochum","Mgladbach",1,3,"A",0,3,"A",2.32,3.88,2.96,"0-3","1-3",23,5,25,9,2,3,0,0,5,10,12,12,4,15,24,"5-10","Y","Y","Y",5,0,6
"1496","D1",2023-09-30,"FC Koln","Stuttgart",0,2,"A",0,0,"D",2.89,3.64,2.46,"0-0","0-2",14,5,18,4,2,1,0,0,8,4,16,8,2,12,24,"8-4","Y","N","N",3,0,6
"1497","D1",2023-09-30,"Heidenheim","Union Berlin",1,0,"H",0,0,"D",3.05,3.72,2.32,"0-0","1-0",9,4,19,8,1,2,0,0,5,7,11,14,1,12,25,"5-7","N","N","N",3,0,6
"1498","D1",2023-09-30,"Mainz","Leverkusen",0,3,"A",0,1,"A",5.85,4.72,1.54,"0-1","0-3",10,3,6,3,4,1,0,0,3,1,13,11,3,4,24,"3-1","Y","Y","N",5,0,6
"1499","D1",2023-09-30,"Wolfsburg","Ein Frankfurt",2,0,"H",1,0,"H",2.11,3.53,3.68,"1-0","2-0",19,7,7,3,1,6,0,1,7,4,11,18,2,11,29,"7-4","Y","N","N",7,1,6
"1500","D1",2023-09-30,"RB Leipzig","Bayern Munich",2,2,"D",2,0,"H",3.73,4.2,1.91,"2-0","2-2",7,2,11,5,2,5,0,0,5,1,10,11,4,6,21,"5-1","Y","Y","Y",7,0,6
"1501","D1",2023-10-01,"Darmstadt","Werder Bremen",4,2,"H",2,0,"H",2.82,3.74,2.47,"2-0","4-2",14,5,10,7,3,2,0,0,2,4,19,19,6,6,38,"2-4","Y","Y","Y",5,0,6
"1502","D1",2023-10-01,"Freiburg","Augsburg",2,0,"H",1,0,"H",1.73,4.19,4.68,"1-0","2-0",7,3,13,4,2,2,0,0,2,3,13,17,2,5,30,"2-3","Y","N","N",4,0,6
"1503","D1",2023-10-06,"Mgladbach","Mainz",2,2,"D",1,1,"D",2.08,3.93,3.48,"1-1","2-2",20,9,13,7,3,1,0,0,10,3,9,9,4,13,18,"10-3","Y","Y","Y",4,0,7
"1504","D1",2023-10-07,"Augsburg","Darmstadt",1,2,"A",0,0,"D",1.92,3.9,3.98,"0-0","1-2",17,3,17,5,4,2,0,0,4,4,13,12,3,8,25,"4-4","Y","Y","N",6,0,7
"1505","D1",2023-10-07,"Dortmund","Union Berlin",4,2,"H",1,2,"A",1.61,4.51,5.28,"1-2","4-2",12,7,12,6,1,1,0,0,4,6,7,15,6,10,22,"4-6","Y","Y","Y",2,0,7
"1506","D1",2023-10-07,"RB Leipzig","Bochum",0,0,"D",0,0,"D",1.25,6.87,10.85,"0-0","0-0",18,5,9,2,2,4,0,0,9,1,10,13,0,10,23,"9-1","N","N","N",6,0,7
"1507","D1",2023-10-07,"Stuttgart","Wolfsburg",3,1,"H",0,1,"A",2.01,3.8,3.73,"0-1","3-1",13,7,12,5,1,3,0,0,5,6,13,14,4,11,27,"5-6","Y","Y","Y",4,0,7
"1508","D1",2023-10-07,"Werder Bremen","Hoffenheim",2,3,"A",1,2,"A",2.75,3.92,2.44,"1-2","2-3",13,3,11,4,5,4,0,0,4,4,15,6,5,8,21,"4-4","Y","Y","Y",9,0,7
"1509","D1",2023-10-08,"Leverkusen","FC Koln",3,0,"H",2,0,"H",1.34,5.68,9.07,"2-0","3-0",21,10,7,3,3,0,0,0,11,4,9,7,3,15,16,"11-4","Y","Y","N",3,0,7
"1510","D1",2023-10-08,"Bayern Munich","Freiburg",3,0,"H",2,0,"H",1.16,9.23,14.64,"2-0","3-0",21,5,2,0,1,0,0,0,7,1,7,8,3,8,15,"7-1","Y","Y","N",1,0,7
"1511","D1",2023-10-08,"Ein Frankfurt","Heidenheim",2,0,"H",1,0,"H",1.74,4.12,4.7,"1-0","2-0",12,6,7,2,2,3,0,0,3,6,14,10,2,9,24,"3-6","Y","N","N",5,0,7
"1512","D1",2023-10-20,"Dortmund","Werder Bremen",1,0,"H",0,0,"D",1.3,6.69,8.63,"0-0","1-0",22,5,6,1,1,5,0,0,10,4,5,10,1,14,15,"10-4","N","N","N",6,0,8
"1513","D1",2023-10-21,"Darmstadt","RB Leipzig",1,3,"A",1,2,"A",6.38,5.09,1.47,"1-2","1-3",16,3,10,7,6,3,0,0,6,0,16,12,4,6,28,"6-0","Y","Y","Y",9,0,8
"1514","D1",2023-10-21,"Freiburg","Bochum",2,1,"H",2,1,"H",1.76,4.02,4.73,"2-1","2-1",15,5,13,5,3,4,0,0,5,2,11,16,3,7,27,"5-2","Y","Y","N",7,0,8
"1515","D1",2023-10-21,"Hoffenheim","Ein Frankfurt",1,3,"A",1,3,"A",2.15,3.72,3.4,"1-3","1-3",14,5,13,5,3,0,0,0,6,3,7,7,4,9,14,"6-3","Y","Y","Y",3,0,8
"1516","D1",2023-10-21,"Union Berlin","Stuttgart",0,3,"A",0,1,"A",2.56,3.58,2.79,"0-1","0-3",10,2,10,5,2,1,0,0,4,2,12,12,3,6,24,"4-2","Y","Y","N",3,0,8
"1517","D1",2023-10-21,"Wolfsburg","Leverkusen",1,2,"A",1,1,"D",4.52,4.2,1.75,"1-1","1-2",18,7,13,6,3,5,0,0,4,3,15,14,3,7,29,"4-3","Y","Y","N",8,0,8
"1518","D1",2023-10-21,"Mainz","Bayern Munich",1,3,"A",1,2,"A",9.99,6.69,1.27,"1-2","1-3",14,3,12,5,3,2,0,0,2,7,12,10,4,9,22,"2-7","Y","Y","Y",5,0,8
"1519","D1",2023-10-22,"FC Koln","Mgladbach",3,1,"H",1,0,"H",2.37,3.77,2.93,"1-0","3-1",21,8,5,2,0,2,0,1,8,3,13,10,4,11,23,"8-3","Y","Y","Y",2,1,8
"1520","D1",2023-10-22,"Heidenheim","Augsburg",2,5,"A",2,3,"A",2.42,3.69,2.91,"2-3","2-5",16,5,9,6,3,2,0,0,6,5,11,11,7,11,22,"6-5","Y","Y","Y",5,0,8
"1521","D1",2023-10-27,"Bochum","Mainz",2,2,"D",1,0,"H",2.78,3.57,2.57,"1-0","2-2",10,4,10,4,3,3,0,0,5,4,14,21,4,9,35,"5-4","Y","Y","Y",6,0,9
"1522","D1",2023-10-28,"Augsburg","Wolfsburg",3,2,"H",1,2,"A",2.91,3.67,2.4,"1-2","3-2",9,5,13,6,6,4,1,0,5,5,19,14,5,10,33,"5-5","Y","Y","Y",10,1,9
"1523","D1",2023-10-28,"Bayern Munich","Darmstadt",8,0,"H",0,0,"D",1.07,16.22,27.11,"0-0","8-0",28,16,10,4,1,2,1,2,7,1,15,13,8,8,28,"7-1","Y","Y","Y",3,3,9
"1524","D1",2023-10-28,"Mgladbach","Heidenheim",2,1,"H",1,1,"D",1.8,4.26,4.16,"1-1","2-1",11,6,8,3,0,3,0,0,6,4,5,18,3,10,23,"6-4","Y","Y","N",3,0,9
"1525","D1",2023-10-28,"Stuttgart","Hoffenheim",2,3,"A",0,2,"A",1.88,4.15,3.82,"0-2","2-3",23,10,7,5,2,1,0,0,6,0,13,11,5,6,24,"6-0","Y","Y","Y",3,0,9
"1526","D1",2023-10-28,"Werder Bremen","Union Berlin",2,0,"H",1,0,"H",2.73,3.61,2.6,"1-0","2-0",9,3,7,2,1,4,0,1,3,3,12,14,2,6,26,"3-3","Y","N","N",5,1,9
"1527","D1",2023-10-28,"RB Leipzig","FC Koln",6,0,"H",4,0,"H",1.44,5.05,7.18,"4-0","6-0",24,13,6,1,2,4,0,1,11,1,8,13,6,12,21,"11-1","Y","Y","Y",6,1,9
"1528","D1",2023-10-29,"Ein Frankfurt","Dortmund",3,3,"D",2,1,"H",3.31,3.73,2.18,"2-1","3-3",11,7,14,4,3,2,0,0,0,4,11,10,6,4,21,"0-4","Y","Y","Y",5,0,9
"1529","D1",2023-10-29,"Leverkusen","Freiburg",2,1,"H",1,0,"H",1.29,6.08,10.27,"1-0","2-1",19,4,10,4,0,2,0,0,11,4,9,10,3,15,19,"11-4","Y","Y","N",2,0,9
"1530","D1",2023-11-03,"Darmstadt","Bochum",1,2,"A",1,1,"D",2.41,3.61,2.98,"1-1","1-2",15,4,9,4,2,5,1,0,11,2,7,16,3,13,23,"11-2","Y","Y","N",7,1,10
"1531","D1",2023-11-04,"FC Koln","Augsburg",1,1,"D",1,1,"D",2.32,3.75,2.97,"1-1","1-1",28,12,18,3,1,4,0,0,10,2,10,10,2,12,20,"10-2","Y","N","N",5,0,10
"1532","D1",2023-11-04,"Freiburg","Mgladbach",3,3,"D",1,3,"A",2.08,4,3.31,"1-3","3-3",15,8,10,5,2,2,0,0,8,2,7,10,6,10,17,"8-2","Y","Y","Y",4,0,10
"1533","D1",2023-11-04,"Hoffenheim","Leverkusen",2,3,"A",0,2,"A",4.92,4.9,1.59,"0-2","2-3",12,7,10,4,3,2,0,0,4,3,6,10,5,7,16,"4-3","Y","Y","Y",5,0,10
"1534","D1",2023-11-04,"Mainz","RB Leipzig",2,0,"H",0,0,"D",5.42,4.56,1.58,"0-0","2-0",10,3,10,2,3,1,0,0,2,7,13,9,2,9,22,"2-7","Y","N","N",4,0,10
"1535","D1",2023-11-04,"Union Berlin","Ein Frankfurt",0,3,"A",0,2,"A",2.57,3.21,3.01,"0-2","0-3",10,3,4,3,0,1,0,0,9,1,13,8,3,10,21,"9-1","Y","Y","N",1,0,10
"1536","D1",2023-11-04,"Dortmund","Bayern Munich",0,4,"A",0,2,"A",3.77,4.42,1.84,"0-2","0-4",15,1,14,8,3,2,0,0,3,2,14,6,4,5,20,"3-2","Y","Y","Y",5,0,10
"1537","D1",2023-11-05,"Wolfsburg","Werder Bremen",2,2,"D",1,1,"D",1.74,4.29,4.37,"1-1","2-2",15,5,13,4,4,1,1,0,5,2,14,17,4,7,31,"5-2","Y","Y","Y",5,1,10
"1538","D1",2023-11-05,"Heidenheim","Stuttgart",2,0,"H",0,0,"D",4.59,4.39,1.69,"0-0","2-0",19,2,14,2,2,2,0,0,9,6,7,13,2,15,20,"9-6","Y","N","N",4,0,10
"1539","D1",2023-11-10,"Mgladbach","Wolfsburg",4,0,"H",2,0,"H",2.41,3.75,2.89,"2-0","4-0",16,8,12,4,1,3,0,0,8,5,7,12,4,13,19,"8-5","Y","Y","Y",4,0,11
"1540","D1",2023-11-11,"Augsburg","Hoffenheim",1,1,"D",0,1,"A",2.62,3.92,2.52,"0-1","1-1",11,6,12,6,1,2,0,0,3,5,9,11,2,8,20,"3-5","Y","N","N",3,0,11
"1541","D1",2023-11-11,"Bayern Munich","Heidenheim",4,2,"H",2,0,"H",1.06,18.13,28.2,"2-0","4-2",18,8,7,2,1,0,0,0,7,2,8,8,6,9,16,"7-2","Y","Y","Y",1,0,11
"1542","D1",2023-11-11,"Darmstadt","Mainz",0,0,"D",0,0,"D",3.04,3.72,2.3,"0-0","0-0",9,3,9,0,3,3,0,0,0,5,20,15,0,5,35,"0-5","N","N","N",6,0,11
"1543","D1",2023-11-11,"Stuttgart","Dortmund",2,1,"H",1,1,"D",2.61,3.85,2.56,"1-1","2-1",22,10,5,1,2,3,0,0,6,1,13,16,3,7,29,"6-1","Y","Y","N",5,0,11
"1544","D1",2023-11-11,"Bochum","FC Koln",1,1,"D",1,0,"H",2.46,3.7,2.81,"1-0","1-1",25,9,10,6,4,1,0,0,3,3,14,19,2,6,33,"3-3","Y","N","N",5,0,11
"1545","D1",2023-11-12,"Leverkusen","Union Berlin",4,0,"H",1,0,"H",1.29,6.09,10.4,"1-0","4-0",19,10,2,2,0,1,0,0,10,1,8,5,4,11,13,"10-1","Y","Y","Y",1,0,11
"1546","D1",2023-11-12,"Werder Bremen","Ein Frankfurt",2,2,"D",1,0,"H",3.01,3.6,2.36,"1-0","2-2",14,5,14,3,1,3,0,0,3,7,3,10,4,10,13,"3-7","Y","Y","Y",4,0,11
"1547","D1",2023-11-12,"RB Leipzig","Freiburg",3,1,"H",1,1,"D",1.46,4.96,6.59,"1-1","3-1",15,6,9,3,2,0,0,0,7,3,10,12,4,10,22,"7-3","Y","Y","Y",2,0,11
"1548","D1",2023-11-24,"FC Koln","Bayern Munich",0,1,"A",0,1,"A",10.64,6.78,1.25,"0-1","0-1",6,2,19,5,0,1,0,0,3,12,6,4,1,15,10,"3-12","N","N","N",1,0,12
"1549","D1",2023-11-25,"Dortmund","Mgladbach",4,2,"H",3,2,"H",1.48,5.38,5.62,"3-2","4-2",20,13,10,3,1,2,0,0,5,4,11,11,6,9,22,"5-4","Y","Y","Y",3,0,12
"1550","D1",2023-11-25,"Freiburg","Darmstadt",1,1,"D",1,1,"D",1.57,4.42,5.65,"1-1","1-1",16,3,7,1,2,0,0,0,11,2,15,15,2,13,30,"11-2","Y","N","N",2,0,12
"1551","D1",2023-11-25,"Union Berlin","Augsburg",1,1,"D",0,1,"A",2.01,3.65,3.79,"0-1","1-1",16,6,11,2,2,2,0,0,3,4,10,15,2,7,25,"3-4","Y","N","N",4,0,12
"1552","D1",2023-11-25,"Werder Bremen","Leverkusen",0,3,"A",0,2,"A",6.3,5.25,1.45,"0-2","0-3",2,1,13,4,3,1,0,0,1,6,15,4,3,7,19,"1-6","Y","Y","N",4,0,12
"1553","D1",2023-11-25,"Wolfsburg","RB Leipzig",2,1,"H",1,0,"H",3.79,3.97,1.93,"1-0","2-1",10,4,26,10,4,2,0,0,1,12,18,11,3,13,29,"1-12","Y","Y","N",6,0,12
"1554","D1",2023-11-25,"Ein Frankfurt","Stuttgart",1,2,"A",1,2,"A",2.65,3.7,2.6,"1-2","1-2",14,1,11,5,0,1,0,0,4,2,14,8,3,6,22,"4-2","Y","Y","N",1,0,12
"1555","D1",2023-11-26,"Heidenheim","Bochum",0,0,"D",0,0,"D",2.23,3.81,3.09,"0-0","0-0",9,3,9,2,4,3,0,0,6,5,14,7,0,11,21,"6-5","N","N","N",7,0,12
"1556","D1",2023-11-26,"Hoffenheim","Mainz",1,1,"D",0,1,"A",1.85,4.08,4.01,"0-1","1-1",15,6,15,6,4,4,0,0,4,5,9,14,2,9,23,"4-5","Y","N","N",8,0,12
"1557","D1",2023-12-01,"Darmstadt","FC Koln",0,1,"A",0,0,"D",2.66,3.54,2.71,"0-0","0-1",11,1,11,6,1,3,0,0,1,6,12,12,1,7,24,"1-6","N","N","N",4,0,13
"1558","D1",2023-12-02,"Bochum","Wolfsburg",3,1,"H",2,1,"H",2.67,3.6,2.62,"2-1","3-1",19,9,15,6,6,2,0,0,6,6,14,13,4,12,27,"6-6","Y","Y","Y",8,0,13
"1559","D1",2023-12-02,"Mgladbach","Hoffenheim",2,1,"H",0,0,"D",2.26,4.13,2.87,"0-0","2-1",9,3,17,5,2,2,0,0,6,3,12,14,3,9,26,"6-3","Y","Y","N",4,0,13
"1560","D1",2023-12-02,"RB Leipzig","Heidenheim",2,1,"H",2,1,"H",1.24,7.2,10.19,"2-1","2-1",23,8,7,1,2,2,0,0,5,3,13,16,3,8,29,"5-3","Y","Y","N",4,0,13
"1561","D1",2023-12-02,"Stuttgart","Werder Bremen",2,0,"H",1,0,"H",1.4,5.24,7.66,"1-0","2-0",17,6,11,3,1,0,0,0,6,7,7,9,2,13,16,"6-7","Y","N","N",1,0,13
"1562","D1",2023-12-03,"Mainz","Freiburg",0,1,"A",0,0,"D",2.29,3.56,3.16,"0-0","0-1",19,6,13,5,1,1,0,0,14,3,16,11,1,17,27,"14-3","N","N","N",2,0,13
"1563","D1",2023-12-03,"Leverkusen","Dortmund",1,1,"D",0,1,"A",1.68,4.46,4.59,"0-1","1-1",22,6,6,2,3,2,0,0,16,1,12,12,2,17,24,"16-1","Y","N","N",5,0,13
"1564","D1",2023-12-03,"Augsburg","Ein Frankfurt",2,1,"H",1,0,"H",2.69,3.6,2.61,"1-0","2-1",9,4,12,6,1,1,0,0,2,4,9,10,3,6,19,"2-4","Y","Y","N",2,0,13
"1565","D2",2023-07-28,"Hamburg","Schalke 04",5,3,"H",1,2,"A",2.43,3.81,2.83,"1-2","5-3",31,14,11,6,3,3,0,1,9,3,10,13,8,12,23,"9-3","Y","Y","Y",6,1,1
"1566","D2",2023-07-29,"Hannover","Elversberg",2,2,"D",1,2,"A",2.12,3.88,3.34,"1-2","2-2",10,4,23,9,3,4,0,0,3,6,5,18,4,9,23,"3-6","Y","Y","Y",7,0,1
"1567","D2",2023-07-29,"Kaiserslautern","St Pauli",1,2,"A",0,0,"D",3.19,3.5,2.33,"0-0","1-2",10,3,14,5,2,1,0,0,3,5,11,10,3,8,21,"3-5","Y","Y","N",3,0,1
"1568","D2",2023-07-29,"Osnabruck","Karlsruhe",2,3,"A",1,2,"A",2.94,3.75,2.38,"1-2","2-3",18,7,14,8,3,2,1,0,4,9,11,9,5,13,20,"4-9","Y","Y","Y",5,1,1
"1569","D2",2023-07-29,"Wehen","Magdeburg",1,1,"D",0,1,"A",2.91,3.8,2.37,"0-1","1-1",9,1,11,3,2,3,1,0,3,2,10,18,2,5,28,"3-2","Y","N","N",5,1,1
"1570","D2",2023-07-29,"Fortuna Dusseldorf","Hertha",1,0,"H",0,0,"D",2.32,3.59,3.13,"0-0","1-0",9,2,12,4,3,2,0,0,7,8,13,11,1,15,24,"7-8","N","N","N",5,0,1
"1571","D2",2023-07-30,"Braunschweig","Holstein Kiel",0,1,"A",0,0,"D",2.66,3.83,2.56,"0-0","0-1",9,2,15,4,3,1,1,0,4,10,10,13,1,14,23,"4-10","N","N","N",4,1,1
"1572","D2",2023-07-30,"Greuther Furth","Paderborn",5,0,"H",3,0,"H",2.46,3.71,2.85,"3-0","5-0",24,11,7,0,1,1,0,1,5,2,9,5,5,7,14,"5-2","Y","Y","Y",2,1,1
"1573","D2",2023-07-30,"Hansa Rostock","Nurnberg",2,0,"H",1,0,"H",2.62,3.23,2.97,"1-0","2-0",14,4,18,7,3,4,0,0,6,6,15,13,2,12,28,"6-6","Y","N","N",7,0,1
"1574","D2",2023-08-04,"Hertha","Wehen",0,1,"A",0,0,"D",1.57,4.43,5.89,"0-0","0-1",21,8,12,5,2,3,0,0,6,4,9,9,1,10,18,"6-4","N","N","N",5,0,2
"1575","D2",2023-08-04,"Paderborn","Osnabruck",1,1,"D",0,0,"D",1.6,4.38,5.68,"0-0","1-1",15,5,15,5,1,0,0,0,7,7,11,12,2,14,23,"7-7","Y","N","N",1,0,2
"1576","D2",2023-08-05,"Elversberg","Hansa Rostock",1,2,"A",0,0,"D",2.15,3.72,3.4,"0-0","1-2",13,4,17,5,3,4,0,0,7,2,12,15,3,9,27,"7-2","Y","Y","N",7,0,2
"1577","D2",2023-08-05,"Holstein Kiel","Greuther Furth",2,1,"H",0,0,"D",2.47,3.85,2.75,"0-0","2-1",9,4,15,2,2,2,0,0,8,5,14,16,3,13,30,"8-5","Y","Y","N",4,0,2
"1578","D2",2023-08-05,"St Pauli","Fortuna Dusseldorf",0,0,"D",0,0,"D",1.97,3.73,3.96,"0-0","0-0",13,5,10,3,2,1,1,0,4,8,11,8,0,12,19,"4-8","N","N","N",3,1,2
"1579","D2",2023-08-05,"Schalke 04","Kaiserslautern",3,0,"H",1,0,"H",1.69,4.07,5.12,"1-0","3-0",16,8,10,4,1,3,0,2,8,7,14,12,3,15,26,"8-7","Y","Y","N",4,2,2
"1580","D2",2023-08-06,"Karlsruhe","Hamburg",2,2,"D",1,0,"H",2.87,4.16,2.28,"1-0","2-2",17,4,13,7,3,2,0,0,7,3,6,14,4,10,20,"7-3","Y","Y","Y",5,0,2
"1581","D2",2023-08-06,"Magdeburg","Braunschweig",2,1,"H",2,0,"H",1.81,4.06,4.35,"2-0","2-1",14,5,9,4,1,3,0,0,1,5,7,20,3,6,27,"1-5","Y","Y","N",4,0,2
"1582","D2",2023-08-06,"Nurnberg","Hannover",2,2,"D",0,2,"A",2.39,3.64,2.99,"0-2","2-2",8,3,19,6,6,2,0,0,5,7,20,14,4,12,34,"5-7","Y","Y","Y",8,0,2
"1583","D2",2023-08-18,"Kaiserslautern","Elversberg",3,2,"H",1,0,"H",2.32,3.65,3.09,"1-0","3-2",20,8,21,9,3,1,0,0,4,6,11,12,5,10,23,"4-6","Y","Y","Y",4,0,3
"1584","D2",2023-08-18,"Wehen","Karlsruhe",1,0,"H",1,0,"H",3.07,3.82,2.27,"1-0","1-0",11,4,15,7,3,1,0,0,2,7,14,2,1,9,16,"2-7","N","N","N",4,0,3
"1585","D2",2023-08-19,"Fortuna Dusseldorf","Paderborn",1,2,"A",0,1,"A",2.11,3.94,3.32,"0-1","1-2",26,6,10,6,0,3,0,0,12,1,6,20,3,13,26,"12-1","Y","Y","N",3,0,3
"1586","D2",2023-08-19,"Greuther Furth","St Pauli",0,0,"D",0,0,"D",2.66,3.59,2.68,"0-0","0-0",16,2,6,1,1,5,0,0,2,1,11,17,0,3,28,"2-1","N","N","N",6,0,3
"1587","D2",2023-08-19,"Hansa Rostock","Hannover",1,2,"A",0,1,"A",2.63,3.63,2.69,"0-1","1-2",10,2,8,2,3,1,0,0,4,5,13,11,3,9,24,"4-5","Y","Y","N",4,0,3
"1588","D2",2023-08-19,"Hamburg","Hertha",3,0,"H",2,0,"H",1.9,4.17,3.79,"2-0","3-0",27,7,11,2,2,2,0,0,4,2,10,7,3,6,17,"4-2","Y","Y","N",4,0,3
"1589","D2",2023-08-20,"Braunschweig","Schalke 04",1,0,"H",1,0,"H",3.61,3.87,2.03,"1-0","1-0",17,6,11,3,3,0,1,0,6,4,15,12,1,10,27,"6-4","N","N","N",3,1,3
"1590","D2",2023-08-20,"Holstein Kiel","Magdeburg",2,4,"A",1,2,"A",2.45,3.82,2.8,"1-2","2-4",17,8,18,10,1,2,0,0,6,3,23,12,6,9,35,"6-3","Y","Y","Y",3,0,3
"1591","D2",2023-08-20,"Osnabruck","Nurnberg",2,3,"A",0,1,"A",2.6,3.4,2.86,"0-1","2-3",15,3,20,7,2,2,0,0,3,12,13,8,5,15,21,"3-12","Y","Y","Y",4,0,3
"1592","D2",2023-08-25,"Paderborn","Kaiserslautern",1,2,"A",0,0,"D",2.21,3.84,3.17,"0-0","1-2",15,5,12,3,2,5,0,0,1,2,17,12,3,3,29,"1-2","Y","Y","N",7,0,4
"1593","D2",2023-08-25,"Schalke 04","Holstein Kiel",0,2,"A",0,1,"A",1.95,4.19,3.61,"0-1","0-2",13,4,14,5,1,1,1,0,3,7,11,13,2,10,24,"3-7","Y","N","N",2,1,4
"1594","D2",2023-08-26,"Elversberg","Fortuna Dusseldorf",0,5,"A",0,3,"A",2.86,3.87,2.38,"0-3","0-5",13,4,15,8,1,3,0,0,8,6,6,9,5,14,15,"8-6","Y","Y","Y",4,0,4
"1595","D2",2023-08-26,"Hansa Rostock","Osnabruck",2,1,"H",1,1,"D",2.12,3.7,3.49,"1-1","2-1",12,5,13,3,3,0,0,0,4,5,17,10,3,9,27,"4-5","Y","Y","N",3,0,4
"1596","D2",2023-08-26,"Hertha","Greuther Furth",5,0,"H",2,0,"H",2.55,3.71,2.73,"2-0","5-0",14,7,17,6,1,1,0,0,5,8,18,9,5,13,27,"5-8","Y","Y","Y",2,0,4
"1597","D2",2023-08-26,"Hannover","Hamburg",0,1,"A",0,0,"D",3.42,4.12,2.03,"0-0","0-1",19,5,11,4,1,4,0,1,3,3,13,13,1,6,26,"3-3","N","N","N",5,1,4
"1598","D2",2023-08-27,"Karlsruhe","Braunschweig",2,0,"H",1,0,"H",1.76,4.3,4.36,"1-0","2-0",22,9,9,0,1,1,0,1,6,4,11,4,2,10,15,"6-4","Y","N","N",2,1,4
"1599","D2",2023-08-27,"Nurnberg","Wehen",2,1,"H",0,0,"D",2.09,3.68,3.59,"0-0","2-1",13,4,15,2,2,6,1,2,10,6,12,17,3,16,29,"10-6","Y","Y","N",8,3,4
"1600","D2",2023-08-27,"St Pauli","Magdeburg",0,0,"D",0,0,"D",1.96,3.96,3.76,"0-0","0-0",26,12,5,2,2,3,0,0,11,3,9,9,0,14,18,"11-3","N","N","N",5,0,4
"1601","D2",2023-09-01,"Braunschweig","St Pauli",1,1,"D",0,0,"D",4.04,3.76,1.94,"0-0","1-1",9,1,19,5,2,3,0,0,3,5,11,11,2,8,22,"3-5","Y","N","N",5,0,5
"1602","D2",2023-09-01,"Fortuna Dusseldorf","Karlsruhe",3,1,"H",1,1,"D",2.25,3.89,3.06,"1-1","3-1",19,5,10,8,1,3,0,0,7,7,8,10,4,14,18,"7-7","Y","Y","Y",4,0,5
"1603","D2",2023-09-02,"Holstein Kiel","Paderborn",2,1,"H",1,1,"D",2.32,4.18,2.8,"1-1","2-1",19,6,13,2,3,3,0,0,6,8,9,9,3,14,18,"6-8","Y","Y","N",6,0,5
"1604","D2",2023-09-02,"Magdeburg","Hertha",6,4,"H",2,3,"A",2.31,4,2.9,"2-3","6-4",23,12,12,7,2,3,0,0,4,3,6,9,10,7,15,"4-3","Y","Y","Y",5,0,5
"1605","D2",2023-09-02,"Wehen","Schalke 04",1,1,"D",0,0,"D",3.32,3.88,2.13,"0-0","1-1",14,3,15,5,4,2,0,0,3,7,17,10,2,10,27,"3-7","Y","N","N",6,0,5
"1606","D2",2023-09-02,"Kaiserslautern","Nurnberg",3,1,"H",3,1,"H",2.24,3.73,3.19,"3-1","3-1",12,4,18,4,1,2,0,1,4,7,12,14,4,11,26,"4-7","Y","Y","Y",3,1,5
"1607","D2",2023-09-03,"Greuther Furth","Hannover",1,3,"A",0,2,"A",2.04,4.12,3.38,"0-2","1-3",19,5,6,5,1,2,0,0,9,2,11,11,4,11,22,"9-2","Y","Y","Y",3,0,5
"1608","D2",2023-09-03,"Hamburg","Hansa Rostock",2,0,"H",1,0,"H",1.52,4.94,5.86,"1-0","2-0",17,11,7,3,2,5,0,0,3,5,14,15,2,8,29,"3-5","Y","N","N",7,0,5
"1609","D2",2023-09-03,"Osnabruck","Elversberg",0,1,"A",0,0,"D",2.44,3.98,2.73,"0-0","0-1",9,4,10,2,1,2,0,0,6,2,16,13,1,8,29,"6-2","N","N","N",3,0,5
"1610","D2",2023-09-15,"Nurnberg","Greuther Furth",1,1,"D",1,1,"D",2.7,3.62,2.62,"1-1","1-1",18,4,9,2,2,3,0,0,6,5,14,17,2,11,31,"6-5","Y","N","N",5,0,6
"1611","D2",2023-09-15,"Paderborn","Wehen",2,1,"H",0,1,"A",1.77,4.21,4.39,"0-1","2-1",17,7,12,5,3,2,0,0,5,1,14,12,3,6,26,"5-1","Y","Y","N",5,0,6
"1612","D2",2023-09-16,"Elversberg","Hamburg",2,1,"H",1,0,"H",4.2,4.49,1.76,"1-0","2-1",16,7,13,6,3,2,0,0,7,6,12,9,3,13,21,"7-6","Y","Y","N",5,0,6
"1613","D2",2023-09-16,"Hansa Rostock","Fortuna Dusseldorf",1,3,"A",1,2,"A",3.36,3.51,2.25,"1-2","1-3",23,4,20,5,2,2,0,0,10,8,11,9,4,18,20,"10-8","Y","Y","Y",4,0,6
"1614","D2",2023-09-16,"Karlsruhe","Kaiserslautern",1,1,"D",1,1,"D",2.08,3.8,3.51,"1-1","1-1",19,6,14,7,0,1,0,0,9,3,10,14,2,12,24,"9-3","Y","N","N",1,0,6
"1615","D2",2023-09-16,"Schalke 04","Magdeburg",4,3,"H",1,2,"A",2.21,3.95,3.1,"1-2","4-3",19,9,12,6,4,4,0,1,9,4,22,12,7,13,34,"9-4","Y","Y","Y",8,1,6
"1616","D2",2023-09-17,"Hannover","Osnabruck",7,0,"H",2,0,"H",1.88,4.02,4.03,"2-0","7-0",24,15,6,3,0,2,0,1,5,3,13,9,7,8,22,"5-3","Y","Y","Y",2,1,6
"1617","D2",2023-09-17,"Hertha","Braunschweig",3,0,"H",2,0,"H",1.63,4.45,5.15,"2-0","3-0",15,8,14,4,2,0,0,0,4,9,11,11,3,13,22,"4-9","Y","Y","N",2,0,6
"1618","D2",2023-09-17,"St Pauli","Holstein Kiel",5,1,"H",3,0,"H",1.89,3.91,4.08,"3-0","5-1",18,7,13,4,3,3,0,0,3,1,13,16,6,4,29,"3-1","Y","Y","Y",6,0,6
"1619","D2",2023-09-22,"Magdeburg","Paderborn",1,1,"D",0,1,"A",2.21,4.05,3.04,"0-1","1-1",11,3,14,4,4,1,0,0,2,6,14,12,2,8,26,"2-6","Y","N","N",5,0,7
"1620","D2",2023-09-22,"Osnabruck","Hamburg",2,1,"H",2,1,"H",4.5,4.74,1.67,"2-1","2-1",18,9,8,3,5,6,0,0,13,7,10,15,3,20,25,"13-7","Y","Y","N",11,0,7
"1621","D2",2023-09-23,"Braunschweig","Nurnberg",2,2,"D",1,2,"A",2.94,3.68,2.41,"1-2","2-2",14,5,11,5,2,2,0,0,2,3,17,15,4,5,32,"2-3","Y","Y","Y",4,0,7
"1622","D2",2023-09-23,"Greuther Furth","Karlsruhe",4,3,"H",3,3,"D",2.27,3.89,3.03,"3-3","4-3",9,6,17,5,3,5,1,0,9,4,10,12,7,13,22,"9-4","Y","Y","Y",8,1,7
"1623","D2",2023-09-23,"Wehen","Elversberg",0,2,"A",0,1,"A",2.67,3.82,2.55,"0-1","0-2",16,3,13,5,4,4,0,0,7,3,13,17,2,10,30,"7-3","Y","N","N",8,0,7
"1624","D2",2023-09-23,"St Pauli","Schalke 04",3,1,"H",1,1,"D",1.89,3.73,4.28,"1-1","3-1",19,8,10,3,1,4,0,0,4,2,3,19,4,6,22,"4-2","Y","Y","Y",5,0,7
"1625","D2",2023-09-24,"Fortuna Dusseldorf","Hannover",1,1,"D",0,1,"A",1.93,4.12,3.7,"0-1","1-1",17,5,6,2,2,3,0,0,5,2,7,10,2,7,17,"5-2","Y","N","N",5,0,7
"1626","D2",2023-09-24,"Holstein Kiel","Hertha",2,3,"A",0,2,"A",2.75,3.68,2.55,"0-2","2-3",16,5,11,7,4,3,1,0,2,4,19,13,5,6,32,"2-4","Y","Y","Y",7,1,7
"1627","D2",2023-09-24,"Kaiserslautern","Hansa Rostock",3,1,"H",2,1,"H",2.11,3.39,3.83,"2-1","3-1",22,11,18,2,2,2,0,0,6,10,9,15,4,16,24,"6-10","Y","Y","Y",4,0,7
"1628","D2",2023-09-29,"Hamburg","Fortuna Dusseldorf",1,0,"H",0,0,"D",2.11,4.16,3.18,"0-0","1-0",10,4,8,2,3,6,0,1,8,3,10,14,1,11,24,"8-3","N","N","N",9,1,8
"1629","D2",2023-09-29,"Paderborn","Schalke 04",3,1,"H",1,0,"H",2.28,3.85,3.04,"1-0","3-1",11,6,13,2,1,3,0,0,2,10,10,9,4,12,19,"2-10","Y","Y","Y",4,0,8
"1630","D2",2023-09-30,"Hannover","Wehen",2,0,"H",1,0,"H",1.71,4.35,4.6,"1-0","2-0",17,5,12,3,0,2,0,0,4,6,13,15,2,10,28,"4-6","Y","N","N",2,0,8
"1631","D2",2023-09-30,"Hansa Rostock","Braunschweig",1,0,"H",0,0,"D",2.03,3.73,3.75,"0-0","1-0",19,6,20,0,3,1,0,0,7,5,20,10,1,12,30,"7-5","N","N","N",4,0,8
"1632","D2",2023-09-30,"Karlsruhe","Holstein Kiel",0,2,"A",0,2,"A",2.1,4.04,3.29,"0-2","0-2",14,4,12,5,0,4,0,0,7,9,4,16,2,16,20,"7-9","Y","N","N",4,0,8
"1633","D2",2023-09-30,"Hertha","St Pauli",1,2,"A",0,1,"A",2.71,3.68,2.59,"0-1","1-2",8,3,24,5,2,0,0,0,7,3,11,5,3,10,16,"7-3","Y","Y","N",2,0,8
"1634","D2",2023-10-01,"Elversberg","Greuther Furth",1,1,"D",1,1,"D",2.48,3.94,2.7,"1-1","1-1",11,4,15,5,1,1,0,0,2,8,13,19,2,10,32,"2-8","Y","N","N",2,0,8
"1635","D2",2023-10-01,"Nurnberg","Magdeburg",1,0,"H",0,0,"D",2.67,3.78,2.57,"0-0","1-0",16,6,13,1,6,5,0,0,7,3,14,21,1,10,35,"7-3","N","N","N",11,0,8
"1636","D2",2023-10-01,"Osnabruck","Kaiserslautern",2,2,"D",2,1,"H",2.77,3.67,2.54,"2-1","2-2",9,4,32,13,4,3,0,0,4,13,15,13,4,17,28,"4-13","Y","Y","Y",7,0,8
"1637","D2",2023-10-06,"Fortuna Dusseldorf","Osnabruck",1,1,"D",0,0,"D",1.59,4.64,5.36,"0-0","1-1",19,4,9,3,5,3,0,0,8,1,13,11,2,9,24,"8-1","Y","N","N",8,0,9
"1638","D2",2023-10-06,"Kaiserslautern","Hannover",3,1,"H",1,1,"D",2.34,3.62,3.08,"1-1","3-1",16,11,11,4,4,2,0,1,5,2,13,17,4,7,30,"5-2","Y","Y","Y",6,1,9
"1639","D2",2023-10-07,"Greuther Furth","Hansa Rostock",1,0,"H",1,0,"H",1.8,3.89,4.6,"1-0","1-0",9,4,8,2,1,7,0,0,8,2,11,16,1,10,27,"8-2","N","N","N",8,0,9
"1640","D2",2023-10-07,"Magdeburg","Karlsruhe",1,1,"D",0,1,"A",2.3,4.05,2.89,"0-1","1-1",19,5,2,2,3,2,0,0,7,1,4,12,2,8,16,"7-1","Y","N","N",5,0,9
"1641","D2",2023-10-07,"Wehen","Hamburg",1,1,"D",0,0,"D",4.61,4.6,1.68,"0-0","1-1",6,2,23,5,2,2,0,0,4,13,11,3,2,17,14,"4-13","Y","N","N",4,0,9
"1642","D2",2023-10-07,"St Pauli","Nurnberg",5,1,"H",1,1,"D",1.61,4.32,5.6,"1-1","5-1",20,7,7,3,4,1,0,0,8,4,7,11,6,12,18,"8-4","Y","Y","Y",5,0,9
"1643","D2",2023-10-08,"Braunschweig","Paderborn",1,3,"A",1,2,"A",3.13,3.86,2.22,"1-2","1-3",24,4,11,6,3,0,0,0,13,4,9,9,4,17,18,"13-4","Y","Y","Y",3,0,9
"1644","D2",2023-10-08,"Holstein Kiel","Elversberg",1,1,"D",1,0,"H",2.15,4.11,3.13,"1-0","1-1",23,7,9,4,1,1,0,0,11,2,13,16,2,13,29,"11-2","Y","N","N",2,0,9
"1645","D2",2023-10-08,"Schalke 04","Hertha",1,2,"A",0,1,"A",2.3,4.04,2.89,"0-1","1-2",16,6,16,4,2,3,1,0,11,5,15,14,3,16,29,"11-5","Y","Y","N",5,1,9
"1646","D2",2023-10-20,"Elversberg","Braunschweig",3,0,"H",2,0,"H",1.9,4.14,3.84,"2-0","3-0",13,7,7,4,0,1,0,0,6,1,12,9,3,7,21,"6-1","Y","Y","N",1,0,10
"1647","D2",2023-10-20,"Hannover","Magdeburg",2,1,"H",1,0,"H",2.16,3.95,3.21,"1-0","2-1",14,4,13,8,2,3,0,0,6,9,9,14,3,15,23,"6-9","Y","Y","N",5,0,10
"1648","D2",2023-10-21,"Hamburg","Greuther Furth",2,0,"H",2,0,"H",1.68,4.52,4.68,"2-0","2-0",17,4,14,3,2,4,0,0,6,7,12,12,2,13,24,"6-7","Y","N","N",6,0,10
"1649","D2",2023-10-21,"Osnabruck","Wehen",0,2,"A",0,1,"A",2.31,3.64,3.13,"0-1","0-2",19,5,14,5,3,1,0,0,2,3,14,17,2,5,31,"2-3","Y","N","N",4,0,10
"1650","D2",2023-10-21,"Paderborn","St Pauli",2,2,"D",1,0,"H",3.21,3.95,2.16,"1-0","2-2",6,3,17,3,0,1,0,0,3,6,7,11,4,9,18,"3-6","Y","Y","Y",1,0,10
"1651","D2",2023-10-21,"Fortuna Dusseldorf","Kaiserslautern",4,3,"H",1,3,"A",1.91,3.91,4,"1-3","4-3",20,5,16,8,4,1,0,0,6,5,12,8,7,11,20,"6-5","Y","Y","Y",5,0,10
"1652","D2",2023-10-22,"Hansa Rostock","Holstein Kiel",1,3,"A",1,1,"D",2.83,3.59,2.53,"1-1","1-3",22,9,10,5,1,4,0,1,9,2,13,14,4,11,27,"9-2","Y","Y","Y",5,1,10
"1653","D2",2023-10-22,"Karlsruhe","Schalke 04",3,0,"H",2,0,"H",2.4,3.79,2.88,"2-0","3-0",12,5,9,3,1,1,0,0,7,5,13,13,3,12,26,"7-5","Y","Y","N",2,0,10
"1654","D2",2023-10-22,"Nurnberg","Hertha",3,1,"H",0,1,"A",2.77,3.77,2.49,"0-1","3-1",18,7,14,6,3,2,1,1,11,5,13,11,4,16,24,"11-5","Y","Y","Y",5,2,10
"1655","D2",2023-10-27,"Braunschweig","Fortuna Dusseldorf",1,4,"A",0,2,"A",4.01,3.97,1.89,"0-2","1-4",16,5,12,6,2,1,0,0,8,4,12,6,5,12,18,"8-4","Y","Y","Y",3,0,11
"1656","D2",2023-10-27,"Greuther Furth","Osnabruck",4,0,"H",1,0,"H",1.76,4.32,4.32,"1-0","4-0",13,6,5,2,0,3,0,0,10,1,15,15,4,11,30,"10-1","Y","Y","Y",3,0,11
"1657","D2",2023-10-28,"Hertha","Paderborn",3,1,"H",2,0,"H",2.25,3.95,3.02,"2-0","3-1",11,5,16,6,5,1,1,0,3,9,13,14,4,12,27,"3-9","Y","Y","Y",6,1,11
"1658","D2",2023-10-28,"Schalke 04","Hannover",3,2,"H",1,0,"H",2.34,4.06,2.82,"1-0","3-2",11,6,14,3,4,1,0,0,4,5,15,15,5,9,30,"4-5","Y","Y","Y",5,0,11
"1659","D2",2023-10-28,"St Pauli","Karlsruhe",2,1,"H",0,1,"A",1.66,4.36,5.01,"0-1","2-1",20,9,6,3,1,2,0,0,7,3,10,10,3,10,20,"7-3","Y","Y","N",3,0,11
"1660","D2",2023-10-28,"Kaiserslautern","Hamburg",3,3,"D",2,1,"H",3.07,3.96,2.23,"2-1","3-3",13,5,20,9,1,4,0,0,3,4,8,15,6,7,23,"3-4","Y","Y","Y",5,0,11
"1661","D2",2023-10-29,"Holstein Kiel","Nurnberg",0,2,"A",0,0,"D",2.11,3.89,3.37,"0-0","0-2",14,1,21,5,2,4,0,0,7,3,12,8,2,10,20,"7-3","Y","N","N",6,0,11
"1662","D2",2023-10-29,"Magdeburg","Elversberg",1,2,"A",0,2,"A",2.13,3.92,3.29,"0-2","1-2",18,5,8,4,2,2,0,0,5,3,12,14,3,8,26,"5-3","Y","Y","N",4,0,11
"1663","D2",2023-10-29,"Wehen","Hansa Rostock",1,0,"H",0,0,"D",2.33,3.51,3.19,"0-0","1-0",16,6,16,4,1,0,0,0,9,11,7,9,1,20,16,"9-11","N","N","N",1,0,11
"1664","D2",2023-11-03,"Elversberg","St Pauli",0,2,"A",0,2,"A",3.65,3.88,2.01,"0-2","0-2",7,2,10,4,2,1,0,0,6,3,10,7,2,9,17,"6-3","Y","N","N",3,0,12
"1665","D2",2023-11-03,"Fortuna Dusseldorf","Wehen",1,3,"A",0,3,"A",1.58,4.67,5.46,"0-3","1-3",25,7,11,5,4,5,0,0,6,6,14,6,4,12,20,"6-6","Y","Y","Y",9,0,12
"1666","D2",2023-11-04,"Kaiserslautern","Greuther Furth",0,2,"A",0,1,"A",2.15,3.72,3.4,"0-1","0-2",18,2,13,6,3,2,1,0,9,3,8,13,2,12,21,"9-3","Y","N","N",5,1,12
"1667","D2",2023-11-04,"Nurnberg","Schalke 04",1,2,"A",0,1,"A",2.25,3.84,3.09,"0-1","1-2",15,4,11,4,4,2,0,0,4,7,9,18,3,11,27,"4-7","Y","Y","N",6,0,12
"1668","D2",2023-11-04,"Osnabruck","Holstein Kiel",1,1,"D",0,0,"D",2.91,3.88,2.35,"0-0","1-1",14,4,16,9,1,3,0,0,6,5,19,15,2,11,34,"6-5","Y","N","N",4,0,12
"1669","D2",2023-11-04,"Hamburg","Magdeburg",2,0,"H",1,0,"H",1.57,5.02,5.15,"1-0","2-0",16,7,13,4,1,2,0,1,4,6,18,10,2,10,28,"4-6","Y","N","N",3,1,12
"1670","D2",2023-11-05,"Hannover","Braunschweig",2,0,"H",2,0,"H",1.59,4.51,5.56,"2-0","2-0",12,6,0,0,2,7,0,1,2,5,10,13,2,7,23,"2-5","Y","N","N",9,1,12
"1671","D2",2023-11-05,"Hansa Rostock","Hertha",0,0,"D",0,0,"D",3.06,3.68,2.33,"0-0","0-0",8,2,16,2,2,2,0,0,7,5,17,11,0,12,28,"7-5","N","N","N",4,0,12
"1672","D2",2023-11-05,"Karlsruhe","Paderborn",0,3,"A",0,1,"A",2.19,3.77,3.27,"0-1","0-3",16,7,11,5,4,1,0,0,2,3,10,10,3,5,20,"2-3","Y","Y","N",5,0,12
"1673","D2",2023-11-10,"Schalke 04","Elversberg",1,2,"A",1,2,"A",2.14,3.86,3.3,"1-2","1-2",22,3,13,5,3,2,0,0,8,2,11,11,3,10,22,"8-2","Y","Y","N",5,0,13
"1674","D2",2023-11-10,"St Pauli","Hannover",0,0,"D",0,0,"D",1.66,4.14,5.31,"0-0","0-0",13,2,2,0,2,4,0,0,7,1,12,15,0,8,27,"7-1","N","N","N",6,0,13
"1675","D2",2023-11-11,"Braunschweig","Osnabruck",3,2,"H",1,1,"D",2.32,3.56,3.16,"1-1","3-2",16,8,6,3,3,5,0,1,4,4,18,12,5,8,30,"4-4","Y","Y","Y",8,1,13
"1676","D2",2023-11-11,"Holstein Kiel","Hamburg",4,2,"H",1,0,"H",3.43,4.03,2.05,"1-0","4-2",16,8,15,7,2,2,0,0,7,6,13,13,6,13,26,"7-6","Y","Y","Y",4,0,13
"1677","D2",2023-11-11,"Paderborn","Nurnberg",1,3,"A",0,3,"A",2.13,3.87,3.33,"0-3","1-3",24,9,12,8,2,1,0,1,12,2,17,8,4,14,25,"12-2","Y","Y","Y",3,1,13
"1678","D2",2023-11-11,"Hertha","Karlsruhe",2,2,"D",2,1,"H",2,4.01,3.57,"2-1","2-2",10,3,12,4,0,2,0,0,6,9,17,13,4,15,30,"6-9","Y","Y","Y",2,0,13
"1679","D2",2023-11-12,"Greuther Furth","Fortuna Dusseldorf",1,0,"H",0,0,"D",2.3,3.64,3.15,"0-0","1-0",9,4,12,3,4,3,0,0,3,7,16,13,1,10,29,"3-7","N","N","N",7,0,13
"1680","D2",2023-11-12,"Magdeburg","Hansa Rostock",1,2,"A",1,0,"H",1.81,4.07,4.32,"1-0","1-2",16,8,16,5,3,2,0,0,13,2,6,15,3,15,21,"13-2","Y","Y","N",5,0,13
"1681","D2",2023-11-12,"Wehen","Kaiserslautern",2,1,"H",0,1,"A",2.93,3.78,2.37,"0-1","2-1",12,6,5,1,0,2,0,0,5,2,16,14,3,7,30,"5-2","Y","Y","N",2,0,13
"1682","D2",2023-11-24,"Hamburg","Braunschweig",2,1,"H",2,0,"H",1.31,6.18,9.49,"2-0","2-1",16,5,14,3,1,2,0,0,7,4,11,10,3,11,21,"7-4","Y","Y","N",3,0,14
"1683","D2",2023-11-24,"Hannover","Hertha",2,2,"D",0,2,"A",2.28,3.61,3.21,"0-2","2-2",18,6,8,4,0,1,0,0,9,1,10,16,4,10,26,"9-1","Y","Y","Y",1,0,14
"1684","D2",2023-11-25,"Elversberg","Paderborn",4,1,"H",1,1,"D",2.48,3.88,2.72,"1-1","4-1",15,9,9,4,2,3,0,0,4,3,10,13,5,7,23,"4-3","Y","Y","Y",5,0,14
"1685","D2",2023-11-25,"Hansa Rostock","St Pauli",2,3,"A",1,3,"A",5,4.08,1.71,"1-3","2-3",16,4,18,9,2,1,0,0,2,1,19,10,5,3,29,"2-1","Y","Y","Y",3,0,14
"1686","D2",2023-11-25,"Osnabruck","Magdeburg",0,2,"A",0,0,"D",3.16,3.83,2.22,"0-0","0-2",12,3,13,6,2,2,0,0,5,8,10,13,2,13,23,"5-8","Y","N","N",4,0,14
"1687","D2",2023-11-25,"Fortuna Dusseldorf","Schalke 04",5,3,"H",3,0,"H",1.88,4,4.03,"3-0","5-3",13,9,11,7,1,2,0,0,6,8,8,9,8,14,17,"6-8","Y","Y","Y",3,0,14
"1688","D2",2023-11-26,"Greuther Furth","Wehen",2,0,"H",1,0,"H",1.75,4.14,4.58,"1-0","2-0",23,7,14,6,3,5,0,0,7,6,7,18,2,13,25,"7-6","Y","N","N",8,0,14
"1689","D2",2023-11-26,"Kaiserslautern","Holstein Kiel",0,3,"A",0,2,"A",2.2,3.85,3.18,"0-2","0-3",13,5,11,6,1,1,0,0,6,10,9,11,3,16,20,"6-10","Y","Y","N",2,0,14
"1690","D2",2023-11-26,"Karlsruhe","Nurnberg",4,1,"H",1,0,"H",2.29,3.88,3,"1-0","4-1",19,8,12,3,2,3,0,0,6,8,10,9,5,14,19,"6-8","Y","Y","Y",5,0,14
"1691","D2",2023-12-01,"Schalke 04","Osnabruck",4,0,"H",1,0,"H",1.56,4.52,5.91,"1-0","4-0",14,5,8,2,2,2,0,0,3,0,15,11,4,3,26,"3-0","Y","Y","Y",4,0,15
"1692","D2",2023-12-01,"St Pauli","Hamburg",2,2,"D",2,0,"H",1.91,3.92,4,"2-0","2-2",16,5,6,3,1,3,0,0,9,3,5,13,4,12,18,"9-3","Y","Y","Y",4,0,15
"1693","D2",2023-12-02,"Braunschweig","Greuther Furth",0,1,"A",0,1,"A",3.76,3.66,2.04,"0-1","0-1",13,6,7,1,4,3,0,0,2,5,7,16,1,7,23,"2-5","N","N","N",7,0,15
"1694","D2",2023-12-02,"Holstein Kiel","Wehen",3,2,"H",2,0,"H",1.85,4.19,4,"2-0","3-2",23,9,13,4,1,2,0,0,11,3,7,10,5,14,17,"11-3","Y","Y","Y",3,0,15
"1695","D2",2023-12-02,"Nurnberg","Fortuna Dusseldorf",0,5,"A",0,3,"A",2.81,3.7,2.49,"0-3","0-5",4,1,14,7,2,3,0,0,2,5,10,6,5,7,16,"2-5","Y","Y","Y",5,0,15
"1696","D2",2023-12-02,"Magdeburg","Kaiserslautern",4,1,"H",1,1,"D",2.09,3.94,3.38,"1-1","4-1",18,11,19,5,3,1,0,0,6,2,9,14,5,8,23,"6-2","Y","Y","Y",4,0,15
"1697","D2",2023-12-03,"Hertha","Elversberg",5,1,"H",2,1,"H",1.96,4.04,3.67,"2-1","5-1",14,6,15,5,0,2,0,0,3,4,7,8,6,7,15,"3-4","Y","Y","Y",2,0,15
"1698","D2",2023-12-03,"Karlsruhe","Hansa Rostock",2,2,"D",1,2,"A",1.77,3.94,4.74,"1-2","2-2",17,7,17,7,2,1,0,0,8,5,6,11,4,13,17,"8-5","Y","Y","Y",3,0,15
"1699","D2",2023-12-03,"Paderborn","Hannover",1,0,"H",0,0,"D",2.41,3.71,2.92,"0-0","1-0",21,6,8,1,1,2,0,1,6,5,18,13,1,11,31,"6-5","N","N","N",3,1,15
"1","E0",2023-08-11,"Burnley","Man City",0,3,"A",0,2,"A",8.58,5.51,1.37,"0-2","0-3",6,1,17,8,0,0,1,0,6,5,11,8,3,11,19,"6-5","Y","Y","N",0,1,1
"2","E0",2023-08-12,"Arsenal","Nottm Forest",2,1,"H",2,0,"H",1.18,7.86,15.67,"2-0","2-1",15,7,6,2,2,2,0,0,8,3,12,12,3,11,24,"8-3","Y","Y","N",4,0,1
"3","E0",2023-08-12,"Bournemouth","West Ham",1,1,"D",0,0,"D",2.7,3.47,2.71,"0-0","1-1",14,5,16,3,1,4,0,0,10,4,9,14,2,14,23,"10-4","Y","N","N",5,0,1
"4","E0",2023-08-12,"Brighton","Luton",4,1,"H",1,0,"H",1.33,5.65,9.61,"1-0","4-1",27,12,9,3,2,2,0,0,6,7,11,12,5,13,23,"6-7","Y","Y","Y",4,0,1
"5","E0",2023-08-12,"Everton","Fulham",0,1,"A",0,0,"D",2.27,3.45,3.35,"0-0","0-1",19,9,9,2,0,2,0,0,10,4,12,6,1,14,18,"10-4","N","N","N",2,0,1
"6","E0",2023-08-12,"Sheffield United","Crystal Palace",0,1,"A",0,0,"D",3.28,3.22,2.43,"0-0","0-1",8,1,24,8,3,0,0,0,5,5,18,11,1,10,29,"5-5","N","N","N",3,0,1
"7","E0",2023-08-12,"Newcastle","Aston Villa",5,1,"H",2,1,"H",1.77,3.92,4.77,"2-1","5-1",17,13,16,6,4,4,0,0,6,5,12,17,6,11,29,"6-5","Y","Y","Y",8,0,1
"8","E0",2023-08-13,"Brentford","Tottenham",2,2,"D",2,2,"D",2.76,3.65,2.55,"2-2","2-2",11,6,18,6,1,4,0,0,3,6,12,13,4,9,25,"3-6","Y","Y","Y",5,0,1
"9","E0",2023-08-13,"Chelsea","Liverpool",1,1,"D",1,1,"D",2.97,3.64,2.4,"1-1","1-1",10,4,13,1,3,3,0,0,4,4,5,12,2,8,17,"4-4","Y","N","N",6,0,1
"10","E0",2023-08-14,"Man United","Wolves",1,0,"H",0,0,"D",1.32,5.79,9.66,"0-0","1-0",15,3,23,6,2,3,0,0,8,7,14,10,1,15,24,"8-7","N","N","N",5,0,1
"11","E0",2023-08-18,"Nottm Forest","Sheffield United",2,1,"H",1,0,"H",1.97,3.48,4.37,"1-0","2-1",16,4,7,3,2,3,0,0,6,7,5,9,3,13,14,"6-7","Y","Y","N",5,0,2
"12","E0",2023-08-19,"Fulham","Brentford",0,3,"A",0,1,"A",2.76,3.43,2.67,"0-1","0-3",10,2,17,8,2,2,1,0,5,5,13,12,3,10,25,"5-5","Y","Y","N",4,1,2
"13","E0",2023-08-19,"Liverpool","Bournemouth",3,1,"H",2,1,"H",1.23,7.14,11.46,"2-1","3-1",26,10,13,5,1,3,1,0,10,2,11,13,4,12,24,"10-2","Y","Y","Y",4,1,2
"14","E0",2023-08-19,"Wolves","Brighton",1,4,"A",0,1,"A",4.12,3.92,1.88,"0-1","1-4",16,5,16,8,3,6,1,0,5,3,14,11,5,8,25,"5-3","Y","Y","Y",9,1,2
"15","E0",2023-08-19,"Tottenham","Man United",2,0,"H",0,0,"D",2.85,3.82,2.41,"0-0","2-0",17,6,22,6,1,3,0,0,5,6,9,8,2,11,17,"5-6","Y","N","N",4,0,2
"16","E0",2023-08-19,"Man City","Newcastle",1,0,"H",1,0,"H",1.73,4.1,4.8,"1-0","1-0",14,4,7,1,1,5,0,0,3,0,12,11,1,3,23,"3-0","N","N","N",6,0,2
"17","E0",2023-08-20,"Aston Villa","Everton",4,0,"H",2,0,"H",1.72,3.99,5.06,"2-0","4-0",13,7,9,2,3,4,0,0,7,6,8,12,4,13,20,"7-6","Y","Y","Y",7,0,2
"18","E0",2023-08-20,"West Ham","Chelsea",3,1,"H",1,1,"D",3.68,3.57,2.1,"1-1","3-1",12,6,17,4,2,3,1,0,3,9,12,9,4,12,21,"3-9","Y","Y","Y",5,1,2
"19","E0",2023-08-21,"Crystal Palace","Arsenal",0,1,"A",0,0,"D",5.73,4.12,1.63,"0-0","0-1",14,2,14,3,2,1,0,1,1,8,14,10,1,9,24,"1-8","N","N","N",3,1,2
"20","E0",2023-08-25,"Chelsea","Luton",3,0,"H",1,0,"H",1.3,6.08,10.68,"1-0","3-0",19,8,11,1,2,3,0,0,6,4,15,12,3,10,27,"6-4","Y","Y","N",5,0,2
"21","E0",2023-08-26,"Bournemouth","Tottenham",0,2,"A",0,1,"A",3.72,4.04,1.95,"0-1","0-2",11,3,17,6,1,3,0,0,6,2,18,11,2,8,29,"6-2","Y","N","N",4,0,3
"22","E0",2023-08-26,"Arsenal","Fulham",2,2,"D",0,1,"A",1.24,6.07,15.25,"0-1","2-2",19,11,8,3,0,3,0,1,8,3,6,5,4,11,11,"8-3","Y","Y","Y",3,1,3
"23","E0",2023-08-26,"Brentford","Crystal Palace",1,1,"D",1,0,"H",2.17,3.43,3.62,"1-0","1-1",12,1,15,5,0,0,0,0,8,6,9,15,2,14,24,"8-6","Y","N","N",0,0,3
"24","E0",2023-08-26,"Everton","Wolves",0,1,"A",0,0,"D",2.34,3.32,3.34,"0-0","0-1",15,7,11,2,3,4,0,0,7,0,10,14,1,7,24,"7-0","N","N","N",7,0,3
"25","E0",2023-08-26,"Man United","Nottm Forest",3,2,"H",1,2,"A",1.32,5.98,9.11,"1-2","3-2",18,9,9,4,4,4,0,1,11,3,13,11,5,14,24,"11-3","Y","Y","Y",8,1,3
"26","E0",2023-08-26,"Brighton","West Ham",1,3,"A",0,1,"A",1.54,4.74,5.81,"0-1","1-3",25,10,12,3,1,3,0,0,17,4,10,9,4,21,19,"17-4","Y","Y","Y",4,0,3
"27","E0",2023-08-27,"Burnley","Aston Villa",1,3,"A",0,2,"A",3.39,3.65,2.18,"0-2","1-3",9,2,16,6,2,0,0,0,4,6,12,11,4,10,23,"4-6","Y","Y","Y",2,0,3
"28","E0",2023-08-27,"Sheffield United","Man City",1,2,"A",0,0,"D",16.72,7.73,1.18,"0-0","1-2",6,2,30,9,3,0,0,0,1,12,11,2,3,13,13,"1-12","Y","Y","N",3,0,3
"29","E0",2023-08-27,"Newcastle","Liverpool",1,2,"A",1,0,"H",2.2,3.95,3.13,"1-0","1-2",23,8,9,4,1,2,0,1,5,9,16,10,3,14,26,"5-9","Y","Y","N",3,1,3
"30","E0",2023-09-01,"Luton","West Ham",1,2,"A",0,1,"A",4.82,4.04,1.75,"0-1","1-2",16,1,9,3,1,1,0,0,9,6,8,13,3,15,21,"9-6","Y","Y","N",2,0,3
"31","E0",2023-09-02,"Sheffield United","Everton",2,2,"D",2,1,"H",3.06,3.27,2.53,"2-1","2-2",13,8,16,6,1,2,0,0,4,6,11,13,4,10,24,"4-6","Y","Y","Y",3,0,4
"32","E0",2023-09-02,"Brentford","Bournemouth",2,2,"D",1,1,"D",1.75,4.14,4.62,"1-1","2-2",21,7,12,5,1,2,0,0,5,2,6,13,4,7,19,"5-2","Y","Y","Y",3,0,4
"33","E0",2023-09-02,"Burnley","Tottenham",2,5,"A",1,2,"A",3.97,4.04,1.88,"1-2","2-5",16,4,20,10,4,3,0,0,7,4,15,9,7,11,24,"7-4","Y","Y","Y",7,0,4
"34","E0",2023-09-02,"Chelsea","Nottm Forest",0,1,"A",0,0,"D",1.39,5.1,8.62,"0-0","0-1",21,2,7,3,3,4,0,0,8,0,10,9,1,8,19,"8-0","N","N","N",7,0,4
"35","E0",2023-09-02,"Man City","Fulham",5,1,"H",2,1,"H",1.15,8.93,18.11,"2-1","5-1",7,5,6,4,2,4,0,0,4,5,12,12,6,9,24,"4-5","Y","Y","Y",6,0,4
"36","E0",2023-09-02,"Brighton","Newcastle",3,1,"H",1,0,"H",2.59,3.94,2.58,"1-0","3-1",15,6,9,2,4,4,0,0,5,3,14,17,4,8,31,"5-3","Y","Y","Y",8,0,4
"37","E0",2023-09-03,"Crystal Palace","Wolves",3,2,"H",0,0,"D",1.97,3.5,4.25,"0-0","3-2",16,11,12,4,1,3,0,0,4,2,12,12,5,6,24,"4-2","Y","Y","Y",4,0,4
"38","E0",2023-09-03,"Liverpool","Aston Villa",3,0,"H",2,0,"H",1.68,4.61,4.6,"2-0","3-0",17,4,9,3,0,1,0,0,7,3,12,7,3,10,19,"7-3","Y","Y","N",1,0,4
"39","E0",2023-09-03,"Arsenal","Man United",3,1,"H",1,1,"D",1.77,4.08,4.55,"1-1","3-1",17,5,10,2,2,3,0,0,12,3,8,7,4,15,15,"12-3","Y","Y","Y",5,0,4
"40","E0",2023-09-16,"Wolves","Liverpool",1,3,"A",1,0,"H",6.66,4.98,1.47,"1-0","1-3",11,2,16,6,1,3,0,0,4,4,10,4,4,8,14,"4-4","Y","Y","Y",4,0,4
"41","E0",2023-09-16,"Aston Villa","Crystal Palace",3,1,"H",0,0,"D",1.93,3.76,4.1,"0-0","3-1",16,5,6,3,5,3,0,0,4,2,13,9,4,6,22,"4-2","Y","Y","Y",8,0,5
"42","E0",2023-09-16,"Fulham","Luton",1,0,"H",0,0,"D",1.68,4.03,5.31,"0-0","1-0",13,2,7,2,2,2,0,0,6,2,6,14,1,8,20,"6-2","N","N","N",4,0,5
"43","E0",2023-09-16,"Man United","Brighton",1,3,"A",0,1,"A",2.25,4.02,2.99,"0-1","1-3",14,4,10,8,2,2,0,0,8,1,8,9,4,9,17,"8-1","Y","Y","Y",4,0,5
"44","E0",2023-09-16,"Tottenham","Sheffield United",2,1,"H",0,0,"D",1.29,6.08,10.21,"0-0","2-1",28,10,7,5,6,5,0,1,15,2,13,14,3,17,27,"15-2","Y","Y","N",11,1,5
"45","E0",2023-09-16,"West Ham","Man City",1,3,"A",1,0,"H",6.58,4.7,1.5,"1-0","1-3",6,3,29,15,3,2,0,0,4,11,7,11,4,15,18,"4-11","Y","Y","Y",5,0,5
"46","E0",2023-09-16,"Newcastle","Brentford",1,0,"H",0,0,"D",1.54,4.47,6.3,"0-0","1-0",9,2,11,2,3,5,0,0,8,3,8,12,1,11,20,"8-3","N","N","N",8,0,5
"47","E0",2023-09-17,"Bournemouth","Chelsea",0,0,"D",0,0,"D",4.39,4.05,1.8,"0-0","0-0",13,4,14,6,1,5,0,0,1,7,15,20,0,8,35,"1-7","N","N","N",6,0,5
"48","E0",2023-09-17,"Everton","Arsenal",0,1,"A",0,0,"D",6.3,4.54,1.53,"0-0","0-1",8,1,13,4,1,1,0,0,1,11,12,10,1,12,22,"1-11","N","N","N",2,0,5
"49","E0",2023-09-18,"Nottm Forest","Burnley",1,1,"D",0,1,"A",2.23,3.58,3.33,"0-1","1-1",14,4,10,3,2,3,0,1,5,4,16,10,2,9,26,"5-4","Y","N","N",5,1,5
"50","E0",2023-09-23,"Crystal Palace","Fulham",0,0,"D",0,0,"D",1.99,3.54,4.11,"0-0","0-0",7,3,10,5,3,2,0,0,3,2,10,15,0,5,25,"3-2","N","N","N",5,0,5
"51","E0",2023-09-23,"Luton","Wolves",1,1,"D",0,0,"D",3.26,3.47,2.31,"0-0","1-1",20,4,3,3,0,2,0,1,10,1,12,17,2,11,29,"10-1","Y","N","N",2,1,6
"52","E0",2023-09-23,"Man City","Nottm Forest",2,0,"H",2,0,"H",1.15,9.04,17.91,"2-0","2-0",7,4,10,3,3,7,1,0,6,6,5,17,2,12,22,"6-6","Y","N","N",10,1,6
"53","E0",2023-09-23,"Brentford","Everton",1,3,"A",1,1,"D",1.81,3.8,4.67,"1-1","1-3",12,2,18,6,2,2,0,0,1,4,9,12,4,5,21,"1-4","Y","Y","Y",4,0,6
"54","E0",2023-09-23,"Burnley","Man United",0,1,"A",0,1,"A",4.28,4.31,1.77,"0-1","0-1",12,4,11,4,1,2,0,0,9,5,6,12,1,14,18,"9-5","N","N","N",3,0,6
"55","E0",2023-09-24,"Arsenal","Tottenham",2,2,"D",1,1,"D",1.68,4.45,4.69,"1-1","2-2",13,6,13,5,3,4,0,0,11,4,12,19,4,15,31,"11-4","Y","Y","Y",7,0,6
"56","E0",2023-09-24,"Brighton","Bournemouth",3,1,"H",1,1,"D",1.41,5.08,7.9,"1-1","3-1",13,4,12,4,3,3,0,0,4,4,12,17,4,8,29,"4-4","Y","Y","Y",6,0,6
"57","E0",2023-09-24,"Chelsea","Aston Villa",0,1,"A",0,0,"D",1.93,3.9,3.93,"0-0","0-1",10,4,15,7,2,3,0,0,5,11,9,11,1,16,20,"5-11","N","N","N",5,0,6
"58","E0",2023-09-24,"Liverpool","West Ham",3,1,"H",1,1,"D",1.4,5.67,7.21,"1-1","3-1",22,7,11,4,0,2,0,0,7,4,12,13,4,11,25,"7-4","Y","Y","Y",2,0,6
"59","E0",2023-09-24,"Sheffield United","Newcastle",0,8,"A",0,3,"A",7.05,4.98,1.45,"0-3","0-8",9,1,22,15,3,0,0,0,2,6,12,8,8,8,20,"2-6","Y","Y","Y",3,0,6
"60","E0",2023-09-30,"Aston Villa","Brighton",6,1,"H",3,0,"H",2.58,3.96,2.58,"3-0","6-1",19,9,11,3,4,4,0,0,1,3,19,21,7,4,40,"1-3","Y","Y","Y",8,0,6
"61","E0",2023-09-30,"Bournemouth","Arsenal",0,4,"A",0,2,"A",5.59,4.77,1.56,"0-2","0-4",8,1,15,8,0,1,0,0,6,6,11,10,4,12,21,"6-6","Y","Y","Y",1,0,7
"62","E0",2023-09-30,"Everton","Luton",1,2,"A",1,2,"A",1.62,3.94,6.24,"1-2","1-2",23,5,9,2,0,1,0,0,3,6,8,10,3,9,18,"3-6","Y","Y","N",1,0,7
"63","E0",2023-09-30,"Man United","Crystal Palace",0,1,"A",0,1,"A",1.57,4.36,5.96,"0-1","0-1",19,4,8,2,3,2,0,0,10,4,10,8,1,14,18,"10-4","N","N","N",5,0,7
"64","E0",2023-09-30,"Newcastle","Burnley",2,0,"H",1,0,"H",1.34,5.67,9.15,"1-0","2-0",20,8,8,2,1,3,0,0,5,3,7,15,2,8,22,"5-3","Y","N","N",4,0,7
"65","E0",2023-09-30,"West Ham","Sheffield United",2,0,"H",2,0,"H",1.44,4.94,7.44,"2-0","2-0",20,9,16,2,1,1,0,0,7,4,6,9,2,11,15,"7-4","Y","N","N",2,0,7
"66","E0",2023-09-30,"Wolves","Man City",2,1,"H",1,0,"H",9.61,5.75,1.33,"1-0","2-1",3,1,23,8,5,4,0,0,0,6,18,12,3,6,30,"0-6","Y","Y","N",9,0,7
"67","E0",2023-09-30,"Tottenham","Liverpool",2,1,"H",1,1,"D",2.98,4.12,2.23,"1-1","2-1",24,8,12,4,5,4,0,2,12,5,11,17,3,17,28,"12-5","Y","Y","N",9,2,7
"68","E0",2023-10-01,"Nottm Forest","Brentford",1,1,"D",0,0,"D",2.84,3.29,2.69,"0-0","1-1",6,1,18,5,1,2,1,0,1,11,6,10,2,12,16,"1-11","Y","N","N",3,1,7
"69","E0",2023-10-02,"Fulham","Chelsea",0,2,"A",0,2,"A",3.93,3.45,2.06,"0-2","0-2",10,3,11,4,1,4,0,0,8,1,15,12,2,9,27,"8-1","Y","N","N",5,0,7
"70","E0",2023-10-03,"Luton","Burnley",1,2,"A",0,1,"A",2.94,3.23,2.65,"0-1","1-2",18,3,14,4,4,2,0,0,7,6,14,6,3,13,20,"7-6","Y","Y","N",6,0,7
"71","E0",2023-10-07,"Luton","Tottenham",0,1,"A",0,0,"D",6.91,4.98,1.46,"0-0","0-1",12,2,15,4,2,1,0,1,5,6,16,7,1,11,23,"5-6","N","N","N",3,1,8
"72","E0",2023-10-07,"Burnley","Chelsea",1,4,"A",1,1,"D",4.58,3.98,1.78,"1-1","1-4",10,3,9,5,2,4,0,0,7,3,11,8,5,10,19,"7-3","Y","Y","Y",6,0,8
"73","E0",2023-10-07,"Everton","Bournemouth",3,0,"H",2,0,"H",1.99,3.71,3.88,"2-0","3-0",25,8,11,4,1,2,0,0,8,7,14,15,3,15,29,"8-7","Y","Y","N",3,0,8
"74","E0",2023-10-07,"Fulham","Sheffield United",3,1,"H",0,0,"D",1.64,4,5.9,"0-0","3-1",20,6,5,2,1,2,0,0,9,4,8,10,4,13,18,"9-4","Y","Y","Y",3,0,8
"75","E0",2023-10-07,"Man United","Brentford",2,1,"H",0,1,"A",1.7,4.23,4.87,"0-1","2-1",21,8,11,3,0,5,0,0,7,5,10,17,3,12,27,"7-5","Y","Y","N",5,0,8
"76","E0",2023-10-07,"Crystal Palace","Nottm Forest",0,0,"D",0,0,"D",2.26,3.3,3.54,"0-0","0-0",8,2,16,5,0,1,0,0,3,7,7,12,0,10,19,"3-7","N","N","N",1,0,8
"77","E0",2023-10-08,"Brighton","Liverpool",2,2,"D",1,2,"A",3.14,4.02,2.17,"1-2","2-2",14,3,14,4,1,2,0,0,8,1,12,20,4,9,32,"8-1","Y","Y","Y",3,0,8
"78","E0",2023-10-08,"West Ham","Newcastle",2,2,"D",1,0,"H",3.41,3.79,2.12,"1-0","2-2",5,3,10,3,3,3,0,0,4,2,11,18,4,6,29,"4-2","Y","Y","Y",6,0,8
"79","E0",2023-10-08,"Wolves","Aston Villa",1,1,"D",0,0,"D",3.39,3.64,2.18,"0-0","1-1",8,3,18,4,2,2,1,0,2,10,19,9,2,12,28,"2-10","Y","N","N",4,1,8
"80","E0",2023-10-08,"Arsenal","Man City",1,0,"H",0,0,"D",2.99,3.49,2.46,"0-0","1-0",12,2,4,1,2,3,0,0,5,4,8,7,1,9,15,"5-4","N","N","N",5,0,8
"81","E0",2023-10-21,"Liverpool","Everton",2,0,"H",0,0,"D",1.37,5.77,7.65,"0-0","2-0",26,6,6,1,1,1,0,1,12,4,9,9,2,16,18,"12-4","Y","N","N",2,1,9
"82","E0",2023-10-21,"Bournemouth","Wolves",1,2,"A",1,0,"H",2.45,3.49,3.01,"1-0","1-2",7,4,20,7,2,6,1,0,3,12,15,10,3,15,25,"3-12","Y","Y","N",8,1,9
"83","E0",2023-10-21,"Brentford","Burnley",3,0,"H",1,0,"H",1.87,3.77,4.37,"1-0","3-0",23,10,6,1,5,2,0,1,5,5,14,12,3,10,26,"5-5","Y","Y","N",7,1,9
"84","E0",2023-10-21,"Man City","Brighton",2,1,"H",2,0,"H",1.42,5.45,6.93,"2-0","2-1",10,6,5,3,2,2,1,0,2,2,9,11,3,4,20,"2-2","Y","Y","N",4,1,9
"85","E0",2023-10-21,"Newcastle","Crystal Palace",4,0,"H",3,0,"H",1.46,4.63,7.7,"3-0","4-0",10,7,17,3,2,3,0,0,6,8,7,12,4,14,19,"6-8","Y","Y","Y",5,0,9
"86","E0",2023-10-21,"Nottm Forest","Luton",2,2,"D",0,0,"D",1.7,3.89,5.43,"0-0","2-2",19,8,13,4,3,0,0,0,4,2,12,11,4,6,23,"4-2","Y","Y","Y",3,0,9
"87","E0",2023-10-21,"Chelsea","Arsenal",2,2,"D",1,0,"H",3.33,3.5,2.26,"1-0","2-2",11,5,13,3,3,3,0,0,2,7,7,14,4,9,21,"2-7","Y","Y","Y",6,0,9
"88","E0",2023-10-21,"Sheffield United","Man United",1,2,"A",1,1,"D",7.57,5.24,1.41,"1-1","1-2",12,6,14,5,3,1,0,0,5,4,12,10,3,9,22,"5-4","Y","Y","N",4,0,9
"89","E0",2023-10-22,"Aston Villa","West Ham",4,1,"H",1,0,"H",1.9,3.93,4.01,"1-0","4-1",15,7,14,4,0,1,0,0,8,7,9,15,5,15,24,"8-7","Y","Y","Y",1,0,9
"90","E0",2023-10-23,"Tottenham","Fulham",2,0,"H",1,0,"H",1.51,4.85,6.06,"1-0","2-0",15,5,10,3,2,0,0,0,3,5,10,14,2,8,24,"3-5","Y","N","N",2,0,9
"91","E0",2023-10-27,"Crystal Palace","Tottenham",1,2,"A",0,0,"D",4.7,3.84,1.79,"0-0","1-2",13,3,10,1,2,1,0,0,11,2,19,11,3,13,30,"11-2","Y","Y","N",3,0,10
"92","E0",2023-10-28,"Chelsea","Brentford",0,2,"A",0,0,"D",1.66,4.15,5.32,"0-0","0-2",17,2,7,5,1,4,0,0,10,1,12,7,2,11,19,"10-1","Y","N","N",5,0,10
"93","E0",2023-10-28,"Arsenal","Sheffield United",5,0,"H",1,0,"H",1.13,10.16,21.31,"1-0","5-0",13,8,2,0,0,3,0,0,6,1,9,13,5,7,22,"6-1","Y","Y","Y",3,0,10
"94","E0",2023-10-28,"Bournemouth","Burnley",2,1,"H",1,1,"D",2.1,3.76,3.49,"1-1","2-1",13,6,6,3,2,3,0,0,10,5,9,12,3,15,21,"10-5","Y","Y","N",5,0,10
"95","E0",2023-10-28,"Wolves","Newcastle",2,2,"D",1,2,"A",4.22,3.99,1.84,"1-2","2-2",11,6,13,5,1,4,0,0,8,7,13,15,4,15,28,"8-7","Y","Y","Y",5,0,10
"96","E0",2023-10-29,"West Ham","Everton",0,1,"A",0,0,"D",2.18,3.62,3.41,"0-0","0-1",12,2,10,4,4,1,0,0,4,3,7,11,1,7,18,"4-3","N","N","N",5,0,10
"97","E0",2023-10-29,"Aston Villa","Luton",3,1,"H",1,0,"H",1.28,6.23,10.8,"1-0","3-1",17,6,7,1,3,2,0,0,6,4,11,10,4,10,21,"6-4","Y","Y","Y",5,0,10
"98","E0",2023-10-29,"Brighton","Fulham",1,1,"D",1,0,"H",1.59,4.65,5.36,"1-0","1-1",18,7,10,5,0,3,0,0,7,3,12,8,2,10,20,"7-3","Y","N","N",3,0,10
"99","E0",2023-10-29,"Liverpool","Nottm Forest",3,0,"H",2,0,"H",1.27,6.51,10.09,"2-0","3-0",21,8,9,1,2,3,0,0,8,3,9,13,3,11,22,"8-3","Y","Y","N",5,0,10
"100","E0",2023-10-29,"Man United","Man City",0,3,"A",0,1,"A",5.16,4.07,1.69,"0-1","0-3",7,3,21,10,4,1,0,0,7,12,9,4,3,19,13,"7-12","Y","Y","N",5,0,10
"101","E0",2023-11-04,"Fulham","Man United",0,1,"A",0,0,"D",3.22,3.68,2.22,"0-0","0-1",18,3,12,5,5,2,0,0,9,4,9,15,1,13,24,"9-4","N","N","N",7,0,11
"102","E0",2023-11-04,"Brentford","West Ham",3,2,"H",1,2,"A",2.07,3.74,3.52,"1-2","3-2",16,4,12,2,1,4,0,0,4,3,12,14,5,7,26,"4-3","Y","Y","Y",5,0,11
"103","E0",2023-11-04,"Burnley","Crystal Palace",0,2,"A",0,1,"A",2.89,3.24,2.65,"0-1","0-2",17,5,4,3,0,5,0,0,12,1,9,12,2,13,21,"12-1","Y","N","N",5,0,11
"104","E0",2023-11-04,"Everton","Brighton",1,1,"D",1,0,"H",3.1,3.87,2.21,"1-0","1-1",10,4,7,2,4,2,0,0,3,3,15,5,2,6,20,"3-3","Y","N","N",6,0,11
"105","E0",2023-11-04,"Man City","Bournemouth",6,1,"H",3,0,"H",1.08,12.84,29.22,"3-0","6-1",21,8,5,1,0,1,0,0,12,1,8,9,7,13,17,"12-1","Y","Y","Y",1,0,11
"106","E0",2023-11-04,"Sheffield United","Wolves",2,1,"H",0,0,"D",3.91,3.68,1.97,"0-0","2-1",11,2,10,3,2,3,0,0,4,4,13,10,3,8,23,"4-4","Y","Y","N",5,0,11
"107","E0",2023-11-04,"Newcastle","Arsenal",1,0,"H",0,0,"D",2.83,3.41,2.59,"0-0","1-0",9,2,14,1,5,1,0,0,0,11,14,9,1,11,23,"0-11","N","N","N",6,0,11
"108","E0",2023-11-05,"Nottm Forest","Aston Villa",2,0,"H",1,0,"H",4.17,3.76,1.89,"1-0","2-0",5,3,13,3,1,1,0,0,0,10,6,9,2,10,15,"0-10","Y","N","N",2,0,11
"109","E0",2023-11-05,"Luton","Liverpool",1,1,"D",0,0,"D",11.23,6.76,1.24,"0-0","1-1",8,5,24,6,1,1,0,0,4,7,7,13,2,11,20,"4-7","Y","N","N",2,0,11
"110","E0",2023-11-06,"Tottenham","Chelsea",1,4,"A",1,1,"D",2.14,3.73,3.34,"1-1","1-4",8,5,17,8,1,5,2,0,1,6,12,21,5,7,33,"1-6","Y","Y","Y",6,2,11
"111","E0",2023-11-11,"Wolves","Tottenham",2,1,"H",0,1,"A",3.11,3.78,2.23,"0-1","2-1",17,4,6,2,4,3,0,0,11,3,19,15,3,14,34,"11-3","Y","Y","N",7,0,12
"112","E0",2023-11-11,"Arsenal","Burnley",3,1,"H",1,0,"H",1.19,7.47,14.74,"1-0","3-1",16,6,8,5,0,1,1,0,3,3,8,9,4,6,17,"3-3","Y","Y","Y",1,1,12
"113","E0",2023-11-11,"Crystal Palace","Everton",2,3,"A",1,1,"D",2.45,3.2,3.19,"1-1","2-3",13,4,8,4,1,4,0,0,9,2,9,18,5,11,27,"9-2","Y","Y","Y",5,0,12
"114","E0",2023-11-11,"Man United","Luton",1,0,"H",0,0,"D",1.31,5.86,9.36,"0-0","1-0",15,4,10,4,0,2,0,0,11,3,9,11,1,14,20,"11-3","N","N","N",2,0,12
"115","E0",2023-11-11,"Bournemouth","Newcastle",2,0,"H",0,0,"D",4.52,4.06,1.76,"0-0","2-0",19,10,8,5,2,1,0,0,6,5,10,4,2,11,14,"6-5","Y","N","N",3,0,12
"116","E0",2023-11-12,"Aston Villa","Fulham",3,1,"H",2,0,"H",1.6,4.27,5.67,"2-0","3-1",12,6,9,5,2,5,0,0,2,2,4,17,4,4,21,"2-2","Y","Y","Y",7,0,12
"117","E0",2023-11-12,"Brighton","Sheffield United",1,1,"D",1,0,"H",1.24,6.8,11.28,"1-0","1-1",11,6,9,1,3,2,1,0,6,3,13,16,2,9,29,"6-3","Y","N","N",5,1,12
"118","E0",2023-11-12,"Liverpool","Brentford",3,0,"H",1,0,"H",1.41,5.26,7.17,"1-0","3-0",17,10,16,3,1,2,0,0,6,8,16,12,3,14,28,"6-8","Y","Y","N",3,0,12
"119","E0",2023-11-12,"West Ham","Nottm Forest",3,2,"H",1,1,"D",1.89,3.79,4.1,"1-1","3-2",16,6,10,5,2,2,0,0,9,4,9,12,5,13,21,"9-4","Y","Y","Y",4,0,12
"120","E0",2023-11-12,"Chelsea","Man City",4,4,"D",2,2,"D",4.92,3.8,1.75,"2-2","4-4",17,9,15,10,5,3,0,0,3,3,12,15,8,6,27,"3-3","Y","Y","Y",8,0,12
"121","E0",2023-11-25,"Man City","Liverpool",1,1,"D",1,0,"H",1.75,4.37,4.24,"1-0","1-1",16,5,8,3,1,3,0,0,9,6,9,11,2,15,20,"9-6","Y","N","N",4,0,13
"122","E0",2023-11-25,"Burnley","West Ham",1,2,"A",0,0,"D",3.58,3.54,2.12,"0-0","1-2",11,5,11,3,1,3,0,0,4,5,11,7,3,9,18,"4-5","Y","Y","N",4,0,13
"123","E0",2023-11-25,"Luton","Crystal Palace",2,1,"H",0,0,"D",3.7,3.41,2.13,"0-0","2-1",8,3,16,8,6,1,0,0,4,5,15,12,3,9,27,"4-5","Y","Y","N",7,0,13
"124","E0",2023-11-25,"Newcastle","Chelsea",4,1,"H",1,1,"D",2.65,3.46,2.73,"1-1","4-1",14,5,7,4,4,4,0,1,4,2,13,19,5,6,32,"4-2","Y","Y","Y",8,1,13
"125","E0",2023-11-25,"Nottm Forest","Brighton",2,3,"A",1,2,"A",3.32,3.63,2.19,"1-2","2-3",18,5,11,5,2,4,0,1,6,4,12,7,5,10,19,"6-4","Y","Y","Y",6,1,13
"126","E0",2023-11-25,"Sheffield United","Bournemouth",1,3,"A",0,2,"A",3.36,3.54,2.2,"0-2","1-3",10,2,23,11,4,1,0,0,4,7,6,8,4,11,14,"4-7","Y","Y","Y",5,0,13
"127","E0",2023-11-25,"Brentford","Arsenal",0,1,"A",0,0,"D",4.74,3.82,1.78,"0-0","0-1",9,3,15,4,1,1,0,0,1,8,9,7,1,9,16,"1-8","N","N","N",2,0,13
"128","E0",2023-11-26,"Tottenham","Aston Villa",1,2,"A",1,1,"D",2.36,3.93,2.82,"1-1","1-2",18,8,15,5,0,4,0,0,9,3,11,13,3,12,24,"9-3","Y","Y","N",4,0,13
"129","E0",2023-11-26,"Everton","Man United",0,3,"A",0,1,"A",2.75,3.51,2.6,"0-1","0-3",24,6,9,4,3,0,0,0,6,5,10,8,3,11,18,"6-5","Y","Y","N",3,0,13
"130","E0",2023-11-27,"Fulham","Wolves",3,2,"H",1,1,"D",2.45,3.37,3.05,"1-1","3-2",12,6,10,6,2,2,0,0,6,2,13,13,5,8,26,"6-2","Y","Y","Y",4,0,13
"131","E0",2023-12-02,"Arsenal","Wolves",2,1,"H",2,0,"H",1.29,5.9,10.82,"2-0","2-1",19,6,6,3,1,2,0,0,4,0,10,10,3,4,20,"4-0","Y","Y","N",3,0,14
"132","E0",2023-12-02,"Brentford","Luton",3,1,"H",0,0,"D",1.45,4.83,7.07,"0-0","3-1",27,6,7,1,1,2,0,0,7,5,10,8,4,12,18,"7-5","Y","Y","Y",3,0,14
"133","E0",2023-12-02,"Burnley","Sheffield United",5,0,"H",2,0,"H",1.83,3.63,4.65,"2-0","5-0",19,7,6,3,2,5,0,1,6,1,9,12,5,7,21,"6-1","Y","Y","Y",7,1,14
"134","E0",2023-12-02,"Nottm Forest","Everton",0,1,"A",0,0,"D",2.85,3.31,2.64,"0-0","0-1",13,2,12,3,1,0,0,0,4,3,15,14,1,7,29,"4-3","N","N","N",1,0,14
"135","E0",2023-12-02,"Newcastle","Man United",1,0,"H",0,0,"D",1.9,3.87,4,"0-0","1-0",22,4,8,1,1,2,0,0,7,3,6,13,1,10,19,"7-3","N","N","N",3,0,14
"136","E0",2023-12-03,"Bournemouth","Aston Villa",2,2,"D",1,1,"D",3.56,4.07,1.97,"1-1","2-2",15,7,11,3,5,3,0,0,7,7,16,12,4,14,28,"7-7","Y","Y","Y",8,0,14
"137","E0",2023-12-03,"Chelsea","Brighton",3,2,"H",2,1,"H",1.75,4.21,4.4,"2-1","3-2",8,5,18,9,3,5,1,0,5,8,16,12,5,13,28,"5-8","Y","Y","Y",8,1,14
"138","E0",2023-12-03,"Liverpool","Fulham",4,3,"H",2,2,"D",1.25,6.76,10.35,"2-2","4-3",26,12,9,5,0,0,0,0,3,4,6,7,7,7,13,"3-4","Y","Y","Y",0,0,14
"139","E0",2023-12-03,"West Ham","Crystal Palace",1,1,"D",1,0,"H",2.01,3.56,3.92,"1-0","1-1",9,3,9,2,2,0,0,0,2,3,17,7,2,5,24,"2-3","Y","N","N",2,0,14
"140","E0",2023-12-03,"Man City","Tottenham",3,3,"D",2,1,"H",1.27,6.42,9.75,"2-1","3-3",18,4,8,4,4,4,0,0,10,8,14,14,6,18,28,"10-8","Y","Y","Y",8,0,14
"141","E0",2023-12-05,"Wolves","Burnley",1,0,"H",1,0,"H",1.92,3.6,4.35,"1-0","1-0",7,4,12,3,2,4,0,0,6,8,11,15,1,14,26,"6-8","N","N","N",6,0,15
"142","E0",2023-12-05,"Luton","Arsenal",3,4,"A",1,2,"A",14.73,6.77,1.22,"1-2","3-4",6,4,23,9,2,1,0,0,3,8,14,7,7,11,21,"3-8","Y","Y","Y",3,0,15
"143","E0",2023-12-06,"Brighton","Brentford",2,1,"H",1,1,"D",1.94,3.89,3.79,"1-1","2-1",18,7,8,2,3,1,0,0,7,3,10,8,3,10,18,"7-3","Y","Y","N",4,0,15
"144","E0",2023-12-06,"Crystal Palace","Bournemouth",0,2,"A",0,1,"A",2.3,3.45,3.23,"0-1","0-2",16,3,11,4,1,3,0,0,3,9,10,17,2,12,27,"3-9","Y","N","N",4,0,15
"145","E0",2023-12-06,"Fulham","Nottm Forest",5,0,"H",2,0,"H",2.06,3.5,3.81,"2-0","5-0",14,6,4,1,0,1,0,0,6,1,7,10,5,7,17,"6-1","Y","Y","Y",1,0,15
"146","E0",2023-12-06,"Sheffield United","Liverpool",0,2,"A",0,1,"A",14.14,7.68,1.19,"0-1","0-2",6,1,15,8,2,3,0,0,2,12,12,8,2,14,20,"2-12","Y","N","N",5,0,15
"147","E0",2023-12-06,"Aston Villa","Man City",1,0,"H",0,0,"D",4.35,4.29,1.75,"0-0","1-0",22,7,2,2,2,2,0,0,6,0,13,13,1,6,26,"6-0","N","N","N",4,0,15
"148","E0",2023-12-06,"Man United","Chelsea",2,1,"H",1,1,"D",2.88,3.67,2.42,"1-1","2-1",28,9,13,3,4,0,0,0,12,4,12,12,3,16,24,"12-4","Y","Y","N",4,0,15
"149","E0",2023-12-07,"Everton","Newcastle",3,0,"H",0,0,"D",3.17,3.41,2.36,"0-0","3-0",21,6,13,3,3,0,0,0,5,2,18,8,3,7,26,"5-2","Y","Y","N",3,0,15
"150","E0",2023-12-07,"Tottenham","West Ham",1,2,"A",1,0,"H",1.8,4.31,4.04,"1-0","1-2",23,7,11,5,3,3,0,0,8,4,11,12,3,12,23,"8-4","Y","Y","N",6,0,15
"151","E1",2023-08-04,"Sheffield Weds","Southampton",1,2,"A",0,1,"A",3.3,3.44,2.3,"0-1","1-2",8,1,23,7,4,4,0,0,3,6,12,10,3,9,22,"3-6","Y","Y","N",8,0,1
"152","E1",2023-08-05,"Blackburn","West Brom",2,1,"H",2,0,"H",2.92,3.24,2.65,"2-0","2-1",12,3,14,4,4,3,0,0,6,5,11,11,3,11,22,"6-5","Y","Y","N",7,0,1
"153","E1",2023-08-05,"Bristol City","Preston",1,1,"D",0,0,"D",2.13,3.45,3.72,"0-0","1-1",5,2,11,3,0,1,0,0,2,4,10,11,2,6,21,"2-4","Y","N","N",1,0,1
"154","E1",2023-08-05,"Middlesbrough","Millwall",0,1,"A",0,0,"D",2.05,3.48,3.96,"0-0","0-1",16,2,12,2,1,3,0,0,12,6,3,8,1,18,11,"12-6","N","N","N",4,0,1
"155","E1",2023-08-05,"Norwich","Hull",2,1,"H",1,1,"D",1.8,3.71,4.87,"1-1","2-1",28,5,8,3,2,5,0,0,9,4,14,12,3,13,26,"9-4","Y","Y","N",7,0,1
"156","E1",2023-08-05,"Plymouth","Huddersfield",3,1,"H",1,1,"D",2.19,3.46,3.55,"1-1","3-1",14,7,15,3,1,0,0,0,2,9,9,15,4,11,24,"2-9","Y","Y","Y",1,0,1
"157","E1",2023-08-05,"Stoke","Rotherham",4,1,"H",3,0,"H",1.65,4,5.74,"3-0","4-1",15,6,6,3,5,3,0,1,10,2,12,10,5,12,22,"10-2","Y","Y","Y",8,1,1
"158","E1",2023-08-05,"Swansea","Birmingham",1,1,"D",0,1,"A",1.9,3.65,4.37,"0-1","1-1",11,6,11,5,1,4,0,0,5,5,9,12,2,10,21,"5-5","Y","N","N",5,0,1
"159","E1",2023-08-05,"Watford","QPR",4,0,"H",4,0,"H",1.88,3.69,4.39,"4-0","4-0",23,12,4,1,1,2,0,0,8,2,8,15,4,10,23,"8-2","Y","Y","Y",3,0,1
"160","E1",2023-08-06,"Leicester","Coventry",2,1,"H",0,0,"D",1.6,4.24,5.9,"0-0","2-1",20,7,20,6,3,2,0,0,6,8,11,13,3,14,24,"6-8","Y","Y","N",5,0,1
"161","E1",2023-08-06,"Leeds","Cardiff",2,2,"D",0,2,"A",1.47,4.76,7.04,"0-2","2-2",25,6,7,2,2,1,0,0,10,0,8,10,4,10,18,"10-0","Y","Y","Y",3,0,1
"162","E1",2023-08-06,"Sunderland","Ipswich",1,2,"A",0,1,"A",2.53,3.36,2.99,"0-1","1-2",20,4,13,5,1,3,1,0,11,4,10,13,3,15,23,"11-4","Y","Y","N",4,1,1
"163","E1",2023-08-12,"Coventry","Middlesbrough",3,0,"H",1,0,"H",2.45,3.45,3.04,"1-0","3-0",12,5,14,2,1,1,0,0,7,7,5,8,3,14,13,"7-7","Y","Y","N",2,0,2
"164","E1",2023-08-12,"Birmingham","Leeds",1,0,"H",0,0,"D",3.43,3.59,2.19,"0-0","1-0",10,2,7,1,1,2,0,0,7,4,13,10,1,11,23,"7-4","N","N","N",3,0,2
"165","E1",2023-08-12,"Cardiff","QPR",1,2,"A",0,1,"A",2,3.58,4.01,"0-1","1-2",15,4,7,3,2,2,0,0,13,7,8,13,3,20,21,"13-7","Y","Y","N",4,0,2
"166","E1",2023-08-12,"Huddersfield","Leicester",0,1,"A",0,0,"D",4.66,3.93,1.78,"0-0","0-1",13,3,17,6,1,4,0,0,5,4,15,8,1,9,23,"5-4","N","N","N",5,0,2
"167","E1",2023-08-12,"Hull","Sheffield Weds",4,2,"H",1,1,"D",2.37,3.42,3.19,"1-1","4-2",16,7,6,2,1,3,0,0,9,1,7,22,6,10,29,"9-1","Y","Y","Y",4,0,2
"168","E1",2023-08-12,"Ipswich","Stoke",2,0,"H",1,0,"H",2.16,3.6,3.47,"1-0","2-0",22,10,9,2,3,1,0,0,7,3,12,17,2,10,29,"7-3","Y","N","N",4,0,2
"169","E1",2023-08-12,"Millwall","Bristol City",0,1,"A",0,0,"D",1.91,3.66,4.32,"0-0","0-1",10,2,13,1,1,3,0,0,1,5,13,11,1,6,24,"1-5","N","N","N",4,0,2
"170","E1",2023-08-12,"Preston","Sunderland",2,1,"H",1,1,"D",2.81,3.41,2.64,"1-1","2-1",11,2,13,4,3,1,0,0,5,12,17,8,3,17,25,"5-12","Y","Y","N",4,0,2
"171","E1",2023-08-12,"Rotherham","Blackburn",2,2,"D",1,0,"H",3.09,3.4,2.44,"1-0","2-2",9,3,21,6,3,1,1,0,5,9,9,8,4,14,17,"5-9","Y","Y","Y",4,1,2
"172","E1",2023-08-12,"Southampton","Norwich",4,4,"D",2,3,"A",1.87,3.77,4.35,"2-3","4-4",31,11,15,6,7,4,0,0,13,4,12,13,8,17,25,"13-4","Y","Y","Y",11,0,2
"173","E1",2023-08-12,"Watford","Plymouth",0,0,"D",0,0,"D",1.72,4.01,4.96,"0-0","0-0",20,3,13,5,0,2,0,0,12,3,16,10,0,15,26,"12-3","N","N","N",2,0,2
"174","E1",2023-08-12,"West Brom","Swansea",3,2,"H",1,0,"H",2.1,3.57,3.68,"1-0","3-2",11,3,13,4,3,4,0,0,4,8,10,10,5,12,20,"4-8","Y","Y","Y",7,0,2
"175","E1",2023-08-18,"Leeds","West Brom",1,1,"D",0,0,"D",2.16,3.56,3.52,"0-0","1-1",16,4,4,2,4,5,0,0,4,3,10,9,2,7,19,"4-3","Y","N","N",9,0,3
"176","E1",2023-08-19,"Plymouth","Southampton",1,2,"A",0,0,"D",3.88,3.98,1.93,"0-0","1-2",15,2,19,9,2,4,0,0,5,10,11,15,3,15,26,"5-10","Y","Y","N",6,0,3
"177","E1",2023-08-19,"Blackburn","Hull",1,2,"A",0,0,"D",1.93,3.77,4.04,"0-0","1-2",14,3,19,5,1,3,1,0,2,8,12,7,3,10,19,"2-8","Y","Y","N",4,1,3
"178","E1",2023-08-19,"Bristol City","Birmingham",0,2,"A",0,1,"A",2.29,3.27,3.5,"0-1","0-2",19,0,16,6,0,2,1,0,8,4,12,10,2,12,22,"8-4","Y","N","N",2,1,3
"179","E1",2023-08-19,"Leicester","Cardiff",2,1,"H",1,1,"D",1.54,4.49,6.29,"1-1","2-1",15,6,10,4,1,4,0,1,10,4,11,10,3,14,21,"10-4","Y","Y","N",5,1,3
"180","E1",2023-08-19,"Middlesbrough","Huddersfield",1,1,"D",0,0,"D",1.78,4.01,4.61,"0-0","1-1",17,7,16,2,1,3,0,0,7,8,10,10,2,15,20,"7-8","Y","N","N",4,0,3
"181","E1",2023-08-19,"QPR","Ipswich",0,1,"A",0,0,"D",4.51,3.63,1.88,"0-0","0-1",10,4,16,3,4,1,0,0,5,4,15,10,1,9,25,"5-4","N","N","N",5,0,3
"182","E1",2023-08-19,"Sheffield Weds","Preston",0,1,"A",0,0,"D",2.61,3.24,2.99,"0-0","0-1",8,3,5,2,1,1,0,0,0,4,14,16,1,4,30,"0-4","N","N","N",2,0,3
"183","E1",2023-08-19,"Stoke","Watford",1,0,"H",0,0,"D",2.25,3.53,3.34,"0-0","1-0",13,2,10,3,4,1,0,0,7,2,21,10,1,9,31,"7-2","N","N","N",5,0,3
"184","E1",2023-08-19,"Sunderland","Rotherham",2,1,"H",1,1,"D",1.66,4.18,5.32,"1-1","2-1",11,4,4,1,2,1,0,0,5,0,11,10,3,5,21,"5-0","Y","Y","N",3,0,3
"185","E1",2023-08-19,"Swansea","Coventry",1,1,"D",1,1,"D",2.43,3.53,3.01,"1-1","1-1",7,3,11,2,2,1,0,0,3,8,12,10,2,11,22,"3-8","Y","N","N",3,0,3
"186","E1",2023-08-20,"Norwich","Millwall",3,1,"H",1,0,"H",2.12,3.56,3.62,"1-0","3-1",20,5,10,2,2,1,0,0,6,3,3,13,4,9,16,"6-3","Y","Y","Y",3,0,3
"187","E1",2023-08-25,"Hull","Bristol City",1,1,"D",1,0,"H",2.41,3.41,3.13,"1-0","1-1",13,9,19,5,1,2,0,0,4,5,5,13,2,9,18,"4-5","Y","N","N",3,0,4
"188","E1",2023-08-26,"Birmingham","Plymouth",2,1,"H",1,0,"H",1.88,3.66,4.46,"1-0","2-1",13,4,16,8,2,1,0,0,10,10,17,5,3,20,22,"10-10","Y","Y","N",3,0,4
"189","E1",2023-08-26,"Cardiff","Sheffield Weds",2,1,"H",0,0,"D",2.13,3.44,3.74,"0-0","2-1",12,4,11,2,0,5,0,0,5,10,6,20,3,15,26,"5-10","Y","Y","N",5,0,4
"190","E1",2023-08-26,"Coventry","Sunderland",0,0,"D",0,0,"D",2.15,3.54,3.57,"0-0","0-0",17,6,15,2,1,4,0,0,4,7,11,7,0,11,18,"4-7","N","N","N",5,0,4
"191","E1",2023-08-26,"Huddersfield","Norwich",0,4,"A",0,2,"A",3.37,3.74,2.15,"0-2","0-4",18,5,9,5,3,1,0,0,5,3,10,8,4,8,18,"5-3","Y","Y","Y",4,0,4
"192","E1",2023-08-26,"Ipswich","Leeds",3,4,"A",2,3,"A",2.39,3.37,3.2,"2-3","3-4",21,6,14,9,3,2,0,0,8,4,12,8,7,12,20,"8-4","Y","Y","Y",5,0,4
"193","E1",2023-08-26,"Millwall","Stoke",1,0,"H",1,0,"H",2.43,3.27,3.22,"1-0","1-0",17,7,20,2,1,5,0,0,6,7,15,7,1,13,22,"6-7","N","N","N",6,0,4
"194","E1",2023-08-26,"Preston","Swansea",2,1,"H",0,1,"A",2.66,3.35,2.84,"0-1","2-1",11,3,10,1,2,1,0,0,6,4,12,7,3,10,19,"6-4","Y","Y","N",3,0,4
"195","E1",2023-08-26,"Rotherham","Leicester",1,2,"A",0,1,"A",5.53,4.21,1.63,"0-1","1-2",8,1,15,7,2,2,0,0,5,4,15,10,3,9,25,"5-4","Y","Y","N",4,0,4
"196","E1",2023-08-26,"Southampton","QPR",2,1,"H",1,1,"D",1.37,5.47,8.46,"1-1","2-1",7,3,11,5,4,2,0,0,4,3,8,14,3,7,22,"4-3","Y","Y","N",6,0,4
"197","E1",2023-08-26,"West Brom","Middlesbrough",4,2,"H",2,1,"H",2.3,3.52,3.24,"2-1","4-2",7,4,15,5,2,1,0,1,4,2,10,9,6,6,19,"4-2","Y","Y","Y",3,1,4
"198","E1",2023-08-27,"Watford","Blackburn",0,1,"A",0,0,"D",2.12,3.65,3.55,"0-0","0-1",24,4,5,3,3,2,0,0,8,4,8,5,1,12,13,"8-4","N","N","N",5,0,4
"199","E1",2023-09-02,"Birmingham","Millwall",1,1,"D",0,1,"A",2.46,3.21,3.23,"0-1","1-1",17,4,9,3,1,2,0,0,1,3,9,18,2,4,27,"1-3","Y","N","N",3,0,5
"200","E1",2023-09-02,"Sunderland","Southampton",5,0,"H",3,0,"H",2.84,3.65,2.49,"3-0","5-0",18,10,13,2,2,2,0,0,5,8,20,10,5,13,30,"5-8","Y","Y","Y",4,0,5
"201","E1",2023-09-02,"Swansea","Bristol City",1,2,"A",1,0,"H",2.17,3.64,3.42,"1-0","1-2",12,4,16,4,3,2,0,0,4,8,13,17,3,12,30,"4-8","Y","Y","N",5,0,5
"202","E1",2023-09-02,"Coventry","Watford",3,3,"D",1,1,"D",2.17,3.62,3.44,"1-1","3-3",16,7,14,5,3,3,0,0,9,6,10,16,6,15,26,"9-6","Y","Y","Y",6,0,5
"203","E1",2023-09-02,"Ipswich","Cardiff",3,2,"H",0,1,"A",1.67,4.16,5.25,"0-1","3-2",19,7,13,5,4,3,0,0,6,3,7,14,5,9,21,"6-3","Y","Y","Y",7,0,5
"204","E1",2023-09-02,"Leeds","Sheffield Weds",0,0,"D",0,0,"D",1.45,5.05,6.95,"0-0","0-0",16,4,10,5,1,2,0,0,5,3,8,9,0,8,17,"5-3","N","N","N",3,0,5
"205","E1",2023-09-02,"Leicester","Hull",0,1,"A",0,1,"A",1.54,4.67,5.95,"0-1","0-1",21,1,7,4,3,5,0,0,8,3,16,12,1,11,28,"8-3","N","N","N",8,0,5
"206","E1",2023-09-02,"Middlesbrough","QPR",0,2,"A",0,1,"A",1.6,4.43,5.61,"0-1","0-2",16,9,11,3,1,2,0,0,7,5,9,11,2,12,20,"7-5","Y","N","N",3,0,5
"207","E1",2023-09-02,"Plymouth","Blackburn",3,0,"H",1,0,"H",2.72,3.79,2.52,"1-0","3-0",23,9,20,4,2,1,0,0,9,9,5,6,3,18,11,"9-9","Y","Y","N",3,0,5
"208","E1",2023-09-02,"Rotherham","Norwich",2,1,"H",2,0,"H",4.85,4,1.74,"2-0","2-1",9,3,17,5,2,1,0,0,2,6,12,10,3,8,22,"2-6","Y","Y","N",3,0,5
"209","E1",2023-09-02,"Stoke","Preston",0,2,"A",0,0,"D",1.96,3.5,4.28,"0-0","0-2",18,1,7,3,3,4,0,0,9,0,15,17,2,9,32,"9-0","Y","N","N",7,0,5
"210","E1",2023-09-02,"West Brom","Huddersfield",1,2,"A",0,1,"A",1.72,4.08,4.89,"0-1","1-2",10,5,14,4,1,1,0,0,4,9,9,9,3,13,18,"4-9","Y","Y","N",2,0,5
"211","E1",2023-09-15,"Hull","Coventry",1,1,"D",0,1,"A",2.88,3.48,2.54,"0-1","1-1",18,4,8,2,2,5,0,0,9,3,7,21,2,12,28,"9-3","Y","N","N",7,0,6
"212","E1",2023-09-15,"Southampton","Leicester",1,4,"A",1,3,"A",2.52,3.6,2.83,"1-3","1-4",19,8,15,8,2,4,1,0,9,3,11,12,5,12,23,"9-3","Y","Y","Y",6,1,6
"213","E1",2023-09-16,"Blackburn","Middlesbrough",2,1,"H",1,0,"H",2.55,3.66,2.77,"1-0","2-1",15,8,21,6,1,2,0,0,5,9,11,10,3,14,21,"5-9","Y","Y","N",3,0,6
"214","E1",2023-09-16,"Bristol City","West Brom",0,0,"D",0,0,"D",2.47,3.43,3.01,"0-0","0-0",14,3,14,0,2,2,0,0,7,7,10,5,0,14,15,"7-7","N","N","N",4,0,6
"215","E1",2023-09-16,"Huddersfield","Rotherham",2,0,"H",1,0,"H",1.87,3.7,4.44,"1-0","2-0",15,5,7,3,1,1,0,0,2,5,10,17,2,7,27,"2-5","Y","N","N",2,0,6
"216","E1",2023-09-16,"Norwich","Stoke",1,0,"H",1,0,"H",1.92,3.83,4.04,"1-0","1-0",13,5,13,2,2,2,0,0,5,3,7,14,1,8,21,"5-3","N","N","N",4,0,6
"217","E1",2023-09-16,"Preston","Plymouth",2,1,"H",2,0,"H",2,3.71,3.84,"2-0","2-1",9,5,18,7,3,1,0,0,4,14,14,11,3,18,25,"4-14","Y","Y","N",4,0,6
"218","E1",2023-09-16,"QPR","Sunderland",1,3,"A",1,1,"D",3.33,3.56,2.24,"1-1","1-3",5,3,22,8,2,0,1,0,0,8,12,3,4,8,15,"0-8","Y","Y","Y",2,1,6
"219","E1",2023-09-16,"Sheffield Weds","Ipswich",0,1,"A",0,1,"A",3.89,3.53,2.05,"0-1","0-1",6,0,13,6,3,4,0,0,7,1,17,13,1,8,30,"7-1","N","N","N",7,0,6
"220","E1",2023-09-16,"Watford","Birmingham",2,0,"H",0,0,"D",2.04,3.48,3.98,"0-0","2-0",12,4,8,3,1,5,0,1,8,1,16,17,2,9,33,"8-1","Y","N","N",6,1,6
"221","E1",2023-09-16,"Cardiff","Swansea",2,0,"H",0,0,"D",2.63,3.39,2.85,"0-0","2-0",13,7,9,3,1,1,0,0,2,2,13,11,2,4,24,"2-2","Y","N","N",2,0,6
"222","E1",2023-09-17,"Millwall","Leeds",0,3,"A",0,1,"A",3.13,3.4,2.42,"0-1","0-3",12,3,14,3,0,0,0,0,8,9,13,9,3,17,22,"8-9","Y","Y","N",0,0,6
"223","E1",2023-09-19,"Bristol City","Plymouth",4,1,"H",3,1,"H",1.78,4.15,4.44,"3-1","4-1",17,6,6,2,3,0,0,0,7,1,9,13,5,8,22,"7-1","Y","Y","Y",3,0,7
"224","E1",2023-09-19,"Cardiff","Coventry",3,2,"H",1,1,"D",2.75,3.4,2.7,"1-1","3-2",8,3,7,3,2,3,0,0,3,5,7,8,5,8,15,"3-5","Y","Y","Y",5,0,7
"225","E1",2023-09-19,"Preston","Birmingham",2,1,"H",0,0,"D",2.4,3.2,3.35,"0-0","2-1",10,3,16,4,2,1,0,0,5,2,11,13,3,7,24,"5-2","Y","Y","N",3,0,7
"226","E1",2023-09-19,"QPR","Swansea",1,1,"D",0,1,"A",2.75,3.44,2.68,"0-1","1-1",11,3,8,3,1,1,0,1,4,6,12,17,2,10,29,"4-6","Y","N","N",2,1,7
"227","E1",2023-09-19,"Southampton","Ipswich",0,1,"A",0,1,"A",2.32,3.74,3.05,"0-1","0-1",13,3,11,3,2,2,0,0,9,3,9,13,1,12,22,"9-3","N","N","N",4,0,7
"228","E1",2023-09-19,"Sheffield Weds","Middlesbrough",1,1,"D",1,0,"H",3.46,3.6,2.17,"1-0","1-1",9,2,10,3,2,1,0,0,3,4,13,8,2,7,21,"3-4","Y","N","N",3,0,7
"229","E1",2023-09-20,"Blackburn","Sunderland",1,3,"A",1,2,"A",2.32,3.76,3.02,"1-2","1-3",22,6,13,4,5,3,0,0,8,4,14,11,4,12,25,"8-4","Y","Y","Y",8,0,7
"230","E1",2023-09-20,"Huddersfield","Stoke",2,2,"D",1,1,"D",2.83,3.45,2.6,"1-1","2-2",10,6,18,3,2,2,0,0,5,8,10,6,4,13,16,"5-8","Y","Y","Y",4,0,7
"231","E1",2023-09-20,"Hull","Leeds",0,0,"D",0,0,"D",3.9,3.73,1.98,"0-0","0-0",9,0,17,4,3,2,0,1,5,6,7,15,0,11,22,"5-6","N","N","N",5,1,7
"232","E1",2023-09-20,"Millwall","Rotherham",3,0,"H",1,0,"H",1.73,3.86,5.17,"1-0","3-0",20,8,5,1,1,1,0,0,6,1,12,16,3,7,28,"6-1","Y","Y","N",2,0,7
"233","E1",2023-09-20,"Watford","West Brom",2,2,"D",2,2,"D",2.22,3.49,3.45,"2-2","2-2",12,4,7,5,2,1,0,0,3,2,8,9,4,5,17,"3-2","Y","Y","Y",3,0,7
"234","E1",2023-09-20,"Norwich","Leicester",0,2,"A",0,1,"A",2.67,3.73,2.6,"0-1","0-2",15,2,10,3,3,4,0,0,10,1,14,15,2,11,29,"10-1","Y","N","N",7,0,7
"235","E1",2023-09-22,"Birmingham","QPR",0,0,"D",0,0,"D",1.86,3.61,4.65,"0-0","0-0",12,4,8,4,3,2,0,0,6,7,13,13,0,13,26,"6-7","N","N","N",5,0,8
"236","E1",2023-09-23,"Ipswich","Blackburn",4,3,"H",3,1,"H",1.7,4.26,4.77,"3-1","4-3",29,11,10,5,3,4,0,0,10,5,10,13,7,15,23,"10-5","Y","Y","Y",7,0,8
"237","E1",2023-09-23,"Leeds","Watford",3,0,"H",0,0,"D",1.75,4.09,4.64,"0-0","3-0",17,10,4,1,1,3,0,0,8,1,13,15,3,9,28,"8-1","Y","Y","N",4,0,8
"238","E1",2023-09-23,"Leicester","Bristol City",1,0,"H",0,0,"D",1.74,4.17,4.68,"0-0","1-0",19,7,6,1,1,2,0,0,9,0,11,10,1,9,21,"9-0","N","N","N",3,0,8
"239","E1",2023-09-23,"Middlesbrough","Southampton",2,1,"H",1,1,"D",2.5,3.62,2.85,"1-1","2-1",14,5,15,5,3,0,0,0,5,7,16,7,3,12,23,"5-7","Y","Y","N",3,0,8
"240","E1",2023-09-23,"Plymouth","Norwich",6,2,"H",4,0,"H",3.44,3.88,2.08,"4-0","6-2",16,10,11,6,1,0,0,0,3,6,9,6,8,9,15,"3-6","Y","Y","Y",1,0,8
"241","E1",2023-09-23,"Rotherham","Preston",1,1,"D",1,1,"D",3.44,3.28,2.31,"1-1","1-1",3,1,14,6,3,2,0,0,2,10,7,6,2,12,13,"2-10","Y","N","N",5,0,8
"242","E1",2023-09-23,"Swansea","Sheffield Weds",3,0,"H",1,0,"H",1.97,3.54,4.17,"1-0","3-0",12,4,10,1,2,2,0,0,2,5,12,16,3,7,28,"2-5","Y","Y","N",4,0,8
"243","E1",2023-09-23,"West Brom","Millwall",0,0,"D",0,0,"D",2.16,3.42,3.67,"0-0","0-0",16,3,7,2,0,2,0,0,6,8,8,12,0,14,20,"6-8","N","N","N",2,0,8
"244","E1",2023-09-24,"Stoke","Hull",1,3,"A",0,2,"A",1.95,3.78,3.97,"0-2","1-3",10,6,13,5,2,3,0,0,11,6,18,9,4,17,27,"11-6","Y","Y","Y",5,0,8
"245","E1",2023-09-24,"Sunderland","Cardiff",0,1,"A",0,0,"D",1.96,3.74,3.98,"0-0","0-1",16,6,7,2,2,2,0,0,4,4,6,14,1,8,20,"4-4","N","N","N",4,0,8
"246","E1",2023-09-25,"Coventry","Huddersfield",1,1,"D",1,0,"H",1.84,3.76,4.53,"1-0","1-1",11,3,10,4,2,3,0,0,10,4,12,14,2,14,26,"10-4","Y","N","N",5,0,8
"247","E1",2023-09-29,"Sheffield Weds","Sunderland",0,3,"A",0,3,"A",3.27,3.49,2.29,"0-3","0-3",8,2,12,6,2,0,0,0,2,5,14,5,3,7,19,"2-5","Y","Y","N",2,0,9
"248","E1",2023-09-30,"Southampton","Leeds",3,1,"H",3,0,"H",2.97,3.7,2.38,"3-0","3-1",10,5,15,5,4,1,0,0,5,6,14,13,4,11,27,"5-6","Y","Y","Y",5,0,9
"249","E1",2023-09-30,"Bristol City","Stoke",2,3,"A",2,1,"H",2.37,3.37,3.23,"2-1","2-3",13,5,6,4,1,1,0,0,11,3,9,13,5,14,22,"11-3","Y","Y","Y",2,0,9
"250","E1",2023-09-30,"Cardiff","Rotherham",2,0,"H",0,0,"D",1.71,3.94,5.2,"0-0","2-0",12,5,7,0,2,0,0,0,6,5,4,11,2,11,15,"6-5","Y","N","N",2,0,9
"251","E1",2023-09-30,"Huddersfield","Ipswich",1,1,"D",0,0,"D",3.88,3.89,1.94,"0-0","1-1",12,6,20,6,3,3,0,0,5,6,10,11,2,11,21,"5-6","Y","N","N",6,0,9
"252","E1",2023-09-30,"Hull","Plymouth",1,1,"D",1,1,"D",1.92,3.92,3.96,"1-1","1-1",21,5,11,5,2,2,0,0,12,4,9,10,2,16,19,"12-4","Y","N","N",4,0,9
"253","E1",2023-09-30,"Millwall","Swansea",0,3,"A",0,1,"A",2.1,3.43,3.85,"0-1","0-3",22,5,7,5,2,2,0,0,6,0,18,10,3,6,28,"6-0","Y","Y","N",4,0,9
"254","E1",2023-09-30,"Norwich","Birmingham",2,0,"H",0,0,"D",1.93,3.68,4.21,"0-0","2-0",16,4,12,2,1,1,0,0,4,4,9,10,2,8,19,"4-4","Y","N","N",2,0,9
"255","E1",2023-09-30,"Preston","West Brom",0,4,"A",0,2,"A",2.5,3.27,3.11,"0-2","0-4",5,1,19,6,3,1,0,0,2,6,12,5,4,8,17,"2-6","Y","Y","Y",4,0,9
"256","E1",2023-09-30,"QPR","Coventry",1,3,"A",0,0,"D",3.25,3.39,2.35,"0-0","1-3",12,3,15,6,4,2,0,0,4,5,11,14,4,9,25,"4-5","Y","Y","Y",6,0,9
"257","E1",2023-09-30,"Watford","Middlesbrough",2,3,"A",1,2,"A",2.46,3.53,2.96,"1-2","2-3",17,4,9,3,2,0,0,0,9,3,10,15,5,12,25,"9-3","Y","Y","Y",2,0,9
"258","E1",2023-10-01,"Blackburn","Leicester",1,4,"A",1,2,"A",3.53,3.82,2.07,"1-2","1-4",15,4,11,4,2,3,0,0,5,6,8,14,5,11,22,"5-6","Y","Y","Y",5,0,9
"259","E1",2023-10-03,"Birmingham","Huddersfield",4,1,"H",2,0,"H",2.3,3.34,3.4,"2-0","4-1",12,6,17,6,3,1,0,0,3,5,14,13,5,8,27,"3-5","Y","Y","Y",4,0,10
"260","E1",2023-10-03,"Ipswich","Hull",3,0,"H",2,0,"H",1.76,3.99,4.74,"2-0","3-0",14,6,13,6,0,0,0,0,6,5,16,11,3,11,27,"6-5","Y","Y","N",0,0,10
"261","E1",2023-10-03,"Middlesbrough","Cardiff",2,0,"H",0,0,"D",1.91,3.84,4.09,"0-0","2-0",11,6,6,3,1,3,0,0,8,2,10,10,2,10,20,"8-2","Y","N","N",4,0,10
"262","E1",2023-10-03,"Plymouth","Millwall",0,2,"A",0,0,"D",2.49,3.58,2.89,"0-0","0-2",22,6,9,3,2,6,0,0,8,1,5,14,2,9,19,"8-1","Y","N","N",8,0,10
"263","E1",2023-10-03,"Stoke","Southampton",0,1,"A",0,1,"A",2.78,3.46,2.64,"0-1","0-1",15,2,9,4,4,1,0,0,8,6,17,2,1,14,19,"8-6","N","N","N",5,0,10
"264","E1",2023-10-03,"West Brom","Sheffield Weds",1,0,"H",1,0,"H",1.61,3.94,6.36,"1-0","1-0",17,3,4,2,0,1,0,0,10,4,2,12,1,14,14,"10-4","N","N","N",1,0,10
"265","E1",2023-10-04,"Coventry","Blackburn",1,0,"H",0,0,"D",2.11,3.73,3.5,"0-0","1-0",14,3,14,4,2,1,0,0,7,8,18,13,1,15,31,"7-8","N","N","N",3,0,10
"266","E1",2023-10-04,"Leeds","QPR",1,0,"H",1,0,"H",1.36,5.53,8.65,"1-0","1-0",16,3,5,2,0,2,0,1,8,0,9,12,1,8,21,"8-0","N","N","N",2,1,10
"267","E1",2023-10-04,"Leicester","Preston",3,0,"H",0,0,"D",1.49,4.52,7.13,"0-0","3-0",9,4,6,1,0,2,0,0,4,4,3,8,3,8,11,"4-4","Y","Y","N",2,0,10
"268","E1",2023-10-04,"Sunderland","Watford",2,0,"H",1,0,"H",1.93,3.71,4.16,"1-0","2-0",9,4,11,4,1,5,0,1,5,2,9,19,2,7,28,"5-2","Y","N","N",6,1,10
"269","E1",2023-10-04,"Swansea","Norwich",2,1,"H",1,1,"D",2.94,3.47,2.51,"1-1","2-1",23,7,14,5,4,2,0,0,8,7,12,12,3,15,24,"8-7","Y","Y","N",6,0,10
"270","E1",2023-10-04,"Rotherham","Bristol City",1,2,"A",0,0,"D",4.01,3.37,2.07,"0-0","1-2",8,1,9,5,1,1,0,0,4,4,3,7,3,8,10,"4-4","Y","Y","N",2,0,10
"271","E1",2023-10-06,"Birmingham","West Brom",3,1,"H",2,1,"H",2.95,3.17,2.68,"2-1","3-1",11,3,10,3,2,1,0,0,6,8,16,6,4,14,22,"6-8","Y","Y","Y",3,0,11
"272","E1",2023-10-07,"Sunderland","Middlesbrough",0,4,"A",0,0,"D",2.4,3.53,3.05,"0-0","0-4",9,3,19,7,3,2,1,0,4,8,14,13,4,12,27,"4-8","Y","Y","Y",5,1,11
"273","E1",2023-10-07,"Cardiff","Watford",1,1,"D",1,0,"H",2.52,3.25,3.09,"1-0","1-1",8,2,8,1,0,2,0,0,2,1,9,10,2,3,19,"2-1","Y","N","N",2,0,11
"274","E1",2023-10-07,"Coventry","Norwich",1,1,"D",0,1,"A",2.57,3.41,2.9,"0-1","1-1",21,3,6,2,1,1,0,0,8,0,11,13,2,8,24,"8-0","Y","N","N",2,0,11
"275","E1",2023-10-07,"Ipswich","Preston",4,2,"H",3,1,"H",1.64,4.14,5.61,"3-1","4-2",16,10,8,2,0,3,0,0,7,0,10,11,6,7,21,"7-0","Y","Y","Y",3,0,11
"276","E1",2023-10-07,"Leeds","Bristol City",2,1,"H",1,1,"D",1.58,4.45,5.77,"1-1","2-1",21,8,9,2,1,2,0,0,8,6,10,8,3,14,18,"8-6","Y","Y","N",3,0,11
"277","E1",2023-10-07,"Leicester","Stoke",2,0,"H",1,0,"H",1.55,4.48,6.15,"1-0","2-0",14,7,3,1,1,1,0,0,4,4,6,5,2,8,11,"4-4","Y","N","N",2,0,11
"278","E1",2023-10-07,"Millwall","Hull",2,2,"D",1,2,"A",2.32,3.48,3.23,"1-2","2-2",13,4,8,3,4,2,0,0,5,1,18,7,4,6,25,"5-1","Y","Y","Y",6,0,11
"279","E1",2023-10-07,"Plymouth","Swansea",1,3,"A",1,0,"H",2.46,3.65,2.89,"1-0","1-3",16,7,14,6,2,0,0,0,12,7,11,5,4,19,16,"12-7","Y","Y","Y",2,0,11
"280","E1",2023-10-07,"QPR","Blackburn",0,4,"A",0,2,"A",3.02,3.65,2.36,"0-2","0-4",21,6,17,7,2,2,0,0,10,7,13,10,4,17,23,"10-7","Y","Y","Y",4,0,11
"281","E1",2023-10-07,"Sheffield Weds","Huddersfield",0,0,"D",0,0,"D",2.66,3.4,2.79,"0-0","0-0",6,1,7,0,1,1,0,0,5,4,16,13,0,9,29,"5-4","N","N","N",2,0,11
"282","E1",2023-10-07,"Southampton","Rotherham",1,1,"D",1,0,"H",1.35,5.51,9.29,"1-0","1-1",22,10,4,2,2,6,0,0,12,4,8,13,2,16,21,"12-4","Y","N","N",8,0,11
"283","E1",2023-10-21,"Preston","Millwall",1,1,"D",1,1,"D",2.52,3.18,3.17,"1-1","1-1",7,2,7,4,4,1,0,0,5,2,13,15,2,7,28,"5-2","Y","N","N",5,0,12
"284","E1",2023-10-21,"Blackburn","Cardiff",1,0,"H",0,0,"D",2.09,3.79,3.51,"0-0","1-0",9,1,11,2,2,1,0,0,4,6,8,8,1,10,16,"4-6","N","N","N",3,0,12
"285","E1",2023-10-21,"Bristol City","Coventry",1,0,"H",1,0,"H",2.47,3.49,2.97,"1-0","1-0",6,3,12,1,2,3,0,0,2,15,15,11,1,17,26,"2-15","N","N","N",5,0,12
"286","E1",2023-10-21,"Huddersfield","QPR",2,1,"H",2,1,"H",1.95,3.64,4.13,"2-1","2-1",6,4,14,2,2,2,0,0,2,9,9,12,3,11,21,"2-9","Y","Y","N",4,0,12
"287","E1",2023-10-21,"Hull","Southampton",1,2,"A",1,1,"D",2.97,3.58,2.43,"1-1","1-2",13,3,18,5,4,3,0,0,7,9,13,14,3,16,27,"7-9","Y","Y","N",7,0,12
"288","E1",2023-10-21,"Middlesbrough","Birmingham",1,0,"H",0,0,"D",1.79,3.89,4.64,"0-0","1-0",17,10,5,3,3,3,0,0,12,0,9,17,1,12,26,"12-0","N","N","N",6,0,12
"289","E1",2023-10-21,"Norwich","Leeds",2,3,"A",2,0,"H",3.21,3.72,2.23,"2-0","2-3",14,4,19,8,2,3,0,0,7,7,11,13,5,14,24,"7-7","Y","Y","Y",5,0,12
"290","E1",2023-10-21,"Stoke","Sunderland",2,1,"H",1,1,"D",2.55,3.56,2.82,"1-1","2-1",11,4,18,7,5,4,0,0,6,2,17,9,3,8,26,"6-2","Y","Y","N",9,0,12
"291","E1",2023-10-21,"Swansea","Leicester",1,3,"A",1,1,"D",4.59,3.97,1.78,"1-1","1-3",11,4,18,7,2,3,0,0,3,3,10,5,4,6,15,"3-3","Y","Y","Y",5,0,12
"292","E1",2023-10-21,"Watford","Sheffield Weds",1,0,"H",0,0,"D",1.72,3.78,5.34,"0-0","1-0",12,3,10,2,2,1,0,0,4,5,15,6,1,9,21,"4-5","N","N","N",3,0,12
"293","E1",2023-10-21,"West Brom","Plymouth",0,0,"D",0,0,"D",1.73,4.04,4.88,"0-0","0-0",14,2,5,2,2,7,0,0,10,5,4,14,0,15,18,"10-5","N","N","N",9,0,12
"294","E1",2023-10-24,"Huddersfield","Cardiff",0,4,"A",0,3,"A",2.41,3.29,3.23,"0-3","0-4",19,6,15,7,1,3,0,0,9,6,7,19,4,15,26,"9-6","Y","Y","Y",4,0,12
"295","E1",2023-10-24,"Millwall","Blackburn",1,2,"A",1,1,"D",2.52,3.54,2.87,"1-1","1-2",16,3,9,6,0,1,0,0,11,3,6,6,3,14,12,"11-3","Y","Y","N",1,0,13
"296","E1",2023-10-24,"Norwich","Middlesbrough",1,2,"A",0,0,"D",2.83,3.68,2.48,"0-0","1-2",13,2,19,8,2,2,0,0,4,7,13,10,3,11,23,"4-7","Y","Y","N",4,0,13
"297","E1",2023-10-24,"Swansea","Watford",0,1,"A",0,0,"D",2.41,3.36,3.17,"0-0","0-1",9,3,12,5,0,3,0,0,6,4,7,14,1,10,21,"6-4","N","N","N",3,0,13
"298","E1",2023-10-24,"Leicester","Sunderland",1,0,"H",1,0,"H",1.53,4.61,6.18,"1-0","1-0",8,5,13,3,4,3,0,0,5,5,13,10,1,10,23,"5-5","N","N","N",7,0,13
"299","E1",2023-10-24,"West Brom","QPR",2,0,"H",0,0,"D",1.63,4.08,5.78,"0-0","2-0",16,4,1,0,1,3,0,1,6,2,8,12,2,8,20,"6-2","Y","N","N",4,1,13
"300","E1",2023-10-25,"Birmingham","Hull",0,2,"A",0,1,"A",2.38,3.36,3.22,"0-1","0-2",14,4,17,8,2,1,0,0,6,5,18,8,2,11,26,"6-5","Y","N","N",3,0,13
"301","E1",2023-10-25,"Bristol City","Ipswich",0,1,"A",0,1,"A",3.55,3.73,2.09,"0-1","0-1",11,4,19,6,0,4,0,0,5,2,11,15,1,7,26,"5-2","N","N","N",4,0,13
"302","E1",2023-10-25,"Plymouth","Sheffield Weds",3,0,"H",2,0,"H",2.06,3.6,3.77,"2-0","3-0",13,6,13,2,2,1,0,0,1,7,10,8,3,8,18,"1-7","Y","Y","N",3,0,13
"303","E1",2023-10-25,"Preston","Southampton",2,2,"D",0,1,"A",3.54,3.59,2.14,"0-1","2-2",12,5,13,5,3,2,0,0,7,2,16,13,4,9,29,"7-2","Y","Y","Y",5,0,13
"304","E1",2023-10-25,"Rotherham","Coventry",2,0,"H",0,0,"D",4.2,3.66,1.93,"0-0","2-0",20,7,23,7,2,1,0,0,6,16,4,6,2,22,10,"6-16","Y","N","N",3,0,13
"305","E1",2023-10-25,"Stoke","Leeds",1,0,"H",0,0,"D",3.96,3.73,1.97,"0-0","1-0",12,4,16,3,1,3,0,0,5,3,16,11,1,8,27,"5-3","N","N","N",4,0,13
"306","E1",2023-10-28,"Leeds","Huddersfield",4,1,"H",4,0,"H",1.36,5.44,8.71,"4-0","4-1",20,5,5,2,0,4,0,0,4,2,7,11,5,6,18,"4-2","Y","Y","Y",4,0,13
"307","E1",2023-10-28,"Southampton","Birmingham",3,1,"H",2,0,"H",1.62,4.27,5.54,"2-0","3-1",11,5,10,2,0,4,0,0,4,4,8,12,4,8,20,"4-4","Y","Y","Y",4,0,14
"308","E1",2023-10-28,"Blackburn","Swansea",0,1,"A",0,1,"A",2.01,3.93,3.62,"0-1","0-1",20,6,16,4,5,3,0,0,6,5,15,7,1,11,22,"6-5","N","N","N",8,0,14
"309","E1",2023-10-28,"Cardiff","Bristol City",2,0,"H",1,0,"H",2.29,3.35,3.41,"1-0","2-0",9,7,8,1,1,2,0,0,4,3,9,9,2,7,18,"4-3","Y","N","N",3,0,14
"310","E1",2023-10-28,"Hull","Preston",1,0,"H",0,0,"D",2.09,3.45,3.83,"0-0","1-0",19,6,11,4,3,3,0,0,7,2,13,13,1,9,26,"7-2","N","N","N",6,0,14
"311","E1",2023-10-28,"Ipswich","Plymouth",3,2,"H",1,1,"D",1.4,5.41,7.45,"1-1","3-2",15,4,10,6,4,2,0,0,11,3,11,7,5,14,18,"11-3","Y","Y","Y",6,0,14
"312","E1",2023-10-28,"Middlesbrough","Stoke",0,2,"A",0,2,"A",1.81,3.9,4.56,"0-2","0-2",9,3,13,6,2,2,0,0,8,4,12,16,2,12,28,"8-4","Y","N","N",4,0,14
"313","E1",2023-10-28,"QPR","Leicester",1,2,"A",1,1,"D",8.06,5.21,1.4,"1-1","1-2",9,3,16,5,1,2,1,0,1,8,13,7,3,9,20,"1-8","Y","Y","N",3,1,14
"314","E1",2023-10-28,"Sunderland","Norwich",3,1,"H",2,1,"H",2.1,3.72,3.52,"2-1","3-1",17,8,9,2,4,4,0,0,7,1,12,17,4,8,29,"7-1","Y","Y","Y",8,0,14
"315","E1",2023-10-28,"Watford","Millwall",2,2,"D",1,1,"D",2.1,3.34,3.95,"1-1","2-2",19,6,11,4,3,3,0,0,7,2,13,13,4,9,26,"7-2","Y","Y","Y",6,0,14
"316","E1",2023-10-29,"Sheffield Weds","Rotherham",2,0,"H",2,0,"H",1.89,3.49,4.65,"2-0","2-0",14,5,6,0,2,3,0,0,4,3,9,16,2,7,25,"4-3","Y","N","N",5,0,14
"317","E1",2023-10-30,"Coventry","West Brom",0,2,"A",0,1,"A",2.33,3.33,3.28,"0-1","0-2",15,3,7,3,2,6,0,0,5,5,9,7,2,10,16,"5-5","Y","N","N",8,0,14
"318","E1",2023-11-03,"Leicester","Leeds",0,1,"A",0,0,"D",2.24,3.67,3.24,"0-0","0-1",10,1,11,6,1,2,0,0,7,6,6,8,1,13,14,"7-6","N","N","N",3,0,14
"319","E1",2023-11-04,"Birmingham","Ipswich",2,2,"D",1,0,"H",4.09,3.86,1.9,"1-0","2-2",13,3,17,7,3,1,0,0,7,8,9,11,4,15,20,"7-8","Y","Y","Y",4,0,15
"320","E1",2023-11-04,"Bristol City","Sheffield Weds",1,0,"H",0,0,"D",2.15,3.36,3.77,"0-0","1-0",17,7,6,2,3,1,0,1,8,7,10,14,1,15,24,"8-7","N","N","N",4,1,15
"321","E1",2023-11-04,"Huddersfield","Watford",0,0,"D",0,0,"D",3.27,3.45,2.31,"0-0","0-0",5,2,9,3,0,2,0,0,1,3,6,20,0,4,26,"1-3","N","N","N",2,0,15
"322","E1",2023-11-04,"Millwall","Southampton",0,1,"A",0,0,"D",3.55,3.68,2.11,"0-0","0-1",7,1,16,8,2,2,0,0,5,12,10,10,1,17,20,"5-12","N","N","N",4,0,15
"323","E1",2023-11-04,"Plymouth","Middlesbrough",3,3,"D",2,1,"H",3.8,3.98,1.94,"2-1","3-3",10,5,20,11,2,3,0,0,8,6,15,15,6,14,30,"8-6","Y","Y","Y",5,0,15
"324","E1",2023-11-04,"Preston","Coventry",3,2,"H",2,1,"H",2.92,3.2,2.69,"2-1","3-2",16,7,18,8,2,2,0,0,6,8,14,15,5,14,29,"6-8","Y","Y","Y",4,0,15
"325","E1",2023-11-04,"Rotherham","QPR",1,1,"D",0,0,"D",2.77,3.26,2.79,"0-0","1-1",8,3,11,4,2,1,0,0,6,6,10,14,2,12,24,"6-6","Y","N","N",3,0,15
"326","E1",2023-11-04,"Stoke","Cardiff",0,0,"D",0,0,"D",2.18,3.42,3.61,"0-0","0-0",7,1,11,3,1,0,0,0,1,7,16,6,0,8,22,"1-7","N","N","N",1,0,15
"327","E1",2023-11-04,"Swansea","Sunderland",0,0,"D",0,0,"D",2.8,3.49,2.61,"0-0","0-0",3,2,25,3,2,3,1,0,2,8,13,12,0,10,25,"2-8","N","N","N",5,1,15
"328","E1",2023-11-04,"West Brom","Hull",3,1,"H",1,1,"D",2.07,3.48,3.86,"1-1","3-1",10,5,9,4,1,1,0,0,1,2,10,12,4,3,22,"1-2","Y","Y","Y",2,0,15
"329","E1",2023-11-05,"Norwich","Blackburn",1,3,"A",0,2,"A",2.17,3.94,3.18,"0-2","1-3",21,8,10,4,3,2,0,1,8,2,11,4,4,10,15,"8-2","Y","Y","Y",5,1,15
"330","E1",2023-11-07,"Rotherham","Ipswich",2,2,"D",1,1,"D",6.51,4.47,1.53,"1-1","2-2",8,3,13,3,1,1,0,0,6,8,12,10,4,14,22,"6-8","Y","Y","Y",2,0,15
"331","E1",2023-11-10,"Blackburn","Preston",1,2,"A",0,1,"A",1.97,3.65,4.02,"0-1","1-2",22,5,9,4,0,1,0,0,7,2,9,13,3,9,22,"7-2","Y","Y","N",1,0,16
"332","E1",2023-11-11,"Sunderland","Birmingham",3,1,"H",1,1,"D",1.76,3.92,4.86,"1-1","3-1",22,6,16,7,2,2,0,0,10,5,5,13,4,15,18,"10-5","Y","Y","Y",4,0,16
"333","E1",2023-11-11,"Cardiff","Norwich",2,3,"A",2,1,"H",2.03,3.8,3.66,"2-1","2-3",13,6,20,8,2,2,0,0,2,9,10,6,5,11,16,"2-9","Y","Y","Y",4,0,16
"334","E1",2023-11-11,"Coventry","Stoke",0,0,"D",0,0,"D",2.32,3.4,3.3,"0-0","0-0",13,2,6,2,1,1,0,0,4,4,14,16,0,8,30,"4-4","N","N","N",2,0,16
"335","E1",2023-11-11,"Hull","Huddersfield",1,0,"H",0,0,"D",1.78,3.71,5.06,"0-0","1-0",20,5,2,1,2,3,0,0,9,1,10,10,1,10,20,"9-1","N","N","N",5,0,16
"336","E1",2023-11-11,"Ipswich","Swansea",3,2,"H",2,1,"H",1.61,4.43,5.46,"2-1","3-2",22,9,7,4,2,1,0,1,6,2,15,9,5,8,24,"6-2","Y","Y","Y",3,1,16
"337","E1",2023-11-11,"Leeds","Plymouth",2,1,"H",2,0,"H",1.27,6.68,10.06,"2-0","2-1",14,6,9,3,1,4,0,0,7,6,10,10,3,13,20,"7-6","Y","Y","N",5,0,16
"338","E1",2023-11-11,"Middlesbrough","Leicester",1,0,"H",0,0,"D",3.02,3.61,2.38,"0-0","1-0",9,6,12,4,4,3,0,0,3,4,18,15,1,7,33,"3-4","N","N","N",7,0,16
"339","E1",2023-11-11,"QPR","Bristol City",0,0,"D",0,0,"D",2.81,3.3,2.72,"0-0","0-0",7,0,7,2,2,2,0,0,5,2,12,16,0,7,28,"5-2","N","N","N",4,0,16
"340","E1",2023-11-11,"Sheffield Weds","Millwall",0,4,"A",0,2,"A",2.76,3.04,2.97,"0-2","0-4",12,2,13,6,2,2,0,0,8,4,13,8,4,12,21,"8-4","Y","Y","Y",4,0,16
"341","E1",2023-11-11,"Southampton","West Brom",2,1,"H",1,0,"H",1.88,3.76,4.31,"1-0","2-1",10,3,14,2,3,0,0,0,3,10,7,10,3,13,17,"3-10","Y","Y","N",3,0,16
"342","E1",2023-11-11,"Watford","Rotherham",5,0,"H",2,0,"H",1.49,4.43,7.55,"2-0","5-0",14,8,9,2,2,1,0,0,7,2,12,11,5,9,23,"7-2","Y","Y","Y",3,0,16
"343","E1",2023-11-24,"Rotherham","Leeds",1,1,"D",1,1,"D",9.25,5.33,1.36,"1-1","1-1",6,3,18,5,0,0,0,0,4,3,11,4,2,7,15,"4-3","Y","N","N",0,0,17
"344","E1",2023-11-25,"Birmingham","Sheffield Weds",2,1,"H",1,1,"D",2.19,3.26,3.79,"1-1","2-1",13,4,16,4,1,0,0,0,6,6,11,11,3,12,22,"6-6","Y","Y","N",1,0,17
"345","E1",2023-11-25,"Bristol City","Middlesbrough",3,2,"H",2,0,"H",3.59,3.49,2.16,"2-0","3-2",10,8,12,4,2,2,0,0,3,8,8,12,5,11,20,"3-8","Y","Y","Y",4,0,17
"346","E1",2023-11-25,"Huddersfield","Southampton",1,1,"D",0,1,"A",4.96,4.07,1.71,"0-1","1-1",10,2,16,4,4,1,0,0,2,7,5,11,2,9,16,"2-7","Y","N","N",5,0,17
"347","E1",2023-11-25,"Leicester","Watford",2,0,"H",0,0,"D",1.61,4.15,5.96,"0-0","2-0",23,8,9,1,2,5,0,1,6,2,5,14,2,8,19,"6-2","Y","N","N",7,1,17
"348","E1",2023-11-25,"Millwall","Coventry",0,3,"A",0,1,"A",2.76,3.27,2.78,"0-1","0-3",20,5,11,9,2,1,0,0,4,3,12,10,3,7,22,"4-3","Y","Y","N",3,0,17
"349","E1",2023-11-25,"Norwich","QPR",1,0,"H",1,0,"H",1.79,3.95,4.56,"1-0","1-0",7,1,9,3,4,4,0,0,4,7,18,12,1,11,30,"4-7","N","N","N",8,0,17
"350","E1",2023-11-25,"Plymouth","Sunderland",2,0,"H",2,0,"H",3.45,3.96,2.06,"2-0","2-0",10,2,24,5,4,1,0,0,4,14,12,5,2,18,17,"4-14","Y","N","N",5,0,17
"351","E1",2023-11-25,"Preston","Cardiff",1,2,"A",0,0,"D",2.47,3.21,3.2,"0-0","1-2",4,2,19,8,3,1,1,0,6,13,9,6,3,19,15,"6-13","Y","Y","N",4,1,17
"352","E1",2023-11-25,"Stoke","Blackburn",0,3,"A",0,1,"A",2.22,3.72,3.24,"0-1","0-3",12,1,7,4,2,1,0,0,7,1,11,9,3,8,20,"7-1","Y","Y","N",3,0,17
"353","E1",2023-11-25,"Swansea","Hull",2,2,"D",2,0,"H",2.63,3.33,2.88,"2-0","2-2",14,4,18,9,0,2,0,0,2,1,12,11,4,3,23,"2-1","Y","Y","Y",2,0,17
"354","E1",2023-11-25,"West Brom","Ipswich",2,0,"H",1,0,"H",2.72,3.55,2.64,"1-0","2-0",10,4,6,0,1,2,0,0,4,5,5,12,2,9,17,"4-5","Y","N","N",3,0,17
"355","E1",2023-11-28,"Cardiff","West Brom",0,1,"A",0,0,"D",3.03,3.2,2.6,"0-0","0-1",11,1,8,1,1,2,0,0,6,3,7,9,1,9,16,"6-3","N","N","N",3,0,18
"356","E1",2023-11-28,"Coventry","Plymouth",1,0,"H",0,0,"D",1.65,4.38,5.07,"0-0","1-0",13,3,13,3,1,3,0,0,7,6,10,11,1,13,21,"7-6","N","N","N",4,0,18
"357","E1",2023-11-28,"Hull","Rotherham",4,1,"H",3,0,"H",1.44,4.66,8,"3-0","4-1",22,12,9,3,1,2,0,0,8,4,5,8,5,12,13,"8-4","Y","Y","Y",3,0,18
"358","E1",2023-11-28,"Middlesbrough","Preston",4,0,"H",3,0,"H",1.69,3.89,5.42,"3-0","4-0",13,8,6,1,0,2,0,0,7,3,15,14,4,10,29,"7-3","Y","Y","Y",2,0,18
"359","E1",2023-11-28,"QPR","Stoke",4,2,"H",1,1,"D",3.29,3.27,2.39,"1-1","4-2",19,9,12,4,2,5,0,1,13,7,13,11,6,20,24,"13-7","Y","Y","Y",7,1,18
"360","E1",2023-11-28,"Watford","Norwich",3,2,"H",2,2,"D",2.19,3.57,3.44,"2-2","3-2",21,9,12,5,1,4,0,0,7,5,14,12,5,12,26,"7-5","Y","Y","Y",5,0,18
"361","E1",2023-11-29,"Blackburn","Birmingham",4,2,"H",0,0,"D",1.8,4.02,4.44,"0-0","4-2",11,6,26,6,4,2,0,0,8,9,12,6,6,17,18,"8-9","Y","Y","Y",6,0,18
"362","E1",2023-11-29,"Leeds","Swansea",3,1,"H",2,1,"H",1.37,5.52,8.43,"2-1","3-1",18,8,10,2,0,1,0,0,6,5,12,11,4,11,23,"6-5","Y","Y","Y",1,0,18
"363","E1",2023-11-29,"Sheffield Weds","Leicester",1,1,"D",0,1,"A",5.84,4.22,1.61,"0-1","1-1",14,7,12,3,2,1,0,0,5,4,10,7,2,9,17,"5-4","Y","N","N",3,0,18
"364","E1",2023-11-29,"Southampton","Bristol City",1,0,"H",0,0,"D",1.59,4.33,5.8,"0-0","1-0",14,5,8,1,3,1,0,0,6,3,11,14,1,9,25,"6-3","N","N","N",4,0,18
"365","E1",2023-11-29,"Sunderland","Huddersfield",1,2,"A",1,1,"D",1.54,4.44,6.29,"1-1","1-2",27,9,9,5,2,1,0,0,10,4,12,11,3,14,23,"10-4","Y","Y","N",3,0,18
"366","E1",2023-11-29,"Ipswich","Millwall",3,1,"H",3,0,"H",1.6,4.28,5.84,"3-0","3-1",19,7,5,3,2,3,0,0,4,2,9,13,4,6,22,"4-2","Y","Y","Y",5,0,18
"367","E1",2023-12-01,"Preston","QPR",0,2,"A",0,0,"D",2.25,3.22,3.67,"0-0","0-2",7,1,8,5,1,1,0,0,6,4,11,11,2,10,22,"6-4","Y","N","N",2,0,19
"368","E1",2023-12-02,"West Brom","Leicester",1,2,"A",0,0,"D",3.02,3.23,2.59,"0-0","1-2",9,3,9,3,2,1,0,0,4,6,10,11,3,10,21,"4-6","Y","Y","N",3,0,19
"369","E1",2023-12-02,"Birmingham","Rotherham",0,0,"D",0,0,"D",1.62,4.3,5.49,"0-0","0-0",12,4,12,4,1,3,0,0,4,6,11,17,0,10,28,"4-6","N","N","N",4,0,19
"370","E1",2023-12-02,"Hull","Watford",1,2,"A",1,1,"D",2.2,3.46,3.5,"1-1","1-2",23,7,10,4,1,2,0,0,8,2,7,12,3,10,19,"8-2","Y","Y","N",3,0,19
"371","E1",2023-12-02,"Ipswich","Coventry",2,1,"H",2,0,"H",1.81,4.08,4.3,"2-0","2-1",13,3,15,1,2,1,0,0,1,6,14,11,3,7,25,"1-6","Y","Y","N",3,0,19
"372","E1",2023-12-02,"Leeds","Middlesbrough",3,2,"H",3,2,"H",1.74,4.15,4.68,"3-2","3-2",20,9,11,5,2,5,0,1,6,3,12,15,5,9,27,"6-3","Y","Y","Y",7,1,19
"373","E1",2023-12-02,"Millwall","Sunderland",1,1,"D",1,0,"H",3.09,3.48,2.4,"1-0","1-1",7,4,10,3,5,3,0,0,4,4,14,12,2,8,26,"4-4","Y","N","N",8,0,19
"374","E1",2023-12-02,"Plymouth","Stoke",2,1,"H",1,1,"D",2.73,3.55,2.63,"1-1","2-1",16,8,9,4,1,2,0,0,7,8,3,15,3,15,18,"7-8","Y","Y","N",3,0,19
"375","E1",2023-12-02,"Sheffield Weds","Blackburn",3,1,"H",1,0,"H",2.93,3.65,2.42,"1-0","3-1",13,8,18,5,2,1,0,0,3,7,12,6,4,10,18,"3-7","Y","Y","Y",3,0,19
"376","E1",2023-12-02,"Southampton","Cardiff",2,0,"H",2,0,"H",1.67,4.11,5.28,"2-0","2-0",18,6,10,3,1,1,0,0,7,3,6,9,2,10,15,"7-3","Y","N","N",2,0,19
"377","E1",2023-12-02,"Swansea","Huddersfield",1,1,"D",0,1,"A",1.95,3.63,4.13,"0-1","1-1",22,5,5,3,1,2,0,0,19,1,11,9,2,20,20,"19-1","Y","N","N",3,0,19
"378","E1",2023-12-03,"Bristol City","Norwich",1,2,"A",1,0,"H",2.33,3.52,3.19,"1-0","1-2",15,6,12,3,1,1,0,0,6,6,5,7,3,12,12,"6-6","Y","Y","N",2,0,19
"379","E2",2023-08-05,"Barnsley","Port Vale",7,0,"H",2,0,"H",1.8,3.72,4.72,"2-0","7-0",12,8,13,4,6,2,0,0,3,6,15,14,7,9,29,"3-6","Y","Y","Y",8,0,1
"380","E2",2023-08-05,"Blackpool","Burton",2,0,"H",2,0,"H",1.61,4.33,5.45,"2-0","2-0",15,4,9,3,4,1,0,0,7,4,10,12,2,11,22,"7-4","Y","N","N",5,0,1
"381","E2",2023-08-05,"Bolton","Lincoln",3,0,"H",1,0,"H",1.66,3.74,5.02,"1-0","3-0",16,4,6,0,3,3,0,0,10,1,19,16,3,11,35,"10-1","Y","Y","N",6,0,1
"382","E2",2023-08-05,"Cambridge","Oxford",2,0,"H",2,0,"H",3.25,3.34,2.31,"2-0","2-0",10,6,10,3,4,1,0,0,2,10,9,10,2,12,19,"2-10","Y","N","N",5,0,1
"383","E2",2023-08-05,"Carlisle","Fleetwood Town",1,1,"D",1,1,"D",2.27,3.41,3.33,"1-1","1-1",15,6,13,5,2,3,0,0,5,2,8,18,2,7,26,"5-2","Y","N","N",5,0,1
"384","E2",2023-08-05,"Charlton","Leyton Orient",1,0,"H",1,0,"H",2.18,3.48,3.49,"1-0","1-0",13,5,8,3,3,2,0,0,2,3,9,14,1,5,23,"2-3","N","N","N",5,0,1
"385","E2",2023-08-05,"Derby","Wigan",1,2,"A",0,1,"A",1.68,3.97,5.27,"0-1","1-2",21,5,7,3,2,2,0,0,11,4,11,6,3,15,17,"11-4","Y","Y","N",4,0,1
"386","E2",2023-08-05,"Northampton","Stevenage",0,1,"A",0,0,"D",2.68,3.17,2.9,"0-0","0-1",8,0,14,5,2,3,0,0,7,4,13,12,1,11,25,"7-4","N","N","N",5,0,1
"387","E2",2023-08-05,"Portsmouth","Bristol Rvs",1,1,"D",0,1,"A",1.92,3.71,4.09,"0-1","1-1",21,5,10,6,4,3,0,0,11,3,14,13,2,14,27,"11-3","Y","N","N",7,0,1
"388","E2",2023-08-05,"Reading","Peterboro",0,1,"A",0,1,"A",3.15,3.5,2.33,"0-1","0-1",15,4,13,6,6,4,0,0,6,6,12,9,1,12,21,"6-6","N","N","N",10,0,1
"389","E2",2023-08-05,"Shrewsbury","Cheltenham",1,0,"H",0,0,"D",2.34,3.28,3.31,"0-0","1-0",12,3,16,4,3,2,0,0,5,4,10,7,1,9,17,"5-4","N","N","N",5,0,1
"390","E2",2023-08-05,"Wycombe","Exeter",0,3,"A",0,2,"A",1.93,3.68,4.07,"0-2","0-3",10,1,11,7,2,2,0,0,4,5,11,12,3,9,23,"4-5","Y","Y","N",4,0,1
"391","E2",2023-08-12,"Bristol Rvs","Barnsley",1,1,"D",0,1,"A",3.18,3.47,2.32,"0-1","1-1",15,4,9,3,0,3,0,0,7,2,13,10,2,9,23,"7-2","Y","N","N",3,0,2
"392","E2",2023-08-12,"Burton","Derby",0,3,"A",0,1,"A",4.22,3.84,1.85,"0-1","0-3",14,2,8,5,1,3,0,0,6,2,12,7,3,8,19,"6-2","Y","Y","N",4,0,2
"393","E2",2023-08-12,"Cheltenham","Bolton",0,3,"A",0,3,"A",4.17,3.51,1.96,"0-3","0-3",5,2,16,7,2,1,0,0,3,9,7,9,3,12,16,"3-9","Y","Y","N",3,0,2
"394","E2",2023-08-12,"Exeter","Blackpool",0,0,"D",0,0,"D",2.96,3.32,2.54,"0-0","0-0",11,1,4,3,2,1,0,0,6,7,6,7,0,13,13,"6-7","N","N","N",3,0,2
"395","E2",2023-08-12,"Fleetwood Town","Cambridge",0,2,"A",0,1,"A",2.21,3.33,3.56,"0-1","0-2",13,2,16,7,3,3,0,0,9,6,16,14,2,15,30,"9-6","Y","N","N",6,0,2
"396","E2",2023-08-12,"Leyton Orient","Portsmouth",0,4,"A",0,2,"A",2.77,3.51,2.53,"0-2","0-4",11,3,10,4,2,2,0,0,3,3,10,8,4,6,18,"3-3","Y","Y","Y",4,0,2
"397","E2",2023-08-12,"Lincoln","Wycombe",3,0,"H",0,0,"D",2.52,3.27,3.03,"0-0","3-0",14,8,7,4,2,2,0,0,3,6,11,12,3,9,23,"3-6","Y","Y","N",4,0,2
"398","E2",2023-08-12,"Oxford","Carlisle",1,0,"H",0,0,"D",1.79,3.81,4.68,"0-0","1-0",14,3,8,0,0,4,0,0,5,4,9,17,1,9,26,"5-4","N","N","N",4,0,2
"399","E2",2023-08-12,"Peterboro","Charlton",1,0,"H",1,0,"H",1.96,3.78,3.83,"1-0","1-0",14,3,12,2,5,5,0,0,7,5,15,12,1,12,27,"7-5","N","N","N",10,0,2
"400","E2",2023-08-12,"Port Vale","Reading",1,0,"H",0,0,"D",2.7,3.45,2.68,"0-0","1-0",17,3,9,1,0,2,0,0,5,2,7,11,1,7,18,"5-2","N","N","N",2,0,2
"401","E2",2023-08-12,"Stevenage","Shrewsbury",2,0,"H",0,0,"D",2.18,3.27,3.72,"0-0","2-0",14,6,2,1,0,3,0,0,13,3,7,12,2,16,19,"13-3","Y","N","N",3,0,2
"402","E2",2023-08-12,"Wigan","Northampton",2,1,"H",0,1,"A",2.02,3.63,3.78,"0-1","2-1",24,5,17,3,4,4,0,0,8,5,10,14,3,13,24,"8-5","Y","Y","N",8,0,2
"403","E2",2023-08-15,"Barnsley","Peterboro",1,3,"A",0,0,"D",2.26,3.48,3.3,"0-0","1-3",13,7,18,9,0,1,0,0,10,5,7,7,4,15,14,"10-5","Y","Y","Y",1,0,3
"404","E2",2023-08-15,"Blackpool","Port Vale",0,0,"D",0,0,"D",1.85,3.7,4.47,"0-0","0-0",14,4,8,1,1,1,0,0,4,2,5,9,0,6,14,"4-2","N","N","N",2,0,3
"405","E2",2023-08-15,"Bolton","Fleetwood Town",3,1,"H",3,0,"H",1.6,4.27,5.58,"3-0","3-1",8,5,10,7,2,4,1,0,5,12,11,12,4,17,23,"5-12","Y","Y","Y",6,1,3
"406","E2",2023-08-15,"Cambridge","Stevenage",1,2,"A",0,1,"A",2.76,3.28,2.74,"0-1","1-2",11,3,11,6,0,3,0,0,6,3,11,17,3,9,28,"6-3","Y","Y","N",3,0,3
"407","E2",2023-08-15,"Carlisle","Wigan",1,1,"D",0,1,"A",2.82,3.24,2.71,"0-1","1-1",11,2,14,4,4,2,0,0,3,5,15,6,2,8,21,"3-5","Y","N","N",6,0,3
"408","E2",2023-08-15,"Charlton","Bristol Rvs",1,2,"A",0,0,"D",2.29,3.46,3.24,"0-0","1-2",18,5,14,7,1,2,0,0,7,5,12,6,3,12,18,"7-5","Y","Y","N",3,0,3
"409","E2",2023-08-15,"Derby","Oxford",1,2,"A",0,1,"A",1.93,3.55,4.28,"0-1","1-2",11,4,14,4,5,2,0,0,15,4,17,13,3,19,30,"15-4","Y","Y","N",7,0,3
"410","E2",2023-08-15,"Northampton","Lincoln",2,2,"D",0,1,"A",2.85,3.14,2.74,"0-1","2-2",19,9,6,3,1,0,0,0,3,1,9,7,4,4,16,"3-1","Y","Y","Y",1,0,3
"411","E2",2023-08-15,"Shrewsbury","Burton",2,1,"H",2,0,"H",2.36,3.45,3.12,"2-0","2-1",9,3,12,4,1,4,0,0,4,3,7,14,3,7,21,"4-3","Y","Y","N",5,0,3
"412","E2",2023-08-15,"Wycombe","Leyton Orient",3,2,"H",1,1,"D",2.14,3.41,3.66,"1-1","3-2",15,6,15,6,1,3,0,1,3,7,4,8,5,10,12,"3-7","Y","Y","Y",4,1,3
"413","E2",2023-08-15,"Portsmouth","Exeter",1,0,"H",0,0,"D",1.89,3.67,4.24,"0-0","1-0",13,7,9,5,5,1,0,0,8,6,14,11,1,14,25,"8-6","N","N","N",6,0,3
"414","E2",2023-08-15,"Reading","Cheltenham",1,0,"H",1,0,"H",1.84,3.56,4.76,"1-0","1-0",11,4,10,3,2,2,0,0,7,7,11,7,1,14,18,"7-7","N","N","N",4,0,3
"415","E2",2023-08-19,"Bolton","Wigan",0,4,"A",0,3,"A",1.79,3.81,4.63,"0-3","0-4",20,4,11,5,2,3,0,0,4,2,18,11,4,6,29,"4-2","Y","Y","Y",5,0,4
"416","E2",2023-08-19,"Barnsley","Oxford",1,3,"A",0,1,"A",2.13,3.54,3.56,"0-1","1-3",14,6,14,8,3,2,0,0,9,8,10,5,4,17,15,"9-8","Y","Y","Y",5,0,4
"417","E2",2023-08-19,"Blackpool","Leyton Orient",0,0,"D",0,0,"D",1.65,4.18,5.28,"0-0","0-0",15,5,9,2,0,4,0,0,8,1,8,8,0,9,16,"8-1","N","N","N",4,0,4
"418","E2",2023-08-19,"Cambridge","Bristol Rvs",2,0,"H",0,0,"D",2.82,3.45,2.53,"0-0","2-0",12,4,7,5,1,3,0,0,6,4,16,10,2,10,26,"6-4","Y","N","N",4,0,4
"419","E2",2023-08-19,"Carlisle","Exeter",0,2,"A",0,0,"D",2.72,3.31,2.75,"0-0","0-2",13,6,11,3,0,1,0,0,11,3,5,10,2,14,15,"11-3","Y","N","N",1,0,4
"420","E2",2023-08-19,"Charlton","Port Vale",2,3,"A",1,0,"H",1.98,3.71,3.86,"1-0","2-3",17,7,15,5,4,3,0,0,9,4,15,13,5,13,28,"9-4","Y","Y","Y",7,0,4
"421","E2",2023-08-19,"Derby","Fleetwood Town",1,0,"H",1,0,"H",1.57,4.3,5.9,"1-0","1-0",14,3,8,2,3,3,0,0,7,9,11,13,1,16,24,"7-9","N","N","N",6,0,4
"422","E2",2023-08-19,"Northampton","Peterboro",1,0,"H",0,0,"D",3.46,3.7,2.11,"0-0","1-0",9,2,17,1,1,2,0,0,4,5,7,9,1,9,16,"4-5","N","N","N",3,0,4
"423","E2",2023-08-19,"Portsmouth","Cheltenham",0,0,"D",0,0,"D",1.49,4.38,7.18,"0-0","0-0",15,5,12,1,0,3,0,0,5,5,9,14,0,10,23,"5-5","N","N","N",3,0,4
"424","E2",2023-08-19,"Reading","Stevenage",2,0,"H",1,0,"H",2.66,3.28,2.85,"1-0","2-0",20,7,6,4,0,3,0,1,7,0,12,8,2,7,20,"7-0","Y","N","N",3,1,4
"425","E2",2023-08-19,"Shrewsbury","Lincoln",0,1,"A",0,0,"D",2.67,3.16,2.93,"0-0","0-1",11,2,7,3,2,4,0,0,6,1,9,13,1,7,22,"6-1","N","N","N",6,0,4
"426","E2",2023-08-19,"Wycombe","Burton",0,0,"D",0,0,"D",1.91,3.66,4.19,"0-0","0-0",14,8,7,3,2,2,0,0,6,2,10,10,0,8,20,"6-2","N","N","N",4,0,4
"427","E2",2023-08-26,"Bristol Rvs","Wycombe",1,2,"A",0,1,"A",2.13,3.58,3.52,"0-1","1-2",12,1,12,5,3,0,0,0,7,3,12,6,3,10,18,"7-3","Y","Y","N",3,0,5
"428","E2",2023-08-26,"Burton","Bolton",1,1,"D",0,0,"D",3.83,3.61,1.98,"0-0","1-1",13,3,17,6,6,2,0,0,4,8,13,12,2,12,25,"4-8","Y","N","N",8,0,5
"429","E2",2023-08-26,"Cheltenham","Northampton",0,1,"A",0,0,"D",2.6,3.46,2.78,"0-0","0-1",8,2,15,2,1,2,0,0,1,8,8,8,1,9,16,"1-8","N","N","N",3,0,5
"430","E2",2023-08-26,"Exeter","Reading",2,1,"H",1,1,"D",2.03,3.56,3.73,"1-1","2-1",20,4,12,3,3,4,0,0,7,7,10,9,3,14,19,"7-7","Y","Y","N",7,0,5
"431","E2",2023-08-26,"Fleetwood Town","Shrewsbury",0,1,"A",0,1,"A",2.02,3.41,3.95,"0-1","0-1",9,1,5,2,1,3,2,0,9,1,14,12,1,10,26,"9-1","N","N","N",4,2,5
"432","E2",2023-08-26,"Leyton Orient","Cambridge",2,0,"H",1,0,"H",2.45,3.48,2.96,"1-0","2-0",16,3,10,3,4,4,0,0,5,7,15,14,2,12,29,"5-7","Y","N","N",8,0,5
"433","E2",2023-08-26,"Lincoln","Blackpool",3,0,"H",2,0,"H",2.72,3.18,2.85,"2-0","3-0",11,5,14,3,1,0,0,1,1,2,13,13,3,3,26,"1-2","Y","Y","N",1,1,5
"434","E2",2023-08-26,"Oxford","Charlton",2,1,"H",1,0,"H",1.92,3.82,3.97,"1-0","2-1",16,5,9,3,3,6,0,0,7,1,11,16,3,8,27,"7-1","Y","Y","N",9,0,5
"435","E2",2023-08-26,"Peterboro","Derby",2,4,"A",1,4,"A",2.47,3.41,2.92,"1-4","2-4",16,6,14,5,2,1,0,0,8,9,6,12,6,17,18,"8-9","Y","Y","Y",3,0,5
"436","E2",2023-08-26,"Port Vale","Carlisle",1,0,"H",0,0,"D",1.92,3.71,4.08,"0-0","1-0",17,5,10,2,0,0,0,0,8,8,6,9,1,16,15,"8-8","N","N","N",0,0,5
"437","E2",2023-08-26,"Stevenage","Portsmouth",0,0,"D",0,0,"D",2.75,3.36,2.69,"0-0","0-0",12,3,13,2,4,3,1,1,4,7,12,13,0,11,25,"4-7","N","N","N",7,2,5
"438","E2",2023-08-26,"Wigan","Barnsley",0,2,"A",0,1,"A",2.38,3.53,3.02,"0-1","0-2",9,1,19,8,1,3,1,0,4,5,7,14,2,9,21,"4-5","Y","N","N",4,1,5
"439","E2",2023-09-02,"Blackpool","Wigan",2,1,"H",1,0,"H",2.26,3.46,3.31,"1-0","2-1",14,7,6,3,3,3,0,0,4,3,14,7,3,7,21,"4-3","Y","Y","N",6,0,6
"440","E2",2023-09-02,"Bolton","Derby",2,1,"H",1,1,"D",2.2,3.49,3.42,"1-1","2-1",17,4,10,1,3,2,0,1,7,6,11,9,3,13,20,"7-6","Y","Y","N",5,1,6
"441","E2",2023-09-02,"Bristol Rvs","Lincoln",1,1,"D",0,0,"D",2.39,3.59,2.98,"0-0","1-1",11,3,12,5,2,3,0,0,7,5,9,8,2,12,17,"7-5","Y","N","N",5,0,6
"442","E2",2023-09-02,"Burton","Exeter",0,1,"A",0,0,"D",2.9,3.43,2.52,"0-0","0-1",9,5,16,4,2,1,1,0,3,5,14,8,1,8,22,"3-5","N","N","N",3,1,6
"443","E2",2023-09-02,"Carlisle","Shrewsbury",2,0,"H",0,0,"D",2.38,3.33,3.2,"0-0","2-0",11,2,9,2,2,4,0,0,8,6,11,8,2,14,19,"8-6","Y","N","N",6,0,6
"444","E2",2023-09-02,"Charlton","Fleetwood Town",2,1,"H",1,1,"D",2.12,3.8,3.35,"1-1","2-1",17,4,11,3,4,3,0,0,13,4,12,12,3,17,24,"13-4","Y","Y","N",7,0,6
"445","E2",2023-09-02,"Cheltenham","Barnsley",0,2,"A",0,0,"D",4.26,3.76,1.87,"0-0","0-2",17,5,19,5,3,3,0,0,7,4,9,11,2,11,20,"7-4","Y","N","N",6,0,6
"446","E2",2023-09-02,"Leyton Orient","Stevenage",0,3,"A",0,2,"A",2.81,3.36,2.64,"0-2","0-3",8,2,10,4,2,1,0,0,9,6,13,9,3,15,22,"9-6","Y","Y","N",3,0,6
"447","E2",2023-09-02,"Northampton","Wycombe",0,1,"A",0,1,"A",2.45,3.43,2.99,"0-1","0-1",20,6,7,1,0,2,0,0,5,3,12,9,1,8,21,"5-3","N","N","N",2,0,6
"448","E2",2023-09-02,"Oxford","Port Vale",1,2,"A",0,0,"D",1.71,3.87,5.2,"0-0","1-2",13,6,8,5,1,2,2,0,5,3,8,14,3,8,22,"5-3","Y","Y","N",3,2,6
"449","E2",2023-09-02,"Portsmouth","Peterboro",3,1,"H",2,1,"H",2.26,3.58,3.22,"2-1","3-1",18,7,16,4,1,3,1,0,10,9,10,12,4,19,22,"10-9","Y","Y","Y",4,1,6
"450","E2",2023-09-04,"Cambridge","Reading",1,0,"H",0,0,"D",2.27,3.35,3.26,"0-0","1-0",17,3,13,4,1,4,0,0,9,5,8,15,1,14,23,"9-5","N","N","N",5,0,6
"451","E2",2023-09-09,"Exeter","Leyton Orient",1,2,"A",0,0,"D",1.75,3.87,4.85,"0-0","1-2",5,2,19,7,3,3,0,0,4,10,12,10,3,14,22,"4-10","Y","Y","N",6,0,7
"452","E2",2023-09-09,"Stevenage","Carlisle",2,2,"D",1,1,"D",1.79,3.67,4.86,"1-1","2-2",16,8,4,2,2,2,0,0,11,2,13,10,4,13,23,"11-2","Y","Y","Y",4,0,7
"453","E2",2023-09-16,"Barnsley","Burton",2,0,"H",1,0,"H",1.67,4.12,5.1,"1-0","2-0",8,3,8,1,0,0,0,0,0,2,5,10,2,2,15,"0-2","Y","N","N",0,0,7
"454","E2",2023-09-16,"Derby","Portsmouth",1,1,"D",0,0,"D",2.16,3.54,3.47,"0-0","1-1",8,1,14,5,2,3,0,0,4,8,16,9,2,12,25,"4-8","Y","N","N",5,0,7
"455","E2",2023-09-16,"Exeter","Cheltenham",1,0,"H",0,0,"D",1.71,3.78,5.3,"0-0","1-0",20,7,9,2,3,2,0,0,8,2,11,9,1,10,20,"8-2","N","N","N",5,0,7
"456","E2",2023-09-16,"Fleetwood Town","Oxford",0,3,"A",0,2,"A",3.22,3.59,2.25,"0-2","0-3",11,0,10,5,2,0,0,0,9,4,12,7,3,13,19,"9-4","Y","Y","N",2,0,7
"457","E2",2023-09-16,"Lincoln","Carlisle",1,1,"D",0,1,"A",1.88,3.53,4.55,"0-1","1-1",12,4,14,6,1,5,0,0,2,1,9,13,2,3,22,"2-1","Y","N","N",6,0,7
"458","E2",2023-09-16,"Peterboro","Leyton Orient",1,1,"D",1,1,"D",1.85,4.04,4.04,"1-1","1-1",7,5,6,2,2,3,0,0,6,3,8,17,2,9,25,"6-3","Y","N","N",5,0,7
"459","E2",2023-09-16,"Port Vale","Northampton",1,0,"H",0,0,"D",2,3.62,3.88,"0-0","1-0",13,4,5,1,1,0,0,0,5,3,7,6,1,8,13,"5-3","N","N","N",1,0,7
"460","E2",2023-09-16,"Reading","Bolton",2,1,"H",0,1,"A",3.6,3.7,2.06,"0-1","2-1",18,7,10,5,3,4,0,1,6,4,17,15,3,10,32,"6-4","Y","Y","N",7,1,7
"461","E2",2023-09-16,"Shrewsbury","Bristol Rvs",0,2,"A",0,0,"D",3.02,3.34,2.48,"0-0","0-2",12,4,9,4,2,3,0,0,5,6,14,10,2,11,24,"5-6","Y","N","N",5,0,7
"462","E2",2023-09-16,"Stevenage","Charlton",1,1,"D",1,0,"H",2.01,3.68,3.78,"1-0","1-1",9,3,12,1,3,3,0,0,5,4,10,16,2,9,26,"5-4","Y","N","N",6,0,7
"463","E2",2023-09-16,"Wigan","Cambridge",2,1,"H",0,0,"D",2.15,3.71,3.35,"0-0","2-1",6,3,18,3,2,0,0,0,3,2,13,10,3,5,23,"3-2","Y","Y","N",2,0,8
"464","E2",2023-09-16,"Wycombe","Blackpool",2,0,"H",1,0,"H",2.81,3.43,2.59,"1-0","2-0",10,4,11,2,3,1,0,0,0,5,14,11,2,5,25,"0-5","Y","N","N",4,0,8
"465","E2",2023-09-19,"Barnsley","Portsmouth",2,3,"A",0,3,"A",2.49,3.47,2.91,"0-3","2-3",15,3,16,6,0,1,0,0,3,5,13,8,5,8,21,"3-5","Y","Y","Y",1,0,8
"466","E2",2023-09-19,"Peterboro","Cheltenham",3,0,"H",0,0,"D",1.45,4.76,7.19,"0-0","3-0",24,5,2,0,0,0,0,2,15,1,7,6,3,16,13,"15-1","Y","Y","N",0,2,8
"467","E2",2023-09-19,"Port Vale","Burton",2,3,"A",1,1,"D",1.94,3.52,4.23,"1-1","2-3",19,9,8,3,2,3,0,0,7,1,11,12,5,8,23,"7-1","Y","Y","Y",5,0,8
"468","E2",2023-09-23,"Blackpool","Reading",4,1,"H",3,0,"H",1.89,3.65,4.3,"3-0","4-1",17,6,5,4,0,1,0,0,10,3,7,12,5,13,19,"10-3","Y","Y","Y",1,0,8
"469","E2",2023-09-23,"Bolton","Peterboro",1,1,"D",1,1,"D",2.07,3.57,3.69,"1-1","1-1",7,3,25,6,4,2,1,0,8,10,11,14,2,18,25,"8-10","Y","N","N",6,1,8
"470","E2",2023-09-23,"Bristol Rvs","Wigan",4,1,"H",2,1,"H",2.24,3.6,3.23,"2-1","4-1",15,6,9,3,3,2,0,0,3,5,12,15,5,8,27,"3-5","Y","Y","Y",5,0,8
"471","E2",2023-09-23,"Burton","Fleetwood Town",1,1,"D",1,1,"D",2.64,3.49,2.72,"1-1","1-1",13,2,13,4,2,0,0,0,4,5,9,9,2,9,18,"4-5","Y","N","N",2,0,8
"472","E2",2023-09-23,"Cambridge","Port Vale",1,1,"D",0,1,"A",2.33,3.29,3.34,"0-1","1-1",12,5,8,2,0,4,0,0,7,7,9,14,2,14,23,"7-7","Y","N","N",4,0,8
"473","E2",2023-09-23,"Carlisle","Derby",0,2,"A",0,1,"A",3.43,3.54,2.14,"0-1","0-2",9,4,9,2,1,1,0,0,8,2,8,13,2,10,21,"8-2","Y","N","N",2,0,8
"474","E2",2023-09-23,"Charlton","Wycombe",3,1,"H",1,0,"H",2.23,3.6,3.24,"1-0","3-1",9,6,12,1,3,2,0,0,7,6,15,10,4,13,25,"7-6","Y","Y","Y",5,0,8
"475","E2",2023-09-23,"Cheltenham","Stevenage",0,3,"A",0,1,"A",4.39,3.59,1.89,"0-1","0-3",9,2,21,9,1,1,0,0,5,4,4,14,3,9,18,"5-4","Y","Y","N",2,0,9
"476","E2",2023-09-23,"Leyton Orient","Shrewsbury",1,0,"H",1,0,"H",1.94,3.47,4.31,"1-0","1-0",9,1,12,5,4,1,0,0,7,7,12,9,1,14,21,"7-7","N","N","N",5,0,9
"477","E2",2023-09-23,"Northampton","Barnsley",1,2,"A",0,1,"A",3.17,3.61,2.27,"0-1","1-2",12,5,9,4,0,4,0,0,10,2,9,13,3,12,22,"10-2","Y","Y","N",4,0,9
"478","E2",2023-09-23,"Oxford","Exeter",3,0,"H",1,0,"H",1.81,3.83,4.51,"1-0","3-0",9,4,14,5,1,1,0,0,3,4,11,13,3,7,24,"3-4","Y","Y","N",2,0,9
"479","E2",2023-09-23,"Portsmouth","Lincoln",2,1,"H",2,1,"H",1.68,3.86,5.55,"2-1","2-1",11,3,10,4,3,2,0,0,3,1,7,11,3,4,18,"3-1","Y","Y","N",5,0,9
"480","E2",2023-09-30,"Barnsley","Blackpool",0,1,"A",0,1,"A",2.26,3.6,3.19,"0-1","0-1",13,0,6,3,1,7,0,0,5,2,10,13,1,7,23,"5-2","N","N","N",8,0,9
"481","E2",2023-09-30,"Derby","Cambridge",0,0,"D",0,0,"D",1.67,4.17,5.03,"0-0","0-0",12,2,4,1,2,2,0,0,9,3,11,12,0,12,23,"9-3","N","N","N",4,0,9
"482","E2",2023-09-30,"Exeter","Northampton",0,2,"A",0,1,"A",2.07,3.51,3.75,"0-1","0-2",10,2,11,7,1,5,0,0,6,2,11,14,2,8,25,"6-2","Y","N","N",6,0,9
"483","E2",2023-09-30,"Fleetwood Town","Leyton Orient",1,0,"H",0,0,"D",2.45,3.39,3.02,"0-0","1-0",14,3,15,5,1,3,1,1,6,6,10,10,1,12,20,"6-6","N","N","N",4,2,9
"484","E2",2023-09-30,"Lincoln","Cheltenham",2,0,"H",2,0,"H",1.66,4.01,5.36,"2-0","2-0",9,3,10,1,4,1,0,0,2,5,14,10,2,7,24,"2-5","Y","N","N",5,0,9
"485","E2",2023-09-30,"Peterboro","Bristol Rvs",2,0,"H",1,0,"H",1.89,3.73,4.2,"1-0","2-0",15,7,16,2,5,2,0,0,9,9,9,14,2,18,23,"9-9","Y","N","N",7,0,9
"486","E2",2023-09-30,"Port Vale","Bolton",0,1,"A",0,1,"A",3.03,3.45,2.38,"0-1","0-1",15,6,13,5,2,3,0,0,8,5,6,14,1,13,20,"8-5","N","N","N",5,0,9
"487","E2",2023-09-30,"Reading","Burton",0,0,"D",0,0,"D",1.96,3.66,3.96,"0-0","0-0",20,7,3,1,1,4,0,0,5,2,7,11,0,7,18,"5-2","N","N","N",5,0,10
"488","E2",2023-09-30,"Shrewsbury","Charlton",0,0,"D",0,0,"D",3.07,3.43,2.4,"0-0","0-0",15,8,14,6,1,4,0,0,7,7,6,9,0,14,15,"7-7","N","N","N",5,0,10
"489","E2",2023-09-30,"Stevenage","Oxford",1,3,"A",1,1,"D",2.4,3.38,3.12,"1-1","1-3",11,3,15,4,1,2,0,0,9,8,10,9,4,17,19,"9-8","Y","Y","Y",3,0,10
"490","E2",2023-09-30,"Wigan","Portsmouth",1,2,"A",1,2,"A",3.15,3.52,2.31,"1-2","1-2",7,1,16,5,3,2,1,0,1,9,17,16,3,10,33,"1-9","Y","Y","N",5,1,10
"491","E2",2023-09-30,"Wycombe","Carlisle",2,0,"H",1,0,"H",1.88,3.68,4.32,"1-0","2-0",19,6,12,1,2,1,0,1,8,2,12,10,2,10,22,"8-2","Y","N","N",3,1,10
"492","E2",2023-10-03,"Blackpool","Derby",1,3,"A",0,0,"D",2.35,3.38,3.2,"0-0","1-3",10,4,9,5,1,1,0,0,9,3,6,11,4,12,17,"9-3","Y","Y","Y",2,0,10
"493","E2",2023-10-03,"Bolton","Stevenage",3,2,"H",1,1,"D",2.1,3.51,3.65,"1-1","3-2",9,4,11,3,3,2,0,0,4,5,13,13,5,9,26,"4-5","Y","Y","Y",5,0,10
"494","E2",2023-10-03,"Bristol Rvs","Port Vale",3,0,"H",2,0,"H",2.07,3.55,3.7,"2-0","3-0",10,7,6,2,1,1,0,1,8,3,11,13,3,11,24,"8-3","Y","Y","N",2,1,10
"495","E2",2023-10-03,"Burton","Wigan",2,1,"H",0,1,"A",2.74,3.37,2.7,"0-1","2-1",15,5,12,1,2,3,1,0,3,4,14,16,3,7,30,"3-4","Y","Y","N",5,1,10
"496","E2",2023-10-03,"Cambridge","Barnsley",0,4,"A",0,2,"A",2.96,3.55,2.42,"0-2","0-4",17,8,12,7,2,2,0,0,6,6,7,12,4,12,19,"6-6","Y","Y","Y",4,0,10
"497","E2",2023-10-03,"Carlisle","Peterboro",1,1,"D",0,0,"D",3.76,3.61,2.04,"0-0","1-1",8,1,15,6,2,0,0,0,3,8,8,14,2,11,22,"3-8","Y","N","N",2,0,10
"498","E2",2023-10-03,"Charlton","Exeter",4,1,"H",1,1,"D",2.08,3.65,3.57,"1-1","4-1",21,10,12,3,1,0,0,1,9,5,12,10,5,14,22,"9-5","Y","Y","Y",1,1,10
"499","E2",2023-10-03,"Cheltenham","Fleetwood Town",0,2,"A",0,1,"A",3.23,3.43,2.31,"0-1","0-2",7,2,20,5,2,5,1,0,0,3,16,11,2,3,27,"0-3","Y","N","N",7,1,11
"500","E2",2023-10-03,"Northampton","Reading",3,1,"H",2,0,"H",2.41,3.53,2.99,"2-0","3-1",12,5,7,4,1,3,0,0,4,1,5,14,4,5,19,"4-1","Y","Y","Y",4,0,11
"501","E2",2023-10-03,"Oxford","Shrewsbury",3,0,"H",1,0,"H",1.57,4.12,6.29,"1-0","3-0",14,5,4,1,3,0,0,1,4,4,12,12,3,8,24,"4-4","Y","Y","N",3,1,11
"502","E2",2023-10-03,"Portsmouth","Wycombe",2,1,"H",0,1,"A",1.75,3.89,4.82,"0-1","2-1",11,3,8,1,2,4,0,0,14,2,8,13,3,16,21,"14-2","Y","Y","N",6,0,11
"503","E2",2023-10-07,"Oxford","Bristol Rvs",2,1,"H",1,0,"H",1.8,4.01,4.31,"1-0","2-1",17,6,15,7,2,2,2,1,8,3,12,11,3,11,23,"8-3","Y","Y","N",4,3,11
"504","E2",2023-10-07,"Bolton","Carlisle",1,3,"A",1,1,"D",1.5,4.46,6.75,"1-1","1-3",12,3,15,9,2,3,0,0,7,7,11,9,4,14,20,"7-7","Y","Y","Y",5,0,11
"505","E2",2023-10-07,"Charlton","Blackpool",2,2,"D",0,1,"A",2.38,3.57,3,"0-1","2-2",18,5,9,4,2,3,0,0,5,3,5,6,4,8,11,"5-3","Y","Y","Y",5,0,11
"506","E2",2023-10-07,"Cheltenham","Derby",1,1,"D",1,1,"D",6.65,4.35,1.52,"1-1","1-1",6,2,17,8,1,0,0,0,1,8,17,8,2,9,25,"1-8","Y","N","N",1,0,11
"507","E2",2023-10-07,"Exeter","Barnsley",0,1,"A",0,0,"D",2.62,3.66,2.64,"0-0","0-1",13,1,13,3,2,2,0,0,6,6,6,14,1,12,20,"6-6","N","N","N",4,0,11
"508","E2",2023-10-07,"Fleetwood Town","Wycombe",1,4,"A",0,3,"A",2.52,3.43,2.9,"0-3","1-4",9,4,17,12,2,2,1,0,5,3,14,5,5,8,19,"5-3","Y","Y","Y",4,1,11
"509","E2",2023-10-07,"Leyton Orient","Reading",2,1,"H",1,1,"D",2.22,3.59,3.28,"1-1","2-1",17,4,11,5,3,2,0,0,11,7,6,8,3,18,14,"11-7","Y","Y","N",5,0,11
"510","E2",2023-10-07,"Peterboro","Lincoln",2,0,"H",0,0,"D",1.68,3.97,5.33,"0-0","2-0",13,5,12,0,1,2,0,0,6,4,10,8,2,10,18,"6-4","Y","N","N",3,0,11
"511","E2",2023-10-07,"Portsmouth","Port Vale",2,0,"H",0,0,"D",1.66,4.07,5.06,"0-0","2-0",13,4,14,3,1,3,0,0,6,6,8,14,2,12,22,"6-6","Y","N","N",4,0,12
"512","E2",2023-10-07,"Shrewsbury","Northampton",1,0,"H",0,0,"D",2.99,3.22,2.58,"0-0","1-0",13,2,17,2,1,3,0,0,3,10,9,13,1,13,22,"3-10","N","N","N",4,0,12
"513","E2",2023-10-07,"Stevenage","Wigan",1,0,"H",1,0,"H",1.79,3.86,4.55,"1-0","1-0",13,5,10,2,3,9,1,1,8,3,18,18,1,11,36,"8-3","N","N","N",12,2,12
"514","E2",2023-10-09,"Burton","Cambridge",2,1,"H",2,0,"H",2.42,3.25,3.09,"2-0","2-1",11,3,10,2,2,0,0,0,7,7,12,5,3,14,17,"7-7","Y","Y","N",2,0,12
"515","E2",2023-10-14,"Blackpool","Stevenage",3,0,"H",1,0,"H",2.45,3.35,3.06,"1-0","3-0",14,3,7,3,1,3,0,0,6,7,9,7,3,13,16,"6-7","Y","Y","N",4,0,12
"516","E2",2023-10-14,"Cambridge","Shrewsbury",1,1,"D",0,0,"D",2.09,3.4,3.84,"0-0","1-1",10,1,15,2,2,1,0,0,4,5,11,10,2,9,21,"4-5","Y","N","N",3,0,12
"517","E2",2023-10-14,"Carlisle","Leyton Orient",0,1,"A",0,1,"A",2.66,3.27,2.85,"0-1","0-1",10,1,12,5,0,3,0,0,9,3,6,18,1,12,24,"9-3","N","N","N",3,0,12
"518","E2",2023-10-14,"Lincoln","Burton",0,1,"A",0,0,"D",2.05,3.41,3.95,"0-0","0-1",10,3,6,1,1,4,1,0,4,4,8,9,1,8,17,"4-4","N","N","N",5,1,12
"519","E2",2023-10-21,"Bolton","Northampton",2,1,"H",2,0,"H",1.93,3.83,3.88,"2-0","2-1",16,6,9,4,0,1,0,0,6,2,14,11,3,8,25,"6-2","Y","Y","N",1,0,12
"520","E2",2023-10-21,"Burton","Bristol Rvs",4,1,"H",2,1,"H",2.76,3.51,2.59,"2-1","4-1",10,4,13,4,3,1,0,1,4,5,15,8,5,9,23,"4-5","Y","Y","Y",4,1,12
"521","E2",2023-10-21,"Charlton","Reading",4,0,"H",0,0,"D",1.77,4.11,4.38,"0-0","4-0",15,8,15,5,0,0,0,0,6,11,7,10,4,17,17,"6-11","Y","Y","Y",0,0,12
"522","E2",2023-10-21,"Cheltenham","Cambridge",1,0,"H",1,0,"H",3.03,3.3,2.5,"1-0","1-0",20,7,12,2,4,1,0,0,4,3,14,13,1,7,27,"4-3","N","N","N",5,0,12
"523","E2",2023-10-21,"Exeter","Wigan",0,2,"A",0,1,"A",2.17,3.7,3.29,"0-1","0-2",30,4,5,1,4,3,0,0,17,1,10,16,2,18,26,"17-1","Y","N","N",7,0,13
"524","E2",2023-10-21,"Fleetwood Town","Lincoln",0,1,"A",0,1,"A",2.25,3.47,3.32,"0-1","0-1",13,4,11,3,3,4,1,0,8,5,14,13,1,13,27,"8-5","N","N","N",7,1,13
"525","E2",2023-10-21,"Leyton Orient","Barnsley",1,1,"D",1,0,"H",2.89,3.37,2.56,"1-0","1-1",13,4,6,2,0,0,0,1,5,4,6,7,2,9,13,"5-4","Y","N","N",0,1,13
"526","E2",2023-10-21,"Oxford","Blackpool",1,1,"D",1,0,"H",1.94,3.64,4.09,"1-0","1-1",4,2,9,3,0,5,0,0,2,1,8,15,2,3,23,"2-1","Y","N","N",5,0,13
"527","E2",2023-10-21,"Peterboro","Wycombe",2,2,"D",2,1,"H",1.8,3.98,4.38,"2-1","2-2",9,6,13,8,1,0,0,0,9,8,6,6,4,17,12,"9-8","Y","Y","Y",1,0,13
"528","E2",2023-10-21,"Portsmouth","Carlisle",1,0,"H",0,0,"D",1.51,4.46,6.57,"0-0","1-0",18,8,14,3,1,3,0,0,6,3,8,16,1,9,24,"6-3","N","N","N",4,0,13
"529","E2",2023-10-21,"Shrewsbury","Derby",1,0,"H",0,0,"D",4.44,3.6,1.88,"0-0","1-0",16,7,11,6,1,2,0,0,9,8,9,12,1,17,21,"9-8","N","N","N",3,0,13
"530","E2",2023-10-21,"Stevenage","Port Vale",0,0,"D",0,0,"D",1.85,3.68,4.51,"0-0","0-0",12,2,8,3,3,3,0,0,6,7,10,8,0,13,18,"6-7","N","N","N",6,0,13
"531","E2",2023-10-24,"Barnsley","Shrewsbury",3,0,"H",2,0,"H",1.65,3.93,5.75,"2-0","3-0",11,3,13,2,1,2,0,0,3,7,8,9,3,10,17,"3-7","Y","Y","N",3,0,13
"532","E2",2023-10-24,"Blackpool","Cheltenham",3,2,"H",3,1,"H",1.34,5.11,10.33,"3-1","3-2",15,6,8,3,0,2,0,0,2,4,16,16,5,6,32,"2-4","Y","Y","Y",2,0,13
"533","E2",2023-10-24,"Bristol Rvs","Stevenage",1,1,"D",0,1,"A",2.56,3.41,2.86,"0-1","1-1",18,2,11,4,6,4,0,0,4,4,16,22,2,8,38,"4-4","Y","N","N",10,0,13
"534","E2",2023-10-24,"Cambridge","Portsmouth",0,0,"D",0,0,"D",4.95,3.83,1.75,"0-0","0-0",6,1,16,3,1,4,0,0,4,7,11,10,0,11,21,"4-7","N","N","N",5,0,13
"535","E2",2023-10-24,"Carlisle","Burton",2,1,"H",0,1,"A",2.59,3.34,2.88,"0-1","2-1",16,7,5,2,1,3,0,0,7,2,7,10,3,9,17,"7-2","Y","Y","N",4,0,14
"536","E2",2023-10-24,"Derby","Exeter",2,0,"H",1,0,"H",1.6,4.2,5.74,"1-0","2-0",26,8,3,0,2,1,0,0,4,3,9,11,2,7,20,"4-3","Y","N","N",3,0,14
"537","E2",2023-10-24,"Lincoln","Charlton",3,1,"H",1,1,"D",2.99,3.45,2.45,"1-1","3-1",23,9,13,4,0,0,0,0,6,5,8,6,4,11,14,"6-5","Y","Y","Y",0,0,14
"538","E2",2023-10-24,"Northampton","Leyton Orient",2,2,"D",0,1,"A",2.69,3.29,2.8,"0-1","2-2",7,4,19,7,1,3,1,0,5,6,6,10,4,11,16,"5-6","Y","Y","Y",4,1,14
"539","E2",2023-10-24,"Port Vale","Peterboro",0,1,"A",0,1,"A",3.44,3.6,2.15,"0-1","0-1",16,5,10,5,1,5,0,0,6,5,7,10,1,11,17,"6-5","N","N","N",6,0,14
"540","E2",2023-10-24,"Wigan","Oxford",2,0,"H",1,0,"H",3.39,3.7,2.13,"1-0","2-0",10,6,11,6,3,2,0,0,6,9,12,9,2,15,21,"6-9","Y","N","N",5,0,14
"541","E2",2023-10-24,"Wycombe","Bolton",2,4,"A",0,2,"A",2.78,3.44,2.61,"0-2","2-4",12,6,8,4,3,1,0,0,1,3,9,13,6,4,22,"1-3","Y","Y","Y",4,0,14
"542","E2",2023-10-24,"Reading","Fleetwood Town",1,2,"A",0,1,"A",2.29,3.54,3.17,"0-1","1-2",18,6,15,6,1,2,0,0,9,11,12,3,3,20,15,"9-11","Y","Y","N",3,0,14
"543","E2",2023-10-28,"Barnsley","Fleetwood Town",2,2,"D",1,2,"A",1.8,4.02,4.33,"1-2","2-2",25,8,7,4,2,2,0,0,7,3,11,13,4,10,24,"7-3","Y","Y","Y",4,0,14
"544","E2",2023-10-28,"Blackpool","Peterboro",2,4,"A",0,1,"A",2.36,3.38,3.19,"0-1","2-4",11,5,12,5,2,3,1,0,2,6,12,12,6,8,24,"2-6","Y","Y","Y",5,1,14
"545","E2",2023-10-28,"Bristol Rvs","Northampton",2,1,"H",2,0,"H",2.19,3.6,3.34,"2-0","2-1",12,6,12,5,3,1,0,0,2,4,10,11,3,6,21,"2-4","Y","Y","N",4,0,14
"546","E2",2023-10-28,"Burton","Leyton Orient",0,0,"D",0,0,"D",2.75,3.37,2.68,"0-0","0-0",15,3,12,4,1,1,0,0,3,4,5,10,0,7,15,"3-4","N","N","N",2,0,14
"547","E2",2023-10-28,"Cambridge","Carlisle",1,0,"H",0,0,"D",2.46,3.16,3.23,"0-0","1-0",14,3,8,0,2,0,0,2,7,6,7,13,1,13,20,"7-6","N","N","N",2,2,15
"548","E2",2023-10-28,"Charlton","Bolton",0,2,"A",0,2,"A",2.47,3.61,2.84,"0-2","0-2",12,1,12,5,1,1,0,0,9,3,8,10,2,12,18,"9-3","Y","N","N",2,0,15
"549","E2",2023-10-28,"Exeter","Lincoln",1,1,"D",0,1,"A",2.35,3.34,3.24,"0-1","1-1",16,5,12,3,4,4,0,0,7,9,10,12,2,16,22,"7-9","Y","N","N",8,0,15
"550","E2",2023-10-28,"Oxford","Wycombe",2,2,"D",1,0,"H",2,3.6,3.9,"1-0","2-2",18,5,7,4,3,5,0,0,7,5,10,11,4,12,21,"7-5","Y","Y","Y",8,0,15
"551","E2",2023-10-28,"Port Vale","Cheltenham",1,2,"A",1,1,"D",1.68,3.95,5.32,"1-1","1-2",16,5,9,3,2,4,0,0,11,7,12,19,3,18,31,"11-7","Y","Y","N",6,0,15
"552","E2",2023-10-28,"Reading","Portsmouth",2,3,"A",2,2,"D",3.52,3.56,2.13,"2-2","2-3",13,5,18,9,4,2,1,0,6,9,14,8,5,15,22,"6-9","Y","Y","Y",6,1,15
"553","E2",2023-10-28,"Stevenage","Derby",3,1,"H",2,1,"H",2.66,3.25,2.87,"2-1","3-1",11,6,13,3,2,2,0,0,3,7,11,14,4,10,25,"3-7","Y","Y","Y",4,0,15
"554","E2",2023-10-28,"Wigan","Shrewsbury",2,0,"H",1,0,"H",2.05,3.53,3.8,"1-0","2-0",20,7,6,0,1,1,0,1,3,1,9,7,2,4,16,"3-1","Y","N","N",2,1,15
"555","E2",2023-10-31,"Derby","Northampton",4,0,"H",3,0,"H",1.55,4.17,6.61,"3-0","4-0",16,5,3,1,1,2,0,0,8,2,5,9,4,10,14,"8-2","Y","Y","Y",3,0,15
"556","E2",2023-10-31,"Lincoln","Oxford",0,2,"A",0,1,"A",3.6,3.38,2.17,"0-1","0-2",8,3,19,9,0,2,0,0,6,9,6,8,2,15,14,"6-9","Y","N","N",2,0,15
"557","E2",2023-10-31,"Wigan","Charlton",2,3,"A",0,3,"A",2.34,3.7,2.99,"0-3","2-3",13,4,17,7,2,1,0,0,3,4,10,9,5,7,19,"3-4","Y","Y","Y",3,0,15
"558","E2",2023-10-31,"Wycombe","Cambridge",0,0,"D",0,0,"D",1.74,3.9,4.9,"0-0","0-0",12,4,8,1,2,3,0,0,8,1,12,12,0,9,24,"8-1","N","N","N",5,0,15
"559","E2",2023-11-01,"Fleetwood Town","Blackpool",3,3,"D",2,0,"H",3.05,3.38,2.44,"2-0","3-3",14,8,30,7,2,3,0,0,2,8,15,7,6,10,22,"2-8","Y","Y","Y",5,0,16
"560","E2",2023-11-07,"Shrewsbury","Bolton",0,2,"A",0,0,"D",4.23,3.57,1.93,"0-0","0-2",5,2,10,2,0,0,0,0,5,1,10,13,2,6,23,"5-1","Y","N","N",0,0,16
"561","E2",2023-11-07,"Wigan","Peterboro",2,1,"H",1,0,"H",3.2,3.7,2.22,"1-0","2-1",12,3,22,7,3,2,0,0,2,6,15,10,3,8,25,"2-6","Y","Y","N",5,0,16
"562","E2",2023-11-07,"Reading","Bristol Rvs",1,1,"D",1,0,"H",2.7,3.57,2.61,"1-0","1-1",6,5,11,5,3,1,0,0,0,4,16,9,2,4,25,"0-4","Y","N","N",4,0,16
"563","E2",2023-11-11,"Peterboro","Cambridge",5,0,"H",3,0,"H",1.58,4.28,5.78,"3-0","5-0",13,7,7,3,0,0,0,0,4,5,9,7,5,9,16,"4-5","Y","Y","Y",0,0,16
"564","E2",2023-11-11,"Bolton","Blackpool",1,0,"H",0,0,"D",2.16,3.76,3.28,"0-0","1-0",15,5,11,0,5,1,0,0,6,4,14,11,1,10,25,"6-4","N","N","N",6,0,16
"565","E2",2023-11-11,"Carlisle","Bristol Rvs",0,1,"A",0,1,"A",2.99,3.39,2.48,"0-1","0-1",16,5,6,2,4,3,0,1,10,0,11,15,1,10,26,"10-0","N","N","N",7,1,16
"566","E2",2023-11-11,"Cheltenham","Wigan",1,1,"D",1,1,"D",3.33,3.51,2.23,"1-1","1-1",18,6,4,1,2,3,0,0,6,1,15,12,2,7,27,"6-1","Y","N","N",5,0,16
"567","E2",2023-11-11,"Derby","Barnsley",3,0,"H",1,0,"H",1.87,3.72,4.34,"1-0","3-0",14,6,9,1,2,1,0,0,7,8,13,14,3,15,27,"7-8","Y","Y","N",3,0,16
"568","E2",2023-11-11,"Fleetwood Town","Exeter",3,0,"H",3,0,"H",2.28,3.56,3.2,"3-0","3-0",20,12,11,7,2,2,0,0,9,5,8,19,3,14,27,"9-5","Y","Y","N",4,0,16
"569","E2",2023-11-11,"Leyton Orient","Oxford",2,3,"A",0,2,"A",2.78,3.46,2.6,"0-2","2-3",10,1,13,7,2,2,0,0,4,4,7,8,5,8,15,"4-4","Y","Y","Y",4,0,16
"570","E2",2023-11-11,"Lincoln","Port Vale",1,1,"D",0,1,"A",2.32,3.44,3.21,"0-1","1-1",15,3,6,4,0,1,1,1,9,1,5,5,2,10,10,"9-1","Y","N","N",1,2,16
"571","E2",2023-11-11,"Northampton","Burton",2,0,"H",0,0,"D",2.31,3.35,3.3,"0-0","2-0",19,6,10,3,0,2,0,0,5,7,7,13,2,12,20,"5-7","Y","N","N",2,0,17
"572","E2",2023-11-11,"Portsmouth","Charlton",2,2,"D",1,0,"H",1.75,4.08,4.57,"1-0","2-2",21,9,13,7,0,4,0,0,10,3,10,15,4,13,25,"10-3","Y","Y","Y",4,0,17
"573","E2",2023-11-11,"Shrewsbury","Reading",3,2,"H",1,2,"A",2.44,3.37,3.07,"1-2","3-2",17,4,12,3,2,2,0,0,11,5,6,6,5,16,12,"11-5","Y","Y","Y",4,0,17
"574","E2",2023-11-11,"Wycombe","Stevenage",0,1,"A",0,1,"A",2.65,3.37,2.79,"0-1","0-1",4,0,8,2,3,2,0,0,2,7,15,16,1,9,31,"2-7","N","N","N",5,0,17
"575","E2",2023-11-18,"Blackpool","Shrewsbury",4,0,"H",2,0,"H",1.59,3.97,6.41,"2-0","4-0",9,7,8,2,0,1,0,0,5,4,12,11,4,9,23,"5-4","Y","Y","Y",1,0,17
"576","E2",2023-11-18,"Stevenage","Lincoln",1,0,"H",0,0,"D",1.86,3.38,4.95,"0-0","1-0",15,5,4,2,1,1,0,0,6,4,11,12,1,10,23,"6-4","N","N","N",2,0,17
"577","E2",2023-11-21,"Leyton Orient","Lincoln",0,1,"A",0,0,"D",1.98,3.37,4.28,"0-0","0-1",17,6,11,5,2,0,0,0,3,4,13,7,1,7,20,"3-4","N","N","N",2,0,17
"578","E2",2023-11-25,"Bolton","Exeter",7,0,"H",2,0,"H",1.47,4.55,7.21,"2-0","7-0",24,10,1,0,0,1,0,0,5,0,4,9,7,5,13,"5-0","Y","Y","Y",1,0,17
"579","E2",2023-11-25,"Carlisle","Charlton",1,1,"D",0,0,"D",3.06,3.52,2.37,"0-0","1-1",14,5,22,8,0,0,0,0,4,8,8,4,2,12,12,"4-8","Y","N","N",0,0,17
"580","E2",2023-11-25,"Cheltenham","Oxford",2,0,"H",1,0,"H",4.36,3.63,1.69,"1-0","2-0",17,4,20,6,3,2,1,1,8,10,13,14,2,18,27,"8-10","Y","N","N",5,2,17
"581","E2",2023-11-25,"Derby","Bristol Rvs",2,1,"H",0,0,"D",1.59,4.26,5.51,"0-0","2-1",10,6,13,3,0,0,0,0,8,1,5,12,3,9,17,"8-1","Y","Y","N",0,0,17
"582","E2",2023-11-25,"Fleetwood Town","Stevenage",0,3,"A",0,1,"A",3.12,3.52,2.33,"0-1","0-3",31,7,8,3,0,0,0,0,10,6,11,13,3,16,24,"10-6","Y","Y","N",0,0,17
"583","E2",2023-11-25,"Leyton Orient","Wigan",1,1,"D",1,1,"D",1.95,3.7,3.98,"1-1","1-1",16,7,5,2,5,1,0,0,3,3,16,9,2,6,25,"3-3","Y","N","N",6,0,18
"584","E2",2023-11-25,"Lincoln","Barnsley",2,2,"D",1,0,"H",2.96,3.56,2.41,"1-0","2-2",10,4,13,4,1,1,0,0,3,6,9,9,4,9,18,"3-6","Y","Y","Y",2,0,18
"585","E2",2023-11-25,"Northampton","Cambridge",2,1,"H",0,0,"D",2,3.46,3.97,"0-0","2-1",13,5,12,5,1,2,0,1,6,1,11,12,3,7,23,"6-1","Y","Y","N",3,1,18
"586","E2",2023-11-25,"Peterboro","Burton",4,0,"H",2,0,"H",1.51,4.45,6.61,"2-0","4-0",25,8,10,2,1,3,0,0,4,2,6,9,4,6,15,"4-2","Y","Y","Y",4,0,18
"587","E2",2023-11-25,"Portsmouth","Blackpool",0,4,"A",0,1,"A",2.03,3.72,3.58,"0-1","0-4",14,5,17,5,3,3,1,0,7,5,11,12,4,12,23,"7-5","Y","Y","Y",6,1,18
"588","E2",2023-11-25,"Shrewsbury","Port Vale",2,1,"H",1,0,"H",2.49,3.39,2.98,"1-0","2-1",10,4,22,5,4,1,0,0,2,14,14,11,3,16,25,"2-14","Y","Y","N",5,0,18
"589","E2",2023-11-25,"Wycombe","Reading",1,2,"A",1,2,"A",1.85,3.85,4.23,"1-2","1-2",8,1,13,6,2,0,0,0,4,7,9,16,3,11,25,"4-7","Y","Y","N",2,0,18
"590","E2",2023-11-28,"Barnsley","Wycombe",1,0,"H",0,0,"D",1.95,3.82,3.85,"0-0","1-0",15,2,10,2,0,3,0,1,9,2,6,6,1,11,12,"9-2","N","N","N",3,1,18
"591","E2",2023-11-28,"Blackpool","Northampton",1,2,"A",0,1,"A",1.52,4.36,6.66,"0-1","1-2",18,5,10,4,0,4,0,0,4,2,9,12,3,6,21,"4-2","Y","Y","N",4,0,18
"592","E2",2023-11-28,"Bristol Rvs","Leyton Orient",1,1,"D",1,0,"H",2.25,3.45,3.35,"1-0","1-1",10,4,10,3,1,3,0,0,4,11,9,9,2,15,18,"4-11","Y","N","N",4,0,18
"593","E2",2023-11-28,"Burton","Portsmouth",0,2,"A",0,1,"A",4.32,3.68,1.88,"0-1","0-2",20,5,13,3,1,0,1,0,6,4,12,9,2,10,21,"6-4","Y","N","N",1,1,18
"594","E2",2023-11-28,"Cambridge","Lincoln",0,3,"A",0,2,"A",2.61,3.17,2.99,"0-2","0-3",5,2,14,7,2,2,0,0,2,4,13,18,3,6,31,"2-4","Y","Y","N",4,0,18
"595","E2",2023-11-28,"Charlton","Cheltenham",2,1,"H",1,1,"D",1.53,4.46,6.3,"1-1","2-1",19,7,11,1,1,5,0,0,9,4,10,18,3,13,28,"9-4","Y","Y","N",6,0,19
"596","E2",2023-11-28,"Exeter","Shrewsbury",0,0,"D",0,0,"D",2.13,3.43,3.68,"0-0","0-0",13,5,11,4,2,1,0,0,7,5,12,11,0,12,23,"7-5","N","N","N",3,0,19
"597","E2",2023-11-28,"Oxford","Bolton",0,0,"D",0,0,"D",2.76,3.52,2.58,"0-0","0-0",7,5,10,3,2,2,0,0,5,4,9,13,0,9,22,"5-4","N","N","N",4,0,19
"598","E2",2023-11-28,"Port Vale","Derby",0,1,"A",0,0,"D",3.81,3.58,2.03,"0-0","0-1",8,3,11,7,2,0,0,0,9,6,12,9,1,15,21,"9-6","N","N","N",2,0,19
"599","E2",2023-11-28,"Stevenage","Peterboro",2,2,"D",2,0,"H",2.72,3.44,2.67,"2-0","2-2",11,5,22,6,2,0,0,0,5,9,16,13,4,14,29,"5-9","Y","Y","Y",2,0,19
"600","E2",2023-11-28,"Wigan","Fleetwood Town",3,0,"H",2,0,"H",2.3,3.67,3.07,"2-0","3-0",13,7,7,3,1,3,0,1,8,5,9,9,3,13,18,"8-5","Y","Y","N",4,1,19
"601","E2",2023-11-28,"Reading","Carlisle",5,1,"H",3,1,"H",1.89,3.68,4.27,"3-1","5-1",16,6,15,6,1,1,0,0,2,5,13,7,6,7,20,"2-5","Y","Y","Y",2,0,19
"602","E2",2023-12-02,"Northampton","Portsmouth",0,3,"A",0,2,"A",3.66,3.4,2.14,"0-2","0-3",8,3,17,5,1,1,0,0,0,8,7,8,3,8,15,"0-8","Y","Y","N",2,0,19
"603","E3",2023-08-05,"Accrington","Newport County",3,0,"H",1,0,"H",2.49,3.27,3.07,"1-0","3-0",16,8,17,2,2,0,0,0,7,4,11,13,3,11,24,"7-4","Y","Y","N",2,0,1
"604","E3",2023-08-05,"Crawley Town","Bradford",1,0,"H",1,0,"H",4.1,3.5,1.98,"1-0","1-0",21,3,14,7,6,3,0,1,2,4,14,14,1,6,28,"2-4","N","N","N",9,1,1
"605","E3",2023-08-05,"Crewe","Mansfield",2,2,"D",1,2,"A",4.15,3.75,1.87,"1-2","2-2",13,3,21,9,2,4,0,1,10,5,8,16,4,15,24,"10-5","Y","Y","Y",6,1,1
"606","E3",2023-08-05,"Doncaster","Harrogate",0,1,"A",0,0,"D",2.26,3.42,3.35,"0-0","0-1",12,3,7,6,1,4,0,0,6,5,7,20,1,11,27,"6-5","N","N","N",5,0,1
"607","E3",2023-08-05,"Forest Green","Salford",0,2,"A",0,0,"D",3.55,3.53,2.13,"0-0","0-2",19,4,7,3,3,3,0,0,10,4,17,9,2,14,26,"10-4","Y","N","N",6,0,1
"608","E3",2023-08-05,"Grimsby","AFC Wimbledon",0,0,"D",0,0,"D",2.06,3.45,3.87,"0-0","0-0",15,5,10,4,4,3,0,0,8,5,10,12,0,13,22,"8-5","N","N","N",7,0,1
"609","E3",2023-08-05,"Morecambe","Walsall",2,1,"H",1,1,"D",2.7,3.26,2.82,"1-1","2-1",7,5,11,1,6,4,0,0,5,3,12,7,3,8,19,"5-3","Y","Y","N",10,0,1
"610","E3",2023-08-05,"Stockport","Gillingham",0,1,"A",0,0,"D",1.79,3.57,5.1,"0-0","0-1",16,3,6,3,0,5,0,0,6,1,11,11,1,7,22,"6-1","N","N","N",5,0,1
"611","E3",2023-08-05,"Sutton","Notts County",5,1,"H",2,0,"H",4.71,4.13,1.72,"2-0","5-1",12,6,14,3,3,3,0,1,4,5,16,8,6,9,24,"4-5","Y","Y","Y",6,1,1
"612","E3",2023-08-05,"Tranmere","Barrow",1,2,"A",0,1,"A",2.45,3.17,3.23,"0-1","1-2",17,3,7,3,2,2,0,0,7,4,9,8,3,11,17,"7-4","Y","Y","N",4,0,1
"613","E3",2023-08-05,"Wrexham","Milton Keynes Dons",3,5,"A",1,2,"A",1.69,3.98,5.13,"1-2","3-5",23,5,8,6,2,3,0,0,5,4,15,9,8,9,24,"5-4","Y","Y","Y",5,0,1
"614","E3",2023-08-12,"AFC Wimbledon","Wrexham",1,1,"D",0,1,"A",3.61,3.62,2.08,"0-1","1-1",13,3,10,6,3,2,0,0,6,4,12,12,2,10,24,"6-4","Y","N","N",5,0,1
"615","E3",2023-08-12,"Barrow","Sutton",2,1,"H",0,1,"A",2.45,3.13,3.28,"0-1","2-1",17,7,9,3,0,1,0,1,9,1,8,7,3,10,15,"9-1","Y","Y","N",1,1,2
"616","E3",2023-08-12,"Bradford","Colchester",2,1,"H",1,1,"D",1.92,3.57,4.15,"1-1","2-1",19,7,11,2,2,2,0,0,4,11,3,9,3,15,12,"4-11","Y","Y","N",4,0,2
"617","E3",2023-08-12,"Gillingham","Accrington",1,0,"H",1,0,"H",2.08,3.31,3.99,"1-0","1-0",17,4,9,1,3,2,0,0,9,1,14,13,1,10,27,"9-1","N","N","N",5,0,2
"618","E3",2023-08-12,"Harrogate","Forest Green",0,1,"A",0,0,"D",2.4,3.46,3.06,"0-0","0-1",10,3,15,2,1,3,0,0,8,5,7,11,1,13,18,"8-5","N","N","N",4,0,2
"619","E3",2023-08-12,"Mansfield","Morecambe",3,0,"H",1,0,"H",1.56,4.48,5.82,"1-0","3-0",27,6,5,0,2,2,0,0,5,4,9,11,3,9,20,"5-4","Y","Y","N",4,0,2
"620","E3",2023-08-12,"Milton Keynes Dons","Tranmere",1,0,"H",1,0,"H",1.79,3.69,4.83,"1-0","1-0",7,2,16,3,2,1,0,0,3,11,8,12,1,14,20,"3-11","N","N","N",3,0,2
"621","E3",2023-08-12,"Newport County","Doncaster",4,0,"H",3,0,"H",2.25,3.47,3.33,"3-0","4-0",14,6,8,2,4,6,0,0,2,5,10,18,4,7,28,"2-5","Y","Y","Y",10,0,2
"622","E3",2023-08-12,"Notts County","Grimsby",3,2,"H",1,2,"A",1.78,4.16,4.32,"1-2","3-2",12,8,10,3,4,4,0,0,7,6,6,16,5,13,22,"7-6","Y","Y","Y",8,0,2
"623","E3",2023-08-12,"Salford","Crawley Town",1,1,"D",0,1,"A",1.48,4.67,6.68,"0-1","1-1",7,3,16,2,1,4,0,0,2,3,13,10,2,5,23,"2-3","Y","N","N",5,0,2
"624","E3",2023-08-12,"Swindon","Crewe",2,2,"D",1,0,"H",1.86,3.6,4.54,"1-0","2-2",20,6,16,5,4,6,0,0,7,2,13,13,4,9,26,"7-2","Y","Y","Y",10,0,2
"625","E3",2023-08-12,"Walsall","Stockport",2,1,"H",1,0,"H",4.13,3.32,2.04,"1-0","2-1",9,2,18,3,3,5,0,0,4,11,8,9,3,15,17,"4-11","Y","Y","N",8,0,2
"626","E3",2023-08-15,"Accrington","Barrow",1,1,"D",1,0,"H",2.61,3.19,2.97,"1-0","1-1",7,2,13,1,2,1,0,0,1,10,10,5,2,11,15,"1-10","Y","N","N",3,0,2
"627","E3",2023-08-15,"Colchester","AFC Wimbledon",0,2,"A",0,0,"D",2.37,3.21,3.34,"0-0","0-2",9,4,21,7,3,3,0,0,7,9,8,12,2,16,20,"7-9","Y","N","N",6,0,3
"628","E3",2023-08-15,"Crawley Town","Milton Keynes Dons",2,1,"H",1,1,"D",3.06,3.44,2.41,"1-1","2-1",14,5,8,2,1,2,0,0,7,5,8,11,3,12,19,"7-5","Y","Y","N",3,0,3
"629","E3",2023-08-15,"Crewe","Newport County",4,2,"H",1,1,"D",3.21,3.42,2.33,"1-1","4-2",10,6,14,7,0,2,0,0,1,5,4,12,6,6,16,"1-5","Y","Y","Y",2,0,3
"630","E3",2023-08-15,"Doncaster","Mansfield",2,2,"D",1,1,"D",4.3,3.71,1.88,"1-1","2-2",11,5,21,8,1,3,0,0,3,7,8,10,4,10,18,"3-7","Y","Y","Y",4,0,3
"631","E3",2023-08-15,"Forest Green","Swindon",1,2,"A",1,0,"H",2.75,3.4,2.66,"1-0","1-2",13,5,21,8,4,3,1,0,6,5,12,11,3,11,23,"6-5","Y","Y","N",7,1,3
"632","E3",2023-08-15,"Grimsby","Salford",2,0,"H",1,0,"H",2.7,3.3,2.78,"1-0","2-0",10,2,7,1,0,3,0,1,2,7,16,16,2,9,32,"2-7","Y","N","N",3,1,3
"633","E3",2023-08-15,"Morecambe","Notts County",0,0,"D",0,0,"D",4.3,4.03,1.8,"0-0","0-0",13,1,9,1,1,1,0,0,4,5,7,4,0,9,11,"4-5","N","N","N",2,0,3
"634","E3",2023-08-15,"Stockport","Bradford",1,1,"D",0,0,"D",1.85,3.46,4.84,"0-0","1-1",15,5,10,6,2,3,0,0,7,4,8,16,2,11,24,"7-4","Y","N","N",5,0,3
"635","E3",2023-08-15,"Sutton","Gillingham",0,1,"A",0,1,"A",2.68,3.18,2.91,"0-1","0-1",6,2,5,1,2,1,0,0,2,9,6,10,1,11,16,"2-9","N","N","N",3,0,3
"636","E3",2023-08-15,"Tranmere","Harrogate",3,0,"H",2,0,"H",2.14,3.4,3.67,"2-0","3-0",11,5,11,2,2,1,0,0,6,3,10,17,3,9,27,"6-3","Y","Y","N",3,0,3
"637","E3",2023-08-15,"Wrexham","Walsall",4,2,"H",2,1,"H",1.62,4.28,5.36,"2-1","4-2",20,11,12,5,1,3,0,0,6,3,3,9,6,9,12,"6-3","Y","Y","Y",4,0,3
"638","E3",2023-08-19,"Accrington","Harrogate",2,1,"H",1,0,"H",2.13,3.46,3.53,"1-0","2-1",23,7,11,2,4,4,1,0,5,3,14,15,3,8,29,"5-3","Y","Y","N",8,1,3
"639","E3",2023-08-19,"Colchester","Milton Keynes Dons",2,3,"A",2,1,"H",2.86,3.28,2.64,"2-1","2-3",12,4,18,6,5,4,0,0,3,6,16,8,5,9,24,"3-6","Y","Y","Y",9,0,4
"640","E3",2023-08-19,"Crawley Town","Gillingham",0,1,"A",0,1,"A",3.13,3.1,2.52,"0-1","0-1",17,7,7,2,3,3,0,0,9,4,8,10,1,13,18,"9-4","N","N","N",6,0,4
"641","E3",2023-08-19,"Crewe","Walsall",2,2,"D",0,2,"A",2.71,3.41,2.7,"0-2","2-2",11,3,19,7,1,1,0,0,8,5,6,10,4,13,16,"8-5","Y","Y","Y",2,0,4
"642","E3",2023-08-19,"Doncaster","Notts County",1,3,"A",0,1,"A",4.23,3.75,1.88,"0-1","1-3",10,6,8,5,0,3,0,0,4,3,10,8,4,7,18,"4-3","Y","Y","Y",3,0,4
"643","E3",2023-08-19,"Forest Green","Newport County",0,3,"A",0,2,"A",2.55,3.47,2.83,"0-2","0-3",12,1,10,7,2,0,1,0,7,4,6,7,3,11,13,"7-4","Y","Y","N",2,1,4
"644","E3",2023-08-19,"Grimsby","Mansfield",1,1,"D",1,0,"H",3.23,3.46,2.3,"1-0","1-1",8,3,20,4,0,0,0,0,4,6,7,11,2,10,18,"4-6","Y","N","N",0,0,4
"645","E3",2023-08-19,"Morecambe","Bradford",3,0,"H",1,0,"H",3.53,3.45,2.17,"1-0","3-0",11,3,12,5,3,3,0,0,6,3,15,11,3,9,26,"6-3","Y","Y","N",6,0,4
"646","E3",2023-08-19,"Stockport","Barrow",1,0,"H",0,0,"D",1.72,3.87,5.08,"0-0","1-0",11,5,10,3,2,1,0,0,4,3,10,5,1,7,15,"4-3","N","N","N",3,0,4
"647","E3",2023-08-19,"Sutton","AFC Wimbledon",0,3,"A",0,0,"D",2.46,3.27,3.13,"0-0","0-3",10,4,15,5,2,1,0,0,4,5,7,18,3,9,25,"4-5","Y","Y","N",3,0,4
"648","E3",2023-08-19,"Tranmere","Salford",3,4,"A",2,1,"H",2.86,3.36,2.59,"2-1","3-4",13,6,15,6,1,2,0,0,4,5,14,10,7,9,24,"4-5","Y","Y","Y",3,0,4
"649","E3",2023-08-19,"Wrexham","Swindon",5,5,"D",1,4,"A",1.62,4.31,5.37,"1-4","5-5",28,12,8,6,1,3,0,0,9,2,12,17,10,11,29,"9-2","Y","Y","Y",4,0,4
"650","E3",2023-08-26,"AFC Wimbledon","Forest Green",1,1,"D",1,0,"H",1.82,3.7,4.64,"1-0","1-1",22,6,8,3,2,1,0,0,9,2,12,4,2,11,16,"9-2","Y","N","N",3,0,4
"651","E3",2023-08-26,"Barrow","Wrexham",1,1,"D",0,1,"A",3.37,3.54,2.2,"0-1","1-1",5,2,12,4,3,2,0,0,3,10,9,9,2,13,18,"3-10","Y","N","N",5,0,5
"652","E3",2023-08-26,"Bradford","Crewe",1,0,"H",1,0,"H",1.65,4.24,5.13,"1-0","1-0",12,2,10,3,2,0,0,0,4,11,10,8,1,15,18,"4-11","N","N","N",2,0,5
"653","E3",2023-08-26,"Gillingham","Colchester",0,3,"A",0,0,"D",1.83,3.44,5.02,"0-0","0-3",10,4,12,5,2,4,1,0,3,4,14,18,3,7,32,"3-4","Y","Y","N",6,1,5
"654","E3",2023-08-26,"Harrogate","Morecambe",2,0,"H",1,0,"H",2.39,3.51,3.03,"1-0","2-0",16,6,9,1,3,3,0,1,1,4,13,11,2,5,24,"1-4","Y","N","N",6,1,5
"655","E3",2023-08-26,"Mansfield","Stockport",3,2,"H",1,2,"A",2.36,3.36,3.22,"1-2","3-2",28,11,10,3,1,0,0,0,11,1,5,7,5,12,12,"11-1","Y","Y","Y",1,0,5
"656","E3",2023-08-26,"Milton Keynes Dons","Doncaster",2,1,"H",2,0,"H",1.7,3.96,5.11,"2-0","2-1",9,5,17,6,1,1,0,0,2,8,8,17,3,10,25,"2-8","Y","Y","N",2,0,5
"657","E3",2023-08-26,"Newport County","Sutton",3,1,"H",0,0,"D",1.99,3.54,3.99,"0-0","3-1",13,5,15,5,1,3,0,0,1,6,8,10,4,7,18,"1-6","Y","Y","Y",4,0,5
"658","E3",2023-08-26,"Notts County","Tranmere",2,1,"H",1,0,"H",1.6,4.43,5.35,"1-0","2-1",17,6,12,4,3,3,0,0,11,3,6,8,3,14,14,"11-3","Y","Y","N",6,0,5
"659","E3",2023-08-26,"Salford","Accrington",1,2,"A",0,2,"A",1.77,3.84,4.59,"0-2","1-2",16,2,16,6,3,3,0,0,1,6,20,10,3,7,30,"1-6","Y","Y","N",6,0,5
"660","E3",2023-08-26,"Swindon","Crawley Town",6,0,"H",1,0,"H",2.08,3.78,3.46,"1-0","6-0",17,10,14,3,0,1,0,0,5,6,10,10,6,11,20,"5-6","Y","Y","Y",1,0,5
"661","E3",2023-08-26,"Walsall","Grimsby",1,1,"D",0,0,"D",2.46,3.35,3.05,"0-0","1-1",16,6,11,2,2,3,1,0,8,10,13,11,2,18,24,"8-10","Y","N","N",5,1,5
"662","E3",2023-09-02,"Tranmere","Wrexham",0,1,"A",0,0,"D",3.58,3.91,2,"0-0","0-1",11,2,23,5,1,1,0,0,7,17,7,11,1,24,18,"7-17","N","N","N",2,0,5
"663","E3",2023-09-02,"Crewe","Milton Keynes Dons",3,1,"H",0,1,"A",3.03,3.57,2.36,"0-1","3-1",15,7,12,4,4,1,0,0,8,2,12,8,4,10,20,"8-2","Y","Y","Y",5,0,6
"664","E3",2023-09-02,"Doncaster","Swindon",0,0,"D",0,0,"D",2.88,3.46,2.52,"0-0","0-0",6,3,13,2,4,4,1,0,1,11,9,15,0,12,24,"1-11","N","N","N",8,1,6
"665","E3",2023-09-02,"Grimsby","Gillingham",2,0,"H",2,0,"H",2.52,3.3,3.01,"2-0","2-0",12,4,6,3,1,0,0,0,6,4,6,12,2,10,18,"6-4","Y","N","N",1,0,6
"666","E3",2023-09-02,"Harrogate","Barrow",0,1,"A",0,1,"A",2.6,3.3,2.9,"0-1","0-1",12,5,10,2,2,2,0,0,8,6,11,10,1,14,21,"8-6","N","N","N",4,0,6
"667","E3",2023-09-02,"Mansfield","Bradford",0,0,"D",0,0,"D",1.82,3.78,4.51,"0-0","0-0",11,1,9,2,2,4,0,0,8,2,10,12,0,10,22,"8-2","N","N","N",6,0,6
"668","E3",2023-09-02,"Morecambe","Salford",1,0,"H",1,0,"H",2.94,3.54,2.44,"1-0","1-0",11,5,7,2,0,0,0,1,9,3,14,11,1,12,25,"9-3","N","N","N",0,1,6
"669","E3",2023-09-02,"Newport County","AFC Wimbledon",2,2,"D",1,2,"A",2.61,3.34,2.86,"1-2","2-2",11,4,14,4,1,1,0,0,6,3,6,8,4,9,14,"6-3","Y","Y","Y",2,0,6
"670","E3",2023-09-02,"Notts County","Accrington",3,1,"H",1,1,"D",1.59,4.51,5.32,"1-1","3-1",10,5,16,6,4,2,0,0,2,7,11,11,4,9,22,"2-7","Y","Y","Y",6,0,6
"671","E3",2023-09-02,"Stockport","Crawley Town",3,3,"D",2,1,"H",1.56,4.35,6.01,"2-1","3-3",17,5,8,5,1,5,0,0,2,3,7,12,6,5,19,"2-3","Y","Y","Y",6,0,6
"672","E3",2023-09-02,"Sutton","Forest Green",0,1,"A",0,0,"D",2.09,3.45,3.76,"0-0","0-1",12,2,17,6,1,2,0,0,7,3,13,14,1,10,27,"7-3","N","N","N",3,0,6
"673","E3",2023-09-02,"Walsall","Colchester",1,0,"H",0,0,"D",2.14,3.46,3.6,"0-0","1-0",16,7,10,3,4,1,0,0,6,4,17,9,1,10,26,"6-4","N","N","N",5,0,6
"674","E3",2023-09-09,"Bradford","Grimsby",1,1,"D",0,1,"A",2.06,3.45,3.87,"0-1","1-1",9,1,7,3,2,4,0,0,7,2,10,10,2,9,20,"7-2","Y","N","N",6,0,6
"675","E3",2023-09-09,"Accrington","Mansfield",0,3,"A",0,2,"A",3.56,3.57,2.11,"0-2","0-3",13,2,12,5,1,1,0,0,5,4,13,17,3,9,30,"5-4","Y","Y","N",2,0,7
"676","E3",2023-09-09,"AFC Wimbledon","Stockport",1,2,"A",1,0,"H",2.81,3.34,2.65,"1-0","1-2",9,4,12,3,2,2,0,0,3,5,13,7,3,8,20,"3-5","Y","Y","N",4,0,7
"677","E3",2023-09-09,"Colchester","Tranmere",2,0,"H",1,0,"H",2.32,3.5,3.16,"1-0","2-0",27,12,10,4,2,4,0,0,11,5,10,8,2,16,18,"11-5","Y","N","N",6,0,7
"678","E3",2023-09-09,"Crawley Town","Newport County",4,1,"H",1,1,"D",3.07,3.49,2.38,"1-1","4-1",13,8,9,5,2,1,0,0,4,0,8,9,5,4,17,"4-0","Y","Y","Y",3,0,7
"679","E3",2023-09-09,"Forest Green","Crewe",1,4,"A",1,0,"H",2.18,3.52,3.44,"1-0","1-4",9,4,18,5,4,3,0,0,3,7,12,10,5,10,22,"3-7","Y","Y","Y",7,0,7
"680","E3",2023-09-09,"Gillingham","Harrogate",1,0,"H",0,0,"D",1.85,3.57,4.69,"0-0","1-0",15,4,5,2,3,1,0,0,10,2,12,7,1,12,19,"10-2","N","N","N",4,0,7
"681","E3",2023-09-09,"Milton Keynes Dons","Notts County",1,1,"D",0,0,"D",2.89,3.86,2.33,"0-0","1-1",11,3,9,3,1,0,0,0,3,6,12,5,2,9,17,"3-6","Y","N","N",1,0,7
"682","E3",2023-09-09,"Salford","Walsall",1,2,"A",1,0,"H",2.1,3.68,3.49,"1-0","1-2",20,7,10,5,2,1,0,0,12,1,12,12,3,13,24,"12-1","Y","Y","N",3,0,7
"683","E3",2023-09-09,"Swindon","Sutton",5,3,"H",3,2,"H",1.83,3.85,4.34,"3-2","5-3",15,7,13,5,1,2,0,0,5,3,4,6,8,8,10,"5-3","Y","Y","Y",3,0,7
"684","E3",2023-09-09,"Wrexham","Doncaster",2,1,"H",1,0,"H",1.43,5.03,7.21,"1-0","2-1",16,8,8,2,2,3,0,0,6,4,9,13,3,10,22,"6-4","Y","Y","N",5,0,7
"685","E3",2023-09-15,"Salford","Notts County",0,2,"A",0,1,"A",3.05,3.9,2.23,"0-1","0-2",12,2,14,4,3,2,1,1,1,8,11,11,2,9,22,"1-8","Y","N","N",5,2,7
"686","E3",2023-09-16,"Accrington","Sutton",4,1,"H",1,0,"H",2.09,3.63,3.57,"1-0","4-1",15,5,12,1,3,1,0,0,2,3,10,12,5,5,22,"2-3","Y","Y","Y",4,0,7
"687","E3",2023-09-16,"AFC Wimbledon","Crewe",2,2,"D",2,0,"H",1.8,3.96,4.41,"2-0","2-2",21,6,9,4,2,2,0,0,13,7,11,9,4,20,20,"13-7","Y","Y","Y",4,0,8
"688","E3",2023-09-16,"Bradford","Harrogate",1,1,"D",0,0,"D",1.76,3.74,4.95,"0-0","1-1",9,3,8,1,0,2,0,0,3,5,8,10,2,8,18,"3-5","Y","N","N",2,0,8
"689","E3",2023-09-16,"Colchester","Mansfield",1,1,"D",1,0,"H",3.64,3.83,2,"1-0","1-1",12,4,10,5,4,3,0,0,3,4,9,4,2,7,13,"3-4","Y","N","N",7,0,8
"690","E3",2023-09-16,"Crawley Town","Tranmere",3,2,"H",0,1,"A",2.22,3.59,3.28,"0-1","3-2",16,7,7,4,4,5,0,0,9,0,7,9,5,9,16,"9-0","Y","Y","Y",9,0,8
"691","E3",2023-09-16,"Forest Green","Doncaster",1,2,"A",0,1,"A",2.21,3.59,3.3,"0-1","1-2",28,3,15,7,4,2,0,0,10,12,8,10,3,22,18,"10-12","Y","Y","N",6,0,8
"692","E3",2023-09-16,"Gillingham","Morecambe",2,1,"H",2,1,"H",1.79,3.7,4.81,"2-1","2-1",11,5,5,3,2,3,0,1,4,3,8,16,3,7,24,"4-3","Y","Y","N",5,1,8
"693","E3",2023-09-16,"Milton Keynes Dons","Stockport",1,2,"A",1,2,"A",3.03,3.61,2.35,"1-2","1-2",20,3,10,5,4,2,0,0,9,4,11,10,3,13,21,"9-4","Y","Y","N",6,0,8
"694","E3",2023-09-16,"Newport County","Barrow",1,1,"D",1,0,"H",2.09,3.44,3.77,"1-0","1-1",8,2,6,3,2,2,1,0,3,10,13,17,2,13,30,"3-10","Y","N","N",4,1,8
"695","E3",2023-09-16,"Swindon","Walsall",2,0,"H",1,0,"H",1.97,3.81,3.76,"1-0","2-0",12,6,7,2,2,2,0,1,4,2,5,10,2,6,15,"4-2","Y","N","N",4,1,8
"696","E3",2023-09-16,"Wrexham","Grimsby",3,0,"H",2,0,"H",1.66,4.19,5.1,"2-0","3-0",17,9,9,1,2,2,0,0,3,1,7,6,3,4,13,"3-1","Y","Y","N",4,0,8
"697","E3",2023-09-23,"Crewe","Colchester",2,1,"H",2,0,"H",2.48,3.65,2.8,"2-0","2-1",10,3,21,6,1,0,0,0,6,10,15,11,3,16,26,"6-10","Y","Y","N",1,0,8
"698","E3",2023-09-23,"Doncaster","Gillingham",2,1,"H",1,1,"D",3.26,3.17,2.43,"1-1","2-1",13,6,15,5,2,2,0,0,7,6,9,10,3,13,19,"7-6","Y","Y","N",4,0,8
"699","E3",2023-09-23,"Grimsby","Crawley Town",2,3,"A",2,2,"D",2.07,3.62,3.64,"2-2","2-3",18,7,13,3,1,1,0,0,5,5,14,8,5,10,22,"5-5","Y","Y","Y",2,0,9
"700","E3",2023-09-23,"Harrogate","Salford",3,2,"H",2,1,"H",2.95,3.45,2.47,"2-1","3-2",16,7,18,5,2,2,0,0,7,5,6,10,5,12,16,"7-5","Y","Y","Y",4,0,9
"701","E3",2023-09-23,"Mansfield","Barrow",1,0,"H",0,0,"D",1.66,3.95,5.56,"0-0","1-0",14,2,9,2,2,1,0,1,6,2,9,11,1,8,20,"6-2","N","N","N",3,1,9
"702","E3",2023-09-23,"Morecambe","Swindon",2,2,"D",1,1,"D",3.39,3.77,2.11,"1-1","2-2",16,4,13,5,1,2,1,0,9,4,11,6,4,13,17,"9-4","Y","Y","Y",3,1,9
"703","E3",2023-09-23,"Newport County","Bradford",1,4,"A",1,3,"A",2.4,3.32,3.16,"1-3","1-4",7,1,17,7,2,1,0,0,6,7,9,8,5,13,17,"6-7","Y","Y","Y",3,0,9
"704","E3",2023-09-23,"Notts County","Forest Green",4,3,"H",2,0,"H",1.51,4.79,5.96,"2-0","4-3",11,6,14,4,3,5,0,0,7,10,10,11,7,17,21,"7-10","Y","Y","Y",8,0,9
"705","E3",2023-09-23,"Stockport","Wrexham",5,0,"H",3,0,"H",2.52,3.73,2.72,"3-0","5-0",10,5,20,5,1,1,0,0,1,5,10,13,5,6,23,"1-5","Y","Y","Y",2,0,9
"706","E3",2023-09-23,"Sutton","Milton Keynes Dons",1,1,"D",1,0,"H",2.66,3.42,2.74,"1-0","1-1",10,5,12,2,0,1,0,0,7,10,10,13,2,17,23,"7-10","Y","N","N",1,0,9
"707","E3",2023-09-23,"Tranmere","Accrington",2,0,"H",1,0,"H",2.74,3.49,2.62,"1-0","2-0",17,7,9,3,0,3,0,1,8,6,11,16,2,14,27,"8-6","Y","N","N",3,1,9
"708","E3",2023-09-23,"Walsall","AFC Wimbledon",1,3,"A",0,1,"A",2.64,3.43,2.76,"0-1","1-3",5,1,15,6,0,2,1,0,0,5,9,13,4,5,22,"0-5","Y","Y","Y",2,1,9
"709","E3",2023-09-30,"Accrington","Stockport",1,3,"A",0,2,"A",3.68,3.77,2.01,"0-2","1-3",14,4,6,4,1,1,0,0,9,4,16,10,4,13,26,"9-4","Y","Y","Y",2,0,9
"710","E3",2023-09-30,"AFC Wimbledon","Tranmere",4,1,"H",2,1,"H",1.72,3.93,4.97,"2-1","4-1",19,8,8,2,1,2,0,1,4,4,9,10,5,8,19,"4-4","Y","Y","Y",3,1,9
"711","E3",2023-09-30,"Barrow","Doncaster",3,2,"H",1,0,"H",1.94,3.64,4.07,"1-0","3-2",7,4,12,4,4,3,0,0,1,8,12,16,5,9,28,"1-8","Y","Y","Y",7,0,10
"712","E3",2023-09-30,"Bradford","Walsall",1,3,"A",1,2,"A",1.82,3.65,4.53,"1-2","1-3",10,2,7,4,1,4,0,0,10,5,8,9,4,15,17,"10-5","Y","Y","Y",5,0,10
"713","E3",2023-09-30,"Colchester","Notts County",5,4,"H",3,1,"H",3.6,3.87,2.01,"3-1","5-4",15,8,21,7,3,3,1,0,3,8,8,9,9,11,17,"3-8","Y","Y","Y",6,1,10
"714","E3",2023-09-30,"Crawley Town","Sutton",3,0,"H",1,0,"H",2.02,3.72,3.68,"1-0","3-0",18,7,7,2,1,3,0,0,5,4,8,12,3,9,20,"5-4","Y","Y","N",4,0,10
"715","E3",2023-09-30,"Forest Green","Morecambe",1,2,"A",0,1,"A",1.98,3.69,3.88,"0-1","1-2",13,2,14,11,3,2,0,0,7,7,8,6,3,14,14,"7-7","Y","Y","N",5,0,10
"716","E3",2023-09-30,"Gillingham","Mansfield",1,1,"D",1,1,"D",3.15,3.28,2.43,"1-1","1-1",20,4,17,3,4,2,0,0,5,11,11,13,2,16,24,"5-11","Y","N","N",6,0,10
"717","E3",2023-09-30,"Milton Keynes Dons","Harrogate",0,1,"A",0,1,"A",1.85,3.81,4.3,"0-1","0-1",27,4,3,3,3,1,0,0,11,3,12,5,1,14,17,"11-3","N","N","N",4,0,10
"718","E3",2023-09-30,"Salford","Newport County",2,1,"H",2,1,"H",2.28,3.66,3.11,"2-1","2-1",10,2,15,4,1,3,0,0,2,6,11,12,3,8,23,"2-6","Y","Y","N",4,0,10
"719","E3",2023-09-30,"Swindon","Grimsby",2,1,"H",1,0,"H",1.86,3.91,4.12,"1-0","2-1",8,3,13,4,2,2,0,0,9,7,5,10,3,16,15,"9-7","Y","Y","N",4,0,10
"720","E3",2023-09-30,"Wrexham","Crewe",3,3,"D",1,2,"A",1.42,5.24,7.06,"1-2","3-3",12,6,11,7,4,4,1,0,7,6,12,12,6,13,24,"7-6","Y","Y","Y",8,1,10
"721","E3",2023-10-03,"Crewe","Gillingham",2,0,"H",1,0,"H",2.78,3.44,2.61,"1-0","2-0",9,4,13,5,1,0,0,0,6,4,7,9,2,10,16,"6-4","Y","N","N",1,0,10
"722","E3",2023-10-03,"Doncaster","Crawley Town",2,0,"H",1,0,"H",2.68,3.67,2.58,"1-0","2-0",17,8,15,4,3,3,0,0,5,5,15,12,2,10,27,"5-5","Y","N","N",6,0,10
"723","E3",2023-10-03,"Grimsby","Barrow",2,1,"H",1,0,"H",2.17,3.33,3.68,"1-0","2-1",9,6,24,7,1,1,0,0,4,7,13,11,3,11,24,"4-7","Y","Y","N",2,0,11
"724","E3",2023-10-03,"Harrogate","AFC Wimbledon",0,1,"A",0,1,"A",3.6,3.39,2.17,"0-1","0-1",4,2,16,4,2,2,0,0,2,4,10,15,1,6,25,"2-4","N","N","N",4,0,11
"725","E3",2023-10-03,"Mansfield","Wrexham",0,0,"D",0,0,"D",2.28,3.74,3.06,"0-0","0-0",19,5,7,1,2,1,0,0,10,6,10,5,0,16,15,"10-6","N","N","N",3,0,11
"726","E3",2023-10-03,"Morecambe","Accrington",1,1,"D",0,0,"D",2.58,3.47,2.8,"0-0","1-1",15,6,15,3,3,3,0,0,4,9,17,9,2,13,26,"4-9","Y","N","N",6,0,11
"727","E3",2023-10-03,"Newport County","Colchester",2,1,"H",1,1,"D",2.3,3.61,3.12,"1-1","2-1",18,7,14,4,2,2,0,1,8,5,12,11,3,13,23,"8-5","Y","Y","N",4,1,11
"728","E3",2023-10-03,"Notts County","Swindon",3,1,"H",3,0,"H",1.86,4.36,3.71,"3-0","3-1",10,6,19,4,3,2,0,0,3,5,13,14,4,8,27,"3-5","Y","Y","Y",5,0,11
"729","E3",2023-10-03,"Stockport","Forest Green",2,0,"H",2,0,"H",1.43,4.75,7.79,"2-0","2-0",15,6,6,1,1,0,0,1,4,3,8,15,2,7,23,"4-3","Y","N","N",1,1,11
"730","E3",2023-10-03,"Sutton","Salford",0,2,"A",0,0,"D",2.56,3.59,2.75,"0-0","0-2",8,2,11,5,1,3,0,0,4,3,15,10,2,7,25,"4-3","Y","N","N",4,0,11
"731","E3",2023-10-03,"Tranmere","Bradford",2,1,"H",1,0,"H",3.36,3.34,2.29,"1-0","2-1",9,5,10,5,3,3,0,0,5,6,6,15,3,11,21,"5-6","Y","Y","N",6,0,11
"732","E3",2023-10-03,"Walsall","Milton Keynes Dons",0,0,"D",0,0,"D",2.74,3.4,2.67,"0-0","0-0",12,4,18,5,3,3,0,0,5,3,17,8,0,8,25,"5-3","N","N","N",6,0,11
"733","E3",2023-10-07,"Accrington","Forest Green",2,1,"H",1,0,"H",2.11,3.81,3.37,"1-0","2-1",16,4,15,5,1,1,0,0,4,5,13,12,3,9,25,"4-5","Y","Y","N",2,0,11
"734","E3",2023-10-07,"Barrow","Notts County",1,1,"D",0,1,"A",3.64,3.73,2.04,"0-1","1-1",14,6,5,1,1,3,0,0,2,5,7,11,2,7,18,"2-5","Y","N","N",4,0,11
"735","E3",2023-10-07,"Bradford","Swindon",1,0,"H",0,0,"D",2.42,3.73,2.84,"0-0","1-0",19,4,11,2,3,3,0,0,6,3,11,7,1,9,18,"6-3","N","N","N",6,0,12
"736","E3",2023-10-07,"Colchester","Morecambe",1,3,"A",0,1,"A",1.92,3.8,3.99,"0-1","1-3",21,5,15,7,2,4,0,1,5,4,7,12,4,9,19,"5-4","Y","Y","Y",6,1,12
"737","E3",2023-10-07,"Crawley Town","Wrexham",0,1,"A",0,1,"A",3.75,4.06,1.92,"0-1","0-1",25,5,10,5,2,6,0,1,6,8,8,9,1,14,17,"6-8","N","N","N",8,1,12
"738","E3",2023-10-07,"Gillingham","Milton Keynes Dons",2,1,"H",1,0,"H",2.4,3.38,3.12,"1-0","2-1",16,6,27,8,2,3,0,1,6,4,11,10,3,10,21,"6-4","Y","Y","N",5,1,12
"739","E3",2023-10-07,"Mansfield","AFC Wimbledon",0,0,"D",0,0,"D",1.98,3.63,3.92,"0-0","0-0",20,4,8,4,2,2,0,0,6,3,13,13,0,9,26,"6-3","N","N","N",4,0,12
"740","E3",2023-10-07,"Newport County","Harrogate",1,2,"A",0,1,"A",1.96,3.62,4.03,"0-1","1-2",11,4,7,3,2,2,0,0,5,4,16,6,3,9,22,"5-4","Y","Y","N",4,0,12
"741","E3",2023-10-07,"Salford","Crewe",4,2,"H",1,1,"D",2.12,3.75,3.3,"1-1","4-2",14,7,14,3,2,2,0,0,5,1,13,14,6,6,27,"5-1","Y","Y","Y",4,0,12
"742","E3",2023-10-07,"Stockport","Doncaster",1,0,"H",0,0,"D",1.49,4.65,6.59,"0-0","1-0",10,4,6,4,2,1,0,0,6,6,6,11,1,12,17,"6-6","N","N","N",3,0,12
"743","E3",2023-10-07,"Sutton","Walsall",4,0,"H",4,0,"H",2.56,3.42,2.8,"4-0","4-0",12,6,13,5,0,0,0,0,4,5,15,8,4,9,23,"4-5","Y","Y","Y",0,0,12
"744","E3",2023-10-07,"Tranmere","Grimsby",2,2,"D",1,2,"A",2.73,3.42,2.67,"1-2","2-2",8,3,13,5,1,1,0,0,1,5,10,9,4,6,19,"1-5","Y","Y","Y",2,0,12
"745","E3",2023-10-14,"Notts County","Mansfield",1,4,"A",1,1,"D",2.24,3.98,2.98,"1-1","1-4",9,2,21,9,1,1,0,0,5,6,4,10,5,11,14,"5-6","Y","Y","Y",2,0,12
"746","E3",2023-10-14,"AFC Wimbledon","Bradford",0,1,"A",0,0,"D",2.07,3.44,3.85,"0-0","0-1",11,5,7,2,3,2,0,0,10,4,13,13,1,14,26,"10-4","N","N","N",5,0,12
"747","E3",2023-10-14,"Crewe","Tranmere",2,0,"H",1,0,"H",1.97,3.8,3.79,"1-0","2-0",16,4,13,3,3,1,0,2,10,4,7,10,2,14,17,"10-4","Y","N","N",4,2,13
"748","E3",2023-10-14,"Doncaster","Sutton",4,1,"H",1,0,"H",2.1,3.59,3.58,"1-0","4-1",12,5,6,3,2,3,0,0,2,1,15,10,5,3,25,"2-1","Y","Y","Y",5,0,13
"749","E3",2023-10-14,"Forest Green","Colchester",5,0,"H",1,0,"H",2.51,3.59,2.8,"1-0","5-0",14,10,6,1,1,1,0,1,5,3,11,12,5,8,23,"5-3","Y","Y","Y",2,1,13
"750","E3",2023-10-14,"Grimsby","Accrington",0,2,"A",0,0,"D",2.19,3.54,3.4,"0-0","0-2",11,2,12,2,0,2,1,0,9,4,17,14,2,13,31,"9-4","Y","N","N",2,1,13
"751","E3",2023-10-14,"Harrogate","Stockport",1,3,"A",0,1,"A",4.73,3.88,1.76,"0-1","1-3",6,4,16,7,0,1,0,0,5,8,7,12,4,13,19,"5-8","Y","Y","Y",1,0,13
"752","E3",2023-10-14,"Milton Keynes Dons","Barrow",2,2,"D",2,0,"H",2.13,3.49,3.62,"2-0","2-2",15,5,18,9,2,1,0,0,1,8,14,11,4,9,25,"1-8","Y","Y","Y",3,0,13
"753","E3",2023-10-14,"Swindon","Newport County",2,0,"H",1,0,"H",1.74,4.11,4.57,"1-0","2-0",13,6,11,4,1,0,0,0,7,5,12,14,2,12,26,"7-5","Y","N","N",1,0,13
"754","E3",2023-10-14,"Walsall","Gillingham",4,1,"H",2,0,"H",2.85,3.29,2.65,"2-0","4-1",13,7,14,5,3,3,0,0,0,4,14,6,5,4,20,"0-4","Y","Y","Y",6,0,13
"755","E3",2023-10-14,"Wrexham","Salford",3,2,"H",1,2,"A",1.53,4.64,5.9,"1-2","3-2",21,7,10,4,3,4,0,0,11,3,13,8,5,14,21,"11-3","Y","Y","Y",7,0,13
"756","E3",2023-10-20,"Newport County","Walsall",3,3,"D",2,1,"H",2.4,3.48,3.04,"2-1","3-3",8,5,16,6,0,2,0,0,7,6,10,9,6,13,19,"7-6","Y","Y","Y",2,0,13
"757","E3",2023-10-20,"Tranmere","Doncaster",1,2,"A",0,1,"A",2.8,3.47,2.58,"0-1","1-2",12,3,11,5,3,2,0,0,5,3,9,6,3,8,15,"5-3","Y","Y","N",5,0,13
"758","E3",2023-10-21,"Accrington","Milton Keynes Dons",1,0,"H",1,0,"H",2.7,3.57,2.62,"1-0","1-0",13,4,10,1,2,1,0,0,6,4,24,7,1,10,31,"6-4","N","N","N",3,0,13
"759","E3",2023-10-21,"Barrow","AFC Wimbledon",0,0,"D",0,0,"D",2.93,3.34,2.54,"0-0","0-0",13,3,10,4,0,2,0,0,6,4,12,9,0,10,21,"6-4","N","N","N",2,0,14
"760","E3",2023-10-21,"Bradford","Wrexham",1,1,"D",0,0,"D",3.05,3.57,2.35,"0-0","1-1",21,5,8,1,3,2,0,0,11,3,10,8,2,14,18,"11-3","Y","N","N",5,0,14
"761","E3",2023-10-21,"Colchester","Harrogate",1,2,"A",0,0,"D",1.98,3.69,3.88,"0-0","1-2",20,5,8,2,1,0,0,0,10,3,6,3,3,13,9,"10-3","Y","Y","N",1,0,14
"762","E3",2023-10-21,"Crawley Town","Crewe",2,4,"A",2,1,"H",2.08,3.92,3.36,"2-1","2-4",14,5,12,8,4,2,0,0,6,7,9,10,6,13,19,"6-7","Y","Y","Y",6,0,14
"763","E3",2023-10-21,"Gillingham","Notts County",1,2,"A",0,1,"A",2.6,3.68,2.66,"0-1","1-2",11,2,10,7,2,3,0,0,3,5,8,5,3,8,13,"3-5","Y","Y","N",5,0,14
"764","E3",2023-10-21,"Salford","Swindon",2,2,"D",1,1,"D",2.71,3.8,2.49,"1-1","2-2",15,7,15,7,3,1,1,0,2,11,8,6,4,13,14,"2-11","Y","Y","Y",4,1,14
"765","E3",2023-10-21,"Stockport","Grimsby",3,2,"H",2,1,"H",1.54,4.45,6.15,"2-1","3-2",11,6,10,4,2,3,0,0,3,0,14,22,5,3,36,"3-0","Y","Y","Y",5,0,14
"766","E3",2023-10-21,"Sutton","Morecambe",2,3,"A",1,2,"A",2.44,3.58,2.91,"1-2","2-3",7,2,7,5,1,2,0,0,11,4,5,10,5,15,15,"11-4","Y","Y","Y",3,0,14
"767","E3",2023-10-24,"AFC Wimbledon","Accrington",2,4,"A",0,2,"A",1.7,4.03,4.97,"0-2","2-4",14,7,17,9,3,3,0,0,4,2,16,17,6,6,33,"4-2","Y","Y","Y",6,0,14
"768","E3",2023-10-24,"Crewe","Stockport",0,2,"A",0,0,"D",4.17,4.09,1.81,"0-0","0-2",5,0,7,3,2,1,0,0,6,4,9,12,2,10,21,"6-4","Y","N","N",3,0,14
"769","E3",2023-10-24,"Doncaster","Salford",0,3,"A",0,2,"A",2.2,3.6,3.33,"0-2","0-3",20,4,11,4,0,2,0,0,8,3,5,10,3,11,15,"8-3","Y","Y","N",2,0,14
"770","E3",2023-10-24,"Forest Green","Barrow",0,2,"A",0,2,"A",2.61,3.36,2.84,"0-2","0-2",17,7,12,4,2,1,0,0,5,4,12,9,2,9,21,"5-4","Y","N","N",3,0,14
"771","E3",2023-10-24,"Grimsby","Colchester",2,3,"A",1,2,"A",2.12,3.69,3.43,"1-2","2-3",18,6,9,4,1,3,0,0,3,3,11,7,5,6,18,"3-3","Y","Y","Y",4,0,15
"772","E3",2023-10-24,"Harrogate","Mansfield",1,4,"A",0,3,"A",5.6,4.11,1.63,"0-3","1-4",11,3,34,11,1,3,0,0,2,7,9,13,5,9,22,"2-7","Y","Y","Y",4,0,15
"773","E3",2023-10-24,"Milton Keynes Dons","Bradford",4,1,"H",2,1,"H",2.48,3.34,3.03,"2-1","4-1",18,11,7,2,0,4,0,0,4,1,11,11,5,5,22,"4-1","Y","Y","Y",4,0,15
"774","E3",2023-10-24,"Morecambe","Tranmere",1,0,"H",0,0,"D",2.06,3.61,3.68,"0-0","1-0",15,5,13,5,2,2,0,0,10,5,9,9,1,15,18,"10-5","N","N","N",4,0,15
"775","E3",2023-10-24,"Notts County","Newport County",3,0,"H",2,0,"H",1.58,4.65,5.32,"2-0","3-0",18,4,10,3,0,1,0,0,5,2,6,5,3,7,11,"5-2","Y","Y","N",1,0,15
"776","E3",2023-10-24,"Swindon","Gillingham",0,1,"A",0,1,"A",1.85,3.83,4.25,"0-1","0-1",22,7,12,4,0,2,0,0,6,10,6,10,1,16,16,"6-10","N","N","N",2,0,15
"777","E3",2023-10-24,"Walsall","Crawley Town",1,1,"D",0,0,"D",2.18,3.66,3.31,"0-0","1-1",17,7,7,4,0,3,0,0,6,6,11,8,2,12,19,"6-6","Y","N","N",3,0,15
"778","E3",2023-10-24,"Wrexham","Sutton",2,1,"H",1,0,"H",1.39,5.46,7.26,"1-0","2-1",15,5,12,1,3,0,0,0,10,2,10,6,3,12,16,"10-2","Y","Y","N",3,0,15
"779","E3",2023-10-28,"Accrington","Colchester",0,1,"A",0,0,"D",2.07,3.79,3.47,"0-0","0-1",31,6,7,6,1,3,0,0,11,0,9,12,1,11,21,"11-0","N","N","N",4,0,15
"780","E3",2023-10-28,"Barrow","Salford",0,0,"D",0,0,"D",2.04,3.62,3.74,"0-0","0-0",13,2,9,0,2,0,0,0,6,4,11,5,0,10,16,"6-4","N","N","N",2,0,15
"781","E3",2023-10-28,"Doncaster","Grimsby",1,0,"H",0,0,"D",2.3,3.52,3.18,"0-0","1-0",9,2,6,1,3,2,0,0,8,4,7,11,1,12,18,"8-4","N","N","N",5,0,15
"782","E3",2023-10-28,"Forest Green","Crawley Town",2,1,"H",2,1,"H",2.15,3.83,3.26,"2-1","2-1",8,5,13,6,4,0,0,0,4,7,16,4,3,11,20,"4-7","Y","Y","N",4,0,15
"783","E3",2023-10-28,"Gillingham","Newport County",0,2,"A",0,2,"A",1.89,3.59,4.37,"0-2","0-2",15,3,12,5,1,3,0,0,4,4,7,14,2,8,21,"4-4","Y","N","N",4,0,16
"784","E3",2023-10-28,"Harrogate","Crewe",0,1,"A",0,1,"A",2.94,3.63,2.4,"0-1","0-1",12,3,15,4,3,0,0,0,6,6,13,11,1,12,24,"6-6","N","N","N",3,0,16
"785","E3",2023-10-28,"Mansfield","Walsall",2,1,"H",1,0,"H",1.51,4.56,6.44,"1-0","2-1",22,7,7,1,3,2,0,0,6,5,12,11,3,11,23,"6-5","Y","Y","N",5,0,16
"786","E3",2023-10-28,"Milton Keynes Dons","Swindon",3,2,"H",1,0,"H",2.52,3.69,2.74,"1-0","3-2",10,6,7,3,3,4,0,0,3,0,13,11,5,3,24,"3-0","Y","Y","Y",7,0,16
"787","E3",2023-10-28,"Morecambe","AFC Wimbledon",4,1,"H",0,0,"D",3.17,3.41,2.36,"0-0","4-1",11,6,22,5,2,1,0,0,2,8,7,13,5,10,20,"2-8","Y","Y","Y",3,0,16
"788","E3",2023-10-28,"Notts County","Wrexham",0,2,"A",0,0,"D",2.4,3.84,2.81,"0-0","0-2",16,6,15,8,2,3,0,0,10,7,6,15,2,17,21,"10-7","Y","N","N",5,0,16
"789","E3",2023-10-28,"Stockport","Tranmere",2,0,"H",1,0,"H",1.35,5.27,9.22,"1-0","2-0",26,7,9,4,0,1,0,1,13,3,5,7,2,16,12,"13-3","Y","N","N",1,1,16
"790","E3",2023-10-28,"Sutton","Bradford",2,1,"H",1,0,"H",3.18,3.35,2.38,"1-0","2-1",11,2,10,1,2,1,0,0,6,8,13,13,3,14,26,"6-8","Y","Y","N",3,0,16
"791","E3",2023-10-31,"Barrow","Morecambe",1,0,"H",1,0,"H",1.81,3.74,4.61,"1-0","1-0",7,3,3,0,1,1,0,0,4,2,7,15,1,6,22,"4-2","N","N","N",2,0,16
"792","E3",2023-11-07,"Colchester","Swindon",3,1,"H",0,1,"A",2.69,3.84,2.49,"0-1","3-1",12,2,13,3,1,2,0,0,4,4,3,16,4,8,19,"4-4","Y","Y","Y",3,0,16
"793","E3",2023-11-11,"AFC Wimbledon","Doncaster",2,0,"H",1,0,"H",1.85,3.83,4.28,"1-0","2-0",5,2,8,1,3,2,2,0,8,3,17,6,2,11,23,"8-3","Y","N","N",5,2,16
"794","E3",2023-11-11,"Bradford","Barrow",1,2,"A",1,1,"D",2.32,3.07,3.61,"1-1","1-2",9,5,7,4,2,2,0,0,5,4,10,6,3,9,16,"5-4","Y","Y","N",4,0,16
"795","E3",2023-11-11,"Colchester","Sutton",1,1,"D",0,0,"D",2.02,3.93,3.51,"0-0","1-1",11,4,13,3,3,4,0,0,6,3,14,9,2,9,23,"6-3","Y","N","N",7,0,17
"796","E3",2023-11-11,"Crawley Town","Accrington",3,1,"H",1,1,"D",2.42,3.78,2.81,"1-1","3-1",9,4,14,6,2,4,0,1,1,8,14,19,4,9,33,"1-8","Y","Y","Y",6,1,17
"797","E3",2023-11-11,"Crewe","Notts County",1,0,"H",0,0,"D",3.03,3.83,2.26,"0-0","1-0",15,4,12,2,2,5,0,0,3,7,16,15,1,10,31,"3-7","N","N","N",7,0,17
"798","E3",2023-11-11,"Grimsby","Morecambe",3,2,"H",0,1,"A",2.25,3.44,3.35,"0-1","3-2",20,10,16,6,3,1,0,0,9,6,9,9,5,15,18,"9-6","Y","Y","Y",4,0,17
"799","E3",2023-11-11,"Newport County","Milton Keynes Dons",0,0,"D",0,0,"D",3.12,3.64,2.28,"0-0","0-0",16,1,11,5,2,2,0,0,2,4,14,11,0,6,25,"2-4","N","N","N",4,0,17
"800","E3",2023-11-11,"Salford","Mansfield",1,2,"A",1,2,"A",4.34,4.04,1.79,"1-2","1-2",18,7,9,5,1,2,0,0,7,4,10,13,3,11,23,"7-4","Y","Y","N",3,0,17
"801","E3",2023-11-11,"Swindon","Stockport",2,4,"A",1,0,"H",3.34,4.23,2,"1-0","2-4",13,4,16,8,2,2,0,0,8,4,9,10,6,12,19,"8-4","Y","Y","Y",4,0,17
"802","E3",2023-11-11,"Tranmere","Forest Green",3,0,"H",1,0,"H",2.67,3.65,2.6,"1-0","3-0",16,7,15,8,1,2,0,1,12,11,8,11,3,23,19,"12-11","Y","Y","N",3,1,17
"803","E3",2023-11-11,"Walsall","Harrogate",0,1,"A",0,0,"D",1.79,3.9,4.51,"0-0","0-1",25,3,7,2,0,2,0,0,11,6,8,9,1,17,17,"11-6","N","N","N",2,0,17
"804","E3",2023-11-11,"Wrexham","Gillingham",2,0,"H",1,0,"H",1.63,4.28,5.3,"1-0","2-0",15,5,8,2,0,0,0,0,5,5,13,7,2,10,20,"5-5","Y","N","N",0,0,17
"805","E3",2023-11-18,"Notts County","Bradford",4,2,"H",4,0,"H",1.89,3.94,3.97,"4-0","4-2",15,8,24,6,3,0,0,0,6,4,3,12,6,10,15,"6-4","Y","Y","Y",3,0,17
"806","E3",2023-11-18,"Accrington","Wrexham",2,0,"H",0,0,"D",3.21,4.03,2.11,"0-0","2-0",14,6,10,4,1,0,0,0,7,6,20,12,2,13,32,"7-6","Y","N","N",1,0,17
"807","E3",2023-11-18,"Barrow","Crawley Town",1,0,"H",0,0,"D",1.93,3.65,4.08,"0-0","1-0",11,3,10,2,2,3,0,0,4,5,8,13,1,9,21,"4-5","N","N","N",5,0,18
"808","E3",2023-11-18,"Forest Green","Grimsby",2,2,"D",2,0,"H",2.54,3.4,2.89,"2-0","2-2",15,5,16,5,1,2,0,0,6,7,8,5,4,13,13,"6-7","Y","Y","Y",3,0,18
"809","E3",2023-11-18,"Gillingham","Salford",3,1,"H",1,1,"D",2.08,3.59,3.63,"1-1","3-1",10,5,15,4,2,1,0,0,3,2,7,7,4,5,14,"3-2","Y","Y","Y",3,0,18
"810","E3",2023-11-18,"Harrogate","Swindon",1,1,"D",0,1,"A",3.72,3.96,1.94,"0-1","1-1",12,5,15,3,1,2,0,0,5,10,4,13,2,15,17,"5-10","Y","N","N",3,0,18
"811","E3",2023-11-18,"Mansfield","Newport County",2,0,"H",1,0,"H",1.37,5.32,8.19,"1-0","2-0",19,8,14,2,0,4,0,0,5,8,7,18,2,13,25,"5-8","Y","N","N",4,0,18
"812","E3",2023-11-18,"Stockport","Colchester",2,0,"H",1,0,"H",1.37,5.37,8.23,"1-0","2-0",13,4,12,5,3,1,0,0,6,1,18,9,2,7,27,"6-1","Y","N","N",4,0,18
"813","E3",2023-11-18,"Sutton","Tranmere",1,1,"D",0,1,"A",2.19,3.59,3.35,"0-1","1-1",13,2,10,3,2,1,0,0,4,2,9,8,2,6,17,"4-2","Y","N","N",3,0,18
"814","E3",2023-11-25,"AFC Wimbledon","Notts County",4,2,"H",2,0,"H",2.55,3.63,2.73,"2-0","4-2",13,8,10,5,2,1,0,0,2,6,20,8,6,8,28,"2-6","Y","Y","Y",3,0,18
"815","E3",2023-11-25,"Bradford","Accrington",1,0,"H",0,0,"D",2.18,3.58,3.39,"0-0","1-0",12,2,12,3,3,4,0,0,5,3,15,16,1,8,31,"5-3","N","N","N",7,0,18
"816","E3",2023-11-25,"Colchester","Barrow",1,4,"A",1,0,"H",2.99,3.33,2.51,"1-0","1-4",12,8,16,6,2,3,1,0,6,5,8,8,5,11,16,"6-5","Y","Y","Y",5,1,18
"817","E3",2023-11-25,"Crawley Town","Harrogate",2,1,"H",1,1,"D",1.86,3.8,4.24,"1-1","2-1",13,6,15,3,3,3,0,0,5,8,8,14,3,13,22,"5-8","Y","Y","N",6,0,18
"818","E3",2023-11-25,"Crewe","Doncaster",3,2,"H",2,1,"H",2.21,3.73,3.2,"2-1","3-2",19,9,22,6,1,2,0,0,8,8,10,14,5,16,24,"8-8","Y","Y","Y",3,0,18
"819","E3",2023-11-25,"Grimsby","Sutton",1,1,"D",1,1,"D",2,3.65,3.84,"1-1","1-1",13,4,13,2,0,0,0,0,8,4,9,5,2,12,14,"8-4","Y","N","N",0,0,19
"820","E3",2023-11-25,"Newport County","Stockport",2,1,"H",1,0,"H",4.89,3.89,1.74,"1-0","2-1",6,2,13,4,0,1,0,0,2,8,12,13,3,10,25,"2-8","Y","Y","N",1,0,19
"821","E3",2023-11-25,"Salford","Milton Keynes Dons",2,4,"A",2,1,"H",2.78,3.6,2.53,"2-1","2-4",9,4,16,5,2,2,0,0,2,2,15,12,6,4,27,"2-2","Y","Y","Y",4,0,19
"822","E3",2023-11-25,"Swindon","Mansfield",2,1,"H",1,0,"H",3.76,4.01,1.93,"1-0","2-1",20,6,15,6,1,1,0,0,3,2,10,12,3,5,22,"3-2","Y","Y","N",2,0,19
"823","E3",2023-11-25,"Tranmere","Gillingham",3,1,"H",1,0,"H",3.03,3.3,2.5,"1-0","3-1",8,3,11,5,3,2,0,0,0,10,8,7,4,10,15,"0-10","Y","Y","Y",5,0,19
"824","E3",2023-11-25,"Walsall","Forest Green",0,0,"D",0,0,"D",2.2,3.73,3.22,"0-0","0-0",11,2,8,1,2,3,0,0,6,4,10,14,0,10,24,"6-4","N","N","N",5,0,19
"825","E3",2023-11-25,"Wrexham","Morecambe",6,0,"H",3,0,"H",1.41,5.16,7.35,"3-0","6-0",19,8,14,2,1,1,0,0,5,7,11,10,6,12,21,"5-7","Y","Y","Y",2,0,19
"826","E3",2023-11-28,"Accrington","Swindon",3,4,"A",0,2,"A",2.16,3.82,3.23,"0-2","3-4",29,8,12,5,6,2,0,0,11,3,15,9,7,14,24,"11-3","Y","Y","Y",8,0,19
"827","E3",2023-11-28,"Barrow","Walsall",2,0,"H",1,0,"H",1.97,3.5,4.13,"1-0","2-0",11,4,11,4,1,2,0,0,7,3,15,15,2,10,30,"7-3","Y","N","N",3,0,19
"828","E3",2023-11-28,"Doncaster","Colchester",3,1,"H",1,1,"D",2.04,3.61,3.75,"1-1","3-1",15,5,14,7,2,4,0,0,8,4,7,14,4,12,21,"8-4","Y","Y","Y",6,0,19
"829","E3",2023-11-28,"Forest Green","Bradford",0,3,"A",0,2,"A",2.83,3.32,2.64,"0-2","0-3",13,2,13,4,2,1,0,1,8,4,7,7,3,12,14,"8-4","Y","Y","N",3,1,19
"830","E3",2023-11-28,"Gillingham","AFC Wimbledon",1,0,"H",0,0,"D",2.97,3.34,2.52,"0-0","1-0",8,4,9,3,0,1,0,0,3,4,8,9,1,7,17,"3-4","N","N","N",1,0,19
"831","E3",2023-11-28,"Harrogate","Wrexham",2,2,"D",1,2,"A",5.68,4.32,1.59,"1-2","2-2",10,4,22,7,2,2,0,0,4,7,6,11,4,11,17,"4-7","Y","Y","Y",4,0,20
"832","E3",2023-11-28,"Mansfield","Tranmere",2,2,"D",1,1,"D",1.37,5.35,8.31,"1-1","2-2",21,5,15,7,2,2,0,1,5,1,9,16,4,6,25,"5-1","Y","Y","Y",4,1,20
"833","E3",2023-11-28,"Milton Keynes Dons","Grimsby",1,1,"D",0,1,"A",1.71,4.05,4.84,"0-1","1-1",13,3,19,6,1,3,0,0,5,10,10,12,2,15,22,"5-10","Y","N","N",4,0,20
"834","E3",2023-11-28,"Morecambe","Newport County",1,2,"A",1,1,"D",2.22,3.54,3.32,"1-1","1-2",12,3,15,3,1,1,0,0,8,7,11,6,3,15,17,"8-7","Y","Y","N",2,0,20
"835","E3",2023-11-28,"Notts County","Crawley Town",3,1,"H",1,1,"D",1.62,4.62,4.9,"1-1","3-1",14,5,18,6,1,3,0,0,3,6,7,13,4,9,20,"3-6","Y","Y","Y",4,0,20
"836","E3",2023-11-28,"Stockport","Salford",0,0,"D",0,0,"D",1.46,4.86,6.78,"0-0","0-0",19,5,9,2,2,2,0,0,7,3,13,5,0,10,18,"7-3","N","N","N",4,0,20
"837","E3",2023-11-28,"Sutton","Crewe",1,1,"D",1,1,"D",2.71,3.57,2.6,"1-1","1-1",9,3,22,4,2,1,0,0,3,9,14,10,2,12,24,"3-9","Y","N","N",3,0,20
"838","EC",2023-08-05,"Aldershot","Oxford City",5,2,"H",3,1,"H",1.99,3.68,3.69,"3-1","5-2",0,0,0,0,2,1,0,0,0,0,0,0,7,0,0,"0-0","Y","Y","Y",3,0,1
"839","EC",2023-08-05,"Altrincham","Dag and Red",1,1,"D",0,0,"D",2.25,3.43,3.23,"0-0","1-1",0,0,0,0,2,2,0,0,0,0,0,0,2,0,0,"0-0","Y","N","N",4,0,1
"840","EC",2023-08-05,"Barnet","Hartlepool",3,2,"H",1,0,"H",2.09,3.65,3.35,"1-0","3-2",0,0,0,0,1,3,0,0,0,0,0,0,5,0,0,"0-0","Y","Y","Y",4,0,1
"841","EC",2023-08-05,"Chesterfield","Dorking",4,3,"H",1,1,"D",1.25,6.07,10.66,"1-1","4-3",0,0,0,0,2,3,0,1,0,0,0,0,7,0,0,"0-0","Y","Y","Y",5,1,1
"842","EC",2023-08-05,"Gateshead","Boreham Wood",2,2,"D",2,0,"H",2.12,3.37,3.63,"2-0","2-2",0,0,0,0,1,3,0,1,0,0,0,0,4,0,0,"0-0","Y","Y","Y",4,1,1
"843","EC",2023-08-05,"Halifax","Bromley",2,0,"H",0,0,"D",2.79,3.24,2.61,"0-0","2-0",0,0,0,0,3,2,0,0,0,0,0,0,2,0,0,"0-0","Y","N","N",5,0,1
"844","EC",2023-08-05,"Kidderminster","Woking",0,0,"D",0,0,"D",2.96,3.29,2.49,"0-0","0-0",0,0,0,0,3,2,0,0,0,0,0,0,0,0,0,"0-0","N","N","N",5,0,1
"845","EC",2023-08-05,"Maidenhead","Fylde",2,2,"D",2,1,"H",2.46,3.33,2.9,"2-1","2-2",0,0,0,0,3,1,0,1,0,0,0,0,4,0,0,"0-0","Y","Y","Y",4,1,1
"846","EC",2023-08-05,"Solihull","Eastleigh",1,1,"D",0,0,"D",2.6,3.76,2.53,"0-0","1-1",0,0,0,0,1,2,1,0,0,0,0,0,2,0,0,"0-0","Y","N","N",3,1,1
"847","EC",2023-08-05,"Southend","Oldham",4,0,"H",1,0,"H",3.1,3.37,2.35,"1-0","4-0",0,0,0,0,2,5,0,1,0,0,0,0,4,0,0,"0-0","Y","Y","Y",7,1,1
"848","EC",2023-08-05,"Wealdstone","York",2,1,"H",0,1,"A",2.68,3.54,2.58,"0-1","2-1",0,0,0,0,3,1,0,1,0,0,0,0,3,0,0,"0-0","Y","Y","N",4,1,1
"849","EC",2023-08-05,"Rochdale","Ebbsfleet",0,1,"A",0,1,"A",1.69,4.25,4.37,"0-1","0-1",0,0,0,0,2,5,0,0,0,0,0,0,1,0,0,"0-0","N","N","N",7,0,1
"850","EC",2023-08-12,"Boreham Wood","Halifax",2,0,"H",0,0,"D",2.23,3.13,3.63,"0-0","2-0",0,0,0,0,1,2,0,0,0,0,0,0,2,0,0,"0-0","Y","N","N",3,0,2
"851","EC",2023-08-12,"Dag and Red","Southend",0,2,"A",0,1,"A",2.68,3.47,2.61,"0-1","0-2",0,0,0,0,3,1,0,0,0,0,0,0,2,0,0,"0-0","Y","N","N",4,0,2
"852","EC",2023-08-12,"Dorking","Maidenhead",0,2,"A",0,0,"D",2.05,3.69,3.49,"0-0","0-2",0,0,0,0,5,1,0,1,0,0,0,0,2,0,0,"0-0","Y","N","N",6,1,2
"853","EC",2023-08-12,"Eastleigh","Wealdstone",0,0,"D",0,0,"D",1.7,3.93,4.68,"0-0","0-0",0,0,0,0,5,3,0,0,0,0,0,0,0,0,0,"0-0","N","N","N",8,0,2
"854","EC",2023-08-12,"Ebbsfleet","Solihull",1,2,"A",0,1,"A",2.17,3.51,3.34,"0-1","1-2",0,0,0,0,3,5,0,0,0,0,0,0,3,0,0,"0-0","Y","Y","N",8,0,2
"855","EC",2023-08-12,"Fylde","Chesterfield",2,4,"A",0,3,"A",3.94,3.92,1.86,"0-3","2-4",0,0,0,0,3,3,1,0,0,0,0,0,6,0,0,"0-0","Y","Y","Y",6,1,2
"856","EC",2023-08-12,"Hartlepool","Gateshead",2,1,"H",1,0,"H",2.54,3.6,2.69,"1-0","2-1",0,0,0,0,2,2,1,0,0,0,0,0,3,0,0,"0-0","Y","Y","N",4,1,2
"857","EC",2023-08-12,"Oldham","Aldershot",5,1,"H",3,0,"H",2.07,3.41,3.7,"3-0","5-1",0,0,0,0,2,1,0,1,0,0,0,0,6,0,0,"0-0","Y","Y","Y",3,1,2
"858","EC",2023-08-12,"Oxford City","Rochdale",0,1,"A",0,0,"D",3.15,3.64,2.21,"0-0","0-1",0,0,0,0,2,1,0,0,0,0,0,0,1,0,0,"0-0","N","N","N",3,0,2
"859","EC",2023-08-12,"Woking","Altrincham",2,3,"A",2,2,"D",1.59,4.37,5.24,"2-2","2-3",0,0,0,0,1,4,0,0,0,0,0,0,5,0,0,"0-0","Y","Y","Y",5,0,2
"860","EC",2023-08-12,"York","Kidderminster",0,1,"A",0,0,"D",1.94,3.57,3.97,"0-0","0-1",0,0,0,0,2,2,0,0,0,0,0,0,1,0,0,"0-0","N","N","N",4,0,2
"861","EC",2023-08-12,"Bromley","Barnet",0,2,"A",0,1,"A",2.25,3.74,3.01,"0-1","0-2",0,0,0,0,2,0,0,0,0,0,0,0,2,0,0,"0-0","Y","N","N",2,0,2
"862","EC",2023-08-15,"Bromley","Wealdstone",1,1,"D",0,1,"A",1.71,4.01,4.63,"0-1","1-1",0,0,0,0,5,2,0,0,0,0,0,0,2,0,0,"0-0","Y","N","N",7,0,3
"863","EC",2023-08-15,"Dag and Red","Gateshead",2,4,"A",0,1,"A",3.64,3.73,1.99,"0-1","2-4",0,0,0,0,4,3,0,0,0,0,0,0,6,0,0,"0-0","Y","Y","Y",7,0,3
"864","EC",2023-08-15,"Dorking","Southend",2,1,"H",1,1,"D",4.21,3.82,1.83,"1-1","2-1",0,0,0,0,1,1,0,0,0,0,0,0,3,0,0,"0-0","Y","Y","N",2,0,3
"865","EC",2023-08-15,"Eastleigh","Barnet",3,3,"D",1,3,"A",2.58,3.55,2.67,"1-3","3-3",0,0,0,0,3,3,0,0,0,0,0,0,6,0,0,"0-0","Y","Y","Y",6,0,3
"866","EC",2023-08-15,"Ebbsfleet","Aldershot",2,0,"H",1,0,"H",1.99,3.66,3.71,"1-0","2-0",0,0,0,0,3,3,0,0,0,0,0,0,2,0,0,"0-0","Y","N","N",6,0,3
"867","EC",2023-08-15,"Fylde","Kidderminster",2,1,"H",0,0,"D",2.18,3.53,3.31,"0-0","2-1",0,0,0,0,3,2,0,0,0,0,0,0,3,0,0,"0-0","Y","Y","N",5,0,3
"868","EC",2023-08-15,"Hartlepool","Maidenhead",3,1,"H",0,0,"D",1.85,3.79,4.14,"0-0","3-1",0,0,0,0,4,2,0,0,0,0,0,0,4,0,0,"0-0","Y","Y","Y",6,0,3
"869","EC",2023-08-15,"Oldham","Halifax",1,2,"A",1,1,"D",1.93,3.27,4.48,"1-1","1-2",0,0,0,0,4,3,0,0,0,0,0,0,3,0,0,"0-0","Y","Y","N",7,0,3
"870","EC",2023-08-15,"Oxford City","Chesterfield",1,2,"A",0,1,"A",6.35,5.09,1.43,"0-1","1-2",0,0,0,0,2,1,0,0,0,0,0,0,3,0,0,"0-0","Y","Y","N",3,0,3
"871","EC",2023-08-15,"Woking","Rochdale",3,2,"H",0,1,"A",2.04,3.54,3.67,"0-1","3-2",0,0,0,0,5,4,0,0,0,0,0,0,5,0,0,"0-0","Y","Y","Y",9,0,3
"872","EC",2023-08-15,"York","Altrincham",2,2,"D",2,1,"H",2.16,3.77,3.16,"2-1","2-2",0,0,0,0,5,3,0,0,0,0,0,0,4,0,0,"0-0","Y","Y","Y",8,0,3
"873","EC",2023-08-16,"Boreham Wood","Solihull",1,2,"A",0,1,"A",2,3.33,4.06,"0-1","1-2",0,0,0,0,2,1,0,0,0,0,0,0,3,0,0,"0-0","Y","Y","N",3,0,3
"874","EC",2023-08-19,"Chesterfield","Oldham",1,1,"D",0,0,"D",1.6,4.29,5.27,"0-0","1-1",0,0,0,0,0,3,0,0,0,0,0,0,2,0,0,"0-0","Y","N","N",3,0,4
"875","EC",2023-08-19,"Aldershot","York",1,1,"D",1,0,"H",2.47,3.5,2.83,"1-0","1-1",0,0,0,0,4,2,0,0,0,0,0,0,2,0,0,"0-0","Y","N","N",6,0,4
"876","EC",2023-08-19,"Altrincham","Boreham Wood",1,1,"D",1,0,"H",2.44,3.45,2.91,"1-0","1-1",0,0,0,0,3,2,0,0,0,0,0,0,2,0,0,"0-0","Y","N","N",5,0,4
"877","EC",2023-08-19,"Barnet","Woking",2,0,"H",1,0,"H",2.35,3.48,3.02,"1-0","2-0",0,0,0,0,1,1,0,0,0,0,0,0,2,0,0,"0-0","Y","N","N",2,0,4
"878","EC",2023-08-19,"Gateshead","Ebbsfleet",4,1,"H",1,1,"D",1.9,3.91,3.78,"1-1","4-1",0,0,0,0,3,3,0,0,0,0,0,0,5,0,0,"0-0","Y","Y","Y",6,0,4
"879","EC",2023-08-19,"Halifax","Oxford City",1,1,"D",1,0,"H",1.66,3.91,5.22,"1-0","1-1",0,0,0,0,2,1,0,0,0,0,0,0,2,0,0,"0-0","Y","N","N",3,0,4
"880","EC",2023-08-19,"Kidderminster","Bromley",0,0,"D",0,0,"D",2.3,3.34,3.22,"0-0","0-0",0,0,0,0,1,2,1,1,0,0,0,0,0,0,0,"0-0","N","N","N",3,2,4
"881","EC",2023-08-19,"Maidenhead","Dag and Red",1,0,"H",0,0,"D",2.45,3.32,2.98,"0-0","1-0",0,0,0,0,1,1,0,0,0,0,0,0,1,0,0,"0-0","N","N","N",2,0,4
"882","EC",2023-08-19,"Rochdale","Eastleigh",2,0,"H",2,0,"H",2.03,3.69,3.54,"2-0","2-0",0,0,0,0,2,5,0,0,0,0,0,0,2,0,0,"0-0","Y","N","N",7,0,4
"883","EC",2023-08-19,"Solihull","Dorking",3,0,"H",2,0,"H",1.76,4.16,4.16,"2-0","3-0",0,0,0,0,0,3,0,1,0,0,0,0,3,0,0,"0-0","Y","Y","N",3,1,4
"884","EC",2023-08-19,"Southend","Hartlepool",2,3,"A",1,1,"D",1.99,3.6,3.75,"1-1","2-3",0,0,0,0,0,0,0,0,0,0,0,0,5,0,0,"0-0","Y","Y","Y",0,0,4
"885","EC",2023-08-19,"Wealdstone","Fylde",3,2,"H",1,1,"D",2.66,3.73,2.5,"1-1","3-2",0,0,0,0,1,2,0,1,0,0,0,0,5,0,0,"0-0","Y","Y","Y",3,1,4
"886","EC",2023-08-25,"Rochdale","Bromley",2,2,"D",1,1,"D",1.88,3.64,4.14,"1-1","2-2",0,0,0,0,0,1,1,1,0,0,0,0,4,0,0,"0-0","Y","Y","Y",1,2,5
"887","EC",2023-08-25,"Solihull","Halifax",1,1,"D",1,0,"H",2.34,3.34,3.15,"1-0","1-1",0,0,0,0,1,1,0,0,0,0,0,0,2,0,0,"0-0","Y","N","N",2,0,5
"888","EC",2023-08-25,"Southend","Eastleigh",2,0,"H",2,0,"H",1.84,3.79,4.18,"2-0","2-0",0,0,0,0,1,1,0,0,0,0,0,0,2,0,0,"0-0","Y","N","N",2,0,5
"889","EC",2023-08-26,"Aldershot","Wealdstone",3,1,"H",1,0,"H",2.32,3.82,2.85,"1-0","3-1",0,0,0,0,3,2,0,0,0,0,0,0,4,0,0,"0-0","Y","Y","Y",5,0,5
"890","EC",2023-08-26,"Altrincham","Chesterfield",2,1,"H",0,1,"A",4.03,4.25,1.78,"0-1","2-1",0,0,0,0,1,4,0,0,0,0,0,0,3,0,0,"0-0","Y","Y","N",5,0,5
"891","EC",2023-08-26,"Boreham Wood","Oldham",0,0,"D",0,0,"D",2.62,3.37,2.73,"0-0","0-0",0,0,0,0,2,0,0,0,0,0,0,0,0,0,0,"0-0","N","N","N",2,0,5
"892","EC",2023-08-26,"Dag and Red","Barnet",1,0,"H",0,0,"D",3.83,3.83,1.91,"0-0","1-0",0,0,0,0,4,0,0,0,0,0,0,0,1,0,0,"0-0","N","N","N",4,0,5
"893","EC",2023-08-26,"Dorking","York",2,2,"D",1,0,"H",3.09,3.64,2.24,"1-0","2-2",0,0,0,0,1,1,0,1,0,0,0,0,4,0,0,"0-0","Y","Y","Y",2,1,5
"894","EC",2023-08-26,"Ebbsfleet","Kidderminster",3,0,"H",3,0,"H",2.57,3.53,2.69,"3-0","3-0",0,0,0,0,1,0,0,1,0,0,0,0,3,0,0,"0-0","Y","Y","N",1,1,5
"895","EC",2023-08-26,"Gateshead","Woking",1,3,"A",1,0,"H",2.08,3.61,3.48,"1-0","1-3",0,0,0,0,1,4,0,0,0,0,0,0,4,0,0,"0-0","Y","Y","Y",5,0,5
"896","EC",2023-08-26,"Maidenhead","Oxford City",0,0,"D",0,0,"D",2.2,3.79,3.06,"0-0","0-0",0,0,0,0,3,2,0,0,0,0,0,0,0,0,0,"0-0","N","N","N",5,0,5
"897","EC",2023-08-26,"Hartlepool","Fylde",3,1,"H",2,1,"H",2.12,3.67,3.33,"2-1","3-1",0,0,0,0,2,1,0,0,0,0,0,0,4,0,0,"0-0","Y","Y","Y",3,0,5
"898","EC",2023-08-28,"Barnet","Ebbsfleet",3,2,"H",1,1,"D",2.01,3.81,3.5,"1-1","3-2",0,0,0,0,2,3,0,0,0,0,0,0,5,0,0,"0-0","Y","Y","Y",5,0,6
"899","EC",2023-08-28,"Bromley","Southend",2,1,"H",1,0,"H",3.75,3.48,2.03,"1-0","2-1",0,0,0,0,3,1,0,0,0,0,0,0,3,0,0,"0-0","Y","Y","N",4,0,6
"900","EC",2023-08-28,"Chesterfield","Hartlepool",3,2,"H",1,2,"A",1.76,4.22,4.1,"1-2","3-2",0,0,0,0,3,4,0,0,0,0,0,0,5,0,0,"0-0","Y","Y","Y",7,0,6
"901","EC",2023-08-28,"Eastleigh","Aldershot",3,0,"H",1,0,"H",2.47,3.51,2.82,"1-0","3-0",0,0,0,0,0,1,0,1,0,0,0,0,3,0,0,"0-0","Y","Y","N",1,1,6
"902","EC",2023-08-28,"Fylde","Altrincham",3,3,"D",0,2,"A",2.45,3.73,2.72,"0-2","3-3",0,0,0,0,4,1,0,0,0,0,0,0,6,0,0,"0-0","Y","Y","Y",5,0,6
"903","EC",2023-08-28,"Halifax","Gateshead",0,0,"D",0,0,"D",2.79,3.51,2.49,"0-0","0-0",0,0,0,0,4,3,0,1,0,0,0,0,0,0,0,"0-0","N","N","N",7,1,6
"904","EC",2023-08-28,"Kidderminster","Maidenhead",0,0,"D",0,0,"D",1.98,3.5,3.93,"0-0","0-0",0,0,0,0,2,2,0,0,0,0,0,0,0,0,0,"0-0","N","N","N",4,0,6
"905","EC",2023-08-28,"Oldham","Solihull",0,2,"A",0,0,"D",1.9,3.98,3.72,"0-0","0-2",0,0,0,0,4,0,1,0,0,0,0,0,2,0,0,"0-0","Y","N","N",4,1,6
"906","EC",2023-08-28,"Oxford City","Boreham Wood",4,0,"H",0,0,"D",3.48,3.47,2.13,"0-0","4-0",0,0,0,0,2,2,0,0,0,0,0,0,4,0,0,"0-0","Y","Y","Y",4,0,6
"907","EC",2023-08-28,"Wealdstone","Dag and Red",0,2,"A",0,0,"D",2.25,3.77,2.98,"0-0","0-2",0,0,0,0,1,0,0,0,0,0,0,0,2,0,0,"0-0","Y","N","N",1,0,6
"908","EC",2023-08-28,"Woking","Dorking",2,0,"H",1,0,"H",1.58,4.38,5.25,"1-0","2-0",0,0,0,0,2,0,0,0,0,0,0,0,2,0,0,"0-0","Y","N","N",2,0,6
"909","EC",2023-08-28,"York","Rochdale",1,3,"A",1,1,"D",2.67,3.41,2.66,"1-1","1-3",0,0,0,0,5,4,1,0,0,0,0,0,4,0,0,"0-0","Y","Y","Y",9,1,6
"910","EC",2023-09-02,"Aldershot","Chesterfield",3,4,"A",1,1,"D",4.25,3.97,1.79,"1-1","3-4",0,0,0,0,1,3,1,0,0,0,0,0,7,0,0,"0-0","Y","Y","Y",4,1,7
"911","EC",2023-09-02,"Altrincham","Bromley",1,2,"A",1,1,"D",1.74,4,4.35,"1-1","1-2",0,0,0,0,2,1,0,0,0,0,0,0,3,0,0,"0-0","Y","Y","N",3,0,7
"912","EC",2023-09-02,"Boreham Wood","Barnet",0,1,"A",0,0,"D",2.67,3.42,2.65,"0-0","0-1",0,0,0,0,3,2,0,0,0,0,0,0,1,0,0,"0-0","N","N","N",5,0,7
"913","EC",2023-09-02,"Dag and Red","Fylde",3,1,"H",2,1,"H",2.55,3.49,2.69,"2-1","3-1",0,0,0,0,1,3,0,0,0,0,0,0,4,0,0,"0-0","Y","Y","Y",4,0,7
"914","EC",2023-09-02,"Dorking","Eastleigh",0,0,"D",0,0,"D",3.03,3.64,2.27,"0-0","0-0",0,0,0,0,1,2,0,0,0,0,0,0,0,0,0,"0-0","N","N","N",3,0,7
"915","EC",2023-09-02,"Ebbsfleet","York",4,1,"H",2,1,"H",2.06,3.64,3.49,"2-1","4-1",0,0,0,0,1,3,0,0,0,0,0,0,5,0,0,"0-0","Y","Y","Y",4,0,7
"916","EC",2023-09-02,"Hartlepool","Wealdstone",2,1,"H",1,0,"H",1.7,4.12,4.57,"1-0","2-1",0,0,0,0,1,0,0,0,0,0,0,0,3,0,0,"0-0","Y","Y","N",1,0,7
"917","EC",2023-09-02,"Maidenhead","Woking",0,0,"D",0,0,"D",3.79,3.37,2.06,"0-0","0-0",0,0,0,0,1,2,0,0,0,0,0,0,0,0,0,"0-0","N","N","N",3,0,7
"918","EC",2023-09-02,"Rochdale","Halifax",0,1,"A",0,1,"A",1.96,3.53,3.96,"0-1","0-1",0,0,0,0,4,1,0,0,0,0,0,0,1,0,0,"0-0","N","N","N",5,0,7
"919","EC",2023-09-02,"Solihull","Oxford City",3,3,"D",2,1,"H",1.8,4.06,4.06,"2-1","3-3",0,0,0,0,0,3,0,0,0,0,0,0,6,0,0,"0-0","Y","Y","Y",3,0,7
"920","EC",2023-09-02,"Southend","Kidderminster",2,1,"H",0,0,"D",1.88,3.41,4.53,"0-0","2-1",0,0,0,0,1,2,0,0,0,0,0,0,3,0,0,"0-0","Y","Y","N",3,0,7
"921","EC",2023-09-02,"Gateshead","Oldham",2,2,"D",0,1,"A",1.88,3.89,3.86,"0-1","2-2",0,0,0,0,2,4,0,1,0,0,0,0,4,0,0,"0-0","Y","Y","Y",6,1,7
"922","EC",2023-09-09,"Halifax","Southend",1,1,"D",0,0,"D",2.66,3.25,2.78,"0-0","1-1",0,0,0,0,2,2,1,0,0,0,0,0,2,0,0,"0-0","Y","N","N",4,1,8
"923","EC",2023-09-09,"Barnet","Altrincham",3,0,"H",1,0,"H",1.92,3.81,3.81,"1-0","3-0",0,0,0,0,2,3,0,0,0,0,0,0,3,0,0,"0-0","Y","Y","N",5,0,8
"924","EC",2023-09-09,"Bromley","Maidenhead",4,1,"H",3,0,"H",2.2,3.49,3.3,"3-0","4-1",0,0,0,0,1,0,0,0,0,0,0,0,5,0,0,"0-0","Y","Y","Y",1,0,8
"925","EC",2023-09-09,"Chesterfield","Dag and Red",3,1,"H",0,1,"A",1.47,4.78,6.23,"0-1","3-1",0,0,0,0,0,2,0,1,0,0,0,0,4,0,0,"0-0","Y","Y","Y",2,1,8
"926","EC",2023-09-09,"Eastleigh","Gateshead",0,6,"A",0,4,"A",2.95,3.45,2.37,"0-4","0-6",0,0,0,0,4,3,0,0,0,0,0,0,6,0,0,"0-0","Y","Y","Y",7,0,8
"927","EC",2023-09-09,"Fylde","Aldershot",0,2,"A",0,0,"D",1.95,4.06,3.46,"0-0","0-2",0,0,0,0,1,1,0,0,0,0,0,0,2,0,0,"0-0","Y","N","N",2,0,8
"928","EC",2023-09-09,"Kidderminster","Rochdale",1,1,"D",1,0,"H",2.59,3.14,2.94,"1-0","1-1",0,0,0,0,4,1,0,0,0,0,0,0,2,0,0,"0-0","Y","N","N",5,0,8
"929","EC",2023-09-09,"Oldham","Dorking",0,0,"D",0,0,"D",1.58,4.35,5.14,"0-0","0-0",0,0,0,0,2,2,0,0,0,0,0,0,0,0,0,"0-0","N","N","N",4,0,8
"930","EC",2023-09-09,"Oxford City","Hartlepool",5,2,"H",1,2,"A",3.71,3.93,1.92,"1-2","5-2",0,0,0,0,4,0,0,0,0,0,0,0,7,0,0,"0-0","Y","Y","Y",4,0,8
"931","EC",2023-09-09,"Wealdstone","Ebbsfleet",2,1,"H",0,0,"D",2.79,3.89,2.29,"0-0","2-1",0,0,0,0,4,5,1,1,0,0,0,0,3,0,0,"0-0","Y","Y","N",9,2,8
"932","EC",2023-09-09,"Woking","Solihull",1,1,"D",0,1,"A",1.68,4.08,4.62,"0-1","1-1",0,0,0,0,4,3,0,0,0,0,0,0,2,0,0,"0-0","Y","N","N",7,0,8
"933","EC",2023-09-09,"York","Boreham Wood",2,2,"D",1,0,"H",2.58,3.34,2.81,"1-0","2-2",0,0,0,0,1,4,0,0,0,0,0,0,4,0,0,"0-0","Y","Y","Y",5,0,8
"934","EC",2023-09-16,"Aldershot","Gateshead",1,1,"D",0,0,"D",3.28,3.85,2.05,"0-0","1-1",0,0,0,0,2,0,0,0,0,0,0,0,2,0,0,"0-0","Y","N","N",2,0,9
"935","EC",2023-09-16,"Bromley","Oldham",3,0,"H",2,0,"H",2.92,3.69,2.32,"2-0","3-0",0,0,0,0,1,1,0,0,0,0,0,0,3,0,0,"0-0","Y","Y","N",2,0,9
"936","EC",2023-09-16,"Ebbsfleet","Chesterfield",0,1,"A",0,0,"D",3.26,4.09,2.02,"0-0","0-1",0,0,0,0,4,3,0,1,0,0,0,0,1,0,0,"0-0","N","N","N",7,1,9
"937","EC",2023-09-16,"Fylde","Eastleigh",1,2,"A",0,1,"A",2.09,3.68,3.39,"0-1","1-2",0,0,0,0,1,2,1,0,0,0,0,0,3,0,0,"0-0","Y","Y","N",3,1,9
"938","EC",2023-09-16,"Halifax","Dorking",0,1,"A",0,1,"A",1.71,4.04,4.47,"0-1","0-1",0,0,0,0,1,4,0,0,0,0,0,0,1,0,0,"0-0","N","N","N",5,0,9
"939","EC",2023-09-16,"Hartlepool","Woking",0,2,"A",0,0,"D",2.28,3.53,3.11,"0-0","0-2",0,0,0,0,1,1,0,0,0,0,0,0,2,0,0,"0-0","Y","N","N",2,0,9
"940","EC",2023-09-16,"Maidenhead","Boreham Wood",0,1,"A",0,0,"D",2.95,3.21,2.5,"0-0","0-1",0,0,0,0,0,3,0,0,0,0,0,0,1,0,0,"0-0","N","N","N",3,0,9
"941","EC",2023-09-16,"Oxford City","Dag and Red",0,0,"D",0,0,"D",2.52,3.5,2.72,"0-0","0-0",0,0,0,0,2,1,0,0,0,0,0,0,0,0,0,"0-0","N","N","N",3,0,9
"942","EC",2023-09-16,"Rochdale","Barnet",4,2,"H",2,1,"H",2.9,3.49,2.43,"2-1","4-2",0,0,0,0,2,1,0,0,0,0,0,0,6,0,0,"0-0","Y","Y","Y",3,0,9
"943","EC",2023-09-16,"Wealdstone","Altrincham",0,0,"D",0,0,"D",2.66,3.8,2.47,"0-0","0-0",0,0,0,0,1,1,0,0,0,0,0,0,0,0,0,"0-0","N","N","N",2,0,9
"944","EC",2023-09-16,"York","Southend",3,0,"H",1,0,"H",3.57,3.69,2.02,"1-0","3-0",0,0,0,0,2,2,0,2,0,0,0,0,3,0,0,"0-0","Y","Y","N",4,2,9
"945","EC",2023-09-16,"Kidderminster","Solihull",0,1,"A",0,1,"A",2.22,3.45,3.28,"0-1","0-1",0,0,0,0,1,2,0,0,0,0,0,0,1,0,0,"0-0","N","N","N",3,0,9
"946","EC",2023-09-19,"Altrincham","Hartlepool",2,2,"D",2,1,"H",2.9,3.76,2.3,"2-1","2-2",0,0,0,0,2,5,0,0,0,0,0,0,4,0,0,"0-0","Y","Y","Y",7,0,10
"947","EC",2023-09-19,"Barnet","Aldershot",2,1,"H",1,0,"H",1.58,4.4,5.25,"1-0","2-1",0,0,0,0,3,3,0,0,0,0,0,0,3,0,0,"0-0","Y","Y","N",6,0,10
"948","EC",2023-09-19,"Boreham Wood","Rochdale",1,1,"D",0,0,"D",2.65,3.18,2.84,"0-0","1-1",0,0,0,0,1,0,0,0,0,0,0,0,2,0,0,"0-0","Y","N","N",1,0,10
"949","EC",2023-09-19,"Chesterfield","Halifax",3,2,"H",2,1,"H",1.46,4.46,7.03,"2-1","3-2",0,0,0,0,4,3,1,1,0,0,0,0,5,0,0,"0-0","Y","Y","Y",7,2,10
"950","EC",2023-09-19,"Dag and Red","Bromley",0,1,"A",0,0,"D",2.66,3.11,2.89,"0-0","0-1",0,0,0,0,2,2,0,0,0,0,0,0,1,0,0,"0-0","N","N","N",4,0,10
"951","EC",2023-09-19,"Dorking","Wealdstone",3,1,"H",3,0,"H",3.27,3.85,2.08,"3-0","3-1",0,0,0,0,3,2,0,0,0,0,0,0,4,0,0,"0-0","Y","Y","Y",5,0,10
"952","EC",2023-09-19,"Eastleigh","Oxford City",2,2,"D",1,0,"H",2.16,3.78,3.15,"1-0","2-2",0,0,0,0,1,2,0,0,0,0,0,0,4,0,0,"0-0","Y","Y","Y",3,0,10
"953","EC",2023-09-19,"Gateshead","Kidderminster",3,0,"H",2,0,"H",1.76,3.96,4.37,"2-0","3-0",0,0,0,0,0,1,0,0,0,0,0,0,3,0,0,"0-0","Y","Y","N",1,0,10
"954","EC",2023-09-19,"Oldham","York",2,0,"H",1,0,"H",2.01,3.84,3.47,"1-0","2-0",0,0,0,0,3,1,0,0,0,0,0,0,2,0,0,"0-0","Y","N","N",4,0,10
"955","EC",2023-09-19,"Solihull","Fylde",2,1,"H",2,1,"H",2.4,3.76,2.76,"2-1","2-1",0,0,0,0,2,3,0,0,0,0,0,0,3,0,0,"0-0","Y","Y","N",5,0,10
"956","EC",2023-09-19,"Southend","Maidenhead",2,0,"H",0,0,"D",2.15,3.32,3.59,"0-0","2-0",0,0,0,0,1,1,0,0,0,0,0,0,2,0,0,"0-0","Y","N","N",2,0,10
"957","EC",2023-09-19,"Woking","Ebbsfleet",1,1,"D",1,0,"H",1.72,3.89,4.76,"1-0","1-1",0,0,0,0,3,1,0,0,0,0,0,0,2,0,0,"0-0","Y","N","N",4,0,10
"958","EC",2023-09-23,"Woking","York",1,2,"A",0,1,"A",1.82,3.82,4.24,"0-1","1-2",0,0,0,0,1,1,0,0,0,0,0,0,3,0,0,"0-0","Y","Y","N",2,0,11
"959","EC",2023-09-23,"Altrincham","Ebbsfleet",6,1,"H",4,1,"H",2.1,3.49,3.55,"4-1","6-1",0,0,0,0,2,1,0,0,0,0,0,0,7,0,0,"0-0","Y","Y","Y",3,0,11
"960","EC",2023-09-23,"Barnet","Halifax",0,0,"D",0,0,"D",1.79,3.5,4.92,"0-0","0-0",0,0,0,0,3,1,0,0,0,0,0,0,0,0,0,"0-0","N","N","N",4,0,11
"961","EC",2023-09-23,"Boreham Wood","Aldershot",1,2,"A",0,1,"A",1.9,3.69,3.91,"0-1","1-2",0,0,0,0,2,0,0,0,0,0,0,0,3,0,0,"0-0","Y","Y","N",2,0,11
"962","EC",2023-09-23,"Chesterfield","Wealdstone",3,2,"H",0,1,"A",1.42,5.39,6.12,"0-1","3-2",0,0,0,0,2,5,0,0,0,0,0,0,5,0,0,"0-0","Y","Y","Y",7,0,11
"963","EC",2023-09-23,"Dag and Red","Hartlepool",0,1,"A",0,1,"A",3.19,3.57,2.22,"0-1","0-1",0,0,0,0,1,3,0,0,0,0,0,0,1,0,0,"0-0","N","N","N",4,0,11
"964","EC",2023-09-23,"Dorking","Rochdale",1,2,"A",0,0,"D",3.81,3.82,1.88,"0-0","1-2",0,0,0,0,3,1,1,0,0,0,0,0,3,0,0,"0-0","Y","Y","N",4,1,11
"965","EC",2023-09-23,"Eastleigh","Kidderminster",2,1,"H",2,1,"H",2.51,3.36,2.87,"2-1","2-1",0,0,0,0,2,1,0,0,0,0,0,0,3,0,0,"0-0","Y","Y","N",3,0,11
"966","EC",2023-09-23,"Gateshead","Maidenhead",3,0,"H",0,0,"D",1.47,4.64,6.53,"0-0","3-0",0,0,0,0,0,1,0,0,0,0,0,0,3,0,0,"0-0","Y","Y","N",1,0,11
"967","EC",2023-09-23,"Oldham","Oxford City",4,0,"H",2,0,"H",1.66,4.09,4.94,"2-0","4-0",0,0,0,0,1,2,0,0,0,0,0,0,4,0,0,"0-0","Y","Y","Y",3,0,11
"968","EC",2023-09-23,"Solihull","Bromley",1,1,"D",0,0,"D",2.13,3.75,3.24,"0-0","1-1",0,0,0,0,1,2,0,0,0,0,0,0,2,0,0,"0-0","Y","N","N",3,0,11
"969","EC",2023-09-23,"Southend","Fylde",1,2,"A",0,1,"A",1.83,3.81,4.21,"0-1","1-2",0,0,0,0,0,1,0,0,0,0,0,0,3,0,0,"0-0","Y","Y","N",1,0,11
"970","EC",2023-09-26,"Aldershot","Southend",1,1,"D",1,0,"H",2.96,3.56,2.35,"1-0","1-1",0,0,0,0,2,3,0,0,0,0,0,0,2,0,0,"0-0","Y","N","N",5,0,12
"971","EC",2023-09-26,"Bromley","Eastleigh",1,0,"H",1,0,"H",2.18,3.49,3.34,"1-0","1-0",0,0,0,0,1,2,0,0,0,0,0,0,1,0,0,"0-0","N","N","N",3,0,12
"972","EC",2023-09-26,"Ebbsfleet","Dorking",0,1,"A",0,0,"D",1.63,4.38,4.79,"0-0","0-1",0,0,0,0,0,4,0,0,0,0,0,0,1,0,0,"0-0","N","N","N",4,0,12
"973","EC",2023-09-26,"Fylde","Boreham Wood",2,2,"D",1,1,"D",2.43,3.44,2.93,"1-1","2-2",0,0,0,0,1,2,0,0,0,0,0,0,4,0,0,"0-0","Y","Y","Y",3,0,12
"974","EC",2023-09-26,"Halifax","Dag and Red",0,0,"D",0,0,"D",2.14,3.25,3.68,"0-0","0-0",0,0,0,0,3,4,0,0,0,0,0,0,0,0,0,"0-0","N","N","N",7,0,12
"975","EC",2023-09-26,"Hartlepool","Solihull",0,2,"A",0,2,"A",2.01,3.78,3.52,"0-2","0-2",0,0,0,0,3,3,0,0,0,0,0,0,2,0,0,"0-0","Y","N","N",6,0,12
"976","EC",2023-09-26,"Kidderminster","Oldham",1,2,"A",0,1,"A",2.98,3.31,2.46,"0-1","1-2",0,0,0,0,1,1,0,0,0,0,0,0,3,0,0,"0-0","Y","Y","N",2,0,12
"977","EC",2023-09-26,"Maidenhead","Altrincham",0,1,"A",0,0,"D",3.11,3.52,2.28,"0-0","0-1",0,0,0,0,2,1,0,0,0,0,0,0,1,0,0,"0-0","N","N","N",3,0,12
"978","EC",2023-09-26,"Oxford City","Gateshead",0,4,"A",0,1,"A",4.94,4.43,1.61,"0-1","0-4",0,0,0,0,1,3,0,0,0,0,0,0,4,0,0,"0-0","Y","Y","Y",4,0,12
"979","EC",2023-09-26,"Wealdstone","Woking",1,0,"H",1,0,"H",3.26,3.85,2.09,"1-0","1-0",0,0,0,0,2,0,0,0,0,0,0,0,1,0,0,"0-0","N","N","N",2,0,12
"980","EC",2023-09-26,"York","Barnet",2,4,"A",1,1,"D",3.1,3.61,2.25,"1-1","2-4",0,0,0,0,0,2,0,0,0,0,0,0,6,0,0,"0-0","Y","Y","Y",2,0,12
"981","EC",2023-09-26,"Rochdale","Chesterfield",1,2,"A",1,2,"A",3.46,3.73,2.05,"1-2","1-2",0,0,0,0,3,3,0,0,0,0,0,0,3,0,0,"0-0","Y","Y","N",6,0,12
"982","EC",2023-09-30,"Aldershot","Dag and Red",3,2,"H",1,1,"D",2.33,3.6,2.97,"1-1","3-2",0,0,0,0,1,5,0,1,0,0,0,0,5,0,0,"0-0","Y","Y","Y",6,1,13
"983","EC",2023-09-30,"Bromley","Gateshead",3,1,"H",0,0,"D",3.72,3.57,2.01,"0-0","3-1",0,0,0,0,4,2,1,0,0,0,0,0,4,0,0,"0-0","Y","Y","Y",6,1,13
"984","EC",2023-09-30,"Ebbsfleet","Boreham Wood",3,1,"H",2,1,"H",2.56,3.65,2.63,"2-1","3-1",0,0,0,0,2,6,0,1,0,0,0,0,4,0,0,"0-0","Y","Y","Y",8,1,13
"985","EC",2023-09-30,"Fylde","Woking",0,2,"A",0,1,"A",2.86,3.55,2.42,"0-1","0-2",0,0,0,0,1,3,0,0,0,0,0,0,2,0,0,"0-0","Y","N","N",4,0,13
"986","EC",2023-09-30,"Halifax","Eastleigh",2,3,"A",0,1,"A",1.99,3.44,3.95,"0-1","2-3",0,0,0,0,1,2,0,0,0,0,0,0,5,0,0,"0-0","Y","Y","Y",3,0,13
"987","EC",2023-09-30,"Hartlepool","Dorking",0,2,"A",0,0,"D",1.56,4.6,5.22,"0-0","0-2",0,0,0,0,1,1,0,0,0,0,0,0,2,0,0,"0-0","Y","N","N",2,0,13
"988","EC",2023-09-30,"Kidderminster","Barnet",1,2,"A",0,2,"A",3.2,3.61,2.16,"0-2","1-2",0,0,0,0,2,3,0,0,0,0,0,0,3,0,0,"0-0","Y","Y","N",5,0,13
"989","EC",2023-09-30,"Maidenhead","Chesterfield",1,1,"D",1,0,"H",6.46,4.21,1.52,"1-0","1-1",0,0,0,0,3,3,0,0,0,0,0,0,2,0,0,"0-0","Y","N","N",6,0,13
"990","EC",2023-09-30,"Rochdale","Southend",2,2,"D",2,1,"H",2.36,3.39,3,"2-1","2-2",0,0,0,0,0,4,0,0,0,0,0,0,4,0,0,"0-0","Y","Y","Y",4,0,13
"991","EC",2023-09-30,"Wealdstone","Oldham",1,1,"D",1,1,"D",3.3,3.7,2.08,"1-1","1-1",0,0,0,0,1,1,0,0,0,0,0,0,2,0,0,"0-0","Y","N","N",2,0,13
"992","EC",2023-09-30,"York","Solihull",2,2,"D",1,0,"H",2.44,3.69,2.7,"1-0","2-2",0,0,0,0,2,1,0,0,0,0,0,0,4,0,0,"0-0","Y","Y","Y",3,0,13
"993","EC",2023-09-30,"Oxford City","Altrincham",1,2,"A",0,1,"A",3.21,3.86,2.11,"0-1","1-2",0,0,0,0,1,0,0,0,0,0,0,0,3,0,0,"0-0","Y","Y","N",1,0,13
"994","EC",2023-10-03,"Altrincham","Aldershot",2,1,"H",1,0,"H",1.81,3.96,4.1,"1-0","2-1",0,0,0,0,2,2,0,0,0,0,0,0,3,0,0,"0-0","Y","Y","N",4,0,14
"995","EC",2023-10-03,"Barnet","Fylde",2,1,"H",0,1,"A",1.51,4.56,6.01,"0-1","2-1",0,0,0,0,1,6,0,1,0,0,0,0,3,0,0,"0-0","Y","Y","N",7,1,14
"996","EC",2023-10-03,"Chesterfield","Bromley",2,0,"H",0,0,"D",1.41,5.02,7.1,"0-0","2-0",0,0,0,0,2,2,0,0,0,0,0,0,2,0,0,"0-0","Y","N","N",4,0,14
"997","EC",2023-10-03,"Dag and Red","York",1,2,"A",0,0,"D",2.5,3.13,3.08,"0-0","1-2",0,0,0,0,2,1,0,0,0,0,0,0,3,0,0,"0-0","Y","Y","N",3,0,14
"998","EC",2023-10-03,"Dorking","Kidderminster",0,1,"A",0,1,"A",2.63,3.52,2.63,"0-1","0-1",0,0,0,0,2,1,0,0,0,0,0,0,1,0,0,"0-0","N","N","N",3,0,14
"999","EC",2023-10-03,"Eastleigh","Ebbsfleet",5,2,"H",2,1,"H",2.1,3.88,3.21,"2-1","5-2",0,0,0,0,4,3,0,1,0,0,0,0,7,0,0,"0-0","Y","Y","Y",7,1,14
"1000","EC",2023-10-03,"Gateshead","Wealdstone",2,1,"H",0,0,"D",1.44,4.92,6.53,"0-0","2-1",0,0,0,0,1,2,0,0,0,0,0,0,3,0,0,"0-0","Y","Y","N",3,0,14
"1001","EC",2023-10-03,"Oldham","Maidenhead",1,1,"D",1,0,"H",1.62,4.22,5.11,"1-0","1-1",0,0,0,0,2,2,0,0,0,0,0,0,2,0,0,"0-0","Y","N","N",4,0,14
"1002","EC",2023-10-03,"Solihull","Rochdale",2,0,"H",0,0,"D",2.46,3.44,2.89,"0-0","2-0",0,0,0,0,0,3,0,0,0,0,0,0,2,0,0,"0-0","Y","N","N",3,0,14
"1003","EC",2023-10-03,"Southend","Oxford City",2,0,"H",2,0,"H",1.52,4.39,6.12,"2-0","2-0",0,0,0,0,2,1,0,0,0,0,0,0,2,0,0,"0-0","Y","N","N",3,0,14
"1004","EC",2023-10-03,"Woking","Halifax",1,2,"A",1,0,"H",1.88,3.47,4.39,"1-0","1-2",0,0,0,0,4,0,0,0,0,0,0,0,3,0,0,"0-0","Y","Y","N",4,0,14
"1005","EC",2023-10-04,"Boreham Wood","Hartlepool",1,0,"H",0,0,"D",2.56,3.45,2.75,"0-0","1-0",0,0,0,0,2,1,0,0,0,0,0,0,1,0,0,"0-0","N","N","N",3,0,14
"1006","EC",2023-10-07,"Boreham Wood","Chesterfield",0,2,"A",0,1,"A",3.87,3.67,1.93,"0-1","0-2",0,0,0,0,1,0,0,0,0,0,0,0,2,0,0,"0-0","Y","N","N",1,0,15
"1007","EC",2023-10-07,"Ebbsfleet","Halifax",0,2,"A",0,1,"A",2.48,3.54,2.79,"0-1","0-2",0,0,0,0,2,2,0,0,0,0,0,0,2,0,0,"0-0","Y","N","N",4,0,15
"1008","EC",2023-10-07,"Gateshead","Altrincham",0,2,"A",0,0,"D",1.59,4.4,5.18,"0-0","0-2",0,0,0,0,5,2,0,0,0,0,0,0,2,0,0,"0-0","Y","N","N",7,0,15
"1009","EC",2023-10-07,"Hartlepool","Eastleigh",3,1,"H",1,1,"D",2.07,3.92,3.19,"1-1","3-1",0,0,0,0,1,2,0,0,0,0,0,0,4,0,0,"0-0","Y","Y","Y",3,0,15
"1010","EC",2023-10-07,"Kidderminster","Wealdstone",1,0,"H",0,0,"D",2.21,3.61,3.18,"0-0","1-0",0,0,0,0,1,2,0,0,0,0,0,0,1,0,0,"0-0","N","N","N",3,0,15
"1011","EC",2023-10-07,"Maidenhead","Rochdale",2,2,"D",0,1,"A",3.37,3.43,2.19,"0-1","2-2",0,0,0,0,3,3,0,0,0,0,0,0,4,0,0,"0-0","Y","Y","Y",6,0,15
"1012","EC",2023-10-07,"Oldham","Dag and Red",1,1,"D",1,0,"H",1.8,3.69,4.51,"1-0","1-1",0,0,0,0,0,1,0,0,0,0,0,0,2,0,0,"0-0","Y","N","N",1,0,15
"1013","EC",2023-10-07,"Oxford City","Fylde",3,0,"H",1,0,"H",3.01,3.32,2.44,"1-0","3-0",0,0,0,0,2,2,0,0,0,0,0,0,3,0,0,"0-0","Y","Y","N",4,0,15
"1014","EC",2023-10-07,"Solihull","Aldershot",0,1,"A",0,0,"D",1.89,3.9,3.82,"0-0","0-1",0,0,0,0,1,4,0,0,0,0,0,0,1,0,0,"0-0","N","N","N",5,0,15
"1015","EC",2023-10-07,"Woking","Southend",0,2,"A",0,1,"A",2.13,3.59,3.29,"0-1","0-2",0,0,0,0,2,1,0,0,0,0,0,0,2,0,0,"0-0","Y","N","N",3,0,15
"1016","EC",2023-10-07,"York","Bromley",2,2,"D",1,0,"H",2.34,3.43,3.02,"1-0","2-2",0,0,0,0,2,2,0,0,0,0,0,0,4,0,0,"0-0","Y","Y","Y",4,0,15
"1017","EC",2023-10-07,"Dorking","Barnet",2,3,"A",2,0,"H",4.86,3.95,1.69,"2-0","2-3",0,0,0,0,3,1,0,0,0,0,0,0,5,0,0,"0-0","Y","Y","Y",4,0,15
"1018","EC",2023-10-21,"Aldershot","Hartlepool",2,1,"H",0,0,"D",2.82,3.78,2.35,"0-0","2-1",0,0,0,0,3,2,0,0,0,0,0,0,3,0,0,"0-0","Y","Y","N",5,0,16
"1019","EC",2023-10-21,"Barnet","Maidenhead",3,2,"H",1,2,"A",1.41,4.77,7.54,"1-2","3-2",0,0,0,0,2,5,0,1,0,0,0,0,5,0,0,"0-0","Y","Y","Y",7,1,16
"1020","EC",2023-10-21,"Bromley","Oxford City",3,1,"H",1,1,"D",1.71,4.25,4.36,"1-1","3-1",0,0,0,0,2,0,0,0,0,0,0,0,4,0,0,"0-0","Y","Y","Y",2,0,16
"1021","EC",2023-10-21,"Dag and Red","Woking",2,1,"H",1,1,"D",2.92,3.32,2.5,"1-1","2-1",0,0,0,0,3,1,0,1,0,0,0,0,3,0,0,"0-0","Y","Y","N",4,1,16
"1022","EC",2023-10-21,"Eastleigh","York",3,1,"H",1,0,"H",2.07,3.78,3.36,"1-0","3-1",0,0,0,0,1,2,0,0,0,0,0,0,4,0,0,"0-0","Y","Y","Y",3,0,16
"1023","EC",2023-10-21,"Fylde","Ebbsfleet",1,1,"D",0,1,"A",2.1,4.02,3.12,"0-1","1-1",0,0,0,0,1,1,0,1,0,0,0,0,2,0,0,"0-0","Y","N","N",2,1,16
"1024","EC",2023-10-21,"Halifax","Kidderminster",2,1,"H",1,1,"D",2.13,3.26,3.71,"1-1","2-1",0,0,0,0,1,2,0,0,0,0,0,0,3,0,0,"0-0","Y","Y","N",3,0,16
"1025","EC",2023-10-21,"Rochdale","Oldham",3,4,"A",0,1,"A",2.29,3.66,2.99,"0-1","3-4",0,0,0,0,0,2,0,0,0,0,0,0,7,0,0,"0-0","Y","Y","Y",2,0,16
"1026","EC",2023-10-21,"Southend","Solihull",5,0,"H",2,0,"H",1.93,3.49,4.14,"2-0","5-0",0,0,0,0,2,5,0,0,0,0,0,0,5,0,0,"0-0","Y","Y","Y",7,0,16
"1027","EC",2023-10-21,"Wealdstone","Boreham Wood",1,1,"D",1,1,"D",2.6,3.35,2.77,"1-1","1-1",0,0,0,0,1,4,1,0,0,0,0,0,2,0,0,"0-0","Y","N","N",5,1,16
"1028","EC",2023-10-24,"Aldershot","Maidenhead",4,2,"H",2,2,"D",1.91,3.77,3.87,"2-2","4-2",0,0,0,0,2,3,0,0,0,0,0,0,6,0,0,"0-0","Y","Y","Y",5,0,16
"1029","EC",2023-10-24,"Altrincham","Kidderminster",1,1,"D",1,1,"D",2.08,3.55,3.53,"1-1","1-1",0,0,0,0,1,3,0,0,0,0,0,0,2,0,0,"0-0","Y","N","N",4,0,16
"1030","EC",2023-10-24,"Barnet","Solihull",1,1,"D",0,0,"D",1.56,4.33,5.59,"0-0","1-1",0,0,0,0,3,3,0,0,0,0,0,0,2,0,0,"0-0","Y","N","N",6,0,17
"1031","EC",2023-10-24,"Bromley","Dorking",2,1,"H",1,1,"D",1.64,4.29,4.87,"1-1","2-1",0,0,0,0,3,3,0,0,0,0,0,0,3,0,0,"0-0","Y","Y","N",6,0,17
"1032","EC",2023-10-24,"Chesterfield","York",4,0,"H",0,0,"D",1.31,5.71,8.83,"0-0","4-0",0,0,0,0,1,1,0,0,0,0,0,0,4,0,0,"0-0","Y","Y","Y",2,0,17
"1033","EC",2023-10-24,"Dag and Red","Boreham Wood",1,3,"A",1,1,"D",2.44,3.21,3.09,"1-1","1-3",0,0,0,0,0,1,0,0,0,0,0,0,4,0,0,"0-0","Y","Y","Y",1,0,17
"1034","EC",2023-10-24,"Eastleigh","Woking",0,1,"A",0,1,"A",3.08,3.58,2.27,"0-1","0-1",0,0,0,0,0,3,0,0,0,0,0,0,1,0,0,"0-0","N","N","N",3,0,17
"1035","EC",2023-10-24,"Fylde","Oldham",3,0,"H",2,0,"H",2.86,3.72,2.35,"2-0","3-0",0,0,0,0,2,1,0,1,0,0,0,0,3,0,0,"0-0","Y","Y","N",3,1,17
"1036","EC",2023-10-24,"Halifax","Hartlepool",2,1,"H",1,1,"D",2.51,3.34,2.88,"1-1","2-1",0,0,0,0,2,5,0,0,0,0,0,0,3,0,0,"0-0","Y","Y","N",7,0,17
"1037","EC",2023-10-24,"Rochdale","Gateshead",2,2,"D",2,0,"H",3.44,3.78,2.04,"2-0","2-2",0,0,0,0,2,3,0,1,0,0,0,0,4,0,0,"0-0","Y","Y","Y",5,1,17
"1038","EC",2023-10-24,"Southend","Ebbsfleet",3,0,"H",1,0,"H",1.47,4.72,6.27,"1-0","3-0",0,0,0,0,0,3,0,0,0,0,0,0,3,0,0,"0-0","Y","Y","N",3,0,17
"1039","EC",2023-10-24,"Wealdstone","Oxford City",3,1,"H",1,1,"D",1.64,4.23,4.94,"1-1","3-1",0,0,0,0,2,0,0,0,0,0,0,0,4,0,0,"0-0","Y","Y","Y",2,0,17
"1040","EC",2023-10-28,"Boreham Wood","Southend",1,1,"D",0,1,"A",3.57,3.66,2.03,"0-1","1-1",0,0,0,0,4,3,0,0,0,0,0,0,2,0,0,"0-0","Y","N","N",7,0,17
"1041","EC",2023-10-28,"Dorking","Aldershot",2,1,"H",1,0,"H",2.82,3.79,2.35,"1-0","2-1",0,0,0,0,6,2,0,0,0,0,0,0,3,0,0,"0-0","Y","Y","N",8,0,17
"1042","EC",2023-10-28,"Ebbsfleet","Dag and Red",0,1,"A",0,0,"D",2.27,3.74,2.83,"0-0","0-1",0,0,0,0,1,4,0,0,0,0,0,0,1,0,0,"0-0","N","N","N",5,0,18
"1043","EC",2023-10-28,"Gateshead","Fylde",0,4,"A",0,2,"A",1.5,4.79,5.79,"0-2","0-4",0,0,0,0,1,2,0,0,0,0,0,0,4,0,0,"0-0","Y","Y","Y",3,0,18
"1044","EC",2023-10-28,"Hartlepool","Rochdale",2,3,"A",1,3,"A",2.23,4.01,2.88,"1-3","2-3",0,0,0,0,1,0,0,0,0,0,0,0,5,0,0,"0-0","Y","Y","Y",1,0,18
"1045","EC",2023-10-28,"Kidderminster","Chesterfield",1,3,"A",1,1,"D",4.53,3.83,1.77,"1-1","1-3",0,0,0,0,2,2,1,0,0,0,0,0,4,0,0,"0-0","Y","Y","Y",4,1,18
"1046","EC",2023-10-28,"Maidenhead","Eastleigh",3,2,"H",2,0,"H",2.93,3.68,2.32,"2-0","3-2",0,0,0,0,2,6,0,0,0,0,0,0,5,0,0,"0-0","Y","Y","Y",8,0,18
"1047","EC",2023-10-28,"Oldham","Altrincham",2,2,"D",1,2,"A",2.25,3.86,2.93,"1-2","2-2",0,0,0,0,2,1,0,0,0,0,0,0,4,0,0,"0-0","Y","Y","Y",3,0,18
"1048","EC",2023-10-28,"Oxford City","Barnet",0,2,"A",0,2,"A",6.08,4.59,1.5,"0-2","0-2",0,0,0,0,1,1,0,0,0,0,0,0,2,0,0,"0-0","Y","N","N",2,0,18
"1049","EC",2023-10-28,"Solihull","Wealdstone",1,0,"H",0,0,"D",2.12,3.82,3.2,"0-0","1-0",0,0,0,0,1,1,0,1,0,0,0,0,1,0,0,"0-0","N","N","N",2,1,18
"1050","EC",2023-10-28,"Woking","Bromley",0,1,"A",0,0,"D",2.05,3.57,3.59,"0-0","0-1",0,0,0,0,2,0,0,0,0,0,0,0,1,0,0,"0-0","N","N","N",2,0,18
"1051","EC",2023-10-28,"York","Halifax",1,1,"D",0,0,"D",2.98,3.65,2.3,"0-0","1-1",0,0,0,0,2,1,0,0,0,0,0,0,2,0,0,"0-0","Y","N","N",3,0,18
"1052","EC",2023-11-04,"Dorking","Dag and Red",1,3,"A",1,2,"A",2.85,3.57,2.42,"1-2","1-3",0,0,0,0,3,1,0,0,0,0,0,0,4,0,0,"0-0","Y","Y","Y",4,0,18
"1053","EC",2023-11-11,"Aldershot","Kidderminster",1,0,"H",1,0,"H",2.16,3.74,3.17,"1-0","1-0",0,0,0,0,0,1,0,0,0,0,0,0,1,0,0,"0-0","N","N","N",1,0,18
"1054","EC",2023-11-11,"Altrincham","Southend",2,0,"H",0,0,"D",2.69,3.59,2.54,"0-0","2-0",0,0,0,0,0,0,0,0,0,0,0,0,2,0,0,"0-0","Y","N","N",0,0,19
"1055","EC",2023-11-11,"Boreham Wood","Bromley",1,1,"D",0,1,"A",2.6,3.27,2.83,"0-1","1-1",0,0,0,0,0,2,1,0,0,0,0,0,2,0,0,"0-0","Y","N","N",2,1,19
"1056","EC",2023-11-11,"Chesterfield","Barnet",4,2,"H",0,0,"D",1.9,3.9,3.8,"0-0","4-2",0,0,0,0,1,2,0,0,0,0,0,0,6,0,0,"0-0","Y","Y","Y",3,0,19
"1057","EC",2023-11-11,"Fylde","York",0,2,"A",0,2,"A",1.89,3.85,3.88,"0-2","0-2",0,0,0,0,0,1,0,0,0,0,0,0,2,0,0,"0-0","Y","N","N",1,0,19
"1058","EC",2023-11-11,"Gateshead","Dorking",6,0,"H",3,0,"H",1.37,5.18,7.75,"3-0","6-0",0,0,0,0,1,3,0,0,0,0,0,0,6,0,0,"0-0","Y","Y","Y",4,0,19
"1059","EC",2023-11-11,"Hartlepool","Ebbsfleet",2,2,"D",1,1,"D",1.71,4.45,4.15,"1-1","2-2",0,0,0,0,2,2,0,0,0,0,0,0,4,0,0,"0-0","Y","Y","Y",4,0,19
"1060","EC",2023-11-11,"Maidenhead","Halifax",1,0,"H",1,0,"H",2.65,3.41,2.64,"1-0","1-0",0,0,0,0,2,1,1,0,0,0,0,0,1,0,0,"0-0","N","N","N",3,1,19
"1061","EC",2023-11-11,"Oldham","Eastleigh",1,1,"D",0,1,"A",1.56,4.1,4.71,"0-1","1-1",0,0,0,0,4,1,0,0,0,0,0,0,2,0,0,"0-0","Y","N","N",5,0,19
"1062","EC",2023-11-11,"Oxford City","Woking",3,2,"H",2,0,"H",4.26,4.09,1.76,"2-0","3-2",0,0,0,0,4,1,0,0,0,0,0,0,5,0,0,"0-0","Y","Y","Y",5,0,19
"1063","EC",2023-11-11,"Wealdstone","Rochdale",3,2,"H",1,1,"D",2.74,3.54,2.48,"1-1","3-2",0,0,0,0,4,1,0,0,0,0,0,0,5,0,0,"0-0","Y","Y","Y",5,0,19
"1064","EC",2023-11-11,"Dag and Red","Solihull",1,2,"A",1,1,"D",2.41,3.27,3.08,"1-1","1-2",0,0,0,0,2,4,0,0,0,0,0,0,3,0,0,"0-0","Y","Y","N",6,0,19
"1065","EC",2023-11-18,"Barnet","Gateshead",0,2,"A",0,0,"D",2.05,3.99,3.26,"0-0","0-2",0,0,0,0,1,2,0,0,0,0,0,0,2,0,0,"0-0","Y","N","N",3,0,19
"1066","EC",2023-11-18,"Bromley","Fylde",1,0,"H",0,0,"D",1.75,4.07,4.32,"0-0","1-0",0,0,0,0,2,1,0,0,0,0,0,0,1,0,0,"0-0","N","N","N",3,0,20
"1067","EC",2023-11-18,"Dorking","Boreham Wood",2,1,"H",1,0,"H",3.83,3.79,1.92,"1-0","2-1",0,0,0,0,0,0,0,0,0,0,0,0,3,0,0,"0-0","Y","Y","N",0,0,20
"1068","EC",2023-11-18,"Eastleigh","Altrincham",2,1,"H",1,0,"H",3.07,3.8,2.19,"1-0","2-1",0,0,0,0,5,0,0,0,0,0,0,0,3,0,0,"0-0","Y","Y","N",5,0,20
"1069","EC",2023-11-18,"Ebbsfleet","Oxford City",0,4,"A",0,2,"A",1.81,4.12,3.97,"0-2","0-4",0,0,0,0,4,2,1,0,0,0,0,0,4,0,0,"0-0","Y","Y","Y",6,1,20
"1070","EC",2023-11-18,"Halifax","Wealdstone",1,0,"H",0,0,"D",2.08,3.77,3.35,"0-0","1-0",0,0,0,0,2,1,0,0,0,0,0,0,1,0,0,"0-0","N","N","N",3,0,20
"1071","EC",2023-11-18,"Kidderminster","Dag and Red",0,1,"A",0,0,"D",2.7,3,2.94,"0-0","0-1",0,0,0,0,2,2,0,0,0,0,0,0,1,0,0,"0-0","N","N","N",4,0,20
"1072","EC",2023-11-18,"Rochdale","Aldershot",2,1,"H",1,1,"D",1.76,4.17,4.17,"1-1","2-1",0,0,0,0,1,0,0,0,0,0,0,0,3,0,0,"0-0","Y","Y","N",1,0,20
"1073","EC",2023-11-18,"Solihull","Maidenhead",1,2,"A",0,1,"A",1.93,3.73,3.88,"0-1","1-2",0,0,0,0,5,2,0,0,0,0,0,0,3,0,0,"0-0","Y","Y","N",7,0,20
"1074","EC",2023-11-18,"Southend","Chesterfield",2,1,"H",0,1,"A",4.1,4.24,1.76,"0-1","2-1",0,0,0,0,0,1,0,0,0,0,0,0,3,0,0,"0-0","Y","Y","N",1,0,20
"1075","EC",2023-11-18,"Woking","Oldham",0,1,"A",0,0,"D",2.05,3.57,3.6,"0-0","0-1",0,0,0,0,2,1,0,0,0,0,0,0,1,0,0,"0-0","N","N","N",3,0,20
"1076","EC",2023-11-18,"York","Hartlepool",1,3,"A",0,2,"A",2.75,3.68,2.44,"0-2","1-3",0,0,0,0,1,0,0,0,0,0,0,0,4,0,0,"0-0","Y","Y","Y",1,0,20
"1077","EC",2023-11-21,"Bromley","Aldershot",2,3,"A",2,0,"H",1.85,3.75,4.18,"2-0","2-3",0,0,0,0,1,5,1,0,0,0,0,0,5,0,0,"0-0","Y","Y","Y",6,1,20
"1078","EC",2023-11-21,"Eastleigh","Boreham Wood",2,1,"H",1,1,"D",2.66,3.55,2.59,"1-1","2-1",0,0,0,0,1,4,0,0,0,0,0,0,3,0,0,"0-0","Y","Y","N",5,0,21
"1079","EC",2023-11-21,"Ebbsfleet","Maidenhead",1,1,"D",0,0,"D",2.24,3.68,3.05,"0-0","1-1",0,0,0,0,0,3,0,0,0,0,0,0,2,0,0,"0-0","Y","N","N",3,0,21
"1080","EC",2023-11-21,"Halifax","Fylde",2,2,"D",0,1,"A",1.95,3.69,3.81,"0-1","2-2",0,0,0,0,2,3,0,1,0,0,0,0,4,0,0,"0-0","Y","Y","Y",5,1,21
"1081","EC",2023-11-21,"Kidderminster","Hartlepool",1,1,"D",1,1,"D",2.73,3.36,2.64,"1-1","1-1",0,0,0,0,1,2,0,0,0,0,0,0,2,0,0,"0-0","Y","N","N",3,0,21
"1082","EC",2023-11-21,"Rochdale","Altrincham",3,0,"H",1,0,"H",2.28,3.62,3.03,"1-0","3-0",0,0,0,0,2,2,0,0,0,0,0,0,3,0,0,"0-0","Y","Y","N",4,0,21
"1083","EC",2023-11-21,"Solihull","Gateshead",1,2,"A",0,2,"A",3.86,3.85,1.89,"0-2","1-2",0,0,0,0,1,4,0,0,0,0,0,0,3,0,0,"0-0","Y","Y","N",5,0,21
"1084","EC",2023-11-21,"Woking","Chesterfield",0,2,"A",0,1,"A",5.57,4.34,1.56,"0-1","0-2",0,0,0,0,2,1,0,0,0,0,0,0,2,0,0,"0-0","Y","N","N",3,0,21
"1085","EC",2023-11-21,"York","Oxford City",2,0,"H",2,0,"H",1.78,4.03,4.23,"2-0","2-0",0,0,0,0,1,0,0,0,0,0,0,0,2,0,0,"0-0","Y","N","N",1,0,21
"1086","EC",2023-11-22,"Barnet","Oldham",1,4,"A",0,1,"A",1.87,3.86,3.95,"0-1","1-4",0,0,0,0,2,3,0,0,0,0,0,0,5,0,0,"0-0","Y","Y","Y",5,0,21
"1087","EC",2023-11-25,"Fylde","Dorking",3,3,"D",3,1,"H",1.62,4.48,4.77,"3-1","3-3",0,0,0,0,1,1,0,0,0,0,0,0,6,0,0,"0-0","Y","Y","Y",2,0,21
"1088","EC",2023-11-25,"Aldershot","Halifax",1,0,"H",0,0,"D",2.01,3.85,3.46,"0-0","1-0",0,0,0,0,7,2,0,0,0,0,0,0,1,0,0,"0-0","N","N","N",9,0,21
"1089","EC",2023-11-25,"Altrincham","Solihull",6,1,"H",3,0,"H",1.75,4.1,4.28,"3-0","6-1",0,0,0,0,0,1,0,0,0,0,0,0,7,0,0,"0-0","Y","Y","Y",1,0,21
"1090","EC",2023-11-25,"Boreham Wood","Woking",4,2,"H",1,2,"A",2.35,3.31,3.16,"1-2","4-2",0,0,0,0,0,3,0,0,0,0,0,0,6,0,0,"0-0","Y","Y","Y",3,0,22
"1091","EC",2023-11-25,"Chesterfield","Eastleigh",3,2,"H",0,0,"D",1.26,6.25,9.92,"0-0","3-2",0,0,0,0,0,0,0,0,0,0,0,0,5,0,0,"0-0","Y","Y","Y",0,0,22
"1092","EC",2023-11-25,"Dag and Red","Rochdale",1,2,"A",0,1,"A",2.7,3.66,2.49,"0-1","1-2",0,0,0,0,2,0,0,0,0,0,0,0,3,0,0,"0-0","Y","Y","N",2,0,22
"1093","EC",2023-11-25,"Gateshead","Southend",1,1,"D",1,0,"H",1.93,3.8,3.79,"1-0","1-1",0,0,0,0,1,0,0,0,0,0,0,0,2,0,0,"0-0","Y","N","N",1,0,22
"1094","EC",2023-11-25,"Hartlepool","Bromley",1,4,"A",0,2,"A",2.49,3.78,2.65,"0-2","1-4",0,0,0,0,2,3,0,0,0,0,0,0,5,0,0,"0-0","Y","Y","Y",5,0,22
"1095","EC",2023-11-25,"Maidenhead","York",1,1,"D",0,0,"D",2.13,3.49,3.26,"0-0","1-1",0,0,0,0,2,1,0,1,0,0,0,0,2,0,0,"0-0","Y","N","N",3,1,22
"1096","EC",2023-11-25,"Oldham","Ebbsfleet",1,4,"A",0,1,"A",1.68,4.22,4.63,"0-1","1-4",0,0,0,0,0,3,0,0,0,0,0,0,5,0,0,"0-0","Y","Y","Y",3,0,22
"1097","EC",2023-11-25,"Oxford City","Kidderminster",2,2,"D",2,1,"H",2.82,3.44,2.51,"2-1","2-2",0,0,0,0,4,2,0,0,0,0,0,0,4,0,0,"0-0","Y","Y","Y",6,0,22
"1098","EC",2023-11-25,"Wealdstone","Barnet",3,2,"H",1,2,"A",3.74,3.83,1.93,"1-2","3-2",0,0,0,0,2,3,0,0,0,0,0,0,5,0,0,"0-0","Y","Y","Y",5,0,22
"1099","EC",2023-12-02,"Bromley","Rochdale",1,0,"H",0,0,"D",2.44,3.52,2.85,"0-0","1-0",0,0,0,0,0,2,0,0,0,0,0,0,1,0,0,"0-0","N","N","N",2,0,22
"1100","EC",2023-12-02,"Kidderminster","Ebbsfleet",2,0,"H",2,0,"H",2.11,3.52,3.49,"2-0","2-0",0,0,0,0,3,4,0,0,0,0,0,0,2,0,0,"0-0","Y","N","N",7,0,22
"1101","EC",2023-12-02,"Oxford City","Maidenhead",1,4,"A",0,3,"A",3.18,3.58,2.22,"0-3","1-4",0,0,0,0,0,1,0,0,0,0,0,0,5,0,0,"0-0","Y","Y","Y",1,0,22
"1700","F1",2023-08-11,"Nice","Lille",1,1,"D",1,0,"H",2.63,3.47,2.83,"1-0","1-1",8,3,12,5,3,2,0,0,3,3,13,9,2,6,22,"3-3","Y","N","N",5,0,1
"1701","F1",2023-08-12,"Marseille","Reims",2,1,"H",1,1,"D",1.73,4.04,4.89,"1-1","2-1",14,4,11,4,1,3,0,0,10,10,7,16,3,20,23,"10-10","Y","Y","N",4,0,1
"1702","F1",2023-08-12,"Paris SG","Lorient",0,0,"D",0,0,"D",1.35,5.73,8.38,"0-0","0-0",20,4,4,0,0,0,0,0,9,2,8,6,0,11,14,"9-2","N","N","N",0,0,1
"1703","F1",2023-08-13,"Brest","Lens",3,2,"H",1,2,"A",4.01,3.62,1.99,"1-2","3-2",15,8,10,2,2,3,0,1,6,8,13,15,5,14,28,"6-8","Y","Y","Y",5,1,1
"1704","F1",2023-08-13,"Clermont","Monaco",2,4,"A",1,2,"A",3.69,3.8,2.02,"1-2","2-4",15,7,14,8,0,4,0,0,6,2,7,16,6,8,23,"6-2","Y","Y","Y",4,0,1
"1705","F1",2023-08-13,"Montpellier","Le Havre",2,2,"D",0,1,"A",2.04,3.47,3.99,"0-1","2-2",15,5,12,4,1,2,0,0,5,2,8,12,4,7,20,"5-2","Y","Y","Y",3,0,1
"1706","F1",2023-08-13,"Nantes","Toulouse",1,2,"A",1,0,"H",2.66,3.36,2.82,"1-0","1-2",9,4,9,5,2,2,0,0,7,5,14,14,3,12,28,"7-5","Y","Y","N",4,0,1
"1707","F1",2023-08-13,"Rennes","Metz",5,1,"H",1,1,"D",1.42,5.07,7.64,"1-1","5-1",29,14,9,3,0,2,0,0,5,4,7,10,6,9,17,"5-4","Y","Y","Y",2,0,1
"1708","F1",2023-08-13,"Strasbourg","Lyon",2,1,"H",0,0,"D",2.61,3.55,2.76,"0-0","2-1",8,2,23,7,2,2,0,0,1,6,8,11,3,7,19,"1-6","Y","Y","N",4,0,1
"1709","F1",2023-08-18,"Metz","Marseille",2,2,"D",0,1,"A",4.96,4.13,1.72,"0-1","2-2",10,5,22,5,3,2,1,0,4,9,15,9,4,13,24,"4-9","Y","Y","Y",5,1,2
"1710","F1",2023-08-19,"Lyon","Montpellier",1,4,"A",0,2,"A",1.72,4.25,4.67,"0-2","1-4",7,3,14,8,4,1,1,0,6,2,20,10,5,8,30,"6-2","Y","Y","Y",5,1,2
"1711","F1",2023-08-19,"Toulouse","Paris SG",1,1,"D",0,0,"D",5.01,4.25,1.68,"0-0","1-1",8,2,16,3,0,3,0,0,5,5,8,11,2,10,19,"5-5","Y","N","N",3,0,2
"1712","F1",2023-08-20,"Lille","Nantes",2,0,"H",0,0,"D",1.43,4.96,7.54,"0-0","2-0",18,8,14,4,0,2,1,0,7,5,8,15,2,12,23,"7-5","Y","N","N",2,1,2
"1713","F1",2023-08-20,"Le Havre","Brest",1,2,"A",0,1,"A",2.82,3.22,2.76,"0-1","1-2",18,7,10,5,0,2,0,0,5,3,18,15,3,8,33,"5-3","Y","Y","N",2,0,2
"1714","F1",2023-08-20,"Lorient","Nice",1,1,"D",0,0,"D",3.49,3.52,2.19,"0-0","1-1",9,2,21,8,1,1,0,0,0,9,8,10,2,9,18,"0-9","Y","N","N",2,0,2
"1715","F1",2023-08-20,"Reims","Clermont",2,0,"H",1,0,"H",1.93,3.72,4.1,"1-0","2-0",8,4,11,4,0,0,0,0,3,10,9,6,2,13,15,"3-10","Y","N","N",0,0,2
"1716","F1",2023-08-20,"Monaco","Strasbourg",3,0,"H",2,0,"H",1.84,4.1,4.13,"2-0","3-0",9,4,4,1,2,1,0,0,4,3,19,16,3,7,35,"4-3","Y","Y","N",3,0,2
"1717","F1",2023-08-20,"Lens","Rennes",1,1,"D",1,0,"H",2.42,3.78,2.86,"1-0","1-1",15,4,10,5,2,1,0,0,11,0,15,10,2,11,25,"11-0","Y","N","N",3,0,2
"1718","F1",2023-08-25,"Nantes","Monaco",3,3,"D",2,1,"H",4.87,3.81,1.79,"2-1","3-3",3,3,27,10,2,2,0,0,1,10,8,7,6,11,15,"1-10","Y","Y","Y",4,0,3
"1719","F1",2023-08-26,"Marseille","Brest",2,0,"H",1,0,"H",1.53,4.48,6.43,"1-0","2-0",15,6,18,7,0,1,0,0,3,10,4,8,2,13,12,"3-10","Y","N","N",1,0,3
"1720","F1",2023-08-26,"Paris SG","Lens",3,1,"H",1,0,"H",1.63,4.27,5.45,"1-0","3-1",17,7,12,4,0,5,0,0,5,5,8,16,4,10,24,"5-5","Y","Y","Y",5,0,3
"1721","F1",2023-08-27,"Rennes","Le Havre",2,2,"D",2,1,"H",1.44,4.76,7.86,"2-1","2-2",22,8,7,3,1,2,0,1,5,2,5,7,4,7,12,"5-2","Y","Y","Y",3,1,3
"1722","F1",2023-08-27,"Clermont","Metz",0,1,"A",0,0,"D",1.93,3.83,3.99,"0-0","0-1",16,4,10,5,1,1,0,0,10,2,8,10,1,12,18,"10-2","N","N","N",2,0,3
"1723","F1",2023-08-27,"Montpellier","Reims",1,3,"A",1,2,"A",2.41,3.54,3.02,"1-2","1-3",19,3,12,6,1,1,0,0,5,3,9,19,4,8,28,"5-3","Y","Y","Y",2,0,3
"1724","F1",2023-08-27,"Strasbourg","Toulouse",2,0,"H",0,0,"D",2.17,3.75,3.32,"0-0","2-0",11,3,7,1,1,3,0,0,3,3,16,17,2,6,33,"3-3","Y","N","N",4,0,3
"1725","F1",2023-08-27,"Lorient","Lille",4,1,"H",2,0,"H",3.83,3.75,1.99,"2-0","4-1",9,6,18,7,2,4,0,0,5,8,22,12,5,13,34,"5-8","Y","Y","Y",6,0,3
"1726","F1",2023-08-27,"Nice","Lyon",0,0,"D",0,0,"D",2.11,3.79,3.44,"0-0","0-0",21,4,6,1,1,4,0,0,7,2,8,14,0,9,22,"7-2","N","N","N",5,0,3
"1727","F1",2023-09-01,"Nantes","Marseille",1,1,"D",1,1,"D",4.97,4.02,1.73,"1-1","1-1",10,2,26,9,0,2,1,0,2,7,7,13,2,9,20,"2-7","Y","N","N",2,1,4
"1728","F1",2023-09-02,"Brest","Rennes",0,0,"D",0,0,"D",3.37,3.68,2.18,"0-0","0-0",13,2,6,3,3,1,0,0,7,5,12,12,0,12,24,"7-5","N","N","N",4,0,4
"1729","F1",2023-09-02,"Monaco","Lens",3,0,"H",2,0,"H",2.11,3.93,3.33,"2-0","3-0",11,6,12,1,4,2,0,0,5,2,21,16,3,7,37,"5-2","Y","Y","N",6,0,4
"1730","F1",2023-09-03,"Toulouse","Clermont",2,2,"D",2,1,"H",2.02,3.69,3.82,"2-1","2-2",9,5,15,3,1,3,0,0,0,8,19,17,4,8,36,"0-8","Y","Y","Y",4,0,4
"1731","F1",2023-09-03,"Le Havre","Lorient",3,0,"H",0,0,"D",2.87,3.12,2.79,"0-0","3-0",17,6,9,2,0,0,0,0,5,4,10,7,3,9,17,"5-4","Y","Y","N",0,0,4
"1732","F1",2023-09-03,"Lille","Montpellier",1,0,"H",1,0,"H",1.83,4.25,4.05,"1-0","1-0",15,6,9,5,2,1,0,0,5,5,15,14,1,10,29,"5-5","N","N","N",3,0,4
"1733","F1",2023-09-03,"Metz","Reims",2,2,"D",1,1,"D",4.09,3.72,1.93,"1-1","2-2",12,4,12,2,0,4,0,0,4,1,10,17,4,5,27,"4-1","Y","Y","Y",4,0,4
"1734","F1",2023-09-03,"Nice","Strasbourg",2,0,"H",1,0,"H",1.98,3.58,4.06,"1-0","2-0",16,6,4,0,2,1,0,0,5,2,7,12,2,7,19,"5-2","Y","N","N",3,0,4
"1735","F1",2023-09-03,"Lyon","Paris SG",1,4,"A",0,4,"A",5.79,5.01,1.52,"0-4","1-4",19,8,22,8,2,2,0,0,5,2,9,5,5,7,14,"5-2","Y","Y","Y",4,0,4
"1736","F1",2023-09-15,"Paris SG","Nice",2,3,"A",1,1,"D",1.56,4.6,5.86,"1-1","2-3",12,3,14,8,2,5,0,0,4,3,8,17,5,7,25,"4-3","Y","Y","Y",7,0,5
"1737","F1",2023-09-16,"Rennes","Lille",2,2,"D",0,1,"A",2.17,3.69,3.37,"0-1","2-2",7,4,10,6,1,4,0,0,5,2,11,16,4,7,27,"5-2","Y","Y","Y",5,0,5
"1738","F1",2023-09-16,"Lens","Metz",0,1,"A",0,1,"A",1.52,4.62,6.36,"0-1","0-1",31,10,2,2,1,2,0,0,9,1,12,12,1,10,24,"9-1","N","N","N",3,0,5
"1739","F1",2023-09-17,"Lorient","Monaco",2,2,"D",1,1,"D",4.12,3.98,1.87,"1-1","2-2",10,3,20,7,0,1,0,0,8,6,13,14,4,14,27,"8-6","Y","Y","Y",1,0,5
"1740","F1",2023-09-17,"Clermont","Nantes",0,1,"A",0,0,"D",2.04,3.6,3.85,"0-0","0-1",16,3,8,5,2,2,0,0,6,3,16,16,1,9,32,"6-3","N","N","N",4,0,5
"1741","F1",2023-09-17,"Reims","Brest",1,2,"A",1,0,"H",1.9,3.6,4.43,"1-0","1-2",13,7,18,7,2,4,0,0,8,8,7,11,3,16,18,"8-8","Y","Y","N",6,0,5
"1742","F1",2023-09-17,"Strasbourg","Montpellier",2,2,"D",0,2,"A",2.39,3.61,3.01,"0-2","2-2",14,7,11,4,4,6,0,0,2,4,17,17,4,6,34,"2-4","Y","Y","Y",10,0,5
"1743","F1",2023-09-17,"Marseille","Toulouse",0,0,"D",0,0,"D",1.5,4.87,6.33,"0-0","0-0",24,6,10,3,2,5,0,0,6,1,9,11,0,7,20,"6-1","N","N","N",7,0,5
"1744","F1",2023-09-17,"Lyon","Le Havre",0,0,"D",0,0,"D",1.7,4.23,4.82,"0-0","0-0",23,7,7,0,3,2,0,0,6,1,13,12,0,7,25,"6-1","N","N","N",5,0,5
"1745","F1",2023-09-22,"Monaco","Nice",0,1,"A",0,0,"D",2.25,3.61,3.27,"0-0","0-1",9,3,13,7,1,1,0,0,5,2,13,15,1,7,28,"5-2","N","N","N",2,0,6
"1746","F1",2023-09-23,"Nantes","Lorient",5,3,"H",1,1,"D",2.46,3.45,3.02,"1-1","5-3",19,9,10,7,1,3,0,0,4,2,8,17,8,6,25,"4-2","Y","Y","Y",4,0,6
"1747","F1",2023-09-23,"Brest","Lyon",1,0,"H",0,0,"D",2.57,3.67,2.73,"0-0","1-0",27,11,6,3,3,1,0,0,10,1,17,16,1,11,33,"10-1","N","N","N",4,0,6
"1748","F1",2023-09-24,"Metz","Strasbourg",0,1,"A",0,0,"D",3.01,3.23,2.59,"0-0","0-1",13,1,4,1,2,0,0,0,1,1,16,15,1,2,31,"1-1","N","N","N",2,0,6
"1749","F1",2023-09-24,"Le Havre","Clermont",2,1,"H",2,1,"H",2.48,3.26,3.15,"2-1","2-1",9,3,11,4,2,3,0,0,1,3,15,17,3,4,32,"1-3","Y","Y","N",5,0,6
"1750","F1",2023-09-24,"Lens","Toulouse",2,1,"H",1,1,"D",1.72,4.05,4.93,"1-1","2-1",27,7,7,2,2,1,0,0,9,4,16,15,3,13,31,"9-4","Y","Y","N",3,0,6
"1751","F1",2023-09-24,"Montpellier","Rennes",0,0,"D",0,0,"D",2.7,3.56,2.65,"0-0","0-0",13,4,18,6,2,1,0,0,3,6,10,15,0,9,25,"3-6","N","N","N",3,0,6
"1752","F1",2023-09-24,"Paris SG","Marseille",4,0,"H",2,0,"H",1.64,4.41,5.15,"2-0","4-0",15,5,6,0,0,3,0,0,8,3,11,14,4,11,25,"8-3","Y","Y","Y",3,0,6
"1753","F1",2023-09-26,"Lille","Reims",1,2,"A",0,2,"A",1.96,3.79,3.95,"0-2","1-2",14,3,4,4,1,2,0,0,4,2,4,19,3,6,23,"4-2","Y","Y","N",3,0,6
"1754","F1",2023-09-29,"Strasbourg","Lens",0,1,"A",0,1,"A",3.69,3.48,2.13,"0-1","0-1",8,2,9,2,2,4,0,0,2,3,16,15,1,5,31,"2-3","N","N","N",6,0,7
"1755","F1",2023-09-30,"Clermont","Paris SG",0,0,"D",0,0,"D",7.03,4.81,1.47,"0-0","0-0",12,3,21,10,2,3,0,0,6,9,11,16,0,15,27,"6-9","N","N","N",5,0,7
"1756","F1",2023-09-30,"Monaco","Marseille",3,2,"H",2,2,"D",2.21,3.88,3.14,"2-2","3-2",10,7,8,4,4,4,0,0,2,6,17,15,5,8,32,"2-6","Y","Y","Y",8,0,7
"1757","F1",2023-10-01,"Reims","Lyon",2,0,"H",1,0,"H",2.1,3.81,3.45,"1-0","2-0",8,3,11,6,2,2,0,0,1,5,19,14,2,6,33,"1-5","Y","N","N",4,0,7
"1758","F1",2023-10-01,"Le Havre","Lille",0,2,"A",0,1,"A",4.08,3.44,2.03,"0-1","0-2",5,0,16,6,0,0,0,0,6,6,18,6,2,12,24,"6-6","Y","N","N",0,0,7
"1759","F1",2023-10-01,"Nice","Brest",0,0,"D",0,0,"D",1.8,3.84,4.69,"0-0","0-0",12,1,7,2,1,3,0,0,6,4,13,9,0,10,22,"6-4","N","N","N",4,0,7
"1760","F1",2023-10-01,"Toulouse","Metz",3,0,"H",2,0,"H",2.13,3.47,3.7,"2-0","3-0",15,10,8,3,3,0,0,0,4,6,10,7,3,10,17,"4-6","Y","Y","N",3,0,7
"1761","F1",2023-10-01,"Lorient","Montpellier",0,3,"A",0,1,"A",2.95,3.59,2.44,"0-1","0-3",14,3,14,8,2,1,0,0,8,3,13,6,3,11,19,"8-3","Y","Y","N",3,0,7
"1762","F1",2023-10-01,"Rennes","Nantes",3,1,"H",1,1,"D",1.53,4.58,6.18,"1-1","3-1",16,5,10,3,3,6,0,1,6,4,11,17,4,10,28,"6-4","Y","Y","Y",9,1,7
"1763","F1",2023-10-06,"Strasbourg","Nantes",1,2,"A",0,0,"D",2.31,3.24,3.57,"0-0","1-2",11,3,16,7,4,0,0,0,3,11,15,12,3,14,27,"3-11","Y","Y","N",4,0,8
"1764","F1",2023-10-07,"Metz","Nice",0,1,"A",0,1,"A",5.12,3.91,1.72,"0-1","0-1",10,3,7,4,0,1,0,0,1,4,9,10,1,5,19,"1-4","N","N","N",1,0,8
"1765","F1",2023-10-07,"Reims","Monaco",1,3,"A",0,1,"A",2.68,3.62,2.64,"0-1","1-3",11,4,11,4,0,3,0,0,10,5,10,14,4,15,24,"10-5","Y","Y","Y",3,0,8
"1766","F1",2023-10-08,"Marseille","Le Havre",3,0,"H",2,0,"H",1.48,4.63,7.2,"2-0","3-0",14,6,7,1,0,3,0,1,4,3,6,16,3,7,22,"4-3","Y","Y","N",3,1,8
"1767","F1",2023-10-08,"Brest","Toulouse",1,1,"D",0,1,"A",1.85,3.74,4.54,"0-1","1-1",13,2,9,3,2,2,0,0,3,5,18,18,2,8,36,"3-5","Y","N","N",4,0,8
"1768","F1",2023-10-08,"Lyon","Lorient",3,3,"D",3,1,"H",1.71,4.06,5.04,"3-1","3-3",9,6,6,5,0,0,0,0,5,2,22,10,6,7,32,"5-2","Y","Y","Y",0,0,8
"1769","F1",2023-10-08,"Lens","Lille",1,1,"D",0,1,"A",2.27,3.48,3.34,"0-1","1-1",14,5,8,3,2,4,0,0,8,5,14,16,2,13,30,"8-5","Y","N","N",6,0,8
"1770","F1",2023-10-08,"Rennes","Paris SG",1,3,"A",0,2,"A",3.61,3.59,2.11,"0-2","1-3",14,4,17,7,1,0,0,0,1,7,12,15,4,8,27,"1-7","Y","Y","Y",1,0,8
"1771","F1",2023-10-20,"Le Havre","Lens",0,0,"D",0,0,"D",4.66,3.6,1.88,"0-0","0-0",14,5,13,7,2,3,0,0,3,3,16,9,0,6,25,"3-3","N","N","N",5,0,8
"1772","F1",2023-10-21,"Paris SG","Strasbourg",3,0,"H",2,0,"H",1.24,6.93,11.72,"2-0","3-0",8,4,7,1,2,0,0,0,1,6,11,10,3,7,21,"1-6","Y","Y","N",2,0,9
"1773","F1",2023-10-21,"Nice","Marseille",1,0,"H",0,0,"D",2.51,3.22,3.14,"0-0","1-0",10,2,9,1,4,3,0,1,4,2,13,6,1,6,19,"4-2","N","N","N",7,1,9
"1774","F1",2023-10-22,"Lorient","Rennes",2,1,"H",2,1,"H",4.02,3.79,1.93,"2-1","2-1",5,4,20,6,0,2,0,0,6,16,5,14,3,22,19,"6-16","Y","Y","N",2,0,9
"1775","F1",2023-10-22,"Lille","Brest",1,0,"H",1,0,"H",1.82,3.64,4.85,"1-0","1-0",6,4,9,1,2,3,0,0,3,5,12,13,1,8,25,"3-5","N","N","N",5,0,9
"1776","F1",2023-10-22,"Nantes","Montpellier",2,0,"H",1,0,"H",3.03,3.62,2.37,"1-0","2-0",14,5,11,6,2,1,0,0,4,3,16,13,2,7,29,"4-3","Y","N","N",3,0,9
"1777","F1",2023-10-22,"Toulouse","Reims",1,1,"D",0,0,"D",2.94,3.47,2.5,"0-0","1-1",11,5,15,4,2,0,0,0,5,7,18,15,2,12,33,"5-7","Y","N","N",2,0,9
"1778","F1",2023-10-22,"Monaco","Metz",2,1,"H",1,1,"D",1.36,5.75,8.16,"1-1","2-1",27,13,8,4,1,3,0,0,10,2,12,11,3,12,23,"10-2","Y","Y","N",4,0,9
"1779","F1",2023-10-22,"Lyon","Clermont",1,2,"A",0,2,"A",1.81,4.08,4.31,"0-2","1-2",25,6,12,5,4,6,0,0,10,3,16,12,3,13,28,"10-3","Y","Y","N",10,0,9
"1780","F1",2023-10-27,"Clermont","Nice",0,1,"A",0,0,"D",4.42,3.42,1.95,"0-0","0-1",8,3,11,5,0,2,0,0,2,2,14,12,1,4,26,"2-2","N","N","N",2,0,9
"1781","F1",2023-10-28,"Reims","Lorient",1,0,"H",0,0,"D",1.67,4.24,5.13,"0-0","1-0",12,5,9,1,1,3,0,0,4,4,16,7,1,8,23,"4-4","N","N","N",4,0,10
"1782","F1",2023-10-28,"Lens","Nantes",4,0,"H",1,0,"H",1.6,4.36,5.65,"1-0","4-0",11,7,11,1,1,2,0,0,4,1,12,17,4,5,29,"4-1","Y","Y","Y",3,0,10
"1783","F1",2023-10-29,"Brest","Paris SG",2,3,"A",1,2,"A",6.06,4.63,1.54,"1-2","2-3",20,5,17,10,3,4,0,0,9,5,14,10,5,14,24,"9-5","Y","Y","Y",7,0,10
"1784","F1",2023-10-29,"Lille","Monaco",2,0,"H",2,0,"H",2.34,3.82,2.95,"2-0","2-0",7,5,16,6,1,2,0,0,2,8,17,13,2,10,30,"2-8","Y","N","N",3,0,10
"1785","F1",2023-10-29,"Metz","Le Havre",0,0,"D",0,0,"D",2.61,3.26,2.96,"0-0","0-0",9,3,12,1,2,2,0,0,5,6,13,15,0,11,28,"5-6","N","N","N",4,0,10
"1786","F1",2023-10-29,"Montpellier","Toulouse",3,0,"H",1,0,"H",1.8,3.95,4.53,"1-0","3-0",19,6,16,5,2,3,0,0,3,4,13,15,3,7,28,"3-4","Y","Y","N",5,0,10
"1787","F1",2023-10-29,"Rennes","Strasbourg",1,1,"D",1,0,"H",1.6,4.19,5.92,"1-0","1-1",20,3,11,3,2,2,0,0,7,5,14,16,2,12,30,"7-5","Y","N","N",4,0,10
"1788","F1",2023-11-03,"Paris SG","Montpellier",3,0,"H",1,0,"H",1.26,6.76,10.17,"1-0","3-0",21,10,7,2,1,0,0,0,9,2,10,13,3,11,23,"9-2","Y","Y","N",1,0,10
"1789","F1",2023-11-04,"Lorient","Lens",0,0,"D",0,0,"D",4.73,3.95,1.75,"0-0","0-0",7,2,14,7,3,3,0,0,1,5,10,14,0,6,24,"1-5","N","N","N",6,0,10
"1790","F1",2023-11-04,"Marseille","Lille",0,0,"D",0,0,"D",2.21,3.59,3.31,"0-0","0-0",8,3,10,1,2,3,0,0,2,8,10,12,0,10,22,"2-8","N","N","N",5,0,11
"1791","F1",2023-11-05,"Lyon","Metz",1,1,"D",0,0,"D",1.67,4.04,5.24,"0-0","1-1",15,4,10,5,1,1,0,0,4,9,16,14,2,13,30,"4-9","Y","N","N",2,0,11
"1792","F1",2023-11-05,"Nantes","Reims",0,1,"A",0,0,"D",2.99,3.2,2.59,"0-0","0-1",17,4,7,4,1,2,0,0,10,6,5,11,1,16,16,"10-6","N","N","N",3,0,11
"1793","F1",2023-11-05,"Strasbourg","Clermont",0,0,"D",0,0,"D",2.42,3.23,3.22,"0-0","0-0",18,5,10,2,2,0,1,0,4,6,11,5,0,10,16,"4-6","N","N","N",2,1,11
"1794","F1",2023-11-05,"Toulouse","Le Havre",1,2,"A",0,0,"D",2.16,3.35,3.67,"0-0","1-2",17,5,15,7,2,2,0,0,4,6,9,12,3,10,21,"4-6","Y","Y","N",4,0,11
"1795","F1",2023-11-05,"Monaco","Brest",2,0,"H",1,0,"H",1.76,4.14,4.44,"1-0","2-0",12,6,15,1,2,4,0,1,6,4,15,11,2,10,26,"6-4","Y","N","N",6,1,11
"1796","F1",2023-11-05,"Nice","Rennes",2,0,"H",1,0,"H",2.13,3.36,3.74,"1-0","2-0",16,4,11,4,0,2,1,1,2,1,7,12,2,3,19,"2-1","Y","N","N",2,2,11
"1797","F1",2023-11-10,"Montpellier","Nice",0,0,"D",0,0,"D",3.61,3.39,2.17,"0-0","0-0",9,1,15,4,0,4,0,0,3,7,11,15,0,10,26,"3-7","N","N","N",4,0,11
"1798","F1",2023-11-11,"Reims","Paris SG",0,3,"A",0,1,"A",5.46,4.35,1.6,"0-1","0-3",19,6,14,6,1,0,0,0,8,4,14,6,3,12,20,"8-4","Y","Y","N",1,0,11
"1799","F1",2023-11-11,"Le Havre","Monaco",0,0,"D",0,0,"D",4.5,3.95,1.78,"0-0","0-0",9,5,10,4,2,3,0,0,2,4,10,18,0,6,28,"2-4","N","N","N",5,0,12
"1800","F1",2023-11-12,"Clermont","Lorient",1,0,"H",0,0,"D",2.18,3.35,3.63,"0-0","1-0",17,6,10,3,3,2,0,0,5,4,15,10,1,9,25,"5-4","N","N","N",5,0,12
"1801","F1",2023-11-12,"Lille","Toulouse",1,1,"D",1,0,"H",1.59,4.33,5.62,"1-0","1-1",13,6,2,1,3,4,0,0,11,1,12,16,2,12,28,"11-1","Y","N","N",7,0,12
"1802","F1",2023-11-12,"Metz","Nantes",3,1,"H",2,1,"H",3.04,3.24,2.53,"2-1","3-1",9,4,16,3,0,0,0,0,2,5,7,9,4,7,16,"2-5","Y","Y","Y",0,0,12
"1803","F1",2023-11-12,"Rennes","Lyon",0,1,"A",0,0,"D",1.75,4.12,4.48,"0-0","0-1",8,2,12,5,3,1,1,0,6,9,5,18,1,15,23,"6-9","N","N","N",4,1,12
"1804","F1",2023-11-12,"Lens","Marseille",1,0,"H",0,0,"D",2.27,3.54,3.22,"0-0","1-0",14,3,8,2,2,2,0,0,4,5,19,15,1,9,34,"4-5","N","N","N",4,0,12
"1805","F1",2023-11-24,"Paris SG","Monaco",5,2,"H",2,1,"H",1.5,5.1,5.7,"2-1","5-2",16,11,14,7,0,1,0,0,2,10,9,19,7,12,28,"2-10","Y","Y","Y",1,0,12
"1806","F1",2023-11-25,"Clermont","Lens",0,3,"A",0,1,"A",3.89,3.52,2.03,"0-1","0-3",13,4,16,10,2,3,1,1,2,4,16,17,3,6,33,"2-4","Y","Y","N",5,2,12
"1807","F1",2023-11-25,"Strasbourg","Marseille",1,1,"D",1,1,"D",3.94,3.58,1.99,"1-1","1-1",15,7,16,3,1,2,0,0,7,11,14,16,2,18,30,"7-11","Y","N","N",3,0,12
"1808","F1",2023-11-26,"Nice","Toulouse",1,0,"H",0,0,"D",1.52,4.18,7.02,"0-0","1-0",8,3,19,3,0,4,0,0,4,2,9,19,1,6,28,"4-2","N","N","N",4,0,13
"1809","F1",2023-11-26,"Lorient","Metz",2,3,"A",2,1,"H",2,3.45,4.07,"2-1","2-3",11,5,14,5,2,1,0,0,5,6,10,17,5,11,27,"5-6","Y","Y","Y",3,0,13
"1810","F1",2023-11-26,"Montpellier","Brest",1,3,"A",0,1,"A",2.31,3.39,3.27,"0-1","1-3",17,5,17,5,2,2,0,0,9,1,11,18,4,10,29,"9-1","Y","Y","Y",4,0,13
"1811","F1",2023-11-26,"Nantes","Le Havre",0,0,"D",0,0,"D",2.07,3.47,3.8,"0-0","0-0",19,3,6,0,1,2,0,1,10,5,10,17,0,15,27,"10-5","N","N","N",3,1,13
"1812","F1",2023-11-26,"Rennes","Reims",3,1,"H",1,1,"D",2,3.63,3.85,"1-1","3-1",10,5,15,5,2,2,0,0,1,8,10,18,4,9,28,"1-8","Y","Y","Y",4,0,13
"1813","F1",2023-11-26,"Lyon","Lille",0,2,"A",0,2,"A",3.1,3.28,2.47,"0-2","0-2",11,5,15,8,2,2,0,0,3,5,17,5,2,8,22,"3-5","Y","N","N",4,0,13
"1814","F1",2023-11-29,"Montpellier","Clermont",1,1,"D",0,1,"A",1.95,3.66,4,"0-1","1-1",32,10,5,1,3,4,0,0,8,0,23,14,2,8,37,"8-0","Y","N","N",7,0,13
"1815","F1",2023-12-01,"Reims","Strasbourg",2,1,"H",2,0,"H",1.76,3.87,4.93,"2-0","2-1",13,4,10,3,1,1,0,0,4,5,7,7,3,9,14,"4-5","Y","Y","N",2,0,13
"1816","F1",2023-12-02,"Lens","Lyon",3,2,"H",1,1,"D",1.7,4.14,4.81,"1-1","3-2",10,7,12,7,2,0,1,0,3,6,11,14,5,9,25,"3-6","Y","Y","Y",2,1,13
"1817","F1",2023-12-02,"Nantes","Nice",1,0,"H",1,0,"H",4.03,3.38,2.04,"1-0","1-0",13,4,13,6,3,0,0,0,5,6,15,18,1,11,33,"5-6","N","N","N",3,0,14
"1818","F1",2023-12-03,"Le Havre","Paris SG",0,2,"A",0,1,"A",9.54,5.88,1.31,"0-1","0-2",22,7,9,5,2,1,0,1,9,2,11,9,2,11,20,"9-2","Y","N","N",3,1,14
"1819","F1",2023-12-03,"Brest","Clermont",3,0,"H",2,0,"H",1.8,3.79,4.62,"2-0","3-0",12,7,10,1,1,2,0,0,4,2,11,17,3,6,28,"4-2","Y","Y","N",3,0,14
"1820","F1",2023-12-03,"Monaco","Montpellier",2,0,"H",1,0,"H",1.66,4.47,4.74,"1-0","2-0",27,9,9,4,2,3,0,1,8,2,15,13,2,10,28,"8-2","Y","N","N",5,1,14
"1821","F1",2023-12-03,"Toulouse","Lorient",1,1,"D",0,0,"D",2.03,3.53,3.86,"0-0","1-1",11,6,11,5,2,4,0,0,3,4,16,10,2,7,26,"3-4","Y","N","N",6,0,14
"1822","F1",2023-12-03,"Lille","Metz",2,0,"H",2,0,"H",1.45,4.82,7.11,"2-0","2-0",16,6,7,4,0,0,0,0,6,1,8,11,2,7,19,"6-1","Y","N","N",0,0,14
"1823","F1",2023-12-03,"Marseille","Rennes",2,0,"H",1,0,"H",1.92,3.84,3.95,"1-0","2-0",5,2,10,0,1,3,1,1,1,6,9,15,2,7,24,"1-6","Y","N","N",4,2,14
"1824","F1",2023-12-06,"Marseille","Lyon",3,0,"H",2,0,"H",1.71,3.94,5.06,"2-0","3-0",12,5,6,1,1,2,0,0,10,3,14,11,3,13,25,"10-3","Y","Y","N",3,0,14
"1825","F1",2023-12-07,"Brest","Strasbourg",1,1,"D",1,0,"H",1.83,3.68,4.61,"1-0","1-1",13,3,9,5,1,0,0,0,6,0,11,18,2,6,29,"6-0","Y","N","N",1,0,14
"1826","F2",2023-08-05,"St Etienne","Grenoble",0,1,"A",0,0,"D",1.65,3.78,6.05,"0-0","0-1",17,4,13,5,2,1,0,0,6,1,14,12,1,7,26,"6-1","N","N","N",3,0,1
"1827","F2",2023-08-05,"Ajaccio","Rodez",1,1,"D",1,1,"D",1.96,3.22,4.69,"1-1","1-1",19,6,8,3,1,3,0,0,7,4,9,12,2,11,21,"7-4","Y","N","N",4,0,1
"1828","F2",2023-08-05,"Amiens","Quevilly Rouen",1,0,"H",0,0,"D",2.59,3.46,2.79,"0-0","1-0",5,2,6,2,1,1,0,0,9,2,12,17,1,11,29,"9-2","N","N","N",2,0,1
"1829","F2",2023-08-05,"Annecy","Guingamp",1,4,"A",1,0,"H",3.6,3.41,2.16,"1-0","1-4",11,4,15,8,2,0,0,0,3,2,13,12,5,5,25,"3-2","Y","Y","Y",2,0,1
"1830","F2",2023-08-05,"Concarneau","Bastia",0,0,"D",0,0,"D",3.11,3.22,2.49,"0-0","0-0",13,3,8,1,0,3,0,0,5,6,7,17,0,11,24,"5-6","N","N","N",3,0,1
"1831","F2",2023-08-05,"Dunkerque","Troyes",2,2,"D",1,2,"A",2.82,3.14,2.78,"1-2","2-2",16,5,14,7,2,1,0,0,4,4,16,6,4,8,22,"4-4","Y","Y","Y",3,0,1
"1832","F2",2023-08-05,"Laval","Angers",1,0,"H",0,0,"D",2.67,3.29,2.82,"0-0","1-0",13,5,6,2,1,3,0,0,3,4,7,11,1,7,18,"3-4","N","N","N",4,0,1
"1833","F2",2023-08-05,"Paris FC","Caen",0,2,"A",0,1,"A",2.91,3.2,2.66,"0-1","0-2",2,0,12,5,2,2,1,0,2,6,12,13,2,8,25,"2-6","Y","N","N",4,1,1
"1834","F2",2023-08-05,"Valenciennes","Auxerre",1,4,"A",1,1,"D",3.97,3.4,2.05,"1-1","1-4",12,5,19,6,1,1,0,0,6,7,10,15,5,13,25,"6-7","Y","Y","Y",2,0,1
"1835","F2",2023-08-07,"Pau FC","Bordeaux",3,0,"H",2,0,"H",3.83,3.51,2,"2-0","3-0",7,4,15,6,2,0,0,0,2,8,21,8,3,10,29,"2-8","Y","Y","N",2,0,1
"1836","F2",2023-08-12,"Rodez","St Etienne",2,1,"H",1,0,"H",3.78,3.7,1.97,"1-0","2-1",21,7,15,8,0,2,0,0,10,2,7,11,3,12,18,"10-2","Y","Y","N",2,0,2
"1837","F2",2023-08-12,"Angers","Annecy",0,0,"D",0,0,"D",1.72,3.76,5.29,"0-0","0-0",12,1,5,2,2,2,0,0,8,3,17,13,0,11,30,"8-3","N","N","N",4,0,2
"1838","F2",2023-08-12,"Auxerre","Amiens",0,1,"A",0,0,"D",1.7,3.77,5.44,"0-0","0-1",15,0,7,1,0,1,0,0,6,5,8,11,1,11,19,"6-5","N","N","N",1,0,2
"1839","F2",2023-08-12,"Bastia","Valenciennes",3,0,"H",1,0,"H",1.81,3.56,4.95,"1-0","3-0",15,7,3,1,0,2,0,0,5,5,12,13,3,10,25,"5-5","Y","Y","N",2,0,2
"1840","F2",2023-08-12,"Caen","Pau FC",2,0,"H",2,0,"H",1.7,3.74,5.54,"2-0","2-0",23,5,7,2,0,2,0,1,8,3,10,16,2,11,26,"8-3","Y","N","N",2,1,2
"1841","F2",2023-08-12,"Grenoble","Paris FC",2,0,"H",0,0,"D",2.45,3.21,3.19,"0-0","2-0",11,7,3,3,1,2,0,1,5,6,9,10,2,11,19,"5-6","Y","N","N",3,1,2
"1842","F2",2023-08-12,"Guingamp","Dunkerque",0,1,"A",0,0,"D",1.93,3.56,4.21,"0-0","0-1",16,3,9,5,4,3,0,0,7,1,13,18,1,8,31,"7-1","N","N","N",7,0,2
"1843","F2",2023-08-12,"Quevilly Rouen","Ajaccio",0,1,"A",0,1,"A",2.57,3.08,3.14,"0-1","0-1",4,2,3,3,2,1,0,0,3,0,19,13,1,3,32,"3-0","N","N","N",3,0,2
"1844","F2",2023-08-12,"Troyes","Laval",3,1,"H",2,0,"H",2.09,3.55,3.64,"2-0","3-1",9,6,19,3,1,1,0,0,5,7,5,20,4,12,25,"5-7","Y","Y","Y",2,0,2
"1845","F2",2023-08-14,"Bordeaux","Concarneau",1,0,"H",0,0,"D",1.67,4.09,4.86,"0-0","1-0",16,5,10,4,2,1,0,0,8,5,16,10,1,13,26,"8-5","N","N","N",3,0,2
"1846","F2",2023-08-19,"Angers","Auxerre",2,2,"D",1,1,"D",2.8,3.39,2.63,"1-1","2-2",12,5,13,5,3,0,0,1,3,3,22,8,4,6,30,"3-3","Y","Y","Y",3,1,3
"1847","F2",2023-08-19,"Amiens","Bastia",2,1,"H",1,1,"D",2.6,3.16,3.02,"1-1","2-1",17,6,11,4,3,2,0,1,12,2,9,17,3,14,26,"12-2","Y","Y","N",5,1,3
"1848","F2",2023-08-19,"Annecy","Dunkerque",3,0,"H",0,0,"D",2.82,3.23,2.71,"0-0","3-0",11,4,4,2,3,1,0,0,4,3,11,9,3,7,20,"4-3","Y","Y","N",4,0,3
"1849","F2",2023-08-19,"Concarneau","Caen",0,2,"A",0,0,"D",3.4,3.45,2.23,"0-0","0-2",14,4,11,3,1,1,0,0,2,2,15,8,2,4,23,"2-2","Y","N","N",2,0,3
"1850","F2",2023-08-19,"Grenoble","Troyes",0,0,"D",0,0,"D",2.48,3.31,3.06,"0-0","0-0",18,7,6,1,1,1,0,1,14,5,13,13,0,19,26,"14-5","N","N","N",2,1,3
"1851","F2",2023-08-19,"Laval","Rodez",1,0,"H",0,0,"D",2.07,3.4,3.87,"0-0","1-0",9,4,7,1,2,0,0,0,2,3,11,13,1,5,24,"2-3","N","N","N",2,0,3
"1852","F2",2023-08-19,"Pau FC","Paris FC",2,0,"H",1,0,"H",2.52,3.27,3.02,"1-0","2-0",9,3,14,5,2,1,0,0,1,2,13,10,2,3,23,"1-2","Y","N","N",3,0,3
"1853","F2",2023-08-19,"St Etienne","Quevilly Rouen",2,1,"H",2,0,"H",1.75,3.93,4.8,"2-0","2-1",5,2,10,1,0,3,0,0,3,5,8,18,3,8,26,"3-5","Y","Y","N",3,0,3
"1854","F2",2023-08-19,"Valenciennes","Guingamp",0,0,"D",0,0,"D",3.43,3.33,2.26,"0-0","0-0",9,3,6,3,3,2,0,0,3,7,12,15,0,10,27,"3-7","N","N","N",5,0,3
"1855","F2",2023-08-21,"Ajaccio","Bordeaux",0,0,"D",0,0,"D",2.8,3.11,2.74,"0-0","0-0",9,2,15,4,4,3,1,0,1,4,11,8,0,5,19,"1-4","N","N","N",7,1,3
"1856","F2",2023-08-26,"Bordeaux","Amiens",2,0,"H",0,0,"D",1.81,3.79,4.55,"0-0","2-0",17,7,12,2,5,1,0,0,6,5,12,7,2,11,19,"6-5","Y","N","N",6,0,4
"1857","F2",2023-08-26,"Auxerre","Grenoble",0,0,"D",0,0,"D",1.86,3.66,4.43,"0-0","0-0",15,2,7,4,2,2,0,0,4,3,11,16,0,7,27,"4-3","N","N","N",4,0,4
"1858","F2",2023-08-26,"Bastia","Troyes",3,2,"H",0,2,"A",2,3.61,3.87,"0-2","3-2",24,6,9,6,2,1,1,1,6,2,18,15,5,8,33,"6-2","Y","Y","Y",3,2,4
"1859","F2",2023-08-26,"Caen","Ajaccio",3,0,"H",2,0,"H",1.85,3.35,5.02,"2-0","3-0",10,4,5,2,1,2,0,0,7,4,5,10,3,11,15,"7-4","Y","Y","N",3,0,4
"1860","F2",2023-08-26,"Dunkerque","Angers",0,1,"A",0,0,"D",2.83,3.35,2.62,"0-0","0-1",14,9,7,3,3,2,0,0,3,4,10,13,1,7,23,"3-4","N","N","N",5,0,4
"1861","F2",2023-08-26,"Guingamp","Pau FC",4,0,"H",2,0,"H",1.93,3.46,4.42,"2-0","4-0",23,9,13,6,3,2,0,0,6,2,17,14,4,8,31,"6-2","Y","Y","Y",5,0,4
"1862","F2",2023-08-26,"Paris FC","Concarneau",3,0,"H",1,0,"H",2.46,3.31,3.08,"1-0","3-0",13,6,13,4,1,0,0,0,3,8,14,14,3,11,28,"3-8","Y","Y","N",1,0,4
"1863","F2",2023-08-26,"Quevilly Rouen","Laval",0,0,"D",0,0,"D",2.31,3.27,3.39,"0-0","0-0",7,2,11,2,1,1,0,0,4,6,15,16,0,10,31,"4-6","N","N","N",2,0,4
"1864","F2",2023-08-26,"Rodez","Valenciennes",0,1,"A",0,1,"A",1.99,3.2,4.57,"0-1","0-1",19,7,10,4,2,3,0,0,7,1,8,18,1,8,26,"7-1","N","N","N",5,0,4
"1865","F2",2023-08-28,"Annecy","St Etienne",1,1,"D",1,0,"H",3.58,3.55,2.06,"1-0","1-1",17,5,10,4,2,2,0,0,3,3,15,13,2,6,28,"3-3","Y","N","N",4,0,4
"1866","F2",2023-09-02,"Bordeaux","Auxerre",2,4,"A",1,2,"A",2.07,3.66,3.6,"1-2","2-4",20,9,15,6,2,2,0,0,3,11,8,17,6,14,25,"3-11","Y","Y","Y",4,0,5
"1867","F2",2023-09-02,"Ajaccio","Dunkerque",2,2,"D",0,1,"A",1.91,3.41,4.58,"0-1","2-2",10,3,10,4,3,1,1,0,2,5,14,20,4,7,34,"2-5","Y","Y","Y",4,1,5
"1868","F2",2023-09-02,"Amiens","Guingamp",4,1,"H",1,1,"D",2.4,3.28,3.22,"1-1","4-1",11,7,12,4,1,4,0,0,2,4,16,15,5,6,31,"2-4","Y","Y","Y",5,0,5
"1869","F2",2023-09-02,"Angers","Paris FC",2,0,"H",1,0,"H",2.04,3.4,3.88,"1-0","2-0",11,4,9,3,1,2,0,0,5,4,12,14,2,9,26,"5-4","Y","N","N",3,0,5
"1870","F2",2023-09-02,"Concarneau","Annecy",1,1,"D",0,1,"A",2.26,3.36,3.33,"0-1","1-1",10,2,17,7,5,4,0,1,4,1,10,21,2,5,31,"4-1","Y","N","N",9,1,5
"1871","F2",2023-09-02,"Grenoble","Bastia",0,0,"D",0,0,"D",2.33,3.25,3.38,"0-0","0-0",22,3,11,1,0,1,0,0,8,3,6,14,0,11,20,"8-3","N","N","N",1,0,5
"1872","F2",2023-09-02,"Laval","Caen",2,1,"H",0,0,"D",3.63,3.17,2.26,"0-0","2-1",9,3,5,2,2,3,0,0,3,2,13,9,3,5,22,"3-2","Y","Y","N",5,0,5
"1873","F2",2023-09-02,"Pau FC","Rodez",2,2,"D",2,0,"H",2.84,3.34,2.62,"2-0","2-2",10,3,17,8,4,3,0,0,4,5,17,15,4,9,32,"4-5","Y","Y","Y",7,0,5
"1874","F2",2023-09-02,"St Etienne","Valenciennes",0,0,"D",0,0,"D",1.6,4.22,5.76,"0-0","0-0",11,1,9,3,7,3,0,0,4,4,11,13,0,8,24,"4-4","N","N","N",10,0,5
"1875","F2",2023-09-02,"Troyes","Quevilly Rouen",2,2,"D",0,2,"A",2.33,3.25,3.37,"0-2","2-2",10,4,10,3,2,1,0,0,5,7,14,9,4,12,23,"5-7","Y","Y","Y",3,0,5
"1876","F2",2023-09-16,"Caen","St Etienne",1,2,"A",0,1,"A",1.93,3.78,3.98,"0-1","1-2",14,6,8,3,3,1,0,0,3,1,12,10,3,4,22,"3-1","Y","Y","N",4,0,6
"1877","F2",2023-09-16,"Annecy","Troyes",0,0,"D",0,0,"D",2.45,3.46,2.98,"0-0","0-0",15,0,7,3,1,0,0,0,10,4,9,11,0,14,20,"10-4","N","N","N",1,0,6
"1878","F2",2023-09-16,"Auxerre","Pau FC",2,2,"D",1,1,"D",1.5,4.47,6.8,"1-1","2-2",24,6,6,4,2,3,0,0,13,4,10,3,4,17,13,"13-4","Y","Y","Y",5,0,6
"1879","F2",2023-09-16,"Bastia","Laval",0,3,"A",0,1,"A",2.19,3.35,3.6,"0-1","0-3",8,3,9,4,2,2,0,0,5,6,14,12,3,11,26,"5-6","Y","Y","N",4,0,6
"1880","F2",2023-09-16,"Dunkerque","Grenoble",0,0,"D",0,0,"D",2.81,3.23,2.72,"0-0","0-0",5,4,18,5,2,2,1,0,3,6,13,9,0,9,22,"3-6","N","N","N",4,1,6
"1881","F2",2023-09-16,"Paris FC","Amiens",3,0,"H",2,0,"H",2.78,3.31,2.7,"2-0","3-0",12,3,13,3,2,2,0,0,3,8,11,17,3,11,28,"3-8","Y","Y","N",4,0,6
"1882","F2",2023-09-16,"Quevilly Rouen","Concarneau",2,3,"A",0,3,"A",1.94,3.46,4.18,"0-3","2-3",23,8,9,6,1,1,0,0,7,1,18,12,5,8,30,"7-1","Y","Y","Y",2,0,6
"1883","F2",2023-09-16,"Rodez","Angers",4,1,"H",0,1,"A",2.96,3.19,2.62,"0-1","4-1",13,5,9,3,2,2,0,0,3,4,12,13,5,7,25,"3-4","Y","Y","Y",4,0,6
"1884","F2",2023-09-16,"Valenciennes","Bordeaux",1,2,"A",0,1,"A",4.26,3.66,1.89,"0-1","1-2",11,3,13,5,3,2,0,0,3,5,7,17,3,8,24,"3-5","Y","Y","N",5,0,6
"1885","F2",2023-09-18,"Guingamp","Ajaccio",3,0,"H",2,0,"H",2.27,3.19,3.45,"2-0","3-0",12,5,15,4,0,1,0,0,3,6,15,9,3,9,24,"3-6","Y","Y","N",1,0,6
"1886","F2",2023-09-23,"Troyes","Auxerre",1,2,"A",0,1,"A",3.45,3.74,2.1,"0-1","1-2",10,4,19,5,2,2,0,0,3,14,20,12,3,17,32,"3-14","Y","Y","N",4,0,7
"1887","F2",2023-09-23,"Ajaccio","Paris FC",2,1,"H",0,0,"D",1.97,3.41,4.26,"0-0","2-1",11,4,6,1,2,2,0,0,4,4,14,11,3,8,25,"4-4","Y","Y","N",4,0,7
"1888","F2",2023-09-23,"Amiens","Valenciennes",0,0,"D",0,0,"D",1.7,3.79,5.38,"0-0","0-0",12,4,8,3,3,3,0,0,4,5,21,19,0,9,40,"4-5","N","N","N",6,0,7
"1889","F2",2023-09-23,"Angers","Bastia",2,0,"H",1,0,"H",1.98,3.48,3.99,"1-0","2-0",10,7,9,3,1,3,0,1,9,3,13,10,2,12,23,"9-3","Y","N","N",4,1,7
"1890","F2",2023-09-23,"Concarneau","St Etienne",0,1,"A",0,0,"D",3.2,3.47,2.31,"0-0","0-1",9,3,16,4,1,1,0,0,5,9,13,11,1,14,24,"5-9","N","N","N",2,0,7
"1891","F2",2023-09-23,"Dunkerque","Rodez",1,2,"A",0,1,"A",2.56,3,3.17,"0-1","1-2",15,3,14,5,1,2,0,0,6,2,10,12,3,8,22,"6-2","Y","Y","N",3,0,7
"1892","F2",2023-09-23,"Grenoble","Quevilly Rouen",2,1,"H",1,1,"D",2.49,3.28,3.07,"1-1","2-1",10,4,11,5,1,2,0,0,4,1,9,11,3,5,20,"4-1","Y","Y","N",3,0,7
"1893","F2",2023-09-23,"Laval","Guingamp",2,1,"H",0,0,"D",2.62,3.09,3.06,"0-0","2-1",15,6,13,6,1,2,0,0,6,3,19,13,3,9,32,"6-3","Y","Y","N",3,0,7
"1894","F2",2023-09-23,"Pau FC","Annecy",0,3,"A",0,2,"A",2.9,3.21,2.65,"0-2","0-3",12,4,9,5,5,1,0,0,7,4,17,16,3,11,33,"7-4","Y","Y","N",6,0,7
"1895","F2",2023-09-26,"Amiens","Ajaccio",0,0,"D",0,0,"D",2.11,3.24,4,"0-0","0-0",7,0,6,2,2,5,0,0,3,3,16,27,0,6,43,"3-3","N","N","N",7,0,7
"1896","F2",2023-09-26,"Auxerre","Annecy",4,0,"H",2,0,"H",1.57,4.17,6.13,"2-0","4-0",11,5,5,1,0,1,0,0,3,5,7,15,4,8,22,"3-5","Y","Y","Y",1,0,8
"1897","F2",2023-09-26,"Bastia","Pau FC",1,4,"A",0,1,"A",1.72,3.87,5.08,"0-1","1-4",10,2,17,10,2,3,1,0,10,3,7,12,5,13,19,"10-3","Y","Y","Y",5,1,8
"1898","F2",2023-09-26,"Caen","Grenoble",1,2,"A",1,0,"H",1.94,3.47,4.33,"1-0","1-2",10,1,10,4,0,3,0,0,3,3,10,17,3,6,27,"3-3","Y","Y","N",3,0,8
"1899","F2",2023-09-26,"Guingamp","Bordeaux",0,0,"D",0,0,"D",2.91,3.19,2.66,"0-0","0-0",11,2,14,3,1,1,0,0,2,4,12,16,0,6,28,"2-4","N","N","N",2,0,8
"1900","F2",2023-09-26,"Paris FC","Laval",0,1,"A",0,0,"D",2.89,3.02,2.82,"0-0","0-1",15,4,11,2,1,1,0,0,9,3,13,11,1,12,24,"9-3","N","N","N",2,0,8
"1901","F2",2023-09-26,"Quevilly Rouen","Angers",0,1,"A",0,1,"A",2.84,3.13,2.77,"0-1","0-1",12,1,6,3,3,4,1,0,2,5,15,17,1,7,32,"2-5","N","N","N",7,1,8
"1902","F2",2023-09-26,"Rodez","Troyes",2,1,"H",0,0,"D",1.96,3.78,3.83,"0-0","2-1",19,5,7,3,1,2,0,0,8,3,11,11,3,11,22,"8-3","Y","Y","N",3,0,8
"1903","F2",2023-09-26,"Valenciennes","Concarneau",0,1,"A",0,1,"A",2.44,3.15,3.26,"0-1","0-1",19,2,9,3,3,4,0,0,4,8,22,20,1,12,42,"4-8","N","N","N",7,0,8
"1904","F2",2023-09-30,"Troyes","St Etienne",0,1,"A",0,0,"D",3.51,3.68,2.09,"0-0","0-1",20,4,11,5,1,1,0,0,11,4,9,6,1,15,15,"11-4","N","N","N",2,0,8
"1905","F2",2023-09-30,"Angers","Concarneau",2,0,"H",0,0,"D",1.74,3.62,5.41,"0-0","2-0",14,7,11,6,1,2,0,0,12,5,12,9,2,17,21,"12-5","Y","N","N",3,0,8
"1906","F2",2023-09-30,"Annecy","Paris FC",2,2,"D",1,0,"H",2.38,3.16,3.36,"1-0","2-2",9,5,11,2,4,2,0,0,7,6,15,7,4,13,22,"7-6","Y","Y","Y",6,0,9
"1907","F2",2023-09-30,"Auxerre","Rodez",3,1,"H",1,0,"H",1.57,4.36,5.76,"1-0","3-1",15,4,7,1,1,3,0,0,5,7,12,9,4,12,21,"5-7","Y","Y","Y",4,0,9
"1908","F2",2023-09-30,"Caen","Guingamp",0,1,"A",0,0,"D",2.03,3.4,4.04,"0-0","0-1",7,1,14,7,1,2,0,0,6,5,17,21,1,11,38,"6-5","N","N","N",3,0,9
"1909","F2",2023-09-30,"Dunkerque","Quevilly Rouen",0,1,"A",0,0,"D",2.48,3.23,3.12,"0-0","0-1",11,3,16,6,0,0,0,0,9,12,8,14,1,21,22,"9-12","N","N","N",0,0,9
"1910","F2",2023-09-30,"Grenoble","Bordeaux",2,0,"H",1,0,"H",2.73,3.17,2.84,"1-0","2-0",10,8,15,4,2,2,0,0,2,8,16,10,2,10,26,"2-8","Y","N","N",4,0,9
"1911","F2",2023-09-30,"Laval","Valenciennes",1,0,"H",0,0,"D",1.78,3.56,5.18,"0-0","1-0",17,8,7,2,1,1,0,0,4,4,19,14,1,8,33,"4-4","N","N","N",2,0,9
"1912","F2",2023-09-30,"Pau FC","Amiens",1,0,"H",1,0,"H",2.96,3.37,2.51,"1-0","1-0",15,6,14,7,2,0,0,0,4,3,14,15,1,7,29,"4-3","N","N","N",2,0,9
"1913","F2",2023-10-02,"Ajaccio","Bastia",2,0,"H",0,0,"D",2.33,3.08,3.44,"0-0","2-0",11,3,7,2,0,1,0,1,4,3,8,11,2,7,19,"4-3","Y","N","N",1,1,9
"1914","F2",2023-10-03,"Bordeaux","Caen",1,1,"D",1,1,"D",2.14,3.5,3.56,"1-1","1-1",19,8,7,2,3,1,0,0,4,4,17,16,2,8,33,"4-4","Y","N","N",4,0,9
"1915","F2",2023-10-04,"St Etienne","Dunkerque",2,0,"H",0,0,"D",1.68,4.12,5.02,"0-0","2-0",20,4,15,4,1,3,0,0,9,6,10,17,2,15,27,"9-6","Y","N","N",4,0,9
"1916","F2",2023-10-07,"Bordeaux","Laval",0,1,"A",0,1,"A",1.88,3.57,4.48,"0-1","0-1",18,5,7,3,1,3,0,0,7,4,12,22,1,11,34,"7-4","N","N","N",4,0,10
"1917","F2",2023-10-07,"Amiens","Angers",1,4,"A",1,2,"A",2.46,3.19,3.19,"1-2","1-4",17,7,15,6,4,4,1,1,11,3,22,13,5,14,35,"11-3","Y","Y","Y",8,2,10
"1918","F2",2023-10-07,"Bastia","Annecy",2,1,"H",0,0,"D",2.02,3.46,3.98,"0-0","2-1",6,2,9,2,3,3,0,0,4,4,7,13,3,8,20,"4-4","Y","Y","N",6,0,10
"1919","F2",2023-10-07,"Concarneau","Dunkerque",4,3,"H",1,2,"A",2.4,3.33,3.16,"1-2","4-3",13,6,12,3,2,4,0,0,3,2,9,20,7,5,29,"3-2","Y","Y","Y",6,0,10
"1920","F2",2023-10-07,"Guingamp","Grenoble",2,2,"D",2,1,"H",2.29,3.35,3.36,"2-1","2-2",13,8,6,2,0,1,0,0,6,3,17,16,4,9,33,"6-3","Y","Y","Y",1,0,10
"1921","F2",2023-10-07,"Paris FC","Auxerre",0,2,"A",0,1,"A",3.82,3.66,2,"0-1","0-2",18,3,7,4,2,0,0,0,10,2,12,14,2,12,26,"10-2","Y","N","N",2,0,10
"1922","F2",2023-10-07,"Quevilly Rouen","Pau FC",2,2,"D",1,1,"D",1.89,3.7,4.25,"1-1","2-2",19,4,4,2,1,3,0,1,3,0,17,14,4,3,31,"3-0","Y","Y","Y",4,1,10
"1923","F2",2023-10-07,"Rodez","Caen",5,3,"H",2,3,"A",3.02,3.2,2.52,"2-3","5-3",19,8,11,4,3,3,0,0,6,7,17,12,8,13,29,"6-7","Y","Y","Y",6,0,10
"1924","F2",2023-10-07,"St Etienne","Ajaccio",0,0,"D",0,0,"D",2.04,3.34,4.1,"0-0","0-0",8,1,5,2,2,2,0,0,4,3,15,16,0,7,31,"4-3","N","N","N",4,0,10
"1925","F2",2023-10-07,"Valenciennes","Troyes",1,1,"D",0,1,"A",2.65,3.08,3.02,"0-1","1-1",21,7,4,2,3,3,0,0,7,2,10,18,2,9,28,"7-2","Y","N","N",6,0,10
"1926","F2",2023-10-21,"Caen","Auxerre",1,1,"D",0,1,"A",3.21,3.66,2.23,"0-1","1-1",9,1,15,6,1,1,0,0,3,8,8,14,2,11,22,"3-8","Y","N","N",2,0,11
"1927","F2",2023-10-21,"Ajaccio","Pau FC",2,0,"H",0,0,"D",1.79,3.6,5.04,"0-0","2-0",11,3,4,1,0,2,0,0,1,4,10,13,2,5,23,"1-4","Y","N","N",2,0,11
"1928","F2",2023-10-21,"Angers","Bordeaux",2,0,"H",1,0,"H",2.56,3.32,2.93,"1-0","2-0",9,4,16,5,0,0,0,0,2,6,6,9,2,8,15,"2-6","Y","N","N",0,0,11
"1929","F2",2023-10-21,"Annecy","Amiens",1,1,"D",1,1,"D",2.85,3.16,2.74,"1-1","1-1",8,3,10,5,2,2,0,0,1,2,19,22,2,3,41,"1-2","Y","N","N",4,0,11
"1930","F2",2023-10-21,"Dunkerque","Paris FC",1,3,"A",0,1,"A",2.58,3.3,2.92,"0-1","1-3",13,4,15,5,2,0,0,0,7,3,18,8,4,10,26,"7-3","Y","Y","Y",2,0,11
"1931","F2",2023-10-21,"Grenoble","Valenciennes",3,3,"D",2,1,"H",1.98,3.3,4.38,"2-1","3-3",13,7,10,7,2,3,0,0,2,2,10,15,6,4,25,"2-2","Y","Y","Y",5,0,11
"1932","F2",2023-10-21,"Guingamp","Quevilly Rouen",2,2,"D",1,1,"D",1.94,3.53,4.23,"1-1","2-2",8,4,13,5,1,1,0,0,3,7,11,12,4,10,23,"3-7","Y","Y","Y",2,0,11
"1933","F2",2023-10-21,"Rodez","Bastia",1,1,"D",0,1,"A",2,3.44,4.08,"0-1","1-1",26,8,6,1,1,2,0,0,10,6,10,21,2,16,31,"10-6","Y","N","N",3,0,11
"1934","F2",2023-10-21,"Troyes","Concarneau",0,0,"D",0,0,"D",2.11,3.52,3.64,"0-0","0-0",8,3,21,5,2,2,1,0,1,6,6,18,0,7,24,"1-6","N","N","N",4,1,11
"1935","F2",2023-10-23,"Laval","St Etienne",0,1,"A",0,1,"A",2.62,3.17,2.88,"0-1","0-1",13,1,6,2,1,1,0,0,4,6,12,6,1,10,18,"4-6","N","N","N",2,0,11
"1936","F2",2023-10-28,"Bordeaux","Rodez",2,2,"D",2,1,"H",1.72,3.92,4.99,"2-1","2-2",11,6,9,3,4,2,1,1,3,4,12,12,4,7,24,"3-4","Y","Y","Y",6,2,12
"1937","F2",2023-10-28,"Amiens","Laval",0,0,"D",0,0,"D",2.53,3.08,3.2,"0-0","0-0",8,4,10,5,2,1,0,0,2,5,13,12,0,7,25,"2-5","N","N","N",3,0,12
"1938","F2",2023-10-28,"Auxerre","Dunkerque",0,1,"A",0,0,"D",1.42,4.93,7.65,"0-0","0-1",24,6,8,2,1,3,0,0,12,6,10,10,1,18,20,"12-6","N","N","N",4,0,12
"1939","F2",2023-10-28,"Bastia","Guingamp",0,0,"D",0,0,"D",2.9,3.35,2.57,"0-0","0-0",6,1,10,2,1,4,0,1,8,3,11,17,0,11,28,"8-3","N","N","N",5,1,12
"1940","F2",2023-10-28,"Concarneau","Ajaccio",2,1,"H",0,0,"D",3.02,3.06,2.62,"0-0","2-1",4,2,16,5,0,1,0,0,5,7,9,16,3,12,25,"5-7","Y","Y","N",1,0,12
"1941","F2",2023-10-28,"Paris FC","Troyes",2,2,"D",0,0,"D",1.98,3.65,3.92,"0-0","2-2",15,3,8,3,1,0,0,0,6,3,7,9,4,9,16,"6-3","Y","Y","Y",1,0,12
"1942","F2",2023-10-28,"Pau FC","Grenoble",3,2,"H",1,1,"D",3.33,3.42,2.23,"1-1","3-2",15,7,7,4,2,2,0,0,5,4,18,11,5,9,29,"5-4","Y","Y","Y",4,0,12
"1943","F2",2023-10-28,"Quevilly Rouen","Annecy",1,2,"A",1,1,"D",2.06,3.48,3.82,"1-1","1-2",19,6,8,3,2,2,0,0,6,8,9,11,3,14,20,"6-8","Y","Y","N",4,0,12
"1944","F2",2023-10-28,"Valenciennes","Caen",2,2,"D",2,0,"H",2.96,3.32,2.54,"2-0","2-2",9,4,14,4,0,2,0,0,5,7,14,8,4,12,22,"5-7","Y","Y","Y",2,0,12
"1945","F2",2023-10-30,"St Etienne","Angers",2,0,"H",0,0,"D",2.56,3.24,2.9,"0-0","2-0",20,10,14,3,2,1,0,0,5,11,15,8,2,16,23,"5-11","Y","N","N",3,0,12
"1946","F2",2023-11-04,"St Etienne","Paris FC",0,1,"A",0,0,"D",1.98,3.59,3.88,"0-0","0-1",11,1,15,5,0,3,0,0,9,8,8,14,1,17,22,"9-8","N","N","N",3,0,13
"1947","F2",2023-11-04,"Angers","Valenciennes",2,0,"H",2,0,"H",1.63,3.92,5.69,"2-0","2-0",9,6,5,2,5,3,0,0,8,1,15,11,2,9,26,"8-1","Y","N","N",8,0,13
"1948","F2",2023-11-04,"Annecy","Laval",1,3,"A",1,1,"D",3.07,3.08,2.61,"1-1","1-3",5,1,9,3,0,2,1,1,4,8,9,13,4,12,22,"4-8","Y","Y","Y",2,2,13
"1949","F2",2023-11-04,"Bastia","Bordeaux",3,1,"H",2,0,"H",3.61,3.47,2.14,"2-0","3-1",16,7,10,2,3,1,0,0,1,5,21,13,4,6,34,"1-5","Y","Y","Y",4,0,13
"1950","F2",2023-11-04,"Dunkerque","Amiens",0,1,"A",0,1,"A",2.99,3.11,2.65,"0-1","0-1",18,5,5,2,0,4,0,0,7,5,7,11,1,12,18,"7-5","N","N","N",4,0,13
"1951","F2",2023-11-04,"Grenoble","Ajaccio",0,3,"A",0,2,"A",2.19,3.06,3.99,"0-2","0-3",12,5,6,3,1,3,0,0,5,0,10,11,3,5,21,"5-0","Y","Y","N",4,0,13
"1952","F2",2023-11-04,"Quevilly Rouen","Rodez",3,1,"H",2,1,"H",2.28,3.46,3.28,"2-1","3-1",12,4,5,3,2,0,0,0,6,4,17,11,4,10,28,"6-4","Y","Y","Y",2,0,13
"1953","F2",2023-11-04,"Troyes","Caen",2,1,"H",1,0,"H",2.82,3.46,2.57,"1-0","2-1",8,4,22,5,4,1,0,0,0,11,15,12,3,11,27,"0-11","Y","Y","N",5,0,13
"1954","F2",2023-11-06,"Guingamp","Auxerre",2,1,"H",0,0,"D",3.33,3.39,2.22,"0-0","2-1",8,1,14,4,6,3,1,1,4,4,14,15,3,8,29,"4-4","Y","Y","N",9,2,13
"1955","F2",2023-11-11,"Bordeaux","Annecy",3,1,"H",2,1,"H",1.59,4.17,5.9,"2-1","3-1",11,7,9,3,1,2,0,0,3,5,9,21,4,8,30,"3-5","Y","Y","Y",3,0,13
"1956","F2",2023-11-11,"Ajaccio","Troyes",1,0,"H",1,0,"H",1.89,3.43,4.65,"1-0","1-0",7,3,3,1,2,1,0,0,1,2,13,17,1,3,30,"1-2","N","N","N",3,0,14
"1957","F2",2023-11-11,"Amiens","Grenoble",1,2,"A",1,1,"D",2.55,3.07,3.18,"1-1","1-2",10,4,6,4,1,2,0,0,1,4,9,12,3,5,21,"1-4","Y","Y","N",3,0,14
"1958","F2",2023-11-11,"Auxerre","St Etienne",5,2,"H",3,1,"H",1.82,3.83,4.46,"3-1","5-2",14,7,14,8,1,2,0,0,1,2,14,11,7,3,25,"1-2","Y","Y","Y",3,0,14
"1959","F2",2023-11-11,"Caen","Quevilly Rouen",3,3,"D",2,2,"D",2.3,3.45,3.24,"2-2","3-3",16,5,9,6,1,2,0,1,4,3,13,17,6,7,30,"4-3","Y","Y","Y",3,1,14
"1960","F2",2023-11-11,"Laval","Concarneau",0,3,"A",0,1,"A",1.77,3.6,5.18,"0-1","0-3",10,5,10,6,4,1,1,0,7,3,26,9,3,10,35,"7-3","Y","Y","N",5,1,14
"1961","F2",2023-11-11,"Paris FC","Bastia",1,0,"H",1,0,"H",2.01,3.57,3.88,"1-0","1-0",11,3,11,4,1,1,0,1,5,5,12,23,1,10,35,"5-5","N","N","N",2,1,14
"1962","F2",2023-11-11,"Pau FC","Angers",4,4,"D",2,1,"H",3.57,3.38,2.19,"2-1","4-4",12,6,7,5,3,0,0,0,6,7,16,8,8,13,24,"6-7","Y","Y","Y",3,0,14
"1963","F2",2023-11-11,"Rodez","Guingamp",0,0,"D",0,0,"D",2.5,3.29,3.04,"0-0","0-0",6,0,13,2,0,1,0,0,6,7,11,13,0,13,24,"6-7","N","N","N",1,0,14
"1964","F2",2023-11-11,"Valenciennes","Dunkerque",0,1,"A",0,0,"D",2.37,3.33,3.21,"0-0","0-1",13,4,11,3,4,3,0,0,4,7,14,22,1,11,36,"4-7","N","N","N",7,0,14
"1965","F2",2023-11-25,"St Etienne","Pau FC",1,2,"A",1,0,"H",1.66,4.03,4.87,"1-0","1-2",14,3,11,4,3,3,0,0,9,5,19,14,3,14,33,"9-5","Y","Y","N",6,0,14
"1966","F2",2023-11-25,"Amiens","Concarneau",1,1,"D",1,1,"D",2.02,3.39,4.07,"1-1","1-1",19,6,6,1,2,0,0,0,6,2,15,7,2,8,22,"6-2","Y","N","N",2,0,15
"1967","F2",2023-11-25,"Annecy","Ajaccio",2,0,"H",1,0,"H",2.96,2.87,2.8,"1-0","2-0",19,6,6,2,4,2,0,0,6,3,21,13,2,9,34,"6-3","Y","N","N",6,0,15
"1968","F2",2023-11-25,"Bastia","Auxerre",0,0,"D",0,0,"D",4.32,3.97,1.75,"0-0","0-0",6,1,20,7,1,2,0,0,1,7,15,5,0,8,20,"1-7","N","N","N",3,0,15
"1969","F2",2023-11-25,"Dunkerque","Laval",0,2,"A",0,2,"A",3.34,3.24,2.29,"0-2","0-2",11,3,5,3,1,4,0,0,6,2,10,15,2,8,25,"6-2","Y","N","N",5,0,15
"1970","F2",2023-11-25,"Grenoble","Rodez",2,1,"H",1,1,"D",1.92,3.62,4.02,"1-1","2-1",9,6,11,4,1,3,0,0,6,5,7,11,3,11,18,"6-5","Y","Y","N",4,0,15
"1971","F2",2023-11-25,"Paris FC","Bordeaux",1,2,"A",1,1,"D",3.21,3.49,2.24,"1-1","1-2",12,2,11,5,0,0,0,0,9,3,16,7,3,12,23,"9-3","Y","Y","N",0,0,15
"1972","F2",2023-11-25,"Quevilly Rouen","Valenciennes",0,0,"D",0,0,"D",1.68,3.91,5.03,"0-0","0-0",17,4,6,2,2,3,0,1,6,1,18,11,0,7,29,"6-1","N","N","N",5,1,15
"1973","F2",2023-11-25,"Troyes","Guingamp",0,1,"A",0,1,"A",3.53,3.41,2.13,"0-1","0-1",7,2,14,4,1,1,0,0,5,8,8,11,1,13,19,"5-8","N","N","N",2,0,15
"1974","F2",2023-11-27,"Angers","Caen",3,0,"H",1,0,"H",2.16,3.33,3.41,"1-0","3-0",11,6,10,2,1,5,0,1,2,6,13,14,3,8,27,"2-6","Y","Y","N",6,1,15
"1975","F2",2023-11-28,"Concarneau","Pau FC",1,2,"A",0,1,"A",2.23,3.37,3.47,"0-1","1-2",17,6,10,2,4,2,1,1,5,2,12,10,3,7,22,"5-2","Y","Y","N",6,2,15
"1976","F2",2023-12-02,"Bordeaux","Troyes",0,1,"A",0,1,"A",1.45,4.58,6.5,"0-1","0-1",24,4,12,3,3,5,1,0,10,5,16,20,1,15,36,"10-5","N","N","N",8,1,16
"1977","F2",2023-12-02,"Ajaccio","Angers",1,1,"D",1,1,"D",2.65,2.95,3.16,"1-1","1-1",13,5,5,2,3,1,0,0,3,3,11,14,2,6,25,"3-3","Y","N","N",4,0,16
"1978","F2",2023-12-02,"Amiens","St Etienne",1,0,"H",1,0,"H",2.82,3.16,2.61,"1-0","1-0",7,3,15,5,3,1,0,0,2,1,16,10,1,3,26,"2-1","N","N","N",4,0,16
"1979","F2",2023-12-02,"Auxerre","Quevilly Rouen",3,2,"H",1,2,"A",1.64,4.18,5.36,"1-2","3-2",17,3,15,6,1,1,0,0,3,3,10,15,5,6,25,"3-3","Y","Y","Y",2,0,16
"1980","F2",2023-12-02,"Caen","Bastia",1,0,"H",0,0,"D",1.88,3.65,4.32,"0-0","1-0",9,3,10,5,1,3,0,0,5,4,12,21,1,9,33,"5-4","N","N","N",4,0,16
"1981","F2",2023-12-02,"Guingamp","Paris FC",0,1,"A",0,0,"D",2.19,3.31,3.63,"0-0","0-1",7,3,4,1,2,3,0,0,4,2,19,14,1,6,33,"4-2","N","N","N",5,0,16
"1982","F2",2023-12-02,"Laval","Grenoble",1,1,"D",0,0,"D",2.35,3.18,3.42,"0-0","1-1",9,5,7,2,4,1,0,0,2,5,14,9,2,7,23,"2-5","Y","N","N",5,0,16
"1983","F2",2023-12-02,"Pau FC","Dunkerque",1,1,"D",1,0,"H",2.3,3.45,3.25,"1-0","1-1",10,5,8,4,2,2,0,0,3,3,14,13,2,6,27,"3-3","Y","N","N",4,0,16
"1984","F2",2023-12-02,"Rodez","Concarneau",2,0,"H",1,0,"H",1.85,3.68,4.51,"1-0","2-0",16,5,8,2,2,4,0,0,9,4,20,7,2,13,27,"9-4","Y","N","N",6,0,16
"1985","F2",2023-12-02,"Valenciennes","Annecy",0,0,"D",0,0,"D",2.54,3.1,3.16,"0-0","0-0",14,6,18,2,1,2,0,1,4,5,14,15,0,9,29,"4-5","N","N","N",3,1,16
"1986","F2",2023-12-05,"Ajaccio","Laval",2,0,"H",0,0,"D",2.53,2.85,3.49,"0-0","2-0",8,4,6,1,1,2,0,0,2,3,14,19,2,5,33,"2-3","Y","N","N",3,0,17
"1987","F2",2023-12-05,"Angers","Grenoble",1,0,"H",1,0,"H",2.06,3.41,3.93,"1-0","1-0",7,1,15,5,0,0,0,0,3,10,5,11,1,13,16,"3-10","N","N","N",0,0,17
"1988","F2",2023-12-05,"Concarneau","Auxerre",1,2,"A",0,2,"A",4.97,4.14,1.68,"0-2","1-2",13,4,16,7,1,2,0,0,6,5,7,11,3,11,18,"6-5","Y","Y","N",3,0,17
"1989","F2",2023-12-05,"Dunkerque","Bastia",0,5,"A",0,2,"A",2.39,3.11,3.42,"0-2","0-5",8,2,14,8,3,1,0,0,3,6,11,10,5,9,21,"3-6","Y","Y","Y",4,0,17
"1990","F2",2023-12-05,"Paris FC","Rodez",2,0,"H",2,0,"H",2.1,3.47,3.71,"2-0","2-0",9,2,12,5,2,1,0,0,2,8,10,16,2,10,26,"2-8","Y","N","N",3,0,17
"1991","F2",2023-12-05,"Pau FC","Valenciennes",3,1,"H",1,0,"H",1.93,3.5,4.31,"1-0","3-1",14,6,14,7,0,0,0,0,5,3,10,22,4,8,32,"5-3","Y","Y","Y",0,0,17
"1992","F2",2023-12-05,"Quevilly Rouen","Bordeaux",3,2,"H",2,0,"H",2.61,3.28,2.89,"2-0","3-2",24,9,26,6,1,1,0,1,4,6,22,12,5,10,34,"4-6","Y","Y","Y",2,1,17
"1993","F2",2023-12-05,"St Etienne","Guingamp",1,3,"A",1,1,"D",2.39,3.15,3.37,"1-1","1-3",10,3,14,6,2,0,0,0,6,10,21,10,4,16,31,"6-10","Y","Y","Y",2,0,17
"1994","F2",2023-12-05,"Troyes","Amiens",2,0,"H",2,0,"H",2.89,3.18,2.68,"2-0","2-0",9,3,18,3,2,3,0,0,5,9,8,16,2,14,24,"5-9","Y","N","N",5,0,17
"1995","F2",2023-12-06,"Annecy","Caen",1,2,"A",1,0,"H",2.81,3.39,2.62,"1-0","1-2",15,5,13,9,2,1,0,0,5,7,14,15,3,12,29,"5-7","Y","Y","N",3,0,17
"2790","G1",2023-08-18,"Volos NFC","Lamia",2,2,"D",0,0,"D",2.5,3.01,3.2,"0-0","2-2",8,4,13,8,3,2,0,0,7,0,13,16,4,7,29,"7-0","Y","Y","Y",5,0,1
"2791","G1",2023-08-20,"Giannina","Kifisias",3,0,"H",1,0,"H",2.26,2.88,3.93,"1-0","3-0",10,7,4,0,3,4,1,0,7,2,16,19,3,9,35,"7-2","Y","Y","N",7,1,1
"2792","G1",2023-08-20,"OFI Crete","Aris",3,2,"H",2,1,"H",2.45,3.17,3.02,"2-1","3-2",13,4,16,7,5,3,0,0,3,4,25,13,5,7,38,"3-4","Y","Y","Y",8,0,1
"2793","G1",2023-08-20,"PAOK","Asteras Tripolis",3,0,"H",1,0,"H",1.27,5.32,11.14,"1-0","3-0",13,6,9,2,2,1,0,0,3,1,5,12,3,4,17,"3-1","Y","Y","N",3,0,1
"2794","G1",2023-08-20,"Olympiakos","Panserraikos",2,0,"H",0,0,"D",1.17,7.06,14.52,"0-0","2-0",29,3,5,2,3,0,0,1,8,3,19,7,2,11,26,"8-3","Y","N","N",3,1,1
"2795","G1",2023-08-25,"Panetolikos","Giannina",0,0,"D",0,0,"D",2.54,2.92,3.26,"0-0","0-0",17,7,8,2,1,4,0,0,2,3,16,19,0,5,35,"2-3","N","N","N",5,0,1
"2796","G1",2023-08-26,"Asteras Tripolis","OFI Crete",3,0,"H",2,0,"H",2.28,3.29,3.3,"2-0","3-0",12,4,16,6,1,3,0,0,3,4,16,16,3,7,32,"3-4","Y","Y","N",4,0,1
"2797","G1",2023-08-26,"Panathinaikos","Volos NFC",3,0,"H",2,0,"H",1.29,5.92,9.42,"2-0","3-0",14,8,5,3,1,3,0,0,6,1,16,19,3,7,35,"6-1","Y","Y","N",4,0,2
"2798","G1",2023-08-26,"AEK","Panserraikos",1,1,"D",0,1,"A",1.14,7.98,20.36,"0-1","1-1",29,10,7,4,1,6,0,0,12,1,6,20,2,13,26,"12-1","Y","N","N",7,0,2
"2799","G1",2023-08-27,"Lamia","Aris",1,0,"H",1,0,"H",3.4,3.3,2.18,"1-0","1-0",7,4,7,3,4,4,1,0,2,2,22,16,1,4,38,"2-2","N","N","N",8,1,2
"2800","G1",2023-08-27,"PAOK","Kifisias",2,1,"H",1,0,"H",1.17,6.66,16.16,"1-0","2-1",19,8,6,3,1,5,0,0,8,5,12,14,3,13,26,"8-5","Y","Y","N",6,0,2
"2801","G1",2023-08-27,"Olympiakos","Atromitos",4,0,"H",2,0,"H",1.28,5.51,10.05,"2-0","4-0",24,9,3,1,1,5,0,1,5,2,9,9,4,7,18,"5-2","Y","Y","Y",6,1,2
"2802","G1",2023-09-01,"Kifisias","Atromitos",2,1,"H",1,0,"H",2.64,3.18,2.86,"1-0","2-1",14,7,13,9,3,1,0,1,5,8,14,12,3,13,26,"5-8","Y","Y","N",4,1,2
"2803","G1",2023-09-02,"Panserraikos","Panetolikos",1,1,"D",1,0,"H",2.31,3.22,3.25,"1-0","1-1",14,3,8,4,3,1,0,0,4,6,14,15,2,10,29,"4-6","Y","N","N",4,0,2
"2804","G1",2023-09-03,"Aris","Asteras Tripolis",3,2,"H",1,1,"D",1.52,3.88,6.81,"1-1","3-2",10,6,4,4,1,3,0,0,3,5,14,13,5,8,27,"3-5","Y","Y","Y",4,0,3
"2805","G1",2023-09-03,"OFI Crete","PAOK",1,0,"H",0,0,"D",5.24,3.85,1.64,"0-0","1-0",7,2,12,4,4,5,0,0,1,5,20,17,1,6,37,"1-5","N","N","N",9,0,3
"2806","G1",2023-09-03,"Olympiakos","Lamia",4,0,"H",2,0,"H",1.25,5.66,11.44,"2-0","4-0",17,8,8,3,2,3,0,0,5,2,14,14,4,7,28,"5-2","Y","Y","Y",5,0,3
"2807","G1",2023-09-03,"Volos NFC","AEK",2,3,"A",1,2,"A",11.46,6.13,1.22,"1-2","2-3",7,5,11,7,4,1,0,1,3,8,18,17,5,11,35,"3-8","Y","Y","Y",5,1,3
"2808","G1",2023-09-03,"Giannina","Panathinaikos",0,1,"A",0,0,"D",6.17,3.66,1.6,"0-0","0-1",11,4,11,2,6,2,0,0,2,8,11,19,1,10,30,"2-8","N","N","N",8,0,3
"2809","G1",2023-09-16,"Lamia","OFI Crete",2,2,"D",0,1,"A",2.72,3.17,2.73,"0-1","2-2",7,2,12,4,1,3,0,0,6,7,7,16,4,13,23,"6-7","Y","Y","Y",4,0,3
"2810","G1",2023-09-16,"Panetolikos","Panathinaikos",0,5,"A",0,2,"A",7.6,4.07,1.49,"0-2","0-5",11,4,18,10,2,1,0,0,3,6,10,13,5,9,23,"3-6","Y","Y","Y",3,0,3
"2811","G1",2023-09-17,"Asteras Tripolis","Giannina",2,2,"D",2,2,"D",2.13,3.07,3.82,"2-2","2-2",10,4,7,6,2,3,0,0,8,1,15,9,4,9,24,"8-1","Y","Y","Y",5,0,4
"2812","G1",2023-09-17,"Kifisias","Panserraikos",4,4,"D",0,3,"A",2.04,3.41,3.66,"0-3","4-4",19,6,9,4,3,5,0,1,3,3,16,22,8,6,38,"3-3","Y","Y","Y",8,1,4
"2813","G1",2023-09-17,"PAOK","Aris",0,0,"D",0,0,"D",1.55,4.01,5.99,"0-0","0-0",10,3,8,4,4,3,0,0,7,1,17,13,0,8,30,"7-1","N","N","N",7,0,4
"2814","G1",2023-09-17,"AEK","Olympiakos",1,1,"D",1,1,"D",2.19,3.35,3.32,"1-1","1-1",9,4,7,3,2,4,0,0,5,5,15,21,2,10,36,"5-5","Y","N","N",6,0,4
"2815","G1",2023-09-18,"Atromitos","Volos NFC",1,1,"D",1,0,"H",1.79,3.83,4.16,"1-0","1-1",8,1,10,1,3,2,0,0,4,1,13,19,2,5,32,"4-1","Y","N","N",5,0,4
"2816","G1",2023-09-23,"OFI Crete","Atromitos",1,1,"D",1,0,"H",2.08,3.41,3.59,"1-0","1-1",16,5,9,4,3,4,0,0,8,4,13,18,2,12,31,"8-4","Y","N","N",7,0,4
"2817","G1",2023-09-23,"Panserraikos","Lamia",2,0,"H",0,0,"D",2.3,3.22,3.33,"0-0","2-0",14,7,4,1,1,2,0,0,3,1,14,19,2,4,33,"3-1","Y","N","N",3,0,4
"2818","G1",2023-09-24,"Olympiakos","Kifisias",4,0,"H",2,0,"H",1.15,7.58,16.14,"2-0","4-0",13,7,8,2,1,2,0,0,7,1,18,11,4,8,29,"7-1","Y","Y","Y",3,0,5
"2819","G1",2023-09-24,"Aris","Panetolikos",3,0,"H",1,0,"H",1.5,4.06,6.79,"1-0","3-0",14,6,5,3,0,2,0,0,6,5,10,8,3,11,18,"6-5","Y","Y","N",2,0,5
"2820","G1",2023-09-24,"Volos NFC","Asteras Tripolis",1,2,"A",0,2,"A",2.63,3.14,2.81,"0-2","1-2",13,7,16,6,4,3,0,0,1,5,18,18,3,6,36,"1-5","Y","Y","N",7,0,5
"2821","G1",2023-09-24,"Giannina","PAOK",1,3,"A",1,2,"A",5.4,3.87,1.62,"1-2","1-3",10,3,10,5,4,2,0,0,8,6,10,9,4,14,19,"8-6","Y","Y","Y",6,0,5
"2822","G1",2023-09-25,"Panathinaikos","AEK",1,2,"A",1,1,"D",2.37,3.09,3.23,"1-1","1-2",10,5,15,4,3,4,0,0,6,6,13,21,3,12,34,"6-6","Y","Y","N",7,0,5
"2823","G1",2023-09-27,"Panetolikos","OFI Crete",1,1,"D",1,1,"D",2.88,3.37,2.38,"1-1","1-1",18,6,21,10,2,2,0,0,3,7,7,13,2,10,20,"3-7","Y","N","N",4,0,5
"2824","G1",2023-09-27,"Kifisias","Lamia",1,1,"D",0,0,"D",2.3,3.33,3.24,"0-0","1-1",17,4,8,4,4,3,1,0,6,8,14,12,2,14,26,"6-8","Y","N","N",7,1,5
"2825","G1",2023-09-27,"Olympiakos","Aris",4,1,"H",1,0,"H",1.36,4.85,9.26,"1-0","4-1",20,5,7,1,2,0,0,0,8,1,17,7,5,9,24,"8-1","Y","Y","Y",2,0,6
"2826","G1",2023-09-27,"PAOK","Volos NFC",3,0,"H",2,0,"H",1.18,7.46,14.45,"2-0","3-0",17,10,5,2,0,1,0,0,5,3,14,13,3,8,27,"5-3","Y","Y","N",1,0,6
"2827","G1",2023-09-28,"Panserraikos","Giannina",3,2,"H",2,1,"H",2.28,3.07,3.45,"2-1","3-2",12,6,6,3,5,3,0,1,4,4,10,11,5,8,21,"4-4","Y","Y","Y",8,1,6
"2828","G1",2023-09-28,"Asteras Tripolis","Panathinaikos",1,4,"A",1,2,"A",5.4,3.6,1.67,"1-2","1-4",9,4,9,7,3,1,0,0,2,4,7,9,5,6,16,"2-4","Y","Y","Y",4,0,6
"2829","G1",2023-09-28,"AEK","Atromitos",2,1,"H",1,0,"H",1.17,7.15,14.76,"1-0","2-1",18,8,5,2,2,4,1,0,6,1,9,10,3,7,19,"6-1","Y","Y","N",6,1,6
"2830","G1",2023-10-01,"Lamia","Panetolikos",1,0,"H",1,0,"H",1.88,3.33,4.41,"1-0","1-0",7,3,13,1,2,4,0,0,2,5,16,18,1,7,34,"2-5","N","N","N",6,0,6
"2831","G1",2023-10-01,"Aris","Kifisias",1,1,"D",1,0,"H",1.41,4.43,7.69,"1-0","1-1",12,6,10,4,2,7,0,0,5,3,13,20,2,8,33,"5-3","Y","N","N",9,0,6
"2832","G1",2023-10-01,"Panathinaikos","PAOK",2,2,"D",1,1,"D",1.9,3.33,4.33,"1-1","2-2",22,13,5,2,2,4,0,0,7,2,10,13,4,9,23,"7-2","Y","Y","Y",6,0,7
"2833","G1",2023-10-01,"Giannina","Olympiakos",0,3,"A",0,2,"A",7.93,4.46,1.4,"0-2","0-3",5,0,25,9,3,2,0,0,2,6,10,14,3,8,24,"2-6","Y","Y","N",5,0,7
"2834","G1",2023-10-02,"Atromitos","Asteras Tripolis",0,0,"D",0,0,"D",2.16,3.17,3.69,"0-0","0-0",8,1,8,4,1,5,1,0,4,5,8,22,0,9,30,"4-5","N","N","N",6,1,7
"2835","G1",2023-10-02,"OFI Crete","AEK",2,0,"H",1,0,"H",6.48,4.38,1.47,"1-0","2-0",7,5,14,4,4,3,0,0,2,4,10,17,2,6,27,"2-4","Y","N","N",7,0,7
"2836","G1",2023-10-08,"AEK","Panetolikos",3,0,"H",2,0,"H",1.06,13.71,32.27,"2-0","3-0",23,9,7,4,0,2,0,0,9,5,10,15,3,14,25,"9-5","Y","Y","N",2,0,7
"2837","G1",2023-10-08,"Panathinaikos","Atromitos",5,0,"H",3,0,"H",1.22,5.9,13.39,"3-0","5-0",14,10,5,1,0,1,1,1,2,1,15,8,5,3,23,"2-1","Y","Y","Y",1,2,7
"2838","G1",2023-10-20,"Lamia","Giannina",2,1,"H",2,1,"H",2.18,2.96,4.04,"2-1","2-1",15,7,12,2,3,3,0,0,4,3,17,13,3,7,30,"4-3","Y","Y","N",6,0,7
"2839","G1",2023-10-21,"Panetolikos","Volos NFC",2,0,"H",1,0,"H",2.1,3.23,3.83,"1-0","2-0",13,6,11,1,2,3,0,0,3,6,18,8,2,9,26,"3-6","Y","N","N",5,0,8
"2840","G1",2023-10-21,"Aris","Panserraikos",1,0,"H",0,0,"D",1.46,4.33,7.33,"0-0","1-0",20,6,5,2,3,6,0,0,8,2,15,18,1,10,33,"8-2","N","N","N",9,0,8
"2841","G1",2023-10-22,"Asteras Tripolis","AEK",0,3,"A",0,1,"A",7.11,4.48,1.44,"0-1","0-3",4,1,15,5,6,5,1,0,2,3,8,9,3,5,17,"2-3","Y","Y","N",11,1,8
"2842","G1",2023-10-22,"Kifisias","OFI Crete",0,0,"D",0,0,"D",2.9,3.36,2.45,"0-0","0-0",8,2,9,3,2,6,1,0,5,4,8,16,0,9,24,"5-4","N","N","N",8,1,8
"2843","G1",2023-10-22,"PAOK","Atromitos",2,0,"H",1,0,"H",1.28,5.46,10.2,"1-0","2-0",15,5,6,3,3,3,0,0,8,1,16,13,2,9,29,"8-1","Y","N","N",6,0,8
"2844","G1",2023-10-28,"Volos NFC","Kifisias",2,1,"H",1,0,"H",2.27,3.46,3.18,"1-0","2-1",17,6,9,2,4,6,0,2,4,8,12,17,3,12,29,"4-8","Y","Y","N",10,2,8
"2845","G1",2023-10-28,"Atromitos","Panetolikos",3,2,"H",0,1,"A",1.81,3.59,4.59,"0-1","3-2",10,5,6,3,2,2,0,1,1,2,19,16,5,3,35,"1-2","Y","Y","Y",4,1,8
"2846","G1",2023-10-29,"Asteras Tripolis","Lamia",0,1,"A",0,0,"D",1.88,3.33,4.41,"0-0","0-1",11,5,10,4,2,3,0,0,5,2,14,10,1,7,24,"5-2","N","N","N",5,0,9
"2847","G1",2023-10-29,"Panathinaikos","Panserraikos",5,0,"H",3,0,"H",1.21,6.39,12.19,"3-0","5-0",13,6,7,1,2,4,0,1,7,1,22,11,5,8,33,"7-1","Y","Y","Y",6,1,9
"2848","G1",2023-10-29,"Aris","Giannina",2,0,"H",0,0,"D",1.4,4.43,7.97,"0-0","2-0",17,7,2,0,4,2,0,1,6,1,11,9,2,7,20,"6-1","Y","N","N",6,1,9
"2849","G1",2023-10-30,"AEK","PAOK",2,0,"H",1,0,"H",1.72,3.74,4.75,"1-0","2-0",15,3,4,2,4,5,0,0,5,2,14,9,2,7,23,"5-2","Y","N","N",9,0,9
"2850","G1",2023-10-30,"OFI Crete","Olympiakos",0,2,"A",0,1,"A",5.97,4.26,1.51,"0-1","0-2",4,0,13,3,1,3,0,0,2,3,7,18,2,5,25,"2-3","Y","N","N",4,0,9
"2851","G1",2023-11-04,"Lamia","Panathinaikos",1,2,"A",0,1,"A",7.97,4.51,1.42,"0-1","1-2",13,4,9,6,3,6,0,1,3,3,17,16,3,6,33,"3-3","Y","Y","N",9,1,9
"2852","G1",2023-11-04,"Kifisias","AEK",1,1,"D",0,0,"D",14.16,8.09,1.16,"0-0","1-1",7,2,18,6,2,2,0,0,5,8,10,13,2,13,23,"5-8","Y","N","N",4,0,9
"2853","G1",2023-11-05,"Panetolikos","Asteras Tripolis",0,1,"A",0,1,"A",3.04,3.06,2.51,"0-1","0-1",15,4,4,3,6,5,0,1,8,3,23,13,1,11,36,"8-3","N","N","N",11,1,10
"2854","G1",2023-11-05,"Giannina","Volos NFC",1,1,"D",0,0,"D",1.93,3.38,4.09,"0-0","1-1",12,3,11,2,5,2,0,0,4,7,23,13,2,11,36,"4-7","Y","N","N",7,0,10
"2855","G1",2023-11-05,"Olympiakos","PAOK",2,4,"A",0,1,"A",1.48,3.9,5.84,"0-1","2-4",11,6,10,5,3,2,0,0,7,2,14,11,6,9,25,"7-2","Y","Y","Y",5,0,10
"2856","G1",2023-11-05,"Aris","Atromitos",1,3,"A",1,1,"D",1.54,4.08,5.96,"1-1","1-3",16,5,8,6,3,4,0,0,9,2,14,18,4,11,32,"9-2","Y","Y","Y",7,0,10
"2857","G1",2023-11-06,"Panserraikos","OFI Crete",2,1,"H",1,1,"D",2.66,3.14,2.78,"1-1","2-1",9,4,15,3,3,4,0,0,4,4,18,13,3,8,31,"4-4","Y","Y","N",7,0,10
"2858","G1",2023-11-11,"OFI Crete","Giannina",1,1,"D",1,0,"H",1.69,3.76,5.02,"1-0","1-1",13,5,18,7,2,2,0,0,2,4,17,14,2,6,31,"2-4","Y","N","N",4,0,10
"2859","G1",2023-11-11,"Atromitos","Panserraikos",1,1,"D",0,1,"A",1.94,3.36,4.27,"0-1","1-1",12,3,7,2,4,4,0,0,5,1,21,20,2,6,41,"5-1","Y","N","N",8,0,10
"2860","G1",2023-11-11,"Volos NFC","Aris",0,2,"A",0,0,"D",4.44,3.8,1.79,"0-0","0-2",14,5,7,3,4,2,0,0,5,7,10,18,2,12,28,"5-7","Y","N","N",6,0,11
"2861","G1",2023-11-12,"PAOK","Panetolikos",2,1,"H",2,1,"H",1.17,7.07,13.77,"2-1","2-1",9,2,8,2,2,3,0,0,4,1,7,14,3,5,21,"4-1","Y","Y","N",5,0,11
"2862","G1",2023-11-12,"AEK","Lamia",3,0,"H",2,0,"H",1.2,6.85,11.31,"2-0","3-0",12,5,5,1,3,3,0,0,4,4,15,15,3,8,30,"4-4","Y","Y","N",6,0,11
"2863","G1",2023-11-12,"Asteras Tripolis","Olympiakos",0,2,"A",0,0,"D",7.05,4.47,1.43,"0-0","0-2",5,2,13,4,3,0,0,0,2,5,7,16,2,7,23,"2-5","Y","N","N",3,0,11
"2864","G1",2023-11-12,"Kifisias","Panathinaikos",0,1,"A",0,0,"D",10.43,5.94,1.24,"0-0","0-1",4,2,14,6,1,3,0,0,0,9,13,14,1,9,27,"0-9","N","N","N",4,0,11
"2865","G1",2023-11-24,"OFI Crete","Volos NFC",1,1,"D",0,1,"A",1.75,3.77,4.77,"0-1","1-1",16,6,10,3,3,5,0,1,6,2,10,17,2,8,27,"6-2","Y","N","N",8,1,11
"2866","G1",2023-11-25,"Olympiakos","Panetolikos",3,1,"H",2,1,"H",1.13,9.49,17.72,"2-1","3-1",9,4,8,4,3,1,0,0,3,2,20,15,4,5,35,"3-2","Y","Y","Y",4,0,11
"2867","G1",2023-11-25,"PAOK","Panserraikos",5,0,"H",2,0,"H",1.24,6.37,11,"2-0","5-0",16,11,7,2,0,0,0,0,8,3,3,7,5,11,10,"8-3","Y","Y","Y",0,0,12
"2868","G1",2023-11-26,"Kifisias","Asteras Tripolis",1,3,"A",0,2,"A",2.45,3.16,3.03,"0-2","1-3",17,6,5,4,2,2,0,0,7,2,17,15,4,9,32,"7-2","Y","Y","Y",4,0,12
"2869","G1",2023-11-26,"Giannina","AEK",0,1,"A",0,1,"A",8.9,5.28,1.31,"0-1","0-1",8,4,20,7,3,1,0,0,3,6,12,13,1,9,25,"3-6","N","N","N",4,0,12
"2870","G1",2023-11-26,"Lamia","Atromitos",3,3,"D",2,2,"D",2.41,3.25,3.02,"2-2","3-3",12,7,11,6,4,3,0,0,3,8,11,18,6,11,29,"3-8","Y","Y","Y",7,0,12
"2871","G1",2023-11-26,"Aris","Panathinaikos",2,0,"H",1,0,"H",3.41,3.42,2.13,"1-0","2-0",8,4,14,8,3,1,0,0,1,9,19,11,2,10,30,"1-9","Y","N","N",4,0,12
"2872","G1",2023-11-29,"Volos NFC","Panserraikos",1,0,"H",0,0,"D",2.43,3.27,3.06,"0-0","1-0",11,5,11,4,2,4,0,0,3,5,21,16,1,8,37,"3-5","N","N","N",6,0,12
"2873","G1",2023-12-02,"Panetolikos","Kifisias",3,0,"H",1,0,"H",2.2,3.26,3.53,"1-0","3-0",14,7,8,4,2,5,0,0,5,6,17,17,3,11,34,"5-6","Y","Y","N",7,0,12
"2874","G1",2023-12-02,"Asteras Tripolis","Panserraikos",1,0,"H",0,0,"D",2,3.36,4.05,"0-0","1-0",9,2,16,4,4,4,0,0,5,3,17,12,1,8,29,"5-3","N","N","N",8,0,13
"2875","G1",2023-12-03,"Volos NFC","Olympiakos",2,2,"D",1,1,"D",12.69,6.38,1.2,"1-1","2-2",10,4,11,3,7,3,1,1,2,6,16,8,4,8,24,"2-6","Y","Y","Y",10,2,13
"2876","G1",2023-12-03,"Atromitos","Giannina",1,1,"D",0,0,"D",2.2,3.28,3.38,"0-0","1-1",12,4,9,3,4,2,0,0,2,2,16,7,2,4,23,"2-2","Y","N","N",6,0,13
"2877","G1",2023-12-03,"Panathinaikos","OFI Crete",4,0,"H",1,0,"H",1.22,6,11.75,"1-0","4-0",16,9,5,3,1,6,0,0,2,3,18,21,4,5,39,"2-3","Y","Y","Y",7,0,13
"2878","G1",2023-12-04,"PAOK","Lamia",3,0,"H",2,0,"H",1.2,6.39,12.52,"2-0","3-0",17,8,11,6,0,1,0,0,5,5,7,9,3,10,16,"5-5","Y","Y","N",1,0,13
"2879","G1",2023-12-04,"AEK","Aris",1,0,"H",0,0,"D",1.39,4.8,7.45,"0-0","1-0",17,4,7,1,1,1,0,0,9,2,15,9,1,11,24,"9-2","N","N","N",2,0,13
"1996","I1",2023-08-19,"Empoli","Verona",0,1,"A",0,0,"D",2.3,3.3,3.44,"0-0","0-1",10,4,10,4,2,2,0,0,2,4,17,18,1,6,35,"2-4","N","N","N",4,0,1
"1997","I1",2023-08-19,"Frosinone","Napoli",1,3,"A",1,2,"A",8.85,5.25,1.37,"1-2","1-3",4,1,19,8,3,3,0,0,4,6,14,17,4,10,31,"4-6","Y","Y","Y",6,0,1
"1998","I1",2023-08-19,"Genoa","Fiorentina",1,4,"A",0,3,"A",3.54,3.36,2.23,"0-3","1-4",4,2,9,5,2,3,0,0,3,4,14,13,5,7,27,"3-4","Y","Y","Y",5,0,1
"1999","I1",2023-08-19,"Inter","Monza",2,0,"H",1,0,"H",1.39,5.1,8.76,"1-0","2-0",22,3,12,2,1,1,0,0,8,3,8,13,2,11,21,"8-3","Y","N","N",2,0,1
"2000","I1",2023-08-20,"Roma","Salernitana",2,2,"D",1,1,"D",1.53,4.18,7.16,"1-1","2-2",13,3,3,2,0,4,0,0,9,1,12,9,4,10,21,"9-1","Y","Y","Y",4,0,1
"2001","I1",2023-08-20,"Sassuolo","Atalanta",0,2,"A",0,0,"D",3.39,3.63,2.18,"0-0","0-2",11,3,16,6,0,0,0,0,7,7,9,13,2,14,22,"7-7","Y","N","N",0,0,1
"2002","I1",2023-08-20,"Lecce","Lazio",2,1,"H",0,1,"A",3.87,3.31,2.14,"0-1","2-1",23,7,10,4,3,2,0,0,5,2,12,16,3,7,28,"5-2","Y","Y","N",5,0,1
"2003","I1",2023-08-20,"Udinese","Juventus",0,3,"A",0,3,"A",4.64,3.66,1.85,"0-3","0-3",18,5,9,4,1,3,0,0,7,3,12,10,3,10,22,"7-3","Y","Y","N",4,0,1
"2004","I1",2023-08-21,"Torino","Cagliari",0,0,"D",0,0,"D",1.67,3.86,5.78,"0-0","0-0",11,2,8,2,1,1,0,0,8,3,8,12,0,11,20,"8-3","N","N","N",2,0,1
"2005","I1",2023-08-21,"Bologna","Milan",0,2,"A",0,2,"A",4.02,3.52,2.01,"0-2","0-2",17,5,10,6,2,2,0,0,3,6,10,4,2,9,14,"3-6","Y","N","N",4,0,1
"2006","I1",2023-08-26,"Frosinone","Atalanta",2,1,"H",2,0,"H",5.04,4.16,1.69,"2-0","2-1",13,5,18,6,1,2,0,0,3,7,10,10,3,10,20,"3-7","Y","Y","N",3,0,2
"2007","I1",2023-08-26,"Monza","Empoli",2,0,"H",1,0,"H",1.95,3.59,4.18,"1-0","2-0",20,5,18,6,1,2,0,0,6,5,14,7,2,11,21,"6-5","Y","N","N",3,0,2
"2008","I1",2023-08-26,"Milan","Torino",4,1,"H",3,1,"H",1.69,3.8,5.71,"3-1","4-1",17,7,8,1,2,3,0,0,2,1,13,16,5,3,29,"2-1","Y","Y","Y",5,0,2
"2009","I1",2023-08-26,"Verona","Roma",2,1,"H",2,0,"H",4.83,3.49,1.87,"2-0","2-1",5,3,23,7,1,3,1,0,1,12,17,12,3,13,29,"1-12","Y","Y","N",4,1,2
"2010","I1",2023-08-27,"Fiorentina","Lecce",2,2,"D",2,0,"H",1.64,4,5.86,"2-0","2-2",9,4,6,2,1,3,0,0,3,3,13,12,4,6,25,"3-3","Y","Y","Y",4,0,2
"2011","I1",2023-08-27,"Juventus","Bologna",1,1,"D",0,1,"A",1.51,4.42,7.08,"0-1","1-1",14,3,9,4,2,1,0,0,5,1,14,13,2,6,27,"5-1","Y","N","N",3,0,2
"2012","I1",2023-08-27,"Lazio","Genoa",0,1,"A",0,1,"A",1.61,4.23,5.75,"0-1","0-1",16,2,5,3,4,2,0,0,15,1,9,16,1,16,25,"15-1","N","N","N",6,0,2
"2013","I1",2023-08-27,"Napoli","Sassuolo",2,0,"H",1,0,"H",1.34,5.87,8.45,"1-0","2-0",25,5,6,1,0,1,0,1,12,4,9,10,2,16,19,"12-4","Y","N","N",1,1,2
"2014","I1",2023-08-28,"Salernitana","Udinese",1,1,"D",0,0,"D",2.8,3.34,2.69,"0-0","1-1",9,4,14,6,4,4,0,0,7,5,12,19,2,12,31,"7-5","Y","N","N",8,0,2
"2015","I1",2023-08-28,"Cagliari","Inter",0,2,"A",0,2,"A",6.7,5.01,1.47,"0-2","0-2",12,2,17,3,1,1,0,0,4,7,9,10,2,11,19,"4-7","Y","N","N",2,0,2
"2016","I1",2023-09-01,"Sassuolo","Verona",3,1,"H",1,0,"H",2.04,3.66,3.84,"1-0","3-1",16,7,11,3,1,3,0,0,10,1,8,13,4,11,21,"10-1","Y","Y","Y",4,0,3
"2017","I1",2023-09-01,"Roma","Milan",1,2,"A",0,1,"A",2.88,3.2,2.76,"0-1","1-2",13,2,9,4,2,4,0,1,3,5,14,15,3,8,29,"3-5","Y","Y","N",6,1,3
"2018","I1",2023-09-02,"Bologna","Cagliari",2,1,"H",0,1,"A",1.75,3.63,5.47,"0-1","2-1",16,7,7,1,1,2,0,0,5,2,9,13,3,7,22,"5-2","Y","Y","N",3,0,3
"2019","I1",2023-09-02,"Udinese","Frosinone",0,0,"D",0,0,"D",1.82,3.72,4.74,"0-0","0-0",12,6,12,2,2,2,0,0,3,5,14,9,0,8,23,"3-5","N","N","N",4,0,3
"2020","I1",2023-09-02,"Atalanta","Monza",3,0,"H",2,0,"H",1.64,4.27,5.32,"2-0","3-0",18,8,8,2,0,3,0,0,7,3,11,9,3,10,20,"7-3","Y","Y","N",3,0,3
"2021","I1",2023-09-02,"Napoli","Lazio",1,2,"A",1,1,"D",1.62,4.19,5.73,"1-1","1-2",22,4,6,2,1,2,0,0,7,2,8,9,3,9,17,"7-2","Y","Y","N",3,0,3
"2022","I1",2023-09-03,"Inter","Fiorentina",4,0,"H",1,0,"H",1.66,4.16,5.29,"1-0","4-0",21,11,6,2,1,1,0,0,1,1,13,12,4,2,25,"1-1","Y","Y","Y",2,0,3
"2023","I1",2023-09-03,"Torino","Genoa",1,0,"H",0,0,"D",2.09,3.31,4.03,"0-0","1-0",10,3,7,2,2,5,0,0,4,0,13,7,1,4,20,"4-0","N","N","N",7,0,3
"2024","I1",2023-09-03,"Empoli","Juventus",0,2,"A",0,1,"A",5.43,3.98,1.68,"0-1","0-2",7,0,18,5,3,3,0,0,3,7,14,13,2,10,27,"3-7","Y","N","N",6,0,3
"2025","I1",2023-09-03,"Lecce","Salernitana",2,0,"H",1,0,"H",2.06,3.4,4,"1-0","2-0",20,6,11,4,3,3,0,0,6,5,17,15,2,11,32,"6-5","Y","N","N",6,0,3
"2026","I1",2023-09-16,"Juventus","Lazio",3,1,"H",2,0,"H",1.94,3.47,4.41,"2-0","3-1",17,7,16,5,5,1,0,0,7,9,13,13,4,16,26,"7-9","Y","Y","Y",6,0,4
"2027","I1",2023-09-16,"Inter","Milan",5,1,"H",2,0,"H",2.15,3.57,3.53,"2-0","5-1",14,7,9,2,2,2,0,0,5,0,16,13,6,5,29,"5-0","Y","Y","Y",4,0,4
"2028","I1",2023-09-16,"Genoa","Napoli",2,2,"D",1,0,"H",5.41,4.1,1.66,"1-0","2-2",8,3,12,4,3,2,0,0,3,1,14,8,4,4,22,"3-1","Y","Y","Y",5,0,4
"2029","I1",2023-09-17,"Cagliari","Udinese",0,0,"D",0,0,"D",2.9,3.27,2.65,"0-0","0-0",10,1,11,1,2,1,1,0,4,6,12,11,0,10,23,"4-6","N","N","N",3,1,4
"2030","I1",2023-09-17,"Frosinone","Sassuolo",4,2,"H",1,2,"A",2.83,3.52,2.57,"1-2","4-2",16,6,18,7,4,2,0,0,5,6,10,9,6,11,19,"5-6","Y","Y","Y",6,0,4
"2031","I1",2023-09-17,"Monza","Lecce",1,1,"D",1,1,"D",2.13,3.5,3.66,"1-1","1-1",25,6,4,3,6,1,1,1,10,1,17,11,2,11,28,"10-1","Y","N","N",7,2,4
"2032","I1",2023-09-17,"Fiorentina","Atalanta",3,2,"H",2,1,"H",2.54,3.55,2.84,"2-1","3-2",15,8,11,4,1,2,0,0,3,4,8,14,5,7,22,"3-4","Y","Y","Y",3,0,4
"2033","I1",2023-09-17,"Roma","Empoli",7,0,"H",3,0,"H",1.43,4.66,8.61,"3-0","7-0",14,9,8,2,2,2,0,0,2,6,15,5,7,8,20,"2-6","Y","Y","Y",4,0,4
"2034","I1",2023-09-18,"Salernitana","Torino",0,3,"A",0,2,"A",3.73,3.27,2.2,"0-2","0-3",14,4,11,3,2,2,0,0,1,2,12,16,3,3,28,"1-2","Y","Y","N",4,0,4
"2035","I1",2023-09-18,"Verona","Bologna",0,0,"D",0,0,"D",3.15,3.39,2.41,"0-0","0-0",9,1,11,4,4,2,0,0,3,4,18,10,0,7,28,"3-4","N","N","N",6,0,4
"2036","I1",2023-09-22,"Salernitana","Frosinone",1,1,"D",0,1,"A",2.59,3.3,3.01,"0-1","1-1",19,6,9,3,2,2,0,0,8,6,12,12,2,14,24,"8-6","Y","N","N",4,0,5
"2037","I1",2023-09-22,"Lecce","Genoa",1,0,"H",0,0,"D",2.49,3.22,3.23,"0-0","1-0",18,3,8,1,1,3,0,1,4,3,12,10,1,7,22,"4-3","N","N","N",4,1,5
"2038","I1",2023-09-23,"Milan","Verona",1,0,"H",1,0,"H",1.39,4.95,9.16,"1-0","1-0",9,4,10,2,4,2,0,0,2,3,13,9,1,5,22,"2-3","N","N","N",6,0,5
"2039","I1",2023-09-23,"Sassuolo","Juventus",4,2,"H",2,1,"H",4.35,4.03,1.81,"2-1","4-2",18,7,15,2,4,2,0,0,6,3,13,8,6,9,21,"6-3","Y","Y","Y",6,0,5
"2040","I1",2023-09-23,"Lazio","Monza",1,1,"D",1,1,"D",1.8,3.94,4.52,"1-1","1-1",8,1,16,4,2,2,0,0,1,3,13,7,2,4,20,"1-3","Y","N","N",4,0,5
"2041","I1",2023-09-24,"Empoli","Inter",0,1,"A",0,0,"D",9.73,5.6,1.33,"0-0","0-1",7,1,23,6,2,2,0,0,3,6,15,11,1,9,26,"3-6","N","N","N",4,0,5
"2042","I1",2023-09-24,"Atalanta","Cagliari",2,0,"H",1,0,"H",1.41,5.11,7.79,"1-0","2-0",10,6,11,1,1,2,0,0,7,7,6,11,2,14,17,"7-7","Y","N","N",3,0,5
"2043","I1",2023-09-24,"Udinese","Fiorentina",0,2,"A",0,1,"A",3.17,3.45,2.37,"0-1","0-2",20,8,6,2,0,1,0,0,10,3,13,11,2,13,24,"10-3","Y","N","N",1,0,5
"2044","I1",2023-09-24,"Bologna","Napoli",0,0,"D",0,0,"D",3.72,3.66,2.06,"0-0","0-0",5,2,12,4,4,5,0,0,5,5,16,12,0,10,28,"5-5","N","N","N",9,0,5
"2045","I1",2023-09-24,"Torino","Roma",1,1,"D",0,0,"D",3.09,3.1,2.62,"0-0","1-1",13,4,11,3,0,2,0,0,7,1,4,5,2,8,9,"7-1","Y","N","N",2,0,5
"2046","I1",2023-09-26,"Juventus","Lecce",1,0,"H",0,0,"D",1.52,4.31,7.27,"0-0","1-0",14,5,2,0,2,5,0,1,5,1,14,15,1,6,29,"5-1","N","N","N",7,1,6
"2047","I1",2023-09-27,"Cagliari","Milan",1,3,"A",1,2,"A",5.46,3.96,1.68,"1-2","1-3",16,6,17,6,3,1,0,0,3,5,13,6,4,8,19,"3-5","Y","Y","Y",4,0,6
"2048","I1",2023-09-27,"Empoli","Salernitana",1,0,"H",1,0,"H",2.41,3.22,3.31,"1-0","1-0",13,6,14,2,2,1,0,0,10,2,18,13,1,12,31,"10-2","N","N","N",3,0,6
"2049","I1",2023-09-27,"Verona","Atalanta",0,1,"A",0,1,"A",4.63,3.78,1.82,"0-1","0-1",11,2,8,2,2,3,0,0,4,1,10,25,1,5,35,"4-1","N","N","N",5,0,6
"2050","I1",2023-09-27,"Inter","Sassuolo",1,2,"A",1,0,"H",1.32,5.99,9.3,"1-0","1-2",13,3,13,6,0,1,0,0,8,6,10,8,3,14,18,"8-6","Y","Y","N",1,0,6
"2051","I1",2023-09-27,"Lazio","Torino",2,0,"H",0,0,"D",2.17,3.37,3.7,"0-0","2-0",6,3,7,2,1,4,0,0,4,2,12,13,2,6,25,"4-2","Y","N","N",5,0,6
"2052","I1",2023-09-27,"Napoli","Udinese",4,1,"H",2,0,"H",1.39,5.16,8.46,"2-0","4-1",23,10,13,3,1,1,0,0,8,4,11,10,5,12,21,"8-4","Y","Y","Y",2,0,6
"2053","I1",2023-09-28,"Frosinone","Fiorentina",1,1,"D",0,1,"A",3.78,3.67,2.03,"0-1","1-1",11,3,19,6,3,3,0,0,8,10,6,11,2,18,17,"8-10","Y","N","N",6,0,6
"2054","I1",2023-09-28,"Monza","Bologna",0,0,"D",0,0,"D",2.49,3.35,3.06,"0-0","0-0",12,3,7,5,5,3,0,1,7,5,9,13,0,12,22,"7-5","N","N","N",8,1,6
"2055","I1",2023-09-28,"Genoa","Roma",4,1,"H",2,1,"H",3.85,3.31,2.14,"2-1","4-1",8,4,13,3,4,3,0,0,1,7,7,12,5,8,19,"1-7","Y","Y","Y",7,0,6
"2056","I1",2023-09-30,"Lecce","Napoli",0,4,"A",0,1,"A",4.84,3.9,1.76,"0-1","0-4",9,4,15,6,3,2,0,0,3,7,11,11,4,10,22,"3-7","Y","Y","Y",5,0,7
"2057","I1",2023-09-30,"Milan","Lazio",2,0,"H",0,0,"D",1.78,3.72,5.04,"0-0","2-0",14,7,13,4,3,2,0,0,7,1,15,5,2,8,20,"7-1","Y","N","N",5,0,7
"2058","I1",2023-09-30,"Salernitana","Inter",0,4,"A",0,0,"D",8.16,4.81,1.43,"0-0","0-4",12,3,16,6,2,1,0,0,3,3,12,10,4,6,22,"3-3","Y","Y","Y",3,0,7
"2059","I1",2023-10-01,"Bologna","Empoli",3,0,"H",1,0,"H",1.66,3.97,5.17,"1-0","3-0",21,9,12,4,2,4,0,0,2,6,11,16,3,8,27,"2-6","Y","Y","N",6,0,7
"2060","I1",2023-10-01,"Udinese","Genoa",2,2,"D",1,2,"A",2.38,3.07,3.35,"1-2","2-2",11,2,8,4,2,2,1,0,5,0,12,12,4,5,24,"5-0","Y","Y","Y",4,1,7
"2061","I1",2023-10-01,"Atalanta","Juventus",0,0,"D",0,0,"D",2.53,3.48,2.77,"0-0","0-0",15,2,5,3,1,2,0,0,5,2,13,7,0,7,20,"5-2","N","N","N",3,0,7
"2062","I1",2023-10-01,"Roma","Frosinone",2,0,"H",1,0,"H",1.45,4.36,7.55,"1-0","2-0",11,5,8,0,1,2,0,0,7,3,12,11,2,10,23,"7-3","Y","N","N",3,0,7
"2063","I1",2023-10-02,"Sassuolo","Monza",0,1,"A",0,0,"D",2.16,3.87,3.04,"0-0","0-1",19,7,13,4,0,0,0,0,7,4,8,10,1,11,18,"7-4","N","N","N",0,0,7
"2064","I1",2023-10-02,"Torino","Verona",0,0,"D",0,0,"D",1.83,3.37,4.73,"0-0","0-0",8,2,5,2,1,1,0,0,10,1,6,11,0,11,17,"10-1","N","N","N",2,0,7
"2065","I1",2023-10-02,"Fiorentina","Cagliari",3,0,"H",2,0,"H",1.48,4.17,6.98,"2-0","3-0",14,2,6,4,1,1,0,0,4,2,10,10,3,6,20,"4-2","Y","Y","N",2,0,7
"2066","I1",2023-10-06,"Empoli","Udinese",0,0,"D",0,0,"D",3.24,3.31,2.43,"0-0","0-0",18,3,11,1,1,2,0,0,5,7,11,15,0,12,26,"5-7","N","N","N",3,0,8
"2067","I1",2023-10-06,"Lecce","Sassuolo",1,1,"D",0,1,"A",2.6,3.56,2.8,"0-1","1-1",13,4,14,1,2,3,0,0,5,3,9,15,2,8,24,"5-3","Y","N","N",5,0,8
"2068","I1",2023-10-07,"Inter","Bologna",2,2,"D",2,1,"H",1.4,5.17,8.08,"2-1","2-2",14,5,8,3,2,3,0,0,7,7,11,9,4,14,20,"7-7","Y","Y","Y",5,0,8
"2069","I1",2023-10-07,"Juventus","Torino",2,0,"H",0,0,"D",1.94,3.39,4.58,"0-0","2-0",17,6,10,1,1,1,0,0,7,3,10,8,2,10,18,"7-3","Y","N","N",2,0,8
"2070","I1",2023-10-07,"Genoa","Milan",0,1,"A",0,0,"D",4.24,3.57,1.95,"0-0","0-1",7,1,12,3,3,5,1,1,3,2,10,13,1,5,23,"3-2","N","N","N",8,2,8
"2071","I1",2023-10-08,"Monza","Salernitana",3,0,"H",2,0,"H",1.68,3.97,5.48,"2-0","3-0",16,7,8,5,1,2,0,0,7,7,8,16,3,14,24,"7-7","Y","Y","N",3,0,8
"2072","I1",2023-10-08,"Frosinone","Verona",2,1,"H",1,0,"H",2.45,3.22,3.23,"1-0","2-1",11,2,16,4,1,4,0,0,2,4,9,12,3,6,21,"2-4","Y","Y","N",5,0,8
"2073","I1",2023-10-08,"Lazio","Atalanta",3,2,"H",2,1,"H",2.93,3.26,2.63,"2-1","3-2",12,4,12,4,1,1,0,0,4,6,7,10,5,10,17,"4-6","Y","Y","Y",2,0,8
"2074","I1",2023-10-08,"Cagliari","Roma",1,4,"A",0,2,"A",4.96,3.46,1.85,"0-2","1-4",16,2,11,5,2,3,0,0,4,3,15,13,5,7,28,"4-3","Y","Y","Y",5,0,8
"2075","I1",2023-10-08,"Napoli","Fiorentina",1,3,"A",1,1,"D",1.62,4.26,5.6,"1-1","1-3",16,4,12,3,2,4,0,0,6,4,4,14,4,10,18,"6-4","Y","Y","Y",6,0,8
"2076","I1",2023-10-21,"Verona","Napoli",1,3,"A",0,2,"A",5.71,3.96,1.66,"0-2","1-3",15,9,22,10,3,2,0,0,5,8,12,9,4,13,21,"5-8","Y","Y","Y",5,0,9
"2077","I1",2023-10-21,"Torino","Inter",0,3,"A",0,0,"D",5.39,3.72,1.74,"0-0","0-3",7,3,14,4,1,2,0,0,2,4,13,8,3,6,21,"2-4","Y","Y","N",3,0,9
"2078","I1",2023-10-21,"Sassuolo","Lazio",0,2,"A",0,2,"A",2.71,3.72,2.57,"0-2","0-2",9,2,18,6,1,5,0,0,5,7,6,10,2,12,16,"5-7","Y","N","N",6,0,9
"2079","I1",2023-10-22,"Roma","Monza",1,0,"H",0,0,"D",1.74,3.87,5.08,"0-0","1-0",21,4,11,4,2,4,0,1,8,5,11,11,1,13,22,"8-5","N","N","N",6,1,9
"2080","I1",2023-10-22,"Bologna","Frosinone",2,1,"H",2,0,"H",1.76,3.86,4.95,"2-0","2-1",12,6,12,5,2,2,0,1,4,5,10,14,3,9,24,"4-5","Y","Y","N",4,1,9
"2081","I1",2023-10-22,"Salernitana","Cagliari",2,2,"D",0,0,"D",2.35,3.18,3.46,"0-0","2-2",13,2,13,6,3,4,0,0,8,5,11,12,4,13,23,"8-5","Y","Y","Y",7,0,9
"2082","I1",2023-10-22,"Atalanta","Genoa",2,0,"H",0,0,"D",1.56,4.19,6.61,"0-0","2-0",13,8,15,4,4,2,0,0,8,4,17,9,2,12,26,"8-4","Y","N","N",6,0,9
"2083","I1",2023-10-22,"Milan","Juventus",0,1,"A",0,0,"D",2.32,3.29,3.42,"0-0","0-1",7,1,14,4,1,4,1,0,6,3,12,16,1,9,28,"6-3","N","N","N",5,1,9
"2084","I1",2023-10-23,"Udinese","Lecce",1,1,"D",0,0,"D",2.21,3.19,3.81,"0-0","1-1",12,6,12,1,3,5,0,0,2,7,11,15,2,9,26,"2-7","Y","N","N",8,0,9
"2085","I1",2023-10-23,"Fiorentina","Empoli",0,2,"A",0,1,"A",1.43,4.89,7.67,"0-1","0-2",19,7,7,3,1,3,0,0,13,3,13,17,2,16,30,"13-3","Y","N","N",4,0,9
"2086","I1",2023-10-27,"Genoa","Salernitana",1,0,"H",1,0,"H",1.76,3.72,5.17,"1-0","1-0",8,4,7,2,3,4,0,0,7,0,11,19,1,7,30,"7-0","N","N","N",7,0,10
"2087","I1",2023-10-28,"Sassuolo","Bologna",1,1,"D",1,1,"D",2.76,3.41,2.69,"1-1","1-1",17,6,9,5,1,4,0,0,6,2,11,10,2,8,21,"6-2","Y","N","N",5,0,10
"2088","I1",2023-10-28,"Lecce","Torino",0,1,"A",0,1,"A",2.8,3.03,2.94,"0-1","0-1",11,6,10,2,3,5,0,0,3,0,17,19,1,3,36,"3-0","N","N","N",8,0,10
"2089","I1",2023-10-28,"Juventus","Verona",1,0,"H",0,0,"D",1.36,5.17,9.54,"0-0","1-0",30,6,7,1,3,2,0,0,5,1,13,8,1,6,21,"5-1","N","N","N",5,0,10
"2090","I1",2023-10-29,"Cagliari","Frosinone",4,3,"H",0,2,"A",2.37,3.42,3.2,"0-2","4-3",24,6,10,6,1,4,0,0,5,7,8,7,7,12,15,"5-7","Y","Y","Y",5,0,10
"2091","I1",2023-10-29,"Monza","Udinese",1,1,"D",1,0,"H",2.14,3.54,3.58,"1-0","1-1",10,4,10,3,2,1,0,0,10,3,15,11,2,13,26,"10-3","Y","N","N",3,0,10
"2092","I1",2023-10-29,"Inter","Roma",1,0,"H",0,0,"D",1.65,4,5.78,"0-0","1-0",19,3,3,1,3,4,0,0,8,0,14,9,1,8,23,"8-0","N","N","N",7,0,10
"2093","I1",2023-10-29,"Napoli","Milan",2,2,"D",0,2,"A",2.3,3.37,3.38,"0-2","2-2",17,4,20,6,4,3,1,0,6,4,14,10,4,10,24,"6-4","Y","Y","Y",7,1,10
"2094","I1",2023-10-30,"Empoli","Atalanta",0,3,"A",0,2,"A",5.03,4.08,1.7,"0-2","0-3",9,2,18,6,4,0,0,0,3,6,10,13,3,9,23,"3-6","Y","Y","N",4,0,10
"2095","I1",2023-10-30,"Lazio","Fiorentina",1,0,"H",0,0,"D",2.31,3.48,3.24,"0-0","1-0",11,4,9,5,3,3,0,0,0,4,12,17,1,4,29,"0-4","N","N","N",6,0,10
"2096","I1",2023-11-03,"Bologna","Lazio",1,0,"H",0,0,"D",2.76,3.17,2.86,"0-0","1-0",6,2,11,1,2,5,0,0,2,6,12,8,1,8,20,"2-6","N","N","N",7,0,11
"2097","I1",2023-11-04,"Salernitana","Napoli",0,2,"A",0,1,"A",7.02,4.99,1.44,"0-1","0-2",10,3,21,8,1,1,0,0,8,9,15,10,2,17,25,"8-9","Y","N","N",2,0,11
"2098","I1",2023-11-04,"Atalanta","Inter",1,2,"A",0,1,"A",3.46,3.47,2.19,"0-1","1-2",14,4,10,4,4,1,1,0,6,1,13,9,3,7,22,"6-1","Y","Y","N",5,1,11
"2099","I1",2023-11-04,"Milan","Udinese",0,1,"A",0,0,"D",1.46,4.66,7.3,"0-0","0-1",14,5,12,2,1,2,0,0,11,5,13,14,1,16,27,"11-5","N","N","N",3,0,11
"2100","I1",2023-11-05,"Verona","Monza",1,3,"A",0,1,"A",3.22,3.29,2.39,"0-1","1-3",16,5,12,6,1,2,0,0,2,6,6,12,4,8,18,"2-6","Y","Y","Y",3,0,11
"2101","I1",2023-11-05,"Cagliari","Genoa",2,1,"H",0,0,"D",2.8,3.18,2.77,"0-0","2-1",12,4,8,2,4,2,0,0,1,1,14,11,3,2,25,"1-1","Y","Y","N",6,0,11
"2102","I1",2023-11-05,"Roma","Lecce",2,1,"H",0,0,"D",1.57,3.99,6.63,"0-0","2-1",15,5,15,4,3,5,0,0,5,2,18,11,3,7,29,"5-2","Y","Y","N",8,0,11
"2103","I1",2023-11-05,"Fiorentina","Juventus",0,1,"A",0,1,"A",2.92,3.3,2.58,"0-1","0-1",25,4,4,3,1,3,0,0,9,2,12,21,1,11,33,"9-2","N","N","N",4,0,11
"2104","I1",2023-11-06,"Frosinone","Empoli",2,1,"H",0,0,"D",2.13,3.58,3.52,"0-0","2-1",17,5,10,2,3,2,0,0,9,2,7,9,3,11,16,"9-2","Y","Y","N",5,0,11
"2105","I1",2023-11-06,"Torino","Sassuolo",2,1,"H",1,1,"D",2.19,3.39,3.54,"1-1","2-1",21,9,5,2,1,1,0,0,9,2,9,6,3,11,15,"9-2","Y","Y","N",2,0,11
"2106","I1",2023-11-10,"Sassuolo","Salernitana",2,2,"D",1,2,"A",1.7,4.17,4.92,"1-2","2-2",29,9,9,2,2,1,0,0,11,0,12,14,4,11,26,"11-0","Y","Y","Y",3,0,12
"2107","I1",2023-11-10,"Genoa","Verona",1,0,"H",1,0,"H",1.93,3.32,4.74,"1-0","1-0",16,6,7,1,1,4,0,0,6,7,9,16,1,13,25,"6-7","N","N","N",5,0,12
"2108","I1",2023-11-11,"Lecce","Milan",2,2,"D",0,2,"A",5.21,3.74,1.74,"0-2","2-2",14,5,10,6,4,6,0,1,3,1,12,16,4,4,28,"3-1","Y","Y","Y",10,1,12
"2109","I1",2023-11-11,"Juventus","Cagliari",2,1,"H",0,0,"D",1.38,5.01,8.82,"0-0","2-1",18,4,11,2,3,1,0,0,12,4,14,8,3,16,22,"12-4","Y","Y","N",4,0,12
"2110","I1",2023-11-11,"Monza","Torino",1,1,"D",0,0,"D",2.51,3.17,3.13,"0-0","1-1",12,5,12,5,2,2,0,0,3,1,11,11,2,4,22,"3-1","Y","N","N",4,0,12
"2111","I1",2023-11-12,"Napoli","Empoli",0,1,"A",0,0,"D",1.22,7.07,11.78,"0-0","0-1",18,7,8,3,1,1,0,0,8,3,11,13,1,11,24,"8-3","N","N","N",2,0,12
"2112","I1",2023-11-12,"Fiorentina","Bologna",2,1,"H",1,1,"D",2.09,3.51,3.69,"1-1","2-1",12,4,11,4,2,2,0,0,0,3,19,15,3,3,34,"0-3","Y","Y","N",4,0,12
"2113","I1",2023-11-12,"Udinese","Atalanta",1,1,"D",1,0,"H",3.8,3.53,2.05,"1-0","1-1",13,4,8,2,2,3,0,0,7,7,13,13,2,14,26,"7-7","Y","N","N",5,0,12
"2114","I1",2023-11-12,"Lazio","Roma",0,0,"D",0,0,"D",3,3.16,2.61,"0-0","0-0",7,2,8,1,3,4,0,0,4,1,12,13,0,5,25,"4-1","N","N","N",7,0,12
"2115","I1",2023-11-12,"Inter","Frosinone",2,0,"H",1,0,"H",1.19,7.86,13.84,"1-0","2-0",21,6,12,3,0,1,0,0,9,4,7,16,2,13,23,"9-4","Y","N","N",1,0,12
"2116","I1",2023-11-25,"Salernitana","Lazio",2,1,"H",0,1,"A",4.82,3.69,1.79,"0-1","2-1",13,6,13,2,5,3,0,0,4,9,11,12,3,13,23,"4-9","Y","Y","N",8,0,13
"2117","I1",2023-11-25,"Atalanta","Napoli",1,2,"A",0,1,"A",2.72,3.42,2.68,"0-1","1-2",16,5,11,4,2,2,0,0,5,4,15,9,3,9,24,"5-4","Y","Y","N",4,0,13
"2118","I1",2023-11-25,"Milan","Fiorentina",1,0,"H",1,0,"H",2.15,3.46,3.59,"1-0","1-0",9,6,20,4,1,2,0,0,3,11,9,10,1,14,19,"3-11","N","N","N",3,0,13
"2119","I1",2023-11-26,"Cagliari","Monza",1,1,"D",1,0,"H",2.9,3.25,2.63,"1-0","1-1",17,6,12,4,1,2,0,0,10,11,10,15,2,21,25,"10-11","Y","N","N",3,0,13
"2120","I1",2023-11-26,"Empoli","Sassuolo",3,4,"A",2,2,"D",2.8,3.6,2.51,"2-2","3-4",11,9,17,9,4,2,0,0,6,5,20,15,7,11,35,"6-5","Y","Y","Y",6,0,13
"2121","I1",2023-11-26,"Frosinone","Genoa",2,1,"H",1,1,"D",2.52,3.2,3.09,"1-1","2-1",9,5,13,3,2,4,0,0,4,2,5,14,3,6,19,"4-2","Y","Y","N",6,0,13
"2122","I1",2023-11-26,"Roma","Udinese",3,1,"H",1,0,"H",1.63,3.89,5.99,"1-0","3-1",12,5,6,2,1,3,0,0,7,1,8,15,4,8,23,"7-1","Y","Y","Y",4,0,13
"2123","I1",2023-11-26,"Juventus","Inter",1,1,"D",1,1,"D",3.5,3.21,2.29,"1-1","1-1",4,1,8,4,2,1,0,0,1,0,12,13,2,1,25,"1-0","Y","N","N",3,0,13
"2124","I1",2023-11-27,"Verona","Lecce",2,2,"D",1,1,"D",2.76,3,2.97,"1-1","2-2",19,11,14,5,1,2,0,0,4,2,15,17,4,6,32,"4-2","Y","Y","Y",3,0,13
"2125","I1",2023-11-27,"Bologna","Torino",2,0,"H",0,0,"D",2.39,3.16,3.34,"0-0","2-0",13,2,9,3,3,4,0,0,3,2,16,15,2,5,31,"3-2","Y","N","N",7,0,13
"2126","I1",2023-12-01,"Monza","Juventus",1,2,"A",0,1,"A",4.12,3.42,2.03,"0-1","1-2",16,1,18,7,1,2,0,0,7,3,12,8,3,10,20,"7-3","Y","Y","N",3,0,14
"2127","I1",2023-12-02,"Genoa","Empoli",1,1,"D",1,0,"H",1.98,3.37,4.28,"1-0","1-1",21,1,9,1,3,1,0,0,5,3,15,19,2,8,34,"5-3","Y","N","N",4,0,14
"2128","I1",2023-12-02,"Lazio","Cagliari",1,0,"H",1,0,"H",1.65,4.02,5.56,"1-0","1-0",10,5,9,2,0,2,0,1,4,3,11,12,1,7,23,"4-3","N","N","N",2,1,14
"2129","I1",2023-12-02,"Milan","Frosinone",3,1,"H",1,0,"H",1.45,4.85,6.94,"1-0","3-1",10,3,15,3,1,1,0,0,6,7,11,6,4,13,17,"6-7","Y","Y","Y",2,0,14
"2130","I1",2023-12-03,"Lecce","Bologna",1,1,"D",0,0,"D",3.16,3.09,2.55,"0-0","1-1",14,4,11,4,3,2,0,0,6,3,12,18,2,9,30,"6-3","Y","N","N",5,0,14
"2131","I1",2023-12-03,"Fiorentina","Salernitana",3,0,"H",2,0,"H",1.45,4.79,7.14,"2-0","3-0",22,9,11,1,1,0,0,0,3,2,13,12,3,5,25,"3-2","Y","Y","N",1,0,14
"2132","I1",2023-12-03,"Udinese","Verona",3,3,"D",2,1,"H",1.72,3.69,5.38,"2-1","3-3",12,6,13,4,2,5,0,0,5,3,16,13,6,8,29,"5-3","Y","Y","Y",7,0,14
"2133","I1",2023-12-03,"Sassuolo","Roma",1,2,"A",1,0,"H",3.91,3.75,1.95,"1-0","1-2",8,2,15,7,4,1,1,0,1,11,10,11,3,12,21,"1-11","Y","Y","N",5,1,14
"2134","I1",2023-12-03,"Napoli","Inter",0,3,"A",0,1,"A",2.95,3.51,2.44,"0-1","0-3",15,4,11,4,2,2,0,0,6,4,2,13,3,10,15,"6-4","Y","Y","N",4,0,14
"2135","I1",2023-12-04,"Torino","Atalanta",3,0,"H",1,0,"H",3.14,3.18,2.5,"1-0","3-0",9,5,10,4,2,2,0,0,4,3,12,14,3,7,26,"4-3","Y","Y","N",4,0,14
"2136","I2",2023-08-18,"Bari","Palermo",0,0,"D",0,0,"D",2.83,3.12,2.83,"0-0","0-0",11,3,16,2,7,4,2,0,3,5,13,15,0,8,28,"3-5","N","N","N",11,2,1
"2137","I2",2023-08-19,"Cosenza","Ascoli",3,0,"H",1,0,"H",2.84,2.96,2.97,"1-0","3-0",22,6,4,0,1,4,0,3,7,0,11,12,3,7,23,"7-0","Y","Y","N",5,3,1
"2138","I2",2023-08-19,"Cremonese","Catanzaro",0,0,"D",0,0,"D",1.98,3.37,4.41,"0-0","0-0",17,3,6,2,3,1,0,0,6,2,7,18,0,8,25,"6-2","N","N","N",4,0,1
"2139","I2",2023-08-19,"Ternana","Sampdoria",1,2,"A",0,1,"A",3.3,3.55,2.26,"0-1","1-2",14,3,13,6,4,1,0,0,5,4,11,10,3,9,21,"5-4","Y","Y","N",5,0,1
"2140","I2",2023-08-20,"Sudtirol","Spezia",3,3,"D",1,2,"A",3.75,3.07,2.3,"1-2","3-3",10,4,17,5,3,3,0,0,2,1,17,20,6,3,37,"2-1","Y","Y","Y",6,0,1
"2141","I2",2023-08-20,"Cittadella","Reggiana",1,0,"H",1,0,"H",2.15,3.28,3.87,"1-0","1-0",13,3,8,1,3,3,0,0,6,2,20,17,1,8,37,"6-2","N","N","N",6,0,1
"2142","I2",2023-08-20,"Parma","FeralpiSalo",2,0,"H",1,0,"H",1.54,4.06,7.38,"1-0","2-0",15,4,13,2,1,4,0,0,7,7,11,11,2,14,22,"7-7","Y","N","N",5,0,1
"2143","I2",2023-08-20,"Venezia","Como",3,0,"H",2,0,"H",2.1,3.41,3.87,"2-0","3-0",18,6,12,3,0,0,0,0,9,3,17,9,3,12,26,"9-3","Y","Y","N",0,0,1
"2144","I2",2023-08-25,"Sampdoria","Pisa",0,2,"A",0,1,"A",1.97,3.35,4.47,"0-1","0-2",12,2,8,3,1,4,0,0,5,3,16,16,2,8,32,"5-3","Y","N","N",5,0,1
"2145","I2",2023-08-26,"Venezia","Cosenza",1,1,"D",0,1,"A",1.78,3.64,5.16,"0-1","1-1",20,4,4,1,1,1,0,0,8,2,6,9,2,10,15,"8-2","Y","N","N",2,0,1
"2146","I2",2023-08-26,"Como","Reggiana",2,2,"D",1,0,"H",2.09,3.46,3.82,"1-0","2-2",10,4,12,5,3,2,0,0,3,4,18,14,4,7,32,"3-4","Y","Y","Y",5,0,2
"2147","I2",2023-08-26,"Cremonese","Bari",0,1,"A",0,1,"A",2.04,3.41,4.08,"0-1","0-1",25,5,7,1,1,3,0,0,5,4,9,10,1,9,19,"5-4","N","N","N",4,0,2
"2148","I2",2023-08-26,"FeralpiSalo","Sudtirol",0,2,"A",0,1,"A",2.71,3.07,3,"0-1","0-2",7,1,9,4,2,3,0,0,6,1,16,12,2,7,28,"6-1","Y","N","N",5,0,2
"2149","I2",2023-08-26,"Modena","Ascoli",1,0,"H",0,0,"D",1.95,3.25,4.78,"0-0","1-0",13,3,8,5,1,1,0,1,9,1,12,17,1,10,29,"9-1","N","N","N",2,1,2
"2150","I2",2023-08-26,"Parma","Cittadella",2,0,"H",1,0,"H",1.89,3.42,4.77,"1-0","2-0",10,3,19,0,1,2,0,0,2,11,16,14,2,13,30,"2-11","Y","N","N",3,0,2
"2151","I2",2023-08-27,"Catanzaro","Ternana",2,1,"H",1,1,"D",2.31,3.34,3.38,"1-1","2-1",15,5,25,7,1,2,0,0,4,7,16,9,3,11,25,"4-7","Y","Y","N",3,0,2
"2152","I2",2023-08-29,"Ascoli","FeralpiSalo",3,0,"H",2,0,"H",1.95,3.53,4.28,"2-0","3-0",19,5,5,4,0,3,0,0,7,3,12,14,3,10,26,"7-3","Y","Y","N",3,0,2
"2153","I2",2023-08-29,"Cosenza","Modena",1,2,"A",1,1,"D",2.55,3.24,3.06,"1-1","1-2",12,2,10,5,4,2,0,0,6,4,12,10,3,10,22,"6-4","Y","Y","N",6,0,2
"2154","I2",2023-08-29,"Pisa","Parma",1,2,"A",0,1,"A",2.6,2.98,3.25,"0-1","1-2",16,2,9,2,1,3,1,1,7,4,11,15,3,11,26,"7-4","Y","Y","N",4,2,2
"2155","I2",2023-08-29,"Reggiana","Palermo",1,3,"A",0,1,"A",3.22,3.29,2.42,"0-1","1-3",15,2,18,9,3,0,1,0,7,3,18,9,4,10,27,"7-3","Y","Y","Y",3,1,2
"2156","I2",2023-08-30,"Bari","Cittadella",1,1,"D",1,0,"H",2.37,3.13,3.51,"1-0","1-1",14,4,17,5,1,1,0,0,1,8,12,12,2,9,24,"1-8","Y","N","N",2,0,3
"2157","I2",2023-08-30,"Catanzaro","Spezia",3,0,"H",0,0,"D",3.09,3.4,2.44,"0-0","3-0",10,5,8,2,2,3,1,0,6,5,21,14,3,11,35,"6-5","Y","Y","N",5,1,3
"2158","I2",2023-08-30,"Sampdoria","Venezia",1,2,"A",0,0,"D",2.21,3.55,3.39,"0-0","1-2",17,5,13,5,5,0,0,0,7,4,7,10,3,11,17,"7-4","Y","Y","N",5,0,3
"2159","I2",2023-08-30,"Ternana","Cremonese",0,1,"A",0,0,"D",3.36,3.28,2.35,"0-0","0-1",10,4,17,4,2,3,0,1,8,5,10,8,1,13,18,"8-5","N","N","N",5,1,3
"2160","I2",2023-09-02,"Modena","Pisa",2,0,"H",1,0,"H",2.53,2.95,3.41,"1-0","2-0",14,4,6,2,2,2,0,1,7,7,10,13,2,14,23,"7-7","Y","N","N",4,1,3
"2161","I2",2023-09-02,"Palermo","FeralpiSalo",3,0,"H",1,0,"H",1.67,3.91,5.68,"1-0","3-0",16,6,8,0,1,1,0,0,5,6,8,14,3,11,22,"5-6","Y","Y","N",2,0,3
"2162","I2",2023-09-02,"Parma","Reggiana",0,0,"D",0,0,"D",1.7,3.77,5.59,"0-0","0-0",18,4,8,1,2,2,0,0,6,2,7,15,0,8,22,"6-2","N","N","N",4,0,3
"2163","I2",2023-09-02,"Sudtirol","Ascoli",3,1,"H",0,1,"A",2.33,2.9,3.95,"0-1","3-1",7,4,14,4,2,4,0,0,0,8,11,16,4,8,27,"0-8","Y","Y","Y",6,0,3
"2164","I2",2023-09-03,"Brescia","Cosenza",1,0,"H",0,0,"D",2.17,3.28,3.8,"0-0","1-0",7,1,13,1,4,2,0,1,5,7,18,18,1,12,36,"5-7","N","N","N",6,1,3
"2165","I2",2023-09-03,"Cremonese","Sampdoria",1,1,"D",1,0,"H",2.07,3.43,3.88,"1-0","1-1",19,11,8,4,2,4,0,0,3,2,12,14,2,5,26,"3-2","Y","N","N",6,0,3
"2166","I2",2023-09-03,"Lecco","Catanzaro",3,4,"A",0,1,"A",NA,NA,NA,"0-1","3-4",17,7,20,8,2,1,0,0,3,6,10,7,7,9,17,"3-6","Y","Y","Y",3,0,4
"2167","I2",2023-09-03,"Spezia","Como",0,1,"A",0,1,"A",1.81,3.42,5.44,"0-1","0-1",9,1,12,5,5,4,0,0,6,6,19,14,1,12,33,"6-6","N","N","N",9,0,4
"2168","I2",2023-09-03,"Ternana","Bari",0,0,"D",0,0,"D",2.76,3.1,2.92,"0-0","0-0",13,2,10,1,3,2,0,0,3,3,14,16,0,6,30,"3-3","N","N","N",5,0,4
"2169","I2",2023-09-03,"Cittadella","Venezia",0,0,"D",0,0,"D",2.57,3.15,3.12,"0-0","0-0",8,4,10,3,3,2,0,0,5,5,13,12,0,10,25,"5-5","N","N","N",5,0,4
"2170","I2",2023-09-15,"Venezia","Spezia",1,0,"H",0,0,"D",2.2,3.51,3.48,"0-0","1-0",9,3,23,7,2,3,0,0,3,5,17,15,1,8,32,"3-5","N","N","N",5,0,4
"2171","I2",2023-09-16,"Ascoli","Palermo",0,1,"A",0,0,"D",3.56,3.3,2.25,"0-0","0-1",16,1,11,4,0,2,0,0,8,10,21,7,1,18,28,"8-10","N","N","N",2,0,4
"2172","I2",2023-09-16,"Cosenza","Sudtirol",2,2,"D",1,0,"H",2.33,3.08,3.66,"1-0","2-2",12,5,6,2,4,1,0,0,5,2,10,13,4,7,23,"5-2","Y","Y","Y",5,0,4
"2173","I2",2023-09-16,"FeralpiSalo","Modena",1,1,"D",1,1,"D",3.59,3.28,2.25,"1-1","1-1",10,1,17,6,4,4,1,0,4,7,15,7,2,11,22,"4-7","Y","N","N",8,1,4
"2174","I2",2023-09-16,"Lecco","Brescia",0,2,"A",0,1,"A",2.91,3.23,2.67,"0-1","0-2",24,7,11,5,3,2,0,0,7,5,16,19,2,12,35,"7-5","Y","N","N",5,0,4
"2175","I2",2023-09-16,"Pisa","Bari",1,1,"D",1,0,"H",2.17,3.23,3.87,"1-0","1-1",7,1,10,3,4,2,1,0,3,5,10,17,2,8,27,"3-5","Y","N","N",6,1,4
"2176","I2",2023-09-16,"Reggiana","Cremonese",2,2,"D",2,0,"H",3.35,3.22,2.39,"2-0","2-2",7,5,37,8,0,1,0,0,0,14,10,5,4,14,15,"0-14","Y","Y","Y",1,0,5
"2177","I2",2023-09-17,"Catanzaro","Parma",0,5,"A",0,3,"A",2.25,3.39,3.47,"0-3","0-5",12,2,10,7,1,4,0,0,8,3,13,5,5,11,18,"8-3","Y","Y","Y",5,0,5
"2178","I2",2023-09-17,"Como","Ternana",2,1,"H",0,0,"D",2.1,3.45,3.76,"0-0","2-1",19,5,10,4,2,2,0,0,1,3,13,16,3,4,29,"1-3","Y","Y","N",4,0,5
"2179","I2",2023-09-18,"Sampdoria","Cittadella",1,2,"A",1,0,"H",2.33,3.33,3.29,"1-0","1-2",12,5,11,6,3,3,0,0,2,4,22,13,3,6,35,"2-4","Y","Y","N",6,0,5
"2180","I2",2023-09-22,"Palermo","Cosenza",0,1,"A",0,0,"D",1.77,3.6,5.36,"0-0","0-1",19,6,14,4,1,3,0,0,4,2,11,11,1,6,22,"4-2","N","N","N",4,0,5
"2181","I2",2023-09-23,"Brescia","Venezia",0,0,"D",0,0,"D",3.31,3.1,2.48,"0-0","0-0",11,3,15,0,3,2,0,0,3,8,12,7,0,11,19,"3-8","N","N","N",5,0,5
"2182","I2",2023-09-23,"Cremonese","Ascoli",2,2,"D",1,1,"D",1.7,3.82,5.54,"1-1","2-2",13,4,17,8,3,4,1,1,6,5,16,11,4,11,27,"6-5","Y","Y","Y",7,2,5
"2183","I2",2023-09-23,"FeralpiSalo","Pisa",0,1,"A",0,0,"D",3.29,3.16,2.46,"0-0","0-1",12,3,16,4,3,4,0,0,4,4,19,11,1,8,30,"4-4","N","N","N",7,0,5
"2184","I2",2023-09-23,"Modena","Lecco",0,0,"D",0,0,"D",1.6,3.86,6.89,"0-0","0-0",17,5,14,4,3,1,0,0,8,8,15,7,0,16,22,"8-8","N","N","N",4,0,5
"2185","I2",2023-09-23,"Ternana","Sudtirol",1,1,"D",1,0,"H",2.19,3.22,3.83,"1-0","1-1",10,3,10,3,3,1,0,0,5,7,10,17,2,12,27,"5-7","Y","N","N",4,0,5
"2186","I2",2023-09-23,"Spezia","Reggiana",1,2,"A",0,0,"D",1.93,3.56,4.38,"0-0","1-2",15,3,11,4,3,5,0,0,7,5,13,16,3,12,29,"7-5","Y","Y","N",8,0,6
"2187","I2",2023-09-24,"Bari","Catanzaro",2,2,"D",1,2,"A",2.45,3.14,3.32,"1-2","2-2",12,4,11,5,1,4,0,1,2,4,13,17,4,6,30,"2-4","Y","Y","Y",5,1,6
"2188","I2",2023-09-24,"Cittadella","Como",0,3,"A",0,2,"A",2.12,3.31,3.95,"0-2","0-3",12,3,9,4,1,2,0,0,5,2,21,13,3,7,34,"5-2","Y","Y","N",3,0,6
"2189","I2",2023-09-24,"Parma","Sampdoria",1,1,"D",0,1,"A",2.15,3.45,3.66,"0-1","1-1",12,7,8,3,3,5,0,0,9,1,11,15,2,10,26,"9-1","Y","N","N",8,0,6
"2190","I2",2023-09-26,"Cosenza","Cremonese",1,2,"A",0,0,"D",3.31,3.24,2.4,"0-0","1-2",9,4,20,4,2,1,0,0,4,7,9,15,3,11,24,"4-7","Y","Y","N",3,0,6
"2191","I2",2023-09-26,"Lecco","FeralpiSalo",1,2,"A",0,0,"D",2.56,3.12,3.17,"0-0","1-2",13,3,12,4,2,3,0,0,4,1,10,13,3,5,23,"4-1","Y","Y","N",5,0,6
"2192","I2",2023-09-26,"Ascoli","Ternana",2,0,"H",1,0,"H",2.4,3.22,3.34,"1-0","2-0",13,5,17,3,2,3,0,0,2,8,20,13,2,10,33,"2-8","Y","N","N",5,0,6
"2193","I2",2023-09-26,"Reggiana","Pisa",0,0,"D",0,0,"D",2.61,3.13,3.08,"0-0","0-0",13,2,12,5,4,4,0,0,3,2,16,12,0,5,28,"3-2","N","N","N",8,0,6
"2194","I2",2023-09-26,"Spezia","Brescia",0,0,"D",0,0,"D",1.84,3.68,4.65,"0-0","0-0",12,5,11,3,1,2,0,0,7,5,8,16,0,12,24,"7-5","N","N","N",3,0,6
"2195","I2",2023-09-26,"Sudtirol","Modena",0,0,"D",0,0,"D",3.11,2.83,2.83,"0-0","0-0",7,1,25,2,1,2,0,0,5,3,13,6,0,8,19,"5-3","N","N","N",3,0,6
"2196","I2",2023-09-26,"Venezia","Palermo",1,3,"A",1,1,"D",2.49,3.27,3.13,"1-1","1-3",17,1,7,4,1,2,0,0,8,1,10,10,4,9,20,"8-1","Y","Y","Y",3,0,7
"2197","I2",2023-09-27,"Catanzaro","Cittadella",1,1,"D",1,1,"D",2.34,3.13,3.54,"1-1","1-1",14,8,10,3,0,3,0,0,5,2,12,14,2,7,26,"5-2","Y","N","N",3,0,7
"2198","I2",2023-09-27,"Como","Sampdoria",1,0,"H",0,0,"D",2.43,3.4,3.1,"0-0","1-0",8,4,13,5,2,5,0,0,2,5,17,15,1,7,32,"2-5","N","N","N",7,0,7
"2199","I2",2023-09-27,"Parma","Bari",2,1,"H",1,0,"H",1.94,3.45,4.44,"1-0","2-1",12,5,14,4,1,3,0,0,5,3,16,12,3,8,28,"5-3","Y","Y","N",4,0,7
"2200","I2",2023-09-30,"Brescia","Ascoli",1,1,"D",0,1,"A",2.23,3.28,3.63,"0-1","1-1",21,3,9,3,2,3,0,0,7,2,13,11,2,9,24,"7-2","Y","N","N",5,0,7
"2201","I2",2023-09-30,"FeralpiSalo","Spezia",1,2,"A",0,2,"A",3.53,3.27,2.28,"0-2","1-2",9,3,13,5,1,6,0,0,2,5,16,17,3,7,33,"2-5","Y","Y","N",7,0,7
"2202","I2",2023-09-30,"Modena","Venezia",1,3,"A",0,0,"D",2.53,3.32,3.02,"0-0","1-3",14,4,9,4,2,2,0,0,7,3,9,5,4,10,14,"7-3","Y","Y","Y",4,0,7
"2203","I2",2023-09-30,"Pisa","Cosenza",1,2,"A",0,1,"A",1.88,3.63,4.45,"0-1","1-2",8,6,15,5,3,6,1,0,2,3,13,13,3,5,26,"2-3","Y","Y","N",9,1,7
"2204","I2",2023-09-30,"Ternana","Reggiana",3,0,"H",2,0,"H",2.17,3.37,3.7,"2-0","3-0",13,7,10,3,6,3,0,0,3,2,13,9,3,5,22,"3-2","Y","Y","N",9,0,7
"2205","I2",2023-10-01,"Bari","Como",1,1,"D",0,0,"D",2.44,3.2,3.28,"0-0","1-1",18,5,9,6,3,4,0,1,6,4,18,16,2,10,34,"6-4","Y","N","N",7,1,7
"2206","I2",2023-10-01,"Cittadella","Lecco",2,1,"H",0,1,"A",1.66,4.02,5.52,"0-1","2-1",15,5,16,6,4,4,0,0,4,5,26,10,3,9,36,"4-5","Y","Y","N",8,0,8
"2207","I2",2023-10-01,"Palermo","Sudtirol",2,1,"H",0,1,"A",1.64,3.91,5.96,"0-1","2-1",24,6,8,2,5,3,0,0,13,1,15,17,3,14,32,"13-1","Y","Y","N",8,0,8
"2208","I2",2023-10-01,"Sampdoria","Catanzaro",1,2,"A",1,2,"A",2.19,3.55,3.46,"1-2","1-2",17,6,4,3,1,4,0,0,11,2,12,23,3,13,35,"11-2","Y","Y","N",5,0,8
"2209","I2",2023-10-01,"Cremonese","Parma",1,2,"A",0,0,"D",2.19,3.4,3.61,"0-0","1-2",15,3,9,3,1,1,0,0,2,4,12,13,3,6,25,"2-4","Y","Y","N",2,0,8
"2210","I2",2023-10-06,"Brescia","FeralpiSalo",1,1,"D",0,1,"A",1.93,3.32,4.76,"0-1","1-1",19,4,16,6,2,3,0,0,2,5,13,11,2,7,24,"2-5","Y","N","N",5,0,8
"2211","I2",2023-10-07,"Cosenza","Lecco",3,0,"H",2,0,"H",1.8,3.44,5.42,"2-0","3-0",22,8,15,6,2,3,0,0,4,3,11,7,3,7,18,"4-3","Y","Y","N",5,0,8
"2212","I2",2023-10-07,"Modena","Palermo",0,2,"A",0,0,"D",2.64,3.07,3.09,"0-0","0-2",11,2,11,4,2,3,1,0,7,2,11,11,2,9,22,"7-2","Y","N","N",5,1,8
"2213","I2",2023-10-07,"Reggiana","Bari",1,1,"D",1,1,"D",2.75,3.15,2.89,"1-1","1-1",14,3,10,2,2,1,0,0,6,9,11,18,2,15,29,"6-9","Y","N","N",3,0,8
"2214","I2",2023-10-07,"Sudtirol","Catanzaro",0,1,"A",0,1,"A",2.64,2.99,3.18,"0-1","0-1",9,3,13,6,1,3,0,0,4,4,11,10,1,8,21,"4-4","N","N","N",4,0,8
"2215","I2",2023-10-07,"Ascoli","Sampdoria",1,1,"D",1,0,"H",2.64,3.24,2.95,"1-0","1-1",14,4,12,4,2,4,0,0,6,1,20,14,2,7,34,"6-1","Y","N","N",6,0,8
"2216","I2",2023-10-07,"Cittadella","Ternana",2,2,"D",2,1,"H",2.27,3.27,3.56,"2-1","2-2",12,4,17,5,2,1,0,0,3,4,10,11,4,7,21,"3-4","Y","Y","Y",3,0,9
"2217","I2",2023-10-07,"Venezia","Parma",3,2,"H",0,0,"D",2.55,3.35,2.97,"0-0","3-2",12,5,15,4,0,2,0,0,5,8,5,8,5,13,13,"5-8","Y","Y","Y",2,0,9
"2218","I2",2023-10-08,"Como","Cremonese",1,3,"A",0,2,"A",2.82,3.26,2.73,"0-2","1-3",16,5,10,3,0,3,0,1,10,6,7,12,4,16,19,"10-6","Y","Y","Y",3,1,9
"2219","I2",2023-10-08,"Spezia","Pisa",0,0,"D",0,0,"D",1.92,3.32,4.84,"0-0","0-0",20,6,10,3,3,2,1,0,6,3,11,12,0,9,23,"6-3","N","N","N",5,1,9
"2220","I2",2023-10-20,"Parma","Como",2,1,"H",1,0,"H",1.99,3.42,4.28,"1-0","2-1",14,4,18,6,2,2,0,0,3,4,11,10,3,7,21,"3-4","Y","Y","N",4,0,9
"2221","I2",2023-10-21,"Bari","Modena",1,1,"D",0,0,"D",2.3,3.19,3.58,"0-0","1-1",11,3,10,4,3,5,0,0,8,4,26,11,2,12,37,"8-4","Y","N","N",8,0,9
"2222","I2",2023-10-21,"Cremonese","Sudtirol",0,1,"A",0,0,"D",1.67,3.8,5.89,"0-0","0-1",20,6,9,4,3,2,0,0,11,8,11,8,1,19,19,"11-8","N","N","N",5,0,9
"2223","I2",2023-10-21,"Lecco","Ascoli",0,2,"A",0,1,"A",2.7,3.41,2.75,"0-1","0-2",12,4,14,5,3,2,0,0,5,2,15,14,2,7,29,"5-2","Y","N","N",5,0,9
"2224","I2",2023-10-21,"Pisa","Cittadella",2,1,"H",1,0,"H",2.29,2.94,3.28,"1-0","2-1",13,6,15,4,3,3,0,0,6,7,14,14,3,13,28,"6-7","Y","Y","N",6,0,9
"2225","I2",2023-10-21,"Ternana","Brescia",0,1,"A",0,0,"D",2.45,3.24,3.21,"0-0","0-1",9,0,14,5,3,1,1,0,4,4,7,9,1,8,16,"4-4","N","N","N",4,1,9
"2226","I2",2023-10-21,"Catanzaro","FeralpiSalo",3,0,"H",0,0,"D",1.64,4.17,5.48,"0-0","3-0",11,6,7,2,3,2,0,0,5,4,13,11,3,9,24,"5-4","Y","Y","N",5,0,10
"2227","I2",2023-10-22,"Sampdoria","Cosenza",2,0,"H",0,0,"D",2.07,3.45,3.93,"0-0","2-0",17,5,14,5,3,5,0,0,4,4,15,16,2,8,31,"4-4","Y","N","N",8,0,10
"2228","I2",2023-10-22,"Reggiana","Venezia",1,0,"H",0,0,"D",2.9,3.37,2.59,"0-0","1-0",11,2,15,5,3,5,0,1,5,9,13,15,1,14,28,"5-9","N","N","N",8,1,10
"2229","I2",2023-10-23,"Palermo","Spezia",2,2,"D",0,1,"A",2.02,3.36,3.39,"0-1","2-2",16,7,10,5,3,6,0,1,4,5,14,12,4,9,26,"4-5","Y","Y","Y",9,1,10
"2230","I2",2023-10-24,"Brescia","Modena",0,1,"A",0,0,"D",2.79,3.08,2.91,"0-0","0-1",6,0,14,3,3,3,0,0,2,7,13,20,1,9,33,"2-7","N","N","N",6,0,10
"2231","I2",2023-10-24,"Pisa","Lecco",1,2,"A",0,1,"A",1.67,3.78,5.95,"0-1","1-2",24,4,10,2,3,4,0,0,8,1,11,13,3,9,24,"8-1","Y","Y","N",7,0,10
"2232","I2",2023-10-27,"Cittadella","Cremonese",1,2,"A",0,0,"D",3.35,3.3,2.35,"0-0","1-2",8,3,20,4,4,1,0,0,4,8,15,13,3,12,28,"4-8","Y","Y","N",5,0,10
"2233","I2",2023-10-28,"Como","Catanzaro",1,0,"H",1,0,"H",2.26,3.34,3.49,"1-0","1-0",15,2,9,4,4,0,0,0,4,4,6,21,1,8,27,"4-4","N","N","N",4,0,10
"2234","I2",2023-10-28,"FeralpiSalo","Reggiana",0,3,"A",0,2,"A",2.58,3.04,3.22,"0-2","0-3",19,4,9,9,2,1,0,0,6,3,15,14,3,9,29,"6-3","Y","Y","N",3,0,10
"2235","I2",2023-10-28,"Spezia","Cosenza",0,0,"D",0,0,"D",1.96,3.49,4.32,"0-0","0-0",19,5,13,3,3,5,0,0,8,4,11,14,0,12,25,"8-4","N","N","N",8,0,10
"2236","I2",2023-10-28,"Sudtirol","Sampdoria",3,1,"H",0,0,"D",2.74,3.26,2.81,"0-0","3-1",9,3,16,4,3,3,0,0,2,9,15,14,4,11,29,"2-9","Y","Y","Y",6,0,11
"2237","I2",2023-10-28,"Ascoli","Parma",1,3,"A",1,2,"A",3.6,3.13,2.32,"1-2","1-3",13,4,9,4,7,2,1,0,9,8,12,12,4,17,24,"9-8","Y","Y","Y",9,1,11
"2238","I2",2023-10-29,"Brescia","Bari",1,2,"A",1,0,"H",2.94,3.05,2.78,"1-0","1-2",16,3,19,6,3,3,0,0,2,5,16,21,3,7,37,"2-5","Y","Y","N",6,0,11
"2239","I2",2023-10-29,"Modena","Ternana",2,1,"H",1,0,"H",2.07,3.48,3.87,"1-0","2-1",19,5,13,3,3,2,0,0,5,5,13,9,3,10,22,"5-5","Y","Y","N",5,0,11
"2240","I2",2023-10-29,"Palermo","Lecco",1,2,"A",0,2,"A",1.47,4.72,7.28,"0-2","1-2",26,9,12,7,2,2,0,0,6,5,10,15,3,11,25,"6-5","Y","Y","N",4,0,11
"2241","I2",2023-10-29,"Venezia","Pisa",2,1,"H",1,1,"D",2.18,3.27,3.78,"1-1","2-1",13,3,8,3,2,4,0,0,6,4,8,11,3,10,19,"6-4","Y","Y","N",6,0,11
"2242","I2",2023-11-04,"Bari","Ascoli",1,0,"H",0,0,"D",2.04,3.18,4.45,"0-0","1-0",18,3,7,3,3,4,0,0,10,7,15,17,1,17,32,"10-7","N","N","N",7,0,11
"2243","I2",2023-11-04,"Catanzaro","Modena",1,2,"A",1,1,"D",2.35,3.46,3.19,"1-1","1-2",10,5,9,4,2,4,0,0,2,2,27,13,3,4,40,"2-2","Y","Y","N",6,0,11
"2244","I2",2023-11-04,"Cittadella","Brescia",3,2,"H",2,1,"H",2.59,2.99,3.26,"2-1","3-2",16,5,16,4,2,3,0,0,5,4,12,14,5,9,26,"5-4","Y","Y","Y",5,0,11
"2245","I2",2023-11-04,"Cosenza","FeralpiSalo",1,1,"D",1,0,"H",1.85,3.57,4.74,"1-0","1-1",8,3,19,5,2,4,0,0,6,8,12,13,2,14,25,"6-8","Y","N","N",6,0,11
"2246","I2",2023-11-04,"Pisa","Como",1,1,"D",0,1,"A",2.28,3.26,3.54,"0-1","1-1",15,4,12,2,3,3,0,0,4,6,11,10,2,10,21,"4-6","Y","N","N",6,0,12
"2247","I2",2023-11-04,"Ternana","Venezia",0,1,"A",0,0,"D",2.73,3.19,2.67,"0-0","0-1",11,2,8,2,1,2,0,0,4,4,14,8,1,8,22,"4-4","N","N","N",3,0,12
"2248","I2",2023-11-04,"Sampdoria","Palermo",1,0,"H",1,0,"H",3.01,3.33,2.53,"1-0","1-0",16,6,9,4,4,1,0,0,2,8,16,17,1,10,33,"2-8","N","N","N",5,0,12
"2249","I2",2023-11-05,"Cremonese","Spezia",3,0,"H",2,0,"H",2.04,3.48,4,"2-0","3-0",21,12,17,5,3,1,0,1,5,7,10,15,3,12,25,"5-7","Y","Y","N",4,1,12
"2250","I2",2023-11-05,"Parma","Sudtirol",2,0,"H",1,0,"H",1.64,3.9,6.05,"1-0","2-0",10,3,10,2,0,5,0,0,4,3,13,14,2,7,27,"4-3","Y","N","N",5,0,12
"2251","I2",2023-11-05,"Reggiana","Lecco",1,1,"D",1,0,"H",1.81,3.76,4.71,"1-0","1-1",16,6,16,4,4,3,0,0,2,7,15,10,2,9,25,"2-7","Y","N","N",7,0,12
"2252","I2",2023-11-08,"Lecco","Spezia",0,0,"D",0,0,"D",3.85,3.56,2.05,"0-0","0-0",20,4,17,4,3,6,0,0,5,2,17,14,0,7,31,"5-2","N","N","N",9,0,12
"2253","I2",2023-11-08,"Palermo","Brescia",1,0,"H",1,0,"H",1.69,3.87,5.56,"1-0","1-0",9,3,18,4,3,4,0,0,2,4,19,8,1,6,27,"2-4","N","N","N",7,0,12
"2254","I2",2023-11-10,"Venezia","Catanzaro",2,1,"H",2,1,"H",2.06,3.4,4.02,"2-1","2-1",10,5,6,2,2,1,1,0,1,3,8,17,3,4,25,"1-3","Y","Y","N",3,1,12
"2255","I2",2023-11-11,"Ascoli","Como",0,1,"A",0,1,"A",3.04,3.01,2.73,"0-1","0-1",8,4,9,3,3,5,0,0,3,3,19,19,1,6,38,"3-3","N","N","N",8,0,12
"2256","I2",2023-11-11,"Cosenza","Reggiana",2,0,"H",1,0,"H",2.16,3.35,3.75,"1-0","2-0",12,5,6,2,4,3,0,0,3,2,16,9,2,5,25,"3-2","Y","N","N",7,0,13
"2257","I2",2023-11-11,"FeralpiSalo","Bari",3,3,"D",0,1,"A",3.5,3.07,2.4,"0-1","3-3",11,5,15,5,4,5,0,0,1,3,19,18,6,4,37,"1-3","Y","Y","Y",9,0,13
"2258","I2",2023-11-11,"Sudtirol","Pisa",1,2,"A",0,1,"A",2.73,2.95,3.11,"0-1","1-2",10,2,8,5,2,6,0,0,3,0,20,15,3,3,35,"3-0","Y","Y","N",8,0,13
"2259","I2",2023-11-11,"Modena","Sampdoria",0,2,"A",0,1,"A",2.15,3.16,4.04,"0-1","0-2",8,2,14,4,5,3,1,0,5,2,13,13,2,7,26,"5-2","Y","N","N",8,1,13
"2260","I2",2023-11-12,"Brescia","Cremonese",0,3,"A",0,2,"A",3.79,3.39,2.11,"0-2","0-3",15,1,25,5,3,3,0,0,4,9,11,13,3,13,24,"4-9","Y","Y","N",6,0,13
"2261","I2",2023-11-12,"Lecco","Parma",3,2,"H",2,1,"H",4.54,3.9,1.81,"2-1","3-2",16,7,12,7,3,4,0,1,5,3,10,13,5,8,23,"5-3","Y","Y","Y",7,1,13
"2262","I2",2023-11-12,"Palermo","Cittadella",0,1,"A",0,0,"D",1.73,3.92,5.06,"0-0","0-1",10,0,15,3,1,4,0,0,2,4,15,11,1,6,26,"2-4","N","N","N",5,0,13
"2263","I2",2023-11-12,"Spezia","Ternana",2,2,"D",1,1,"D",1.85,3.61,4.62,"1-1","2-2",22,9,13,5,2,3,0,0,4,5,19,16,4,9,35,"4-5","Y","Y","Y",5,0,13
"2264","I2",2023-11-24,"Sampdoria","Spezia",2,1,"H",1,1,"D",2.31,3.29,3.44,"1-1","2-1",14,4,9,2,5,4,0,0,2,6,19,19,3,8,38,"2-6","Y","Y","N",9,0,13
"2265","I2",2023-11-25,"Bari","Venezia",0,3,"A",0,1,"A",2.63,3.01,2.92,"0-1","0-3",17,4,13,6,3,0,0,0,8,2,7,14,3,10,21,"8-2","Y","Y","N",3,0,13
"2266","I2",2023-11-25,"Cittadella","Sudtirol",2,1,"H",1,0,"H",1.94,3.14,4.44,"1-0","2-1",14,6,5,2,3,5,0,0,5,2,14,13,3,7,27,"5-2","Y","Y","N",8,0,14
"2267","I2",2023-11-25,"Como","FeralpiSalo",2,1,"H",1,0,"H",1.65,3.77,5.24,"1-0","2-1",14,7,11,3,2,2,1,1,3,5,8,12,3,8,20,"3-5","Y","Y","N",4,2,14
"2268","I2",2023-11-25,"Cremonese","Lecco",1,0,"H",1,0,"H",1.38,4.85,7.42,"1-0","1-0",16,2,11,3,4,2,0,0,6,7,11,19,1,13,30,"6-7","N","N","N",6,0,14
"2269","I2",2023-11-25,"Parma","Modena",1,1,"D",0,0,"D",2.03,3.26,3.87,"0-0","1-1",18,7,6,1,3,2,1,0,10,5,9,16,2,15,25,"10-5","Y","N","N",5,1,14
"2270","I2",2023-11-25,"Reggiana","Ascoli",1,1,"D",0,1,"A",2.32,3.13,3.3,"0-1","1-1",18,3,6,3,2,4,0,0,9,5,11,11,2,14,22,"9-5","Y","N","N",6,0,14
"2271","I2",2023-11-25,"Pisa","Brescia",1,1,"D",1,1,"D",2.08,3.08,4,"1-1","1-1",12,2,18,7,2,2,0,0,3,6,9,8,2,9,17,"3-6","Y","N","N",4,0,14
"2272","I2",2023-11-26,"Catanzaro","Cosenza",2,0,"H",1,0,"H",1.88,3.43,4.19,"1-0","2-0",12,3,14,4,3,4,0,0,6,8,21,16,2,14,37,"6-8","Y","N","N",7,0,14
"2273","I2",2023-11-26,"Ternana","Palermo",1,1,"D",0,1,"A",3.19,3.26,2.28,"0-1","1-1",16,4,16,5,3,2,1,0,7,8,8,10,2,15,18,"7-8","Y","N","N",5,1,14
"2274","I2",2023-11-28,"Como","Lecco",0,0,"D",0,0,"D",1.69,3.97,5.35,"0-0","0-0",16,3,11,4,2,3,0,0,3,2,11,14,0,5,25,"3-2","N","N","N",5,0,14
"2275","I2",2023-11-28,"Sudtirol","Brescia",1,1,"D",1,0,"H",2.55,2.91,3.44,"1-0","1-1",10,4,8,3,1,4,0,1,5,5,18,15,2,10,33,"5-5","Y","N","N",5,1,14
"2276","I2",2023-12-01,"Palermo","Catanzaro",1,2,"A",0,1,"A",1.98,3.44,4.27,"0-1","1-2",14,8,17,7,4,5,0,0,8,4,9,19,3,12,28,"8-4","Y","Y","N",9,0,15
"2277","I2",2023-12-02,"Cosenza","Ternana",1,3,"A",0,0,"D",2.19,3.44,3.55,"0-0","1-3",18,6,16,7,2,4,1,0,11,4,14,9,4,15,23,"11-4","Y","Y","Y",6,1,15
"2278","I2",2023-12-02,"FeralpiSalo","Cittadella",0,1,"A",0,1,"A",3.22,3.09,2.54,"0-1","0-1",14,4,9,5,2,2,0,0,6,2,18,11,1,8,29,"6-2","N","N","N",4,0,15
"2279","I2",2023-12-02,"Modena","Reggiana",2,1,"H",1,0,"H",1.9,3.64,4.38,"1-0","2-1",12,7,8,3,2,4,0,1,6,6,17,20,3,12,37,"6-6","Y","Y","N",6,1,15
"2280","I2",2023-12-02,"Pisa","Cremonese",0,0,"D",0,0,"D",3.54,3.43,2.2,"0-0","0-0",15,4,10,2,3,4,0,0,5,4,16,9,0,9,25,"5-4","N","N","N",7,0,15
"2281","I2",2023-12-02,"Venezia","Ascoli",3,1,"H",2,0,"H",1.83,3.59,4.92,"2-0","3-1",23,6,17,4,1,3,0,0,6,4,13,12,4,10,25,"6-4","Y","Y","Y",4,0,15
"2282","I2",2023-12-02,"Spezia","Parma",0,1,"A",0,0,"D",2.62,3.35,2.87,"0-0","0-1",6,1,13,6,1,2,0,0,3,7,15,6,1,10,21,"3-7","N","N","N",3,0,15
"2283","I2",2023-12-03,"Brescia","Sampdoria",3,1,"H",3,0,"H",2.94,3.17,2.69,"3-0","3-1",13,4,9,3,4,3,0,0,4,7,15,19,4,11,34,"4-7","Y","Y","Y",7,0,15
"2284","I2",2023-12-03,"Lecco","Bari",1,0,"H",0,0,"D",2.99,3.44,2.48,"0-0","1-0",10,5,13,1,5,3,0,0,3,4,12,13,1,7,25,"3-4","N","N","N",8,0,15
"2285","I2",2023-12-03,"Sudtirol","Como",0,1,"A",0,0,"D",3.26,3.05,2.55,"0-0","0-1",8,1,16,4,1,3,0,0,6,2,8,17,1,8,25,"6-2","N","N","N",4,0,15
"2394","N1",2023-08-11,"Volendam","Vitesse",1,2,"A",1,0,"H",3.47,3.88,2.07,"1-0","1-2",4,4,13,9,3,1,1,0,3,7,12,10,3,10,22,"3-7","Y","Y","N",4,1,1
"2395","N1",2023-08-12,"PSV Eindhoven","Utrecht",2,0,"H",1,0,"H",1.37,5.75,7.93,"1-0","2-0",23,8,7,1,2,1,0,0,4,2,15,14,2,6,29,"4-2","Y","N","N",3,0,1
"2396","N1",2023-08-12,"Heerenveen","Waalwijk",3,1,"H",3,0,"H",1.78,4.1,4.46,"3-0","3-1",19,9,13,5,0,1,0,0,7,2,9,8,4,9,17,"7-2","Y","Y","Y",1,0,1
"2397","N1",2023-08-12,"Ajax","Heracles",4,1,"H",1,1,"D",1.19,8.58,12.96,"1-1","4-1",31,13,7,2,2,5,0,0,13,4,11,14,5,17,25,"13-4","Y","Y","Y",7,0,1
"2398","N1",2023-08-12,"Zwolle","Sparta Rotterdam",1,2,"A",0,1,"A",2.51,3.51,2.91,"0-1","1-2",20,7,9,4,2,4,0,0,7,1,8,15,3,8,23,"7-1","Y","Y","N",6,0,1
"2399","N1",2023-08-13,"Nijmegen","Excelsior",3,4,"A",2,1,"H",1.53,4.76,6,"2-1","3-4",8,6,6,6,1,2,0,0,2,7,4,10,7,9,14,"2-7","Y","Y","Y",3,0,1
"2400","N1",2023-08-13,"AZ Alkmaar","Go Ahead Eagles",5,1,"H",2,0,"H",1.35,5.34,9.01,"2-0","5-1",13,8,9,4,2,3,0,0,5,4,8,13,6,9,21,"5-4","Y","Y","Y",5,0,1
"2401","N1",2023-08-13,"Feyenoord","For Sittard",0,0,"D",0,0,"D",1.17,8.25,16.82,"0-0","0-0",22,6,14,5,0,6,1,0,8,3,4,21,0,11,25,"8-3","N","N","N",6,1,1
"2402","N1",2023-08-13,"Almere City","Twente",1,4,"A",0,0,"D",5.67,4.35,1.6,"0-0","1-4",12,4,20,8,4,0,1,0,2,11,15,10,5,13,25,"2-11","Y","Y","Y",4,1,1
"2403","N1",2023-08-18,"Heracles","Nijmegen",2,1,"H",0,1,"A",2.5,3.68,2.81,"0-1","2-1",16,7,17,4,2,2,0,0,5,9,10,10,3,14,20,"5-9","Y","Y","N",4,0,2
"2404","N1",2023-08-19,"Excelsior","Ajax",2,2,"D",1,1,"D",10.04,6.56,1.27,"1-1","2-2",13,2,15,8,0,0,0,0,4,10,7,7,4,14,14,"4-10","Y","Y","Y",0,0,2
"2405","N1",2023-08-19,"Vitesse","PSV Eindhoven",1,3,"A",1,0,"H",5.98,4.62,1.54,"1-0","1-3",12,2,19,7,0,1,0,0,4,7,7,2,4,11,9,"4-7","Y","Y","Y",1,0,2
"2406","N1",2023-08-19,"For Sittard","Almere City",2,1,"H",2,1,"H",1.97,3.97,3.72,"2-1","2-1",21,7,8,5,3,2,0,0,5,6,8,13,3,11,21,"5-6","Y","Y","N",5,0,2
"2407","N1",2023-08-19,"Go Ahead Eagles","Volendam",4,1,"H",3,0,"H",1.65,4.48,4.94,"3-0","4-1",8,6,19,5,1,3,1,0,4,12,3,8,5,16,11,"4-12","Y","Y","Y",4,1,2
"2408","N1",2023-08-20,"Utrecht","Heerenveen",0,2,"A",0,0,"D",1.83,3.83,4.47,"0-0","0-2",12,6,12,6,0,1,0,0,9,2,11,10,2,11,21,"9-2","Y","N","N",1,0,2
"2409","N1",2023-08-20,"Sparta Rotterdam","Feyenoord",2,2,"D",1,0,"H",5.17,4.61,1.61,"1-0","2-2",10,5,24,8,2,0,0,0,3,12,9,5,4,15,14,"3-12","Y","Y","Y",2,0,2
"2410","N1",2023-08-20,"Twente","Zwolle",3,1,"H",1,1,"D",1.36,5.61,8.29,"1-1","3-1",18,3,9,4,2,5,0,0,8,3,6,15,4,11,21,"8-3","Y","Y","Y",7,0,2
"2411","N1",2023-08-20,"Waalwijk","AZ Alkmaar",1,3,"A",1,0,"H",5.06,4.39,1.65,"1-0","1-3",7,5,15,7,2,1,0,0,1,10,9,12,4,11,21,"1-10","Y","Y","Y",3,0,2
"2412","N1",2023-08-26,"Nijmegen","Waalwijk",3,0,"H",1,0,"H",1.79,4.3,4.19,"1-0","3-0",13,10,10,1,1,2,0,0,2,4,10,9,3,6,19,"2-4","Y","Y","N",3,0,3
"2413","N1",2023-08-26,"Excelsior","For Sittard",2,2,"D",1,0,"H",2.46,3.75,2.82,"1-0","2-2",9,6,13,5,1,1,0,0,0,6,5,9,4,6,14,"0-6","Y","Y","Y",2,0,3
"2414","N1",2023-08-27,"Zwolle","Utrecht",1,0,"H",0,0,"D",2.86,3.83,2.4,"0-0","1-0",9,2,10,1,2,3,0,0,2,8,13,8,1,10,21,"2-8","N","N","N",5,0,3
"2415","N1",2023-08-27,"Feyenoord","Almere City",6,1,"H",3,0,"H",1.16,9.16,16.46,"3-0","6-1",31,18,6,1,0,1,0,0,8,2,8,15,7,10,23,"8-2","Y","Y","Y",1,0,3
"2416","N1",2023-08-27,"Heerenveen","Sparta Rotterdam",1,3,"A",0,1,"A",2.35,3.79,2.95,"0-1","1-3",19,6,16,7,0,0,1,0,6,7,4,8,4,13,12,"6-7","Y","Y","Y",0,1,3
"2417","N1",2023-09-01,"Sparta Rotterdam","Nijmegen",1,1,"D",0,0,"D",1.9,3.83,4.11,"0-0","1-1",15,6,13,6,1,4,0,0,10,1,11,10,2,11,21,"10-1","Y","N","N",5,0,3
"2418","N1",2023-09-02,"Almere City","Zwolle",1,2,"A",0,1,"A",3.26,3.66,2.23,"0-1","1-2",10,3,13,6,3,4,0,1,7,4,12,10,3,11,22,"7-4","Y","Y","N",7,1,3
"2419","N1",2023-09-02,"Go Ahead Eagles","Heerenveen",3,2,"H",2,1,"H",2.21,3.76,3.24,"2-1","3-2",21,7,13,3,3,0,0,1,9,8,10,9,5,17,19,"9-8","Y","Y","Y",3,1,3
"2420","N1",2023-09-02,"Waalwijk","PSV Eindhoven",0,4,"A",0,1,"A",8.33,5.63,1.36,"0-1","0-4",10,3,22,9,0,0,0,0,4,8,1,13,4,12,14,"4-8","Y","Y","Y",0,0,3
"2421","N1",2023-09-02,"Heracles","Excelsior",3,1,"H",0,1,"A",1.84,3.92,4.34,"0-1","3-1",15,5,9,3,1,4,0,1,8,1,6,11,4,9,17,"8-1","Y","Y","Y",5,1,4
"2422","N1",2023-09-03,"Utrecht","Feyenoord",1,5,"A",1,2,"A",4.89,4.55,1.65,"1-2","1-5",5,1,21,11,1,0,0,0,5,8,13,13,6,13,26,"5-8","Y","Y","Y",1,0,4
"2423","N1",2023-09-03,"For Sittard","Ajax",0,0,"D",0,0,"D",7.39,5.51,1.4,"0-0","0-0",12,4,12,4,3,2,0,0,3,7,20,7,0,10,27,"3-7","N","N","N",5,0,4
"2424","N1",2023-09-03,"Volendam","Twente",0,2,"A",0,1,"A",5.22,4.57,1.61,"0-1","0-2",7,2,12,4,1,2,0,0,1,5,10,7,2,6,17,"1-5","Y","N","N",3,0,4
"2425","N1",2023-09-03,"Vitesse","AZ Alkmaar",0,2,"A",0,0,"D",3.62,3.83,2.04,"0-0","0-2",4,2,16,7,3,0,0,0,0,9,12,10,2,9,22,"0-9","Y","N","N",3,0,4
"2426","N1",2023-09-16,"Feyenoord","Heerenveen",6,1,"H",3,1,"H",1.24,6.83,12.31,"3-1","6-1",21,9,7,1,1,0,0,0,6,3,8,9,7,9,17,"6-3","Y","Y","Y",1,0,4
"2427","N1",2023-09-16,"Vitesse","Waalwijk",0,2,"A",0,1,"A",1.53,4.75,5.99,"0-1","0-2",16,2,18,9,1,5,1,0,8,6,9,9,2,14,18,"8-6","Y","N","N",6,1,4
"2428","N1",2023-09-16,"For Sittard","Volendam",3,1,"H",0,1,"A",1.66,4.4,4.99,"0-1","3-1",27,11,7,2,1,0,0,0,15,3,9,6,4,18,15,"15-3","Y","Y","Y",1,0,4
"2429","N1",2023-09-16,"PSV Eindhoven","Nijmegen",4,0,"H",2,0,"H",1.17,8.54,15.69,"2-0","4-0",28,11,3,0,1,2,0,0,8,3,11,11,4,11,22,"8-3","Y","Y","Y",3,0,4
"2430","N1",2023-09-16,"Heracles","Utrecht",1,3,"A",0,2,"A",2.56,3.62,2.78,"0-2","1-3",11,1,11,7,3,3,0,0,4,4,12,13,4,8,25,"4-4","Y","Y","Y",6,0,5
"2431","N1",2023-09-17,"Zwolle","Go Ahead Eagles",1,1,"D",0,0,"D",2.45,3.59,2.93,"0-0","1-1",27,11,9,2,1,4,0,1,11,4,9,6,2,15,15,"11-4","Y","N","N",5,1,5
"2432","N1",2023-09-17,"Excelsior","Almere City",0,0,"D",0,0,"D",2.1,4.05,3.23,"0-0","0-0",14,2,16,3,2,3,0,0,4,5,7,13,0,9,20,"4-5","N","N","N",5,0,5
"2433","N1",2023-09-17,"Twente","Ajax",3,1,"H",2,1,"H",2.58,3.72,2.7,"2-1","3-1",24,9,11,2,1,2,0,0,5,9,13,9,4,14,22,"5-9","Y","Y","Y",3,0,5
"2434","N1",2023-09-17,"AZ Alkmaar","Sparta Rotterdam",2,0,"H",2,0,"H",1.53,4.6,6.13,"2-0","2-0",18,7,10,3,0,3,0,0,9,4,8,5,2,13,13,"9-4","Y","N","N",3,0,5
"2435","N1",2023-09-22,"Go Ahead Eagles","For Sittard",3,0,"H",1,0,"H",2.26,3.7,3.17,"1-0","3-0",20,9,21,2,0,4,0,0,2,5,2,14,3,7,16,"2-5","Y","Y","N",4,0,5
"2436","N1",2023-09-23,"Volendam","Heracles",2,2,"D",0,0,"D",2.86,3.81,2.4,"0-0","2-2",16,6,15,5,1,1,0,0,5,7,14,14,4,12,28,"5-7","Y","Y","Y",2,0,5
"2437","N1",2023-09-23,"Nijmegen","Utrecht",3,0,"H",2,0,"H",2.67,3.67,2.63,"2-0","3-0",9,5,17,4,1,2,0,0,4,4,8,11,3,8,19,"4-4","Y","Y","N",3,0,5
"2438","N1",2023-09-23,"Almere City","PSV Eindhoven",0,4,"A",0,2,"A",13.47,7.38,1.21,"0-2","0-4",9,2,20,9,1,1,0,0,5,8,15,6,4,13,21,"5-8","Y","Y","Y",2,0,5
"2439","N1",2023-09-23,"Heerenveen","Excelsior",0,3,"A",0,2,"A",1.67,4.45,4.82,"0-2","0-3",9,2,7,4,4,2,0,0,3,2,10,11,3,5,21,"3-2","Y","Y","N",6,0,6
"2440","N1",2023-09-24,"Sparta Rotterdam","Vitesse",1,0,"H",1,0,"H",1.91,3.91,3.99,"1-0","1-0",17,5,6,0,1,2,0,0,5,3,13,19,1,8,32,"5-3","N","N","N",3,0,6
"2441","N1",2023-09-24,"Waalwijk","Twente",1,0,"H",0,0,"D",5.91,4.58,1.55,"0-0","1-0",9,3,7,2,1,1,0,0,1,6,12,13,1,7,25,"1-6","N","N","N",2,0,6
"2442","N1",2023-09-24,"Zwolle","AZ Alkmaar",0,3,"A",0,1,"A",4.78,3.99,1.75,"0-1","0-3",7,3,15,5,3,3,0,0,2,6,13,8,3,8,21,"2-6","Y","Y","N",6,0,6
"2443","N1",2023-09-27,"Ajax","Feyenoord",0,4,"A",0,3,"A",2.85,3.86,2.39,"0-3","0-4",9,2,14,7,3,2,0,0,4,0,15,14,4,4,29,"4-0","Y","Y","Y",5,0,6
"2444","N1",2023-09-27,"PSV Eindhoven","Go Ahead Eagles",3,0,"H",1,0,"H",1.17,8.61,14.81,"1-0","3-0",23,11,9,2,0,2,0,0,9,2,10,7,3,11,17,"9-2","Y","Y","N",2,0,6
"2445","N1",2023-09-27,"Twente","Vitesse",1,0,"H",1,0,"H",1.4,5.13,8.1,"1-0","1-0",18,5,10,3,1,4,0,0,5,2,10,15,1,7,25,"5-2","N","N","N",5,0,6
"2446","N1",2023-09-28,"AZ Alkmaar","Heracles",1,1,"D",1,0,"H",1.27,6.44,10.66,"1-0","1-1",21,7,4,2,1,2,0,0,16,0,9,8,2,16,17,"16-0","Y","N","N",3,0,6
"2447","N1",2023-09-30,"Feyenoord","Go Ahead Eagles",3,1,"H",1,0,"H",1.16,9.16,15.85,"1-0","3-1",29,9,7,3,1,2,0,0,11,0,10,11,4,11,21,"11-0","Y","Y","Y",3,0,6
"2448","N1",2023-09-30,"PSV Eindhoven","Volendam",3,1,"H",1,0,"H",1.07,16,31.33,"1-0","3-1",38,17,2,1,1,2,0,1,7,0,11,8,4,7,19,"7-0","Y","Y","Y",3,1,7
"2449","N1",2023-09-30,"Utrecht","Almere City",0,2,"A",0,0,"D",1.56,4.65,5.78,"0-0","0-2",11,2,17,5,4,4,1,0,4,6,18,15,2,10,33,"4-6","Y","N","N",8,1,7
"2450","N1",2023-09-30,"Twente","Heerenveen",1,0,"H",0,0,"D",1.36,5.75,8.23,"0-0","1-0",11,3,5,1,3,1,0,0,8,1,10,12,1,9,22,"8-1","N","N","N",4,0,7
"2451","N1",2023-10-01,"Nijmegen","Vitesse",1,3,"A",1,1,"D",2.19,3.82,3.23,"1-1","1-3",9,5,10,5,2,5,0,0,6,5,9,18,4,11,27,"6-5","Y","Y","Y",7,0,7
"2452","N1",2023-10-01,"Excelsior","Sparta Rotterdam",2,1,"H",0,0,"D",3.59,3.59,2.12,"0-0","2-1",15,7,9,5,4,1,0,0,2,7,9,12,3,9,21,"2-7","Y","Y","N",5,0,7
"2453","N1",2023-10-01,"Heracles","Zwolle",2,1,"H",0,0,"D",2.29,3.82,3.03,"0-0","2-1",13,6,13,5,1,3,0,0,2,2,8,12,3,4,20,"2-2","Y","Y","N",4,0,7
"2454","N1",2023-10-01,"AZ Alkmaar","For Sittard",4,0,"H",1,0,"H",1.39,5.44,7.8,"1-0","4-0",12,7,8,1,1,3,0,0,1,3,14,12,4,4,26,"1-3","Y","Y","Y",4,0,7
"2455","N1",2023-10-06,"Volendam","Utrecht",1,0,"H",0,0,"D",3.93,4.23,1.85,"0-0","1-0",15,5,7,3,3,2,0,1,6,0,20,11,1,6,31,"6-0","N","N","N",5,1,7
"2456","N1",2023-10-07,"Heerenveen","Nijmegen",1,1,"D",1,1,"D",2.18,3.7,3.34,"1-1","1-1",18,7,9,3,1,0,0,0,7,1,4,12,2,8,16,"7-1","Y","N","N",1,0,7
"2457","N1",2023-10-07,"Almere City","Waalwijk",1,0,"H",1,0,"H",2.37,3.92,2.85,"1-0","1-0",18,6,13,4,1,1,0,0,4,3,12,8,1,7,20,"4-3","N","N","N",2,0,8
"2458","N1",2023-10-07,"Go Ahead Eagles","Heracles",4,0,"H",2,0,"H",1.84,4.12,4.11,"2-0","4-0",22,13,17,8,0,2,0,0,9,5,10,11,4,14,21,"9-5","Y","Y","Y",2,0,8
"2459","N1",2023-10-07,"Vitesse","Excelsior",0,0,"D",0,0,"D",1.78,4.2,4.38,"0-0","0-0",21,7,11,5,2,0,0,0,11,5,9,10,0,16,19,"11-5","N","N","N",2,0,8
"2460","N1",2023-10-08,"Zwolle","Feyenoord",0,2,"A",0,1,"A",9.24,6,1.31,"0-1","0-2",4,1,13,5,1,0,0,0,3,4,11,6,2,7,17,"3-4","Y","N","N",1,0,8
"2461","N1",2023-10-08,"Ajax","AZ Alkmaar",1,2,"A",0,1,"A",2.26,3.98,2.98,"0-1","1-2",6,1,12,4,2,1,0,0,6,4,7,12,3,10,19,"6-4","Y","Y","N",3,0,8
"2462","N1",2023-10-08,"For Sittard","Twente",0,3,"A",0,1,"A",3.95,3.83,1.94,"0-1","0-3",3,1,15,6,2,2,1,0,3,7,13,16,3,10,29,"3-7","Y","Y","N",4,1,8
"2463","N1",2023-10-08,"Sparta Rotterdam","PSV Eindhoven",0,4,"A",0,0,"D",8.72,5.45,1.36,"0-0","0-4",8,3,30,11,3,1,0,0,1,8,12,14,4,9,26,"1-8","Y","Y","Y",4,0,8
"2464","N1",2023-10-21,"PSV Eindhoven","For Sittard",3,1,"H",1,0,"H",1.11,12.4,21.49,"1-0","3-1",18,6,2,1,0,1,0,0,10,1,8,5,4,11,13,"10-1","Y","Y","Y",1,0,8
"2465","N1",2023-10-21,"Waalwijk","Volendam",2,1,"H",1,0,"H",1.72,4.63,4.3,"1-0","2-1",10,4,11,3,3,2,0,0,3,4,6,10,3,7,16,"3-4","Y","Y","N",5,0,8
"2466","N1",2023-10-21,"Nijmegen","Almere City",1,1,"D",0,1,"A",1.89,3.86,4.15,"0-1","1-1",12,4,14,2,2,2,1,0,6,5,11,19,2,11,30,"6-5","Y","N","N",4,1,9
"2467","N1",2023-10-21,"AZ Alkmaar","Heerenveen",3,0,"H",1,0,"H",1.29,6.16,10.42,"1-0","3-0",11,3,9,3,1,1,0,0,6,3,3,10,3,9,13,"6-3","Y","Y","N",2,0,9
"2468","N1",2023-10-21,"Feyenoord","Vitesse",4,0,"H",2,0,"H",1.15,9.03,17.56,"2-0","4-0",23,8,4,1,0,1,0,0,9,2,9,6,4,11,15,"9-2","Y","Y","Y",1,0,9
"2469","N1",2023-10-22,"Utrecht","Ajax",4,3,"H",1,0,"H",3.69,4.1,1.94,"1-0","4-3",14,8,11,6,1,2,0,0,6,5,11,9,7,11,20,"6-5","Y","Y","Y",3,0,9
"2470","N1",2023-10-22,"Excelsior","Zwolle",2,4,"A",1,0,"H",2.45,3.69,2.84,"1-0","2-4",18,6,11,6,0,2,0,0,2,4,8,10,6,6,18,"2-4","Y","Y","Y",2,0,9
"2471","N1",2023-10-22,"Heracles","Twente",2,2,"D",0,2,"A",5.38,4.34,1.63,"0-2","2-2",16,3,17,5,1,4,0,0,6,6,21,14,4,12,35,"6-6","Y","Y","Y",5,0,9
"2472","N1",2023-10-22,"Go Ahead Eagles","Sparta Rotterdam",0,0,"D",0,0,"D",2.2,3.71,3.28,"0-0","0-0",16,6,15,6,0,0,0,0,3,6,4,10,0,9,14,"3-6","N","N","N",0,0,9
"2473","N1",2023-10-27,"Vitesse","Zwolle",1,1,"D",0,1,"A",2.05,3.72,3.68,"0-1","1-1",29,12,5,2,0,1,0,0,18,2,7,12,2,20,19,"18-2","Y","N","N",1,0,9
"2474","N1",2023-10-28,"Heerenveen","Heracles",3,0,"H",2,0,"H",1.98,3.93,3.72,"2-0","3-0",18,9,9,3,2,2,0,0,10,4,11,9,3,14,20,"10-4","Y","Y","N",4,0,9
"2475","N1",2023-10-28,"Almere City","Go Ahead Eagles",0,0,"D",0,0,"D",2.8,3.59,2.55,"0-0","0-0",12,1,9,3,1,0,0,0,6,5,19,7,0,11,26,"6-5","N","N","N",1,0,10
"2476","N1",2023-10-28,"Sparta Rotterdam","Waalwijk",2,0,"H",0,0,"D",1.75,4,4.79,"0-0","2-0",15,4,11,3,2,1,1,0,8,4,7,7,2,12,14,"8-4","Y","N","N",3,1,10
"2477","N1",2023-10-28,"For Sittard","Utrecht",0,0,"D",0,0,"D",2.51,3.68,2.79,"0-0","0-0",12,6,12,3,1,1,0,0,5,5,7,5,0,10,12,"5-5","N","N","N",2,0,10
"2478","N1",2023-10-29,"Twente","Feyenoord",2,1,"H",1,0,"H",3.17,3.73,2.25,"1-0","2-1",12,5,11,6,5,1,0,0,2,5,12,16,3,7,28,"2-5","Y","Y","N",6,0,10
"2479","N1",2023-10-29,"PSV Eindhoven","Ajax",5,2,"H",1,2,"A",1.31,6.24,8.94,"1-2","5-2",26,9,16,7,1,2,0,0,5,5,9,8,7,10,17,"5-5","Y","Y","Y",3,0,10
"2480","N1",2023-10-29,"Volendam","Excelsior",3,1,"H",0,1,"A",2.77,3.9,2.44,"0-1","3-1",20,12,10,2,1,2,0,0,8,6,5,13,4,14,18,"8-6","Y","Y","Y",3,0,10
"2481","N1",2023-11-02,"Ajax","Volendam",2,0,"H",0,0,"D",1.31,6.42,8.49,"0-0","2-0",30,10,7,3,0,1,0,0,9,4,6,6,2,13,12,"9-4","Y","N","N",1,0,10
"2482","N1",2023-11-04,"Heracles","PSV Eindhoven",0,6,"A",0,2,"A",12.28,7.36,1.22,"0-2","0-6",7,1,34,11,1,0,1,0,1,7,9,7,6,8,16,"1-7","Y","Y","Y",1,1,10
"2483","N1",2023-11-04,"Excelsior","AZ Alkmaar",1,1,"D",0,0,"D",7.81,5.17,1.41,"0-0","1-1",15,5,11,4,2,3,0,0,3,7,11,9,2,10,20,"3-7","Y","N","N",5,0,10
"2484","N1",2023-11-04,"Waalwijk","Feyenoord",1,2,"A",1,1,"D",13.32,7.51,1.21,"1-1","1-2",5,1,27,12,0,2,1,0,2,10,6,5,3,12,11,"2-10","Y","Y","N",2,1,11
"2485","N1",2023-11-04,"Go Ahead Eagles","Vitesse",5,1,"H",1,0,"H",1.96,3.91,3.81,"1-0","5-1",22,14,13,3,0,4,0,0,4,6,5,13,6,10,18,"4-6","Y","Y","Y",4,0,11
"2486","N1",2023-11-05,"Utrecht","Twente",1,1,"D",1,1,"D",4.98,4.06,1.71,"1-1","1-1",14,6,10,1,3,4,0,1,5,2,6,10,2,7,16,"5-2","Y","N","N",7,1,11
"2487","N1",2023-11-05,"Nijmegen","Volendam",3,3,"D",1,1,"D",1.63,4.42,5.21,"1-1","3-3",13,7,15,7,4,2,1,0,8,4,6,11,6,12,17,"8-4","Y","Y","Y",6,1,11
"2488","N1",2023-11-05,"Zwolle","For Sittard",2,0,"H",1,0,"H",2.23,3.68,3.25,"1-0","2-0",15,6,8,2,3,1,0,0,2,2,11,9,2,4,20,"2-2","Y","N","N",4,0,11
"2489","N1",2023-11-05,"Ajax","Heerenveen",4,1,"H",2,1,"H",1.5,5.4,5.64,"2-1","4-1",14,8,12,3,1,2,0,0,5,8,10,8,5,13,18,"5-8","Y","Y","Y",3,0,11
"2490","N1",2023-11-05,"Sparta Rotterdam","Almere City",1,2,"A",0,1,"A",1.71,4.27,4.71,"0-1","1-2",24,6,11,4,0,0,0,0,10,3,2,13,3,13,15,"10-3","Y","Y","N",0,0,11
"2491","N1",2023-11-10,"For Sittard","Heracles",4,1,"H",4,0,"H",1.76,4.06,4.61,"4-0","4-1",15,8,7,3,0,4,0,0,9,7,10,10,5,16,20,"9-7","Y","Y","Y",4,0,11
"2492","N1",2023-11-11,"Waalwijk","Go Ahead Eagles",0,1,"A",0,1,"A",2.89,3.74,2.42,"0-1","0-1",19,5,9,2,1,0,0,0,7,0,8,5,1,7,13,"7-0","N","N","N",1,0,11
"2493","N1",2023-11-11,"Twente","Nijmegen",3,3,"D",1,0,"H",1.32,5.81,9.83,"1-0","3-3",35,7,14,8,1,3,0,0,13,3,9,14,6,16,23,"13-3","Y","Y","Y",4,0,12
"2494","N1",2023-11-11,"Vitesse","Heerenveen",1,3,"A",1,1,"D",2.38,3.7,2.97,"1-1","1-3",9,5,19,7,2,1,1,0,4,7,10,3,4,11,13,"4-7","Y","Y","Y",3,1,12
"2495","N1",2023-11-12,"PSV Eindhoven","Zwolle",4,0,"H",2,0,"H",1.1,12.68,22.26,"2-0","4-0",21,6,3,2,0,2,0,0,12,0,8,7,4,12,15,"12-0","Y","Y","Y",2,0,12
"2496","N1",2023-11-12,"Almere City","Ajax",2,2,"D",0,0,"D",5.43,4.87,1.56,"0-0","2-2",13,5,22,13,5,2,0,0,4,6,12,10,4,10,22,"4-6","Y","Y","Y",7,0,12
"2497","N1",2023-11-12,"Volendam","Sparta Rotterdam",1,4,"A",1,2,"A",3.28,3.9,2.14,"1-2","1-4",17,1,16,7,0,1,0,0,3,5,4,10,5,8,14,"3-5","Y","Y","Y",1,0,12
"2498","N1",2023-11-12,"Feyenoord","AZ Alkmaar",1,0,"H",1,0,"H",1.57,4.62,5.58,"1-0","1-0",10,5,7,1,2,1,0,0,2,0,8,13,1,2,21,"2-0","N","N","N",3,0,12
"2499","N1",2023-11-12,"Utrecht","Excelsior",2,2,"D",0,0,"D",1.73,3.84,4,"0-0","2-2",13,6,12,6,0,1,0,0,13,2,6,11,4,15,17,"13-2","Y","Y","Y",1,0,12
"2500","N1",2023-11-25,"Excelsior","Feyenoord",2,4,"A",1,1,"D",12.46,7.59,1.21,"1-1","2-4",13,3,20,9,1,1,0,0,2,5,5,9,6,7,14,"2-5","Y","Y","Y",2,0,12
"2501","N1",2023-11-25,"Heerenveen","For Sittard",3,0,"H",1,0,"H",2.09,3.63,3.64,"1-0","3-0",16,5,10,4,1,2,0,0,3,7,8,6,3,10,14,"3-7","Y","Y","N",3,0,12
"2502","N1",2023-11-25,"Twente","PSV Eindhoven",0,3,"A",0,1,"A",3.75,3.9,1.98,"0-1","0-3",12,1,17,7,1,2,1,0,3,4,9,8,3,7,17,"3-4","Y","Y","N",3,1,13
"2503","N1",2023-11-25,"Ajax","Vitesse",5,0,"H",2,0,"H",1.31,6.35,8.36,"2-0","5-0",19,12,9,4,1,2,0,0,7,4,9,5,5,11,14,"7-4","Y","Y","Y",3,0,13
"2504","N1",2023-11-25,"Zwolle","Waalwijk",1,2,"A",1,1,"D",1.82,4.01,4.34,"1-1","1-2",17,6,13,4,1,2,0,0,5,8,7,12,3,13,19,"5-8","Y","Y","N",3,0,13
"2505","N1",2023-11-26,"Almere City","Heracles",0,5,"A",0,1,"A",2.01,3.85,3.68,"0-1","0-5",17,3,17,6,0,3,0,0,6,4,6,15,5,10,21,"6-4","Y","Y","Y",3,0,13
"2506","N1",2023-11-26,"AZ Alkmaar","Volendam",3,0,"H",1,0,"H",1.15,9.34,16.26,"1-0","3-0",19,8,7,1,0,0,0,0,5,4,6,8,3,9,14,"5-4","Y","Y","N",0,0,13
"2507","N1",2023-11-26,"Nijmegen","Go Ahead Eagles",1,1,"D",0,0,"D",2.42,3.81,2.82,"0-0","1-1",15,5,13,4,0,3,0,0,4,10,9,11,2,14,20,"4-10","Y","N","N",3,0,13
"2508","N1",2023-11-26,"Sparta Rotterdam","Utrecht",1,2,"A",1,1,"D",2.45,3.42,3.06,"1-1","1-2",19,6,7,2,0,3,0,0,5,4,9,6,3,9,15,"5-4","Y","Y","N",3,0,13
"2509","N1",2023-12-01,"Heerenveen","Almere City",3,0,"H",2,0,"H",1.68,4.05,5.25,"2-0","3-0",15,8,13,2,1,2,0,0,7,8,6,12,3,15,18,"7-8","Y","Y","N",3,0,13
"2510","N1",2023-12-02,"Volendam","Zwolle",0,5,"A",0,0,"D",2.68,3.72,2.59,"0-0","0-5",9,3,20,10,2,0,0,0,6,5,5,4,5,11,9,"6-5","Y","Y","Y",2,0,13
"2511","N1",2023-12-02,"For Sittard","Vitesse",3,1,"H",2,0,"H",2.02,3.63,3.86,"2-0","3-1",15,11,8,4,1,3,0,1,5,4,16,14,4,9,30,"5-4","Y","Y","Y",4,1,14
"2512","N1",2023-12-02,"Waalwijk","Excelsior",2,2,"D",1,0,"H",2.12,3.92,3.31,"1-0","2-2",17,8,13,6,0,0,0,0,2,2,4,4,4,4,8,"2-2","Y","Y","Y",0,0,14
"2513","N1",2023-12-02,"Heracles","Sparta Rotterdam",0,1,"A",0,0,"D",2.68,3.75,2.58,"0-0","0-1",13,3,10,4,1,0,0,0,6,3,11,7,1,9,18,"6-3","N","N","N",1,0,14
"2514","N1",2023-12-03,"Feyenoord","PSV Eindhoven",1,2,"A",0,0,"D",2.22,3.93,3.1,"0-0","1-2",14,3,14,7,1,3,0,0,10,5,10,13,3,15,23,"10-5","Y","Y","N",4,0,14
"2515","N1",2023-12-03,"Go Ahead Eagles","Twente",1,3,"A",0,2,"A",3.87,3.82,1.96,"0-2","1-3",15,9,13,5,1,0,0,0,4,4,7,17,4,8,24,"4-4","Y","Y","Y",1,0,14
"2516","N1",2023-12-03,"Nijmegen","Ajax",1,2,"A",0,0,"D",4.32,4.39,1.75,"0-0","1-2",7,3,22,10,0,0,0,0,2,6,4,7,3,8,11,"2-6","Y","Y","N",0,0,14
"2517","N1",2023-12-03,"Utrecht","AZ Alkmaar",1,1,"D",0,1,"A",4.24,3.75,1.9,"0-1","1-1",15,4,20,9,0,1,0,0,7,5,10,13,2,12,23,"7-5","Y","N","N",1,0,14
"2518","N1",2023-12-06,"AZ Alkmaar","Nijmegen",1,2,"A",0,2,"A",1.28,6.15,10.59,"0-2","1-2",26,4,4,2,0,1,0,0,13,1,4,6,3,14,10,"13-1","Y","Y","N",1,0,14
"2519","N1",2023-12-06,"Waalwijk","Ajax",2,3,"A",1,2,"A",5.15,4.57,1.62,"1-2","2-3",10,2,16,6,2,0,0,0,8,9,12,9,5,17,21,"8-9","Y","Y","Y",2,0,14
"2520","N1",2023-12-07,"PSV Eindhoven","Heerenveen",2,0,"H",1,0,"H",1.17,9.01,14.21,"1-0","2-0",30,8,12,1,2,1,0,0,11,2,4,10,2,13,14,"11-2","Y","N","N",3,0,15
"2521","N1",2023-12-07,"Feyenoord","Volendam",3,1,"H",1,1,"D",1.06,17.73,29.18,"1-1","3-1",30,10,2,2,1,1,0,0,12,3,4,5,4,15,9,"12-3","Y","Y","Y",2,0,15
"2286","P1",2023-08-11,"Sp Braga","Famalicao",1,2,"A",1,0,"H",1.45,4.86,7.21,"1-0","1-2",13,2,12,4,4,4,0,0,3,4,17,12,3,7,29,"3-4","Y","Y","N",8,0,1
"2287","P1",2023-08-12,"Gil Vicente","Portimonense",5,0,"H",2,0,"H",2.05,3.38,4.07,"2-0","5-0",8,5,9,3,0,0,0,0,1,1,11,14,5,2,25,"1-1","Y","Y","Y",0,0,1
"2288","P1",2023-08-12,"Farense","Casa Pia",0,3,"A",0,1,"A",2.59,3.07,3.17,"0-1","0-3",12,5,14,5,2,4,0,0,5,6,13,13,3,11,26,"5-6","Y","Y","N",6,0,1
"2289","P1",2023-08-12,"Sp Lisbon","Vizela",3,2,"H",2,0,"H",1.18,7.76,16.94,"2-0","3-2",19,6,10,4,4,0,0,0,8,3,16,9,5,11,25,"8-3","Y","Y","Y",4,0,1
"2290","P1",2023-08-13,"Rio Ave","Chaves",2,0,"H",0,0,"D",2.14,3.37,3.79,"0-0","2-0",21,8,6,1,3,4,0,1,14,3,12,20,2,17,32,"14-3","Y","N","N",7,1,1
"2291","P1",2023-08-13,"Estrela","Guimaraes",0,1,"A",0,1,"A",NA,NA,NA,"0-1","0-1",5,0,11,3,3,3,1,0,3,10,13,18,1,13,31,"3-10","N","N","N",6,1,1
"2292","P1",2023-08-13,"Arouca","Estoril",4,3,"H",1,1,"D",2.22,3.13,3.89,"1-1","4-3",11,5,12,8,4,2,1,0,2,6,11,17,7,8,28,"2-6","Y","Y","Y",6,1,1
"2293","P1",2023-08-14,"Moreirense","Porto",1,2,"A",0,0,"D",8.32,5.36,1.37,"0-0","1-2",8,1,18,7,4,7,0,1,5,10,22,15,3,15,37,"5-10","Y","Y","N",11,1,1
"2294","P1",2023-08-14,"Boavista","Benfica",3,2,"H",0,1,"A",11.02,5.89,1.29,"0-1","3-2",11,3,15,5,6,4,1,1,3,3,18,15,5,6,33,"3-3","Y","Y","Y",10,2,1
"2295","P1",2023-08-18,"Casa Pia","Sp Lisbon",1,2,"A",0,1,"A",7.6,4.77,1.45,"0-1","1-2",13,3,17,5,4,1,0,0,4,5,14,11,3,9,25,"4-5","Y","Y","N",5,0,2
"2296","P1",2023-08-19,"Guimaraes","Gil Vicente",2,1,"H",0,0,"D",2.11,3.39,3.86,"0-0","2-1",15,3,11,3,3,3,0,0,6,4,14,14,3,10,28,"6-4","Y","Y","N",6,0,2
"2297","P1",2023-08-19,"Chaves","Sp Braga",2,4,"A",1,1,"D",4.98,4.2,1.69,"1-1","2-4",15,4,13,6,2,2,1,0,5,6,12,12,6,11,24,"5-6","Y","Y","Y",4,1,2
"2298","P1",2023-08-19,"Benfica","Estrela",2,0,"H",0,0,"D",1.09,13.06,27.99,"0-0","2-0",27,10,6,1,3,3,0,0,9,4,8,14,2,13,22,"9-4","Y","N","N",6,0,2
"2299","P1",2023-08-19,"Portimonense","Boavista",1,4,"A",0,3,"A",2.81,3.18,2.8,"0-3","1-4",10,5,9,6,3,2,0,0,11,2,19,13,5,13,32,"11-2","Y","Y","Y",5,0,2
"2300","P1",2023-08-20,"Estoril","Rio Ave",2,0,"H",0,0,"D",2.54,3.24,3.07,"0-0","2-0",5,4,9,3,4,2,0,0,3,3,14,13,2,6,27,"3-3","Y","N","N",6,0,2
"2301","P1",2023-08-20,"Porto","Farense",2,1,"H",1,1,"D",1.13,9.69,19.53,"1-1","2-1",26,8,7,1,2,3,0,0,17,3,9,11,3,20,20,"17-3","Y","Y","N",5,0,2
"2302","P1",2023-08-20,"Vizela","Arouca",2,2,"D",1,1,"D",2.17,3.31,3.78,"1-1","2-2",13,7,9,2,6,6,1,1,6,3,24,11,4,9,35,"6-3","Y","Y","Y",12,2,2
"2303","P1",2023-08-21,"Famalicao","Moreirense",0,0,"D",0,0,"D",1.95,3.55,4.14,"0-0","0-0",4,2,12,3,4,3,1,0,3,6,15,10,0,9,25,"3-6","N","N","N",7,1,2
"2304","P1",2023-08-25,"Estrela","Estoril",2,1,"H",0,0,"D",2.37,3.19,3.43,"0-0","2-1",15,3,11,4,1,1,0,0,8,8,8,6,3,16,14,"8-8","Y","Y","N",2,0,3
"2305","P1",2023-08-26,"Arouca","Portimonense",1,1,"D",0,1,"A",1.66,4,5.64,"0-1","1-1",21,4,5,2,1,2,0,0,16,2,12,19,2,18,31,"16-2","Y","N","N",3,0,3
"2306","P1",2023-08-26,"Farense","Chaves",5,0,"H",4,0,"H",2.36,3.37,3.25,"4-0","5-0",18,10,19,7,2,1,0,0,7,4,24,15,5,11,39,"7-4","Y","Y","Y",3,0,3
"2307","P1",2023-08-26,"Gil Vicente","Benfica",2,3,"A",0,1,"A",9.93,6.01,1.31,"0-1","2-3",11,7,14,7,3,3,0,0,1,5,15,14,5,6,29,"1-5","Y","Y","Y",6,0,3
"2308","P1",2023-08-27,"Boavista","Casa Pia",1,1,"D",0,1,"A",2.3,3.29,3.45,"0-1","1-1",10,5,10,7,1,0,0,0,11,4,18,14,2,15,32,"11-4","Y","N","N",1,0,3
"2309","P1",2023-08-27,"Guimaraes","Vizela",2,0,"H",0,0,"D",1.93,3.58,4.35,"0-0","2-0",6,3,9,4,1,3,1,0,3,4,11,9,2,7,20,"3-4","Y","N","N",4,1,3
"2310","P1",2023-08-27,"Sp Lisbon","Famalicao",1,0,"H",0,0,"D",1.25,6.56,11.91,"0-0","1-0",10,6,7,1,3,2,0,0,8,1,17,13,1,9,30,"8-1","N","N","N",5,0,3
"2311","P1",2023-08-28,"Rio Ave","Porto",1,2,"A",0,0,"D",7.11,4.83,1.45,"0-0","1-2",4,1,9,5,4,3,0,0,1,7,22,17,3,8,39,"1-7","Y","Y","N",7,0,3
"2312","P1",2023-09-01,"Vizela","Gil Vicente",1,0,"H",0,0,"D",2.27,3.4,3.42,"0-0","1-0",13,5,5,1,0,3,0,0,4,3,20,16,1,7,36,"4-3","N","N","N",3,0,3
"2313","P1",2023-09-02,"Casa Pia","Rio Ave",1,1,"D",1,0,"H",2.22,3.39,3.53,"1-0","1-1",10,5,11,5,1,2,0,0,12,0,18,15,2,12,33,"12-0","Y","N","N",3,0,4
"2314","P1",2023-09-02,"Famalicao","Farense",1,0,"H",0,0,"D",1.79,3.72,4.92,"0-0","1-0",21,4,6,1,1,3,0,1,12,4,16,14,1,16,30,"12-4","N","N","N",4,1,4
"2315","P1",2023-09-02,"Portimonense","Estrela",1,1,"D",1,1,"D",2.7,3.22,2.89,"1-1","1-1",15,4,10,1,3,6,0,0,3,7,12,16,2,10,28,"3-7","Y","N","N",9,0,4
"2316","P1",2023-09-02,"Benfica","Guimaraes",4,0,"H",3,0,"H",1.21,7.46,13.1,"3-0","4-0",20,9,7,1,2,4,0,1,11,2,9,14,4,13,23,"11-2","Y","Y","Y",6,1,4
"2317","P1",2023-09-03,"Chaves","Moreirense",1,2,"A",0,1,"A",2.54,3.34,2.99,"0-1","1-2",13,3,9,2,3,4,0,0,3,4,14,21,3,7,35,"3-4","Y","Y","N",7,0,4
"2318","P1",2023-09-03,"Estoril","Boavista",1,2,"A",1,2,"A",2.48,3.37,3.01,"1-2","1-2",13,4,14,8,3,1,0,0,10,5,21,12,3,15,33,"10-5","Y","Y","N",4,0,4
"2319","P1",2023-09-03,"Porto","Arouca",1,1,"D",0,0,"D",1.26,6.43,11.28,"0-0","1-1",12,3,10,2,3,2,0,0,5,2,9,14,2,7,23,"5-2","Y","N","N",5,0,4
"2320","P1",2023-09-03,"Sp Braga","Sp Lisbon",1,1,"D",0,1,"A",3.04,3.63,2.36,"0-1","1-1",6,2,4,2,2,5,0,0,4,2,16,9,2,6,25,"4-2","Y","N","N",7,0,4
"2321","P1",2023-09-09,"Moreirense","Sp Braga",2,3,"A",2,1,"H",4.28,3.97,1.84,"2-1","2-3",11,3,12,5,2,2,0,0,4,5,12,11,5,9,23,"4-5","Y","Y","Y",4,0,4
"2322","P1",2023-09-15,"Estrela","Porto",0,1,"A",0,1,"A",9.42,5.38,1.35,"0-1","0-1",9,1,10,4,3,5,0,0,10,6,12,21,1,16,33,"10-6","N","N","N",8,0,5
"2323","P1",2023-09-16,"Rio Ave","Famalicao",1,1,"D",0,1,"A",2.66,3.15,3,"0-1","1-1",5,0,12,4,1,3,0,0,3,3,15,20,2,6,35,"3-3","Y","N","N",4,0,5
"2324","P1",2023-09-16,"Farense","Sp Braga",3,1,"H",2,0,"H",4.72,4.26,1.71,"2-0","3-1",16,4,17,7,4,5,0,0,7,3,16,10,4,10,26,"7-3","Y","Y","Y",9,0,5
"2325","P1",2023-09-16,"Vizela","Benfica",1,2,"A",0,2,"A",8.67,5.89,1.34,"0-2","1-2",12,2,17,7,2,1,0,0,2,3,15,6,3,5,21,"2-3","Y","Y","N",3,0,5
"2326","P1",2023-09-17,"Arouca","Casa Pia",0,1,"A",0,0,"D",2.46,3.25,3.19,"0-0","0-1",11,5,12,2,2,3,0,0,2,7,12,7,1,9,19,"2-7","N","N","N",5,0,5
"2327","P1",2023-09-17,"Gil Vicente","Estoril",5,3,"H",3,0,"H",2.18,3.55,3.49,"3-0","5-3",12,7,14,6,3,2,0,0,5,8,11,15,8,13,26,"5-8","Y","Y","Y",5,0,5
"2328","P1",2023-09-17,"Guimaraes","Portimonense",1,2,"A",1,0,"H",1.58,4.21,6.2,"1-0","1-2",11,3,9,2,2,4,0,0,10,3,16,13,3,13,29,"10-3","Y","Y","N",6,0,5
"2329","P1",2023-09-17,"Sp Lisbon","Moreirense",3,0,"H",0,0,"D",1.23,7.02,12.49,"0-0","3-0",20,9,7,1,3,3,0,1,8,2,10,16,3,10,26,"8-2","Y","Y","N",6,1,5
"2330","P1",2023-09-18,"Boavista","Chaves",4,1,"H",4,0,"H",1.74,4.1,4.64,"4-0","4-1",7,4,21,10,1,3,0,0,3,12,12,15,5,15,27,"3-12","Y","Y","Y",4,0,5
"2331","P1",2023-09-22,"Famalicao","Arouca",1,0,"H",1,0,"H",2.04,3.4,4.1,"1-0","1-0",7,4,13,6,5,2,1,1,6,8,15,23,1,14,38,"6-8","N","N","N",7,2,6
"2332","P1",2023-09-23,"Estoril","Vizela",2,2,"D",0,0,"D",2.56,3.48,2.87,"0-0","2-2",16,6,11,7,1,2,0,0,5,3,13,15,4,8,28,"5-3","Y","Y","Y",3,0,6
"2333","P1",2023-09-23,"Moreirense","Farense",1,0,"H",1,0,"H",2.23,3.52,3.39,"1-0","1-0",15,3,10,2,1,2,0,0,11,3,10,17,1,14,27,"11-3","N","N","N",3,0,6
"2334","P1",2023-09-23,"Casa Pia","Guimaraes",0,0,"D",0,0,"D",2.43,3.26,3.23,"0-0","0-0",10,2,14,3,3,2,0,0,8,9,16,11,0,17,27,"8-9","N","N","N",5,0,6
"2335","P1",2023-09-23,"Porto","Gil Vicente",2,1,"H",1,1,"D",1.22,7.32,11.96,"1-1","2-1",20,7,12,4,1,3,0,0,6,3,15,12,3,9,27,"6-3","Y","Y","N",4,0,6
"2336","P1",2023-09-24,"Chaves","Estrela",2,2,"D",0,1,"A",2.73,3.55,2.64,"0-1","2-2",17,8,10,3,4,4,0,1,9,5,11,11,4,14,22,"9-5","Y","Y","Y",8,1,6
"2337","P1",2023-09-24,"Portimonense","Benfica",1,3,"A",0,2,"A",11.17,6.7,1.25,"0-2","1-3",9,2,13,7,1,0,0,0,3,4,7,7,4,7,14,"3-4","Y","Y","Y",1,0,6
"2338","P1",2023-09-24,"Sp Braga","Boavista",4,1,"H",2,1,"H",1.55,4.78,5.69,"2-1","4-1",24,9,6,2,2,3,0,1,6,2,8,9,5,8,17,"6-2","Y","Y","Y",5,1,6
"2339","P1",2023-09-25,"Sp Lisbon","Rio Ave",2,0,"H",2,0,"H",1.2,7.3,13.69,"2-0","2-0",10,6,7,2,NA,5,0,0,4,2,14,12,2,6,26,"4-2","Y","N","N",NA,0,6
"2340","P1",2023-09-28,"Estrela","Sp Braga",2,4,"A",0,1,"A",4.72,4.16,1.71,"0-1","2-4",17,9,17,9,1,3,0,0,8,6,9,13,6,14,22,"8-6","Y","Y","Y",4,0,7
"2341","P1",2023-09-29,"Benfica","Porto",1,0,"H",0,0,"D",1.93,3.69,4.14,"0-0","1-0",12,2,6,3,4,5,0,1,9,5,18,10,1,14,28,"9-5","N","N","N",9,1,7
"2342","P1",2023-09-30,"Vizela","Portimonense",2,3,"A",0,2,"A",1.83,3.76,4.62,"0-2","2-3",14,4,9,7,3,3,0,0,13,2,11,16,5,15,27,"13-2","Y","Y","Y",6,0,7
"2343","P1",2023-09-30,"Boavista","Famalicao",2,2,"D",1,1,"D",2.21,3.51,3.44,"1-1","2-2",10,6,7,3,5,4,1,2,2,4,23,21,4,6,44,"2-4","Y","Y","Y",9,3,7
"2344","P1",2023-09-30,"Farense","Sp Lisbon",2,3,"A",1,2,"A",6.17,4.58,1.44,"1-2","2-3",9,4,23,10,5,6,1,0,2,8,13,12,5,10,25,"2-8","Y","Y","Y",11,1,7
"2345","P1",2023-10-01,"Arouca","Chaves",0,2,"A",0,0,"D",1.85,3.76,4.39,"0-0","0-2",11,2,5,3,3,5,1,0,5,3,16,10,2,8,26,"5-3","Y","N","N",8,1,7
"2346","P1",2023-10-01,"Guimaraes","Estoril",3,2,"H",0,2,"A",1.85,3.79,4.45,"0-2","3-2",25,8,10,5,4,4,0,1,11,2,16,13,5,13,29,"11-2","Y","Y","Y",8,1,7
"2347","P1",2023-10-01,"Rio Ave","Moreirense",0,4,"A",0,2,"A",2.38,3.46,3.13,"0-2","0-4",10,4,11,6,3,5,0,0,4,2,13,26,4,6,39,"4-2","Y","Y","Y",8,0,7
"2348","P1",2023-10-02,"Gil Vicente","Casa Pia",2,0,"H",0,0,"D",2.41,3.34,3.14,"0-0","2-0",16,9,8,1,3,3,0,1,5,5,10,15,2,10,25,"5-5","Y","N","N",6,1,7
"2349","P1",2023-10-06,"Moreirense","Boavista",1,1,"D",1,1,"D",1.94,3.72,4.07,"1-1","1-1",11,6,8,1,0,3,0,0,6,1,13,13,2,7,26,"6-1","Y","N","N",3,0,8
"2350","P1",2023-10-07,"Chaves","Gil Vicente",4,2,"H",1,2,"A",2.65,3.61,2.68,"1-2","4-2",15,9,9,5,3,3,1,0,6,1,17,14,6,7,31,"6-1","Y","Y","Y",6,1,8
"2351","P1",2023-10-07,"Farense","Vizela",0,0,"D",0,0,"D",2.19,3.58,3.43,"0-0","0-0",20,6,17,6,1,1,0,0,14,6,21,11,0,20,32,"14-6","N","N","N",2,0,8
"2352","P1",2023-10-07,"Sp Braga","Rio Ave",2,1,"H",0,1,"A",1.32,5.88,9.83,"0-1","2-1",33,11,9,3,1,2,0,0,16,1,8,11,3,17,19,"16-1","Y","Y","N",3,0,8
"2353","P1",2023-10-07,"Estoril","Benfica",0,1,"A",0,0,"D",10.21,6.4,1.28,"0-0","0-1",16,4,21,5,3,2,0,0,4,7,15,8,1,11,23,"4-7","N","N","N",5,0,8
"2354","P1",2023-10-08,"Casa Pia","Estrela",0,1,"A",0,0,"D",2.09,3.4,3.9,"0-0","0-1",7,2,11,6,1,1,0,0,3,6,16,8,1,9,24,"3-6","N","N","N",2,0,8
"2355","P1",2023-10-08,"Famalicao","Guimaraes",1,3,"A",0,2,"A",2.71,3.17,2.92,"0-2","1-3",13,6,12,4,4,3,0,0,11,3,15,20,4,14,35,"11-3","Y","Y","Y",7,0,8
"2356","P1",2023-10-08,"Porto","Portimonense",1,0,"H",1,0,"H",1.16,8.85,16.19,"1-0","1-0",18,7,4,2,4,6,1,0,10,5,12,19,1,15,31,"10-5","N","N","N",10,1,8
"2357","P1",2023-10-08,"Sp Lisbon","Arouca",2,1,"H",1,0,"H",1.25,6.6,11.63,"1-0","2-1",10,5,11,5,4,7,1,1,5,2,7,18,3,7,25,"5-2","Y","Y","N",11,2,8
"2358","P1",2023-10-27,"Arouca","Moreirense",0,1,"A",0,1,"A",2.61,3.28,2.94,"0-1","0-1",13,3,12,5,2,2,0,1,7,5,11,14,1,12,25,"7-5","N","N","N",4,1,9
"2359","P1",2023-10-28,"Portimonense","Estoril",1,0,"H",1,0,"H",2.52,3.5,2.9,"1-0","1-0",14,8,14,4,6,1,0,0,6,4,14,8,1,10,22,"6-4","N","N","N",7,0,9
"2360","P1",2023-10-28,"Benfica","Casa Pia",1,1,"D",1,0,"H",1.19,7.53,15.99,"1-0","1-1",13,7,6,3,1,2,0,0,10,2,12,20,2,12,32,"10-2","Y","N","N",3,0,9
"2361","P1",2023-10-28,"Guimaraes","Chaves",5,0,"H",3,0,"H",1.62,4.22,5.63,"3-0","5-0",13,6,7,3,0,3,0,1,4,3,16,6,5,7,22,"4-3","Y","Y","Y",3,1,9
"2362","P1",2023-10-28,"Gil Vicente","Sp Braga",3,3,"D",1,0,"H",4.16,4.28,1.8,"1-0","3-3",13,6,18,7,4,2,0,1,4,9,14,21,6,13,35,"4-9","Y","Y","Y",6,1,9
"2363","P1",2023-10-29,"Rio Ave","Farense",3,4,"A",2,2,"D",2.37,3.45,3.17,"2-2","3-4",11,4,13,7,3,3,0,0,5,6,19,12,7,11,31,"5-6","Y","Y","Y",6,0,9
"2364","P1",2023-10-29,"Estrela","Famalicao",1,0,"H",0,0,"D",2.58,3.29,2.98,"0-0","1-0",12,4,9,1,3,3,0,1,3,2,18,15,1,5,33,"3-2","N","N","N",6,1,9
"2365","P1",2023-10-29,"Vizela","Porto",0,2,"A",0,2,"A",7.81,4.73,1.44,"0-2","0-2",8,1,13,3,3,4,0,0,4,4,16,17,2,8,33,"4-4","Y","N","N",7,0,9
"2366","P1",2023-10-30,"Boavista","Sp Lisbon",0,2,"A",0,1,"A",6.59,4.69,1.49,"0-1","0-2",7,2,14,6,3,2,0,0,4,8,16,13,2,12,29,"4-8","Y","N","N",5,0,9
"2367","P1",2023-11-03,"Porto","Estoril",0,1,"A",0,0,"D",1.17,8.39,15.51,"0-0","0-1",16,4,7,3,5,7,0,0,9,6,16,16,1,15,32,"9-6","N","N","N",12,0,10
"2368","P1",2023-11-04,"Chaves","Benfica",0,2,"A",0,0,"D",9.53,6.19,1.3,"0-0","0-2",8,0,14,5,5,2,0,0,3,8,13,11,2,11,24,"3-8","Y","N","N",7,0,10
"2369","P1",2023-11-04,"Famalicao","Gil Vicente",3,1,"H",2,0,"H",2.09,3.6,3.68,"2-0","3-1",12,5,9,4,3,3,0,0,7,2,11,10,4,9,21,"7-2","Y","Y","Y",6,0,10
"2370","P1",2023-11-04,"Sp Braga","Portimonense",6,1,"H",0,1,"A",1.25,6.8,11,"0-1","6-1",19,10,8,3,1,2,0,0,5,5,10,10,7,10,20,"5-5","Y","Y","Y",3,0,10
"2371","P1",2023-11-05,"Casa Pia","Vizela",0,1,"A",0,0,"D",2.2,3.39,3.6,"0-0","0-1",11,2,14,4,3,3,0,0,6,6,16,17,1,12,33,"6-6","N","N","N",6,0,10
"2372","P1",2023-11-05,"Moreirense","Guimaraes",1,0,"H",0,0,"D",2.75,3.25,2.8,"0-0","1-0",12,3,10,2,1,2,0,0,4,12,10,11,1,16,21,"4-12","N","N","N",3,0,10
"2373","P1",2023-11-05,"Rio Ave","Boavista",2,0,"H",1,0,"H",2.66,3.45,2.74,"1-0","2-0",9,3,10,2,3,2,0,0,3,3,17,15,2,6,32,"3-3","Y","N","N",5,0,10
"2374","P1",2023-11-05,"Sp Lisbon","Estrela",3,2,"H",1,0,"H",1.24,7.12,11.43,"1-0","3-2",23,8,6,4,1,1,0,0,6,1,7,5,5,7,12,"6-1","Y","Y","Y",2,0,10
"2375","P1",2023-11-06,"Farense","Arouca",2,0,"H",2,0,"H",2.25,3.4,3.38,"2-0","2-0",7,2,15,5,1,1,0,0,6,6,16,14,2,12,30,"6-6","Y","N","N",2,0,10
"2376","P1",2023-11-10,"Estoril","Casa Pia",4,0,"H",2,0,"H",2.59,3.26,2.98,"2-0","4-0",18,6,12,3,3,4,0,0,4,7,15,16,4,11,31,"4-7","Y","Y","Y",7,0,11
"2377","P1",2023-11-11,"Portimonense","Chaves",2,1,"H",2,0,"H",2.34,3.44,3.23,"2-0","2-1",12,7,19,8,4,2,0,0,3,8,15,12,3,11,27,"3-8","Y","Y","N",6,0,11
"2378","P1",2023-11-11,"Estrela","Moreirense",0,1,"A",0,0,"D",2.65,3.41,2.8,"0-0","0-1",8,3,12,2,3,6,0,1,2,5,22,17,1,7,39,"2-5","N","N","N",9,1,11
"2379","P1",2023-11-11,"Vizela","Famalicao",0,0,"D",0,0,"D",2.72,3.31,2.8,"0-0","0-0",9,4,13,2,1,3,0,0,5,7,17,17,0,12,34,"5-7","N","N","N",4,0,11
"2380","P1",2023-11-11,"Guimaraes","Porto",1,2,"A",1,1,"D",5.16,3.98,1.71,"1-1","1-2",14,8,7,4,3,3,0,0,10,6,19,17,3,16,36,"10-6","Y","Y","N",6,0,11
"2381","P1",2023-11-12,"Boavista","Farense",1,3,"A",0,1,"A",2.05,3.7,3.7,"0-1","1-3",15,2,13,7,3,1,0,0,9,2,19,9,4,11,28,"9-2","Y","Y","Y",4,0,11
"2382","P1",2023-11-12,"Gil Vicente","Rio Ave",1,1,"D",0,0,"D",2.02,3.64,3.8,"0-0","1-1",8,2,16,5,1,1,0,0,4,7,10,18,2,11,28,"4-7","Y","N","N",2,0,11
"2383","P1",2023-11-12,"Arouca","Sp Braga",0,1,"A",0,1,"A",5.32,4.36,1.63,"0-1","0-1",12,7,17,5,2,4,0,0,3,8,14,14,1,11,28,"3-8","N","N","N",6,0,11
"2384","P1",2023-11-12,"Benfica","Sp Lisbon",2,1,"H",0,1,"A",2.34,3.58,3.11,"0-1","2-1",11,4,8,3,2,5,0,1,6,4,10,12,3,10,22,"6-4","Y","Y","N",7,1,11
"2385","P1",2023-12-01,"Chaves","Vizela",2,1,"H",1,1,"D",2.73,3.23,2.73,"1-1","2-1",15,5,8,2,5,3,0,0,2,1,14,16,3,3,30,"2-1","Y","Y","N",8,0,12
"2386","P1",2023-12-02,"Farense","Guimaraes",1,2,"A",0,1,"A",3.15,3.46,2.28,"0-1","1-2",5,2,16,5,3,3,1,0,1,7,12,14,3,8,26,"1-7","Y","Y","N",6,1,12
"2387","P1",2023-12-02,"Rio Ave","Estrela",1,1,"D",0,0,"D",2.2,3.46,3.31,"0-0","1-1",13,3,8,0,4,1,0,0,7,0,15,13,2,7,28,"7-0","Y","N","N",5,0,12
"2388","P1",2023-12-02,"Famalicao","Porto",0,3,"A",0,2,"A",5.17,3.84,1.64,"0-2","0-3",12,0,9,5,4,5,1,0,7,2,16,22,3,9,38,"7-2","Y","Y","N",9,1,12
"2389","P1",2023-12-02,"Casa Pia","Portimonense",1,0,"H",0,0,"D",1.95,3.51,4.02,"0-0","1-0",11,3,10,2,3,3,0,1,5,5,20,15,1,10,35,"5-5","N","N","N",6,1,12
"2390","P1",2023-12-03,"Sp Braga","Estoril",3,1,"H",1,1,"D",1.34,5.77,7.59,"1-1","3-1",18,6,4,1,2,2,0,0,5,2,13,14,4,7,27,"5-2","Y","Y","Y",4,0,12
"2391","P1",2023-12-03,"Moreirense","Benfica",0,0,"D",0,0,"D",6.42,4.41,1.5,"0-0","0-0",11,4,12,3,4,1,0,0,2,7,13,13,0,9,26,"2-7","N","N","N",5,0,12
"2392","P1",2023-12-03,"Boavista","Arouca",0,4,"A",0,3,"A",2.17,3.31,3.55,"0-3","0-4",8,2,12,7,5,4,1,1,8,1,12,10,4,9,22,"8-1","Y","Y","Y",9,2,12
"2393","P1",2023-12-04,"Sp Lisbon","Gil Vicente",3,1,"H",1,1,"D",1.16,7.91,13.5,"1-1","3-1",12,4,5,1,4,1,0,0,9,0,14,9,4,9,23,"9-0","Y","Y","Y",5,0,12
"2880","SC0",2023-08-05,"Celtic","Ross County",4,2,"H",3,0,"H",1.12,11.1,20.81,"3-0","4-2",18,12,7,2,0,4,0,0,4,8,6,14,6,12,20,"4-8","Y","Y","Y",4,0,1
"2881","SC0",2023-08-05,"Dundee","Motherwell",1,1,"D",0,1,"A",2.65,3.38,2.82,"0-1","1-1",17,2,13,3,0,2,0,0,7,12,12,12,2,19,24,"7-12","Y","N","N",2,0,1
"2882","SC0",2023-08-05,"Livingston","Aberdeen",0,0,"D",0,0,"D",2.99,3.32,2.55,"0-0","0-0",12,2,11,0,3,4,0,0,7,7,22,13,0,14,35,"7-7","N","N","N",7,0,1
"2883","SC0",2023-08-05,"St Johnstone","Hearts",0,2,"A",0,0,"D",3.27,3.68,2.22,"0-0","0-2",9,3,16,9,2,3,0,0,6,9,14,13,2,15,27,"6-9","Y","N","N",5,0,1
"2884","SC0",2023-08-05,"Kilmarnock","Rangers",1,0,"H",0,0,"D",7.25,4.98,1.44,"0-0","1-0",10,3,18,4,0,0,0,0,2,8,7,10,1,10,17,"2-8","N","N","N",0,0,1
"2885","SC0",2023-08-06,"Hibernian","St Mirren",2,3,"A",0,2,"A",1.93,3.65,4.17,"0-2","2-3",14,7,8,4,2,2,0,0,2,7,14,7,5,9,21,"2-7","Y","Y","Y",4,0,1
"2886","SC0",2023-08-12,"Rangers","Livingston",4,0,"H",1,0,"H",1.28,6.16,10.41,"1-0","4-0",21,9,6,2,1,1,0,0,5,4,9,9,4,9,18,"5-4","Y","Y","Y",2,0,2
"2887","SC0",2023-08-12,"Ross County","St Johnstone",2,0,"H",1,0,"H",2.2,3.34,3.64,"1-0","2-0",19,8,12,3,2,2,0,0,6,7,11,14,2,13,25,"6-7","Y","N","N",4,0,2
"2888","SC0",2023-08-12,"St Mirren","Dundee",2,1,"H",2,0,"H",2.09,3.45,3.83,"2-0","2-1",15,2,7,4,2,3,0,0,4,3,8,8,3,7,16,"4-3","Y","Y","N",5,0,2
"2889","SC0",2023-08-13,"Aberdeen","Celtic",1,3,"A",1,2,"A",8.1,5.6,1.37,"1-2","1-3",11,2,15,10,0,2,0,0,9,9,12,11,4,18,23,"9-9","Y","Y","Y",2,0,2
"2890","SC0",2023-08-13,"Hearts","Kilmarnock",0,0,"D",0,0,"D",1.89,3.73,4.31,"0-0","0-0",8,1,15,5,3,4,0,0,6,5,12,15,0,11,27,"6-5","N","N","N",7,0,2
"2891","SC0",2023-08-13,"Motherwell","Hibernian",2,1,"H",0,0,"D",2.69,3.32,2.82,"0-0","2-1",10,3,4,1,1,4,0,0,5,2,14,16,3,7,30,"5-2","Y","Y","N",5,0,2
"2892","SC0",2023-08-26,"Ross County","Rangers",0,2,"A",0,2,"A",8.67,5.53,1.36,"0-2","0-2",8,2,24,9,3,1,0,0,4,8,10,11,2,12,21,"4-8","Y","N","N",4,0,3
"2893","SC0",2023-08-26,"Celtic","St Johnstone",0,0,"D",0,0,"D",1.05,19.42,39.84,"0-0","0-0",19,5,5,2,1,3,0,0,19,1,9,12,0,20,21,"19-1","N","N","N",4,0,3
"2894","SC0",2023-08-26,"Hibernian","Livingston",2,3,"A",0,1,"A",1.88,3.82,4.25,"0-1","2-3",13,3,8,4,2,4,0,0,9,3,12,10,5,12,22,"9-3","Y","Y","Y",6,0,3
"2895","SC0",2023-08-26,"Motherwell","Kilmarnock",2,1,"H",0,1,"A",2.52,3.28,3.07,"0-1","2-1",13,7,12,3,6,3,0,0,1,6,15,19,3,7,34,"1-6","Y","Y","N",9,0,3
"2896","SC0",2023-08-27,"Dundee","Hearts",1,0,"H",0,0,"D",2.93,3.49,2.47,"0-0","1-0",12,4,10,5,1,1,0,0,3,8,16,10,1,11,26,"3-8","N","N","N",2,0,3
"2897","SC0",2023-08-27,"St Mirren","Aberdeen",2,2,"D",0,1,"A",2.35,3.33,3.32,"0-1","2-2",13,6,4,2,2,2,0,0,4,3,9,14,4,7,23,"4-3","Y","Y","Y",4,0,3
"2898","SC0",2023-09-02,"Kilmarnock","Ross County",0,1,"A",0,0,"D",1.93,3.6,4.33,"0-0","0-1",15,4,9,4,0,5,0,0,14,2,9,17,1,16,26,"14-2","N","N","N",5,0,4
"2899","SC0",2023-09-02,"Livingston","St Mirren",1,1,"D",0,0,"D",2.97,3.06,2.75,"0-0","1-1",13,2,8,4,3,1,0,0,6,2,17,13,2,8,30,"6-2","Y","N","N",4,0,4
"2900","SC0",2023-09-02,"St Johnstone","Dundee",2,2,"D",0,1,"A",2.72,3.34,2.77,"0-1","2-2",8,3,12,4,3,0,0,0,4,6,13,11,4,10,24,"4-6","Y","Y","Y",3,0,4
"2901","SC0",2023-09-03,"Rangers","Celtic",0,1,"A",0,1,"A",2.43,3.78,2.84,"0-1","0-1",17,3,7,5,1,1,0,0,6,2,15,15,1,8,30,"6-2","N","N","N",2,0,4
"2902","SC0",2023-09-03,"Aberdeen","Hibernian",0,2,"A",0,0,"D",2.34,3.47,3.19,"0-0","0-2",10,3,15,7,2,4,0,0,7,5,15,11,2,12,26,"7-5","Y","N","N",6,0,4
"2903","SC0",2023-09-03,"Hearts","Motherwell",0,1,"A",0,1,"A",2.01,3.69,3.8,"0-1","0-1",18,1,8,4,1,2,0,1,16,5,10,16,1,21,26,"16-5","N","N","N",3,1,4
"2904","SC0",2023-09-16,"St Johnstone","Rangers",0,2,"A",0,1,"A",12.28,6.42,1.25,"0-1","0-2",3,0,20,6,5,2,0,0,3,5,13,13,2,8,26,"3-5","Y","N","N",7,0,5
"2905","SC0",2023-09-16,"Celtic","Dundee",3,0,"H",0,0,"D",1.13,10.55,19.28,"0-0","3-0",19,7,4,1,0,0,0,0,9,1,6,7,3,10,13,"9-1","Y","Y","N",0,0,5
"2906","SC0",2023-09-16,"Hearts","Aberdeen",2,0,"H",1,0,"H",2.15,3.65,3.45,"1-0","2-0",12,4,11,5,4,2,0,0,9,3,11,12,2,12,23,"9-3","Y","N","N",6,0,5
"2907","SC0",2023-09-16,"Kilmarnock","Hibernian",2,2,"D",0,1,"A",2.65,3.27,2.91,"0-1","2-2",16,5,11,4,5,4,0,0,4,4,16,8,4,8,24,"4-4","Y","Y","Y",9,0,5
"2908","SC0",2023-09-16,"Motherwell","St Mirren",0,1,"A",0,0,"D",2.41,3.19,3.34,"0-0","0-1",20,7,9,3,0,5,0,0,8,3,6,18,1,11,24,"8-3","N","N","N",5,0,5
"2909","SC0",2023-09-16,"Ross County","Livingston",1,1,"D",0,0,"D",2.44,3.34,3.14,"0-0","1-1",16,5,5,2,0,3,0,0,6,2,14,13,2,8,27,"6-2","Y","N","N",3,0,5
"2910","SC0",2023-09-23,"Livingston","Celtic",0,3,"A",0,1,"A",10.91,6.27,1.27,"0-1","0-3",15,4,14,7,5,2,0,1,2,4,17,6,3,6,23,"2-4","Y","Y","N",7,1,6
"2911","SC0",2023-09-23,"Dundee","Kilmarnock",2,2,"D",1,1,"D",2.56,3.29,3.01,"1-1","2-2",10,3,23,3,1,3,1,0,4,7,8,12,4,11,20,"4-7","Y","Y","Y",4,1,6
"2912","SC0",2023-09-23,"Hibernian","St Johnstone",2,0,"H",1,0,"H",1.61,4.29,5.5,"1-0","2-0",17,8,12,1,1,3,0,0,4,4,9,10,2,8,19,"4-4","Y","N","N",4,0,6
"2913","SC0",2023-09-23,"St Mirren","Hearts",1,0,"H",1,0,"H",2.74,3.2,2.86,"1-0","1-0",13,5,11,3,2,1,0,0,4,8,13,12,1,12,25,"4-8","N","N","N",3,0,6
"2914","SC0",2023-09-24,"Aberdeen","Ross County",4,0,"H",2,0,"H",2,3.49,4.04,"2-0","4-0",13,6,11,2,0,4,0,0,5,5,9,10,4,10,19,"5-5","Y","Y","Y",4,0,6
"2915","SC0",2023-09-24,"Rangers","Motherwell",1,0,"H",1,0,"H",1.24,6.72,12.04,"1-0","1-0",17,7,9,4,2,2,0,0,2,2,14,15,1,4,29,"2-2","N","N","N",4,0,6
"2916","SC0",2023-09-30,"Motherwell","Celtic",1,2,"A",0,0,"D",10.22,5.91,1.31,"0-0","1-2",10,4,24,6,3,1,0,0,4,6,12,11,3,10,23,"4-6","Y","Y","N",4,0,7
"2917","SC0",2023-09-30,"Hibernian","Dundee",0,0,"D",0,0,"D",1.79,4.05,4.44,"0-0","0-0",23,9,11,2,1,4,0,0,14,1,7,10,0,15,17,"14-1","N","N","N",5,0,7
"2918","SC0",2023-09-30,"Kilmarnock","St Mirren",1,1,"D",1,1,"D",2.44,3.31,3.17,"1-1","1-1",12,2,8,3,2,3,0,0,7,6,15,16,2,13,31,"7-6","Y","N","N",5,0,7
"2919","SC0",2023-09-30,"Rangers","Aberdeen",1,3,"A",0,1,"A",1.28,6.23,10.73,"0-1","1-3",18,5,14,6,2,1,1,0,5,8,18,4,4,13,22,"5-8","Y","Y","Y",3,1,7
"2920","SC0",2023-09-30,"Ross County","Hearts",0,1,"A",0,0,"D",3.25,3.6,2.26,"0-0","0-1",9,1,17,3,3,2,0,0,5,5,15,10,1,10,25,"5-5","N","N","N",5,0,7
"2921","SC0",2023-09-30,"St Johnstone","Livingston",1,1,"D",1,0,"H",2.71,3.1,2.96,"1-0","1-1",12,2,7,3,2,2,1,0,5,2,14,14,2,7,28,"5-2","Y","N","N",4,1,7
"2922","SC0",2023-10-07,"Celtic","Kilmarnock",3,1,"H",2,0,"H",1.19,7.92,13.83,"2-0","3-1",27,12,6,1,2,2,0,0,11,1,9,7,4,12,16,"11-1","Y","Y","Y",4,0,8
"2923","SC0",2023-10-07,"Hearts","Hibernian",2,2,"D",1,0,"H",2.35,3.52,3.14,"1-0","2-2",21,5,17,3,2,1,0,0,7,4,12,9,4,11,21,"7-4","Y","Y","Y",3,0,8
"2924","SC0",2023-10-07,"Livingston","Motherwell",2,0,"H",0,0,"D",2.88,3.14,2.77,"0-0","2-0",11,3,3,2,1,3,0,1,3,5,12,15,2,8,27,"3-5","Y","N","N",4,1,8
"2925","SC0",2023-10-08,"St Mirren","Rangers",0,3,"A",0,1,"A",6.31,4.62,1.52,"0-1","0-3",3,0,13,8,1,2,1,0,3,10,8,16,3,13,24,"3-10","Y","Y","N",3,1,8
"2926","SC0",2023-10-08,"Aberdeen","St Johnstone",0,0,"D",0,0,"D",1.62,4.1,5.86,"0-0","0-0",10,3,9,0,0,2,0,0,5,3,11,11,0,8,22,"5-3","N","N","N",2,0,8
"2927","SC0",2023-10-21,"Kilmarnock","Livingston",3,1,"H",2,1,"H",1.93,3.54,4.38,"2-1","3-1",13,5,8,1,2,1,0,0,5,4,9,10,4,9,19,"5-4","Y","Y","Y",3,0,8
"2928","SC0",2023-10-21,"Rangers","Hibernian",4,0,"H",2,0,"H",1.36,5.38,8.91,"2-0","4-0",23,8,7,1,1,2,0,0,5,4,12,5,4,9,17,"5-4","Y","Y","Y",3,0,9
"2929","SC0",2023-10-22,"Hearts","Celtic",1,4,"A",0,2,"A",6.55,4.85,1.49,"0-2","1-4",13,6,19,7,2,1,0,0,3,5,16,11,5,8,27,"3-5","Y","Y","Y",3,0,9
"2930","SC0",2023-10-24,"Dundee","Ross County",0,0,"D",0,0,"D",2.04,3.56,3.88,"0-0","0-0",15,9,6,4,1,6,0,0,7,4,7,13,0,11,20,"7-4","N","N","N",7,0,9
"2931","SC0",2023-10-28,"Hibernian","Celtic",0,0,"D",0,0,"D",6.55,4.82,1.49,"0-0","0-0",6,1,21,4,0,2,0,0,3,6,4,12,0,9,16,"3-6","N","N","N",2,0,9
"2932","SC0",2023-10-28,"Livingston","Dundee",0,2,"A",0,0,"D",2.52,3.25,3.1,"0-0","0-2",4,0,18,7,0,0,1,0,1,5,13,15,2,6,28,"1-5","Y","N","N",0,1,9
"2933","SC0",2023-10-28,"Motherwell","Ross County",3,3,"D",0,0,"D",1.93,3.68,4.17,"0-0","3-3",13,3,13,6,2,2,0,0,6,4,10,9,6,10,19,"6-4","Y","Y","Y",4,0,9
"2934","SC0",2023-10-28,"St Mirren","St Johnstone",4,0,"H",1,0,"H",1.57,4.15,6.5,"1-0","4-0",9,5,14,3,2,0,0,0,4,8,9,5,4,12,14,"4-8","Y","Y","Y",2,0,10
"2935","SC0",2023-10-29,"Kilmarnock","Aberdeen",2,0,"H",1,0,"H",2.56,3.32,2.98,"1-0","2-0",19,8,5,1,1,3,0,0,9,3,12,14,2,12,26,"9-3","Y","N","N",4,0,10
"2936","SC0",2023-10-29,"Rangers","Hearts",2,1,"H",0,1,"A",1.31,5.92,10.1,"0-1","2-1",28,5,5,1,1,5,0,0,11,2,6,13,3,13,19,"11-2","Y","Y","N",6,0,10
"2937","SC0",2023-10-31,"Hibernian","Ross County",2,2,"D",1,0,"H",1.58,4.19,6.25,"1-0","2-2",7,2,8,3,1,2,0,0,5,5,12,16,4,10,28,"5-5","Y","Y","Y",3,0,10
"2938","SC0",2023-11-01,"Celtic","St Mirren",2,1,"H",1,1,"D",1.21,7.58,13.12,"1-1","2-1",23,8,6,2,2,2,0,0,12,2,9,12,3,14,21,"12-2","Y","Y","N",4,0,10
"2939","SC0",2023-11-01,"Dundee","Rangers",0,5,"A",0,1,"A",7.93,5.08,1.41,"0-1","0-5",9,4,32,11,4,1,0,0,6,7,13,3,5,13,16,"6-7","Y","Y","Y",5,0,10
"2940","SC0",2023-11-01,"Hearts","Livingston",1,0,"H",0,0,"D",1.65,3.92,5.86,"0-0","1-0",25,10,3,0,2,4,0,0,12,1,9,12,1,13,21,"12-1","N","N","N",6,0,11
"2941","SC0",2023-11-01,"Motherwell","Aberdeen",2,4,"A",0,2,"A",2.55,3.42,2.92,"0-2","2-4",9,2,15,6,6,1,0,0,1,4,14,6,6,5,20,"1-4","Y","Y","Y",7,0,11
"2942","SC0",2023-11-01,"St Johnstone","Kilmarnock",2,1,"H",2,0,"H",3.39,3.3,2.33,"2-0","2-1",15,4,23,5,2,2,1,0,5,12,13,9,3,17,22,"5-12","Y","Y","N",4,1,11
"2943","SC0",2023-11-04,"Ross County","Celtic",0,3,"A",0,1,"A",13.53,7.01,1.22,"0-1","0-3",3,0,39,16,0,1,1,0,2,13,9,10,3,15,19,"2-13","Y","Y","N",1,1,11
"2944","SC0",2023-11-04,"Kilmarnock","Motherwell",1,0,"H",0,0,"D",2.18,3.54,3.48,"0-0","1-0",20,8,11,1,2,1,0,0,9,3,9,12,1,12,21,"9-3","N","N","N",3,0,11
"2945","SC0",2023-11-05,"Dundee","Livingston",1,0,"H",0,0,"D",2.1,3.41,3.88,"0-0","1-0",10,3,16,3,2,3,0,0,5,12,14,14,1,17,28,"5-12","N","N","N",5,0,11
"2946","SC0",2023-11-07,"St Johnstone","Motherwell",2,2,"D",2,0,"H",2.91,3.1,2.77,"2-0","2-2",10,3,11,5,1,2,0,0,6,7,11,18,4,13,29,"6-7","Y","Y","Y",3,0,12
"2947","SC0",2023-11-08,"St Mirren","Hibernian",2,2,"D",0,1,"A",2.55,3.28,3.02,"0-1","2-2",18,4,9,4,3,2,0,0,3,1,9,9,4,4,18,"3-1","Y","Y","Y",5,0,12
"2948","SC0",2023-11-11,"Dundee","St Mirren",4,0,"H",2,0,"H",2.33,3.36,3.31,"2-0","4-0",11,7,5,0,1,1,0,0,7,4,6,12,4,11,18,"7-4","Y","Y","Y",2,0,12
"2949","SC0",2023-11-11,"Hibernian","Kilmarnock",1,0,"H",1,0,"H",2.17,3.6,3.47,"1-0","1-0",7,5,9,1,2,5,0,0,5,10,6,14,1,15,20,"5-10","N","N","N",7,0,12
"2950","SC0",2023-11-11,"Motherwell","Hearts",1,2,"A",0,1,"A",2.99,3.51,2.45,"0-1","1-2",8,1,14,3,4,2,0,0,4,10,13,12,3,14,25,"4-10","Y","Y","N",6,0,12
"2951","SC0",2023-11-11,"St Johnstone","Ross County",1,0,"H",0,0,"D",2.71,3.39,2.76,"0-0","1-0",10,3,8,2,4,3,0,0,3,4,11,13,1,7,24,"3-4","N","N","N",7,0,12
"2952","SC0",2023-11-12,"Livingston","Rangers",0,2,"A",0,1,"A",10.93,5.89,1.29,"0-1","0-2",4,1,18,6,1,1,0,0,3,9,14,7,2,12,21,"3-9","Y","N","N",2,0,13
"2953","SC0",2023-11-12,"Celtic","Aberdeen",6,0,"H",2,0,"H",1.23,7.21,12.14,"2-0","6-0",21,10,3,1,0,3,0,0,11,0,5,8,6,11,13,"11-0","Y","Y","Y",3,0,13
"2954","SC0",2023-11-25,"Celtic","Motherwell",1,1,"D",0,0,"D",1.14,9.94,18.23,"0-0","1-1",20,4,6,2,1,4,0,0,13,2,8,9,2,15,17,"13-2","Y","N","N",5,0,13
"2955","SC0",2023-11-25,"Dundee","Hibernian",1,2,"A",0,1,"A",2.74,3.33,2.76,"0-1","1-2",19,7,10,3,2,1,0,1,7,3,6,9,3,10,15,"7-3","Y","Y","N",3,1,13
"2956","SC0",2023-11-25,"Hearts","St Johnstone",1,0,"H",0,0,"D",1.58,4.17,6.31,"0-0","1-0",18,4,10,3,2,2,0,0,6,5,5,17,1,11,22,"6-5","N","N","N",4,0,13
"2957","SC0",2023-11-25,"Ross County","Kilmarnock",0,0,"D",0,0,"D",2.9,3.33,2.61,"0-0","0-0",15,5,13,1,1,0,0,0,9,5,10,9,0,14,19,"9-5","N","N","N",1,0,13
"2958","SC0",2023-11-25,"St Mirren","Livingston",1,0,"H",1,0,"H",1.8,3.71,4.89,"1-0","1-0",15,1,11,1,1,0,0,0,7,3,13,10,1,10,23,"7-3","N","N","N",1,0,14
"2959","SC0",2023-11-26,"Aberdeen","Rangers",1,1,"D",1,0,"H",6.19,4.59,1.53,"1-0","1-1",5,4,22,10,4,1,0,0,0,5,16,11,2,5,27,"0-5","Y","N","N",5,0,14
"2960","SC0",2023-11-28,"Ross County","St Mirren",1,0,"H",0,0,"D",2.81,3.04,2.91,"0-0","1-0",6,2,6,1,0,2,0,0,7,5,11,14,1,12,25,"7-5","N","N","N",2,0,14
"2961","SC0",2023-12-02,"Kilmarnock","Hearts",0,1,"A",0,1,"A",3.03,3.39,2.48,"0-1","0-1",17,3,11,1,2,1,0,0,7,3,14,12,1,10,26,"7-3","N","N","N",3,0,14
"2962","SC0",2023-12-02,"Motherwell","Dundee",3,3,"D",1,2,"A",2.34,3.41,3.25,"1-2","3-3",9,4,16,4,3,2,1,0,4,4,6,9,6,8,15,"4-4","Y","Y","Y",5,1,14
"2963","SC0",2023-12-03,"St Johnstone","Celtic",1,3,"A",1,0,"H",11.88,7.19,1.23,"1-0","1-3",5,3,25,7,2,1,0,0,2,12,8,7,4,14,15,"2-12","Y","Y","Y",3,0,14
"2964","SC0",2023-12-03,"Hibernian","Aberdeen",2,0,"H",1,0,"H",2.07,3.59,3.74,"1-0","2-0",11,3,23,5,3,2,0,0,6,6,13,13,2,12,26,"6-6","Y","N","N",5,0,15
"2965","SC0",2023-12-03,"Rangers","St Mirren",2,0,"H",1,0,"H",1.21,7.05,15.15,"1-0","2-0",21,6,4,3,1,3,0,0,8,5,9,8,2,13,17,"8-5","Y","N","N",4,0,15
"2966","SC0",2023-12-05,"Ross County","Motherwell",3,0,"H",2,0,"H",2.35,3.15,3.52,"2-0","3-0",13,6,14,4,1,2,1,0,6,3,14,9,3,9,23,"6-3","Y","Y","N",3,1,15
"2967","SC0",2023-12-06,"Aberdeen","Kilmarnock",0,1,"A",0,0,"D",2.37,3.38,3.23,"0-0","0-1",18,3,8,2,3,1,0,0,4,5,11,21,1,9,32,"4-5","N","N","N",4,0,15
"2968","SC0",2023-12-06,"Celtic","Hibernian",4,1,"H",2,0,"H",1.22,7.23,12.83,"2-0","4-1",26,12,6,3,2,2,0,0,11,4,10,8,5,15,18,"11-4","Y","Y","Y",4,0,15
"2969","SC0",2023-12-06,"St Johnstone","St Mirren",1,0,"H",0,0,"D",3.18,3.12,2.55,"0-0","1-0",11,5,13,5,2,1,0,0,0,7,9,10,1,7,19,"0-7","N","N","N",3,0,15
"2970","SC0",2023-12-06,"Hearts","Rangers",0,1,"A",0,1,"A",6.16,4.47,1.55,"0-1","0-1",12,5,22,5,3,1,0,0,6,5,13,11,1,11,24,"6-5","N","N","N",4,0,16
"2971","SC1",2023-08-04,"Arbroath","Dundee United",0,4,"A",0,4,"A",3.88,3.26,2.08,"0-4","0-4",3,1,15,7,2,0,0,0,6,10,13,3,4,16,16,"6-10","Y","Y","Y",2,0,1
"2972","SC1",2023-08-05,"Dunfermline","Airdrie Utd",2,1,"H",1,1,"D",1.96,3.69,3.78,"1-1","2-1",13,5,12,3,1,1,1,0,4,5,11,9,3,9,20,"4-5","Y","Y","N",2,1,1
"2973","SC1",2023-08-05,"Inverness C","Queens Park",1,2,"A",0,1,"A",2.21,3.63,3.16,"0-1","1-2",12,6,12,7,1,3,0,0,5,4,9,10,3,9,19,"5-4","Y","Y","N",4,0,1
"2974","SC1",2023-08-05,"Morton","Ayr",3,1,"H",0,0,"D",2.6,3.29,2.81,"0-0","3-1",19,6,7,4,3,5,0,0,3,4,9,16,4,7,25,"3-4","Y","Y","Y",8,0,1
"2975","SC1",2023-08-05,"Partick","Raith Rvs",2,2,"D",2,0,"H",1.75,3.87,4.59,"2-0","2-2",14,5,14,6,1,2,0,0,7,4,8,9,4,11,17,"7-4","Y","Y","Y",3,0,1
"2976","SC1",2023-08-12,"Airdrie Utd","Partick",2,1,"H",0,1,"A",3,3.61,2.21,"0-1","2-1",11,2,7,2,0,0,0,0,6,4,6,9,3,10,15,"6-4","Y","Y","N",0,0,2
"2977","SC1",2023-08-12,"Ayr","Inverness C",1,0,"H",1,0,"H",2.01,3.63,3.66,"1-0","1-0",7,3,10,4,2,2,0,0,5,3,10,13,1,8,23,"5-3","N","N","N",4,0,2
"2978","SC1",2023-08-12,"Dundee United","Dunfermline",1,1,"D",0,0,"D",1.65,4.24,4.79,"0-0","1-1",16,4,5,2,0,2,0,0,10,4,14,3,2,14,17,"10-4","Y","N","N",2,0,2
"2979","SC1",2023-08-12,"Queens Park","Arbroath",2,1,"H",1,0,"H",1.69,3.99,4.68,"1-0","2-1",14,5,6,1,3,1,0,0,15,2,8,7,3,17,15,"15-2","Y","Y","N",4,0,2
"2980","SC1",2023-08-12,"Raith Rvs","Morton",3,2,"H",2,1,"H",2.52,3.46,2.79,"2-1","3-2",4,4,3,2,5,8,0,0,5,6,8,13,5,11,21,"5-6","Y","Y","Y",13,0,2
"2981","SC1",2023-08-19,"Arbroath","Queens Park",0,1,"A",0,0,"D",3.49,3.44,2.14,"0-0","0-1",12,3,4,3,1,2,0,0,3,6,15,9,1,9,24,"3-6","N","N","N",3,0,3
"2982","SC1",2023-08-26,"Airdrie Utd","Inverness C",2,1,"H",2,0,"H",2.17,3.58,3.28,"2-0","2-1",8,3,19,6,1,3,1,0,1,3,11,15,3,4,26,"1-3","Y","Y","N",4,1,3
"2983","SC1",2023-08-26,"Ayr","Dundee United",0,3,"A",0,0,"D",3.21,3.34,2.31,"0-0","0-3",2,2,13,8,1,2,0,0,4,11,8,9,3,15,17,"4-11","Y","Y","N",3,0,3
"2984","SC1",2023-08-26,"Dunfermline","Raith Rvs",0,1,"A",0,1,"A",2.34,3.41,3.09,"0-1","0-1",5,2,3,2,2,2,0,0,12,2,8,7,1,14,15,"12-2","N","N","N",4,0,3
"2985","SC1",2023-08-26,"Morton","Arbroath",0,3,"A",0,1,"A",1.69,3.7,5.33,"0-1","0-3",17,8,13,6,2,3,0,0,14,6,11,17,3,20,28,"14-6","Y","Y","N",5,0,3
"2986","SC1",2023-08-26,"Partick","Queens Park",3,1,"H",2,1,"H",2.01,3.82,3.5,"2-1","3-1",10,6,14,4,2,1,0,0,1,6,8,10,4,7,18,"1-6","Y","Y","Y",3,0,4
"2987","SC1",2023-09-02,"Arbroath","Ayr",2,1,"H",1,1,"D",2.8,2.96,2.87,"1-1","2-1",11,6,9,3,3,1,0,0,5,7,9,7,3,12,16,"5-7","Y","Y","N",4,0,4
"2988","SC1",2023-09-02,"Dundee United","Airdrie Utd",2,0,"H",1,0,"H",1.64,4,5.26,"1-0","2-0",9,3,9,3,2,2,0,0,5,3,14,8,2,8,22,"5-3","Y","N","N",4,0,4
"2989","SC1",2023-09-02,"Inverness C","Dunfermline",1,1,"D",1,0,"H",2.35,3.39,3.09,"1-0","1-1",7,2,10,4,2,1,0,0,2,7,10,7,2,9,17,"2-7","Y","N","N",3,0,4
"2990","SC1",2023-09-02,"Morton","Partick",1,4,"A",1,1,"D",2.56,3.61,2.66,"1-1","1-4",15,8,13,6,1,0,0,1,2,7,6,6,5,9,12,"2-7","Y","Y","Y",1,1,4
"2991","SC1",2023-09-02,"Raith Rvs","Queens Park",3,2,"H",1,0,"H",2.14,3.68,3.28,"1-0","3-2",8,7,4,2,1,0,0,1,8,1,5,10,5,9,15,"8-1","Y","Y","Y",1,1,5
"2992","SC1",2023-09-15,"Ayr","Partick",0,4,"A",0,1,"A",3.29,3.73,2.12,"0-1","0-4",13,10,11,5,3,1,0,0,9,3,6,7,4,12,13,"9-3","Y","Y","Y",4,0,5
"2993","SC1",2023-09-16,"Arbroath","Airdrie Utd",4,0,"H",2,0,"H",2.43,3.68,2.77,"2-0","4-0",11,6,6,0,0,1,1,1,2,5,13,8,4,7,21,"2-5","Y","Y","Y",1,2,5
"2994","SC1",2023-09-16,"Dundee United","Morton",1,1,"D",1,0,"H",1.67,4.02,4.94,"1-0","1-1",9,1,7,1,1,3,1,0,5,4,15,12,2,9,27,"5-4","Y","N","N",4,1,5
"2995","SC1",2023-09-16,"Queens Park","Dunfermline",0,2,"A",0,0,"D",2.31,3.52,3.05,"0-0","0-2",14,2,15,5,2,3,0,0,8,9,11,7,2,17,18,"8-9","Y","N","N",5,0,5
"2996","SC1",2023-09-16,"Raith Rvs","Inverness C",1,0,"H",0,0,"D",1.88,3.69,3.95,"0-0","1-0",7,2,8,5,2,2,0,0,3,7,9,15,1,10,24,"3-7","N","N","N",4,0,6
"2997","SC1",2023-09-22,"Queens Park","Ayr",2,5,"A",1,4,"A",2.07,3.61,3.49,"1-4","2-5",12,4,10,6,2,0,0,0,4,2,8,7,7,6,15,"4-2","Y","Y","Y",2,0,6
"2998","SC1",2023-09-23,"Airdrie Utd","Raith Rvs",1,0,"H",0,0,"D",2.41,3.57,2.86,"0-0","1-0",7,3,11,6,1,4,0,0,2,1,8,9,1,3,17,"2-1","N","N","N",5,0,6
"2999","SC1",2023-09-23,"Dunfermline","Morton",3,1,"H",2,0,"H",2.07,3.48,3.65,"2-0","3-1",10,5,9,2,0,3,0,0,10,4,8,14,4,14,22,"10-4","Y","Y","Y",3,0,6
"3000","SC1",2023-09-23,"Inverness C","Dundee United",0,1,"A",0,0,"D",3.69,3.48,2.05,"0-0","0-1",8,2,12,4,2,3,0,1,4,2,6,13,1,6,19,"4-2","N","N","N",5,1,6
"3001","SC1",2023-09-23,"Partick","Arbroath",0,3,"A",0,2,"A",1.62,4.17,5.18,"0-2","0-3",8,1,19,7,3,2,0,0,4,6,12,10,3,10,22,"4-6","Y","Y","N",5,0,7
"3002","SC1",2023-09-30,"Arbroath","Inverness C",2,3,"A",0,2,"A",2.19,3.6,3.14,"0-2","2-3",11,3,7,6,1,1,0,0,8,2,14,18,5,10,32,"8-2","Y","Y","Y",2,0,7
"3003","SC1",2023-09-30,"Ayr","Raith Rvs",1,2,"A",0,2,"A",2.78,3.45,2.5,"0-2","1-2",13,4,8,3,2,2,0,0,8,4,10,6,3,12,16,"8-4","Y","Y","N",4,0,7
"3004","SC1",2023-09-30,"Dundee United","Queens Park",4,1,"H",1,1,"D",1.56,4.24,5.82,"1-1","4-1",14,5,8,3,0,2,0,0,4,2,7,7,5,6,14,"4-2","Y","Y","Y",2,0,7
"3005","SC1",2023-09-30,"Morton","Airdrie Utd",0,1,"A",0,1,"A",2.16,3.81,3.13,"0-1","0-1",13,1,8,2,2,3,0,0,6,3,12,13,1,9,25,"6-3","N","N","N",5,0,7
"3006","SC1",2023-09-30,"Partick","Dunfermline",3,0,"H",1,0,"H",1.99,3.78,3.5,"1-0","3-0",23,12,19,4,3,1,0,0,4,9,8,5,3,13,13,"4-9","Y","Y","N",4,0,8
"3007","SC1",2023-10-07,"Airdrie Utd","Ayr",1,2,"A",0,1,"A",2.09,3.51,3.55,"0-1","1-2",8,3,11,3,1,1,0,0,7,7,5,9,3,14,14,"7-7","Y","Y","N",2,0,8
"3008","SC1",2023-10-07,"Inverness C","Partick",0,0,"D",0,0,"D",3.01,3.47,2.36,"0-0","0-0",4,1,4,3,0,1,0,0,6,4,10,8,0,10,18,"6-4","N","N","N",1,0,8
"3009","SC1",2023-10-07,"Queens Park","Morton",0,0,"D",0,0,"D",2.3,3.67,2.96,"0-0","0-0",11,4,7,2,1,3,0,0,10,3,10,8,0,13,18,"10-3","N","N","N",4,0,8
"3010","SC1",2023-10-07,"Raith Rvs","Dundee United",1,1,"D",1,0,"H",3.01,3.56,2.32,"1-0","1-1",7,6,7,4,3,4,0,0,3,3,15,13,2,6,28,"3-3","Y","N","N",7,0,8
"3011","SC1",2023-10-20,"Airdrie Utd","Queens Park",1,1,"D",1,0,"H",2.28,3.69,2.98,"1-0","1-1",10,6,13,6,0,3,0,1,1,5,12,12,2,6,24,"1-5","Y","N","N",3,1,9
"3012","SC1",2023-10-21,"Dunfermline","Ayr",0,1,"A",0,1,"A",1.94,3.5,4.08,"0-1","0-1",9,1,15,5,0,1,0,0,4,11,8,14,1,15,22,"4-11","N","N","N",1,0,9
"3013","SC1",2023-10-21,"Partick","Dundee United",0,5,"A",0,1,"A",2.81,3.58,2.4,"0-1","0-5",7,2,13,8,1,2,1,0,2,4,9,12,5,6,21,"2-4","Y","Y","Y",3,1,9
"3014","SC1",2023-10-27,"Dundee United","Arbroath",6,0,"H",3,0,"H",1.5,4.43,6.43,"3-0","6-0",18,10,5,2,0,1,0,0,10,5,5,7,6,15,12,"10-5","Y","Y","Y",1,0,9
"3015","SC1",2023-10-27,"Queens Park","Partick",2,2,"D",0,1,"A",2.82,3.66,2.4,"0-1","2-2",18,8,5,4,2,0,0,0,9,1,7,11,4,10,18,"9-1","Y","Y","Y",2,0,9
"3016","SC1",2023-10-28,"Ayr","Morton",0,1,"A",0,0,"D",2.02,3.7,3.57,"0-0","0-1",13,6,10,5,2,4,0,0,4,10,15,17,1,14,32,"4-10","N","N","N",6,0,10
"3017","SC1",2023-10-28,"Inverness C","Airdrie Utd",1,0,"H",1,0,"H",2.28,3.64,3.03,"1-0","1-0",7,2,9,4,2,2,0,0,3,5,9,12,1,8,21,"3-5","N","N","N",4,0,10
"3018","SC1",2023-10-28,"Raith Rvs","Dunfermline",1,0,"H",0,0,"D",2.19,3.44,3.36,"0-0","1-0",8,2,10,6,1,3,0,0,6,9,5,11,1,15,16,"6-9","N","N","N",4,0,10
"3019","SC1",2023-10-31,"Airdrie Utd","Dundee United",0,2,"A",0,1,"A",5.07,4.17,1.63,"0-1","0-2",10,3,10,5,0,0,0,0,9,3,8,6,2,12,14,"9-3","Y","N","N",0,0,10
"3020","SC1",2023-10-31,"Morton","Raith Rvs",1,2,"A",0,2,"A",3.01,3.08,2.58,"0-2","1-2",10,5,13,3,4,2,0,0,5,5,11,9,3,10,20,"5-5","Y","Y","N",6,0,10
"3021","SC1",2023-10-31,"Partick","Ayr",2,2,"D",1,1,"D",1.96,4,3.5,"1-1","2-2",13,6,8,4,1,0,0,0,4,3,12,13,4,7,25,"4-3","Y","Y","Y",1,0,11
"3022","SC1",2023-11-03,"Morton","Dunfermline",1,2,"A",0,2,"A",2.61,3.17,2.9,"0-2","1-2",10,7,11,5,4,2,0,0,7,6,11,9,3,13,20,"7-6","Y","Y","N",6,0,11
"3023","SC1",2023-11-04,"Arbroath","Partick",1,3,"A",0,1,"A",2.76,3.55,2.5,"0-1","1-3",7,3,10,8,2,1,0,0,7,9,13,12,4,16,25,"7-9","Y","Y","Y",3,0,11
"3024","SC1",2023-11-04,"Ayr","Queens Park",2,2,"D",2,0,"H",2.1,3.84,3.25,"2-0","2-2",10,6,7,3,0,2,0,0,2,7,5,9,4,9,14,"2-7","Y","Y","Y",2,0,11
"3025","SC1",2023-11-04,"Dundee United","Inverness C",1,1,"D",0,0,"D",1.37,5.09,7.93,"0-0","1-1",13,7,4,2,1,1,0,0,5,3,11,7,2,8,18,"5-3","Y","N","N",2,0,11
"3026","SC1",2023-11-04,"Raith Rvs","Airdrie Utd",1,1,"D",1,0,"H",1.68,4.08,4.78,"1-0","1-1",10,5,16,9,0,1,0,0,6,3,10,8,2,9,18,"6-3","Y","N","N",1,0,12
"3027","SC1",2023-11-10,"Dunfermline","Dundee United",1,2,"A",0,1,"A",4.08,3.88,1.83,"0-1","1-2",6,2,16,5,4,3,0,0,3,7,7,9,3,10,16,"3-7","Y","Y","N",7,0,12
"3028","SC1",2023-11-11,"Airdrie Utd","Arbroath",2,0,"H",1,0,"H",2.24,3.65,3.08,"1-0","2-0",6,5,8,1,0,0,0,0,5,5,10,12,2,10,22,"5-5","Y","N","N",0,0,12
"3029","SC1",2023-11-11,"Inverness C","Ayr",3,1,"H",3,0,"H",2.44,3.5,2.87,"3-0","3-1",5,5,5,1,2,0,0,0,5,4,8,9,4,9,17,"5-4","Y","Y","Y",2,0,12
"3030","SC1",2023-11-11,"Partick","Morton",2,1,"H",1,1,"D",1.79,4.12,4.06,"1-1","2-1",10,5,6,2,2,3,1,0,2,2,15,14,3,4,29,"2-2","Y","Y","N",5,1,12
"3031","SC1",2023-11-11,"Queens Park","Raith Rvs",2,3,"A",0,1,"A",3.18,3.39,2.3,"0-1","2-3",18,9,12,6,2,1,1,0,5,1,11,6,5,6,17,"5-1","Y","Y","Y",3,1,13
"3032","SC1",2023-11-18,"Dunfermline","Inverness C",1,1,"D",0,1,"A",2.31,3.37,3.18,"0-1","1-1",12,2,5,2,2,3,0,0,10,7,2,5,2,17,7,"10-7","Y","N","N",5,0,13
"3033","SC1",2023-11-28,"Dunfermline","Arbroath",3,0,"H",0,0,"D",1.96,3.7,3.74,"0-0","3-0",17,9,6,0,1,1,0,0,12,1,8,7,3,13,15,"12-1","Y","Y","N",2,0,13
"3034","SC1",2023-12-02,"Inverness C","Raith Rvs",1,2,"A",0,0,"D",3.43,3.39,2.18,"0-0","1-2",6,2,13,5,2,2,0,0,3,10,12,5,3,13,17,"3-10","Y","Y","N",4,0,13
"3035","SC1",2023-12-02,"Partick","Airdrie Utd",2,1,"H",2,0,"H",1.76,4.18,4.15,"2-0","2-1",7,3,7,4,1,0,0,0,4,8,7,7,3,12,14,"4-8","Y","Y","N",1,0,13
"3036","SC2",2023-08-05,"Falkirk","Annan Athletic",3,0,"H",0,0,"D",NA,NA,NA,"0-0","3-0",17,8,4,0,3,1,0,0,11,1,14,5,3,12,19,"11-1","Y","Y","N",4,0,1
"3037","SC2",2023-08-05,"Hamilton","Cove Rangers",1,0,"H",1,0,"H",NA,NA,NA,"1-0","1-0",9,6,4,0,2,1,0,1,7,5,8,2,1,12,10,"7-5","N","N","N",3,1,1
"3038","SC2",2023-08-05,"Montrose","Kelty Hearts",0,2,"A",0,0,"D",2.26,3.4,2.93,"0-0","0-2",11,4,11,4,3,3,0,0,12,5,17,13,2,17,30,"12-5","Y","N","N",6,0,1
"3039","SC2",2023-08-05,"Queen of Sth","Alloa",3,4,"A",2,4,"A",1.93,3.61,3.68,"2-4","3-4",9,4,10,8,3,2,0,0,8,3,9,18,7,11,27,"8-3","Y","Y","Y",5,0,1
"3040","SC2",2023-08-05,"Stirling","Edinburgh City",1,0,"H",0,0,"D",NA,NA,NA,"0-0","1-0",12,5,5,4,0,3,0,0,10,1,12,10,1,11,22,"10-1","N","N","N",3,0,1
"3041","SC2",2023-08-12,"Alloa","Stirling",0,1,"A",0,0,"D",NA,NA,NA,"0-0","0-1",3,1,4,2,3,2,1,0,3,5,11,10,1,8,21,"3-5","N","N","N",5,1,2
"3042","SC2",2023-08-12,"Annan Athletic","Montrose",1,3,"A",0,3,"A",2.51,3.43,2.67,"0-3","1-3",16,5,4,3,0,2,0,0,4,3,7,11,4,7,18,"4-3","Y","Y","Y",2,0,2
"3043","SC2",2023-08-12,"Cove Rangers","Falkirk",2,2,"D",0,0,"D",NA,NA,NA,"0-0","2-2",7,4,13,7,3,3,0,0,3,8,17,11,4,11,28,"3-8","Y","Y","Y",6,0,2
"3044","SC2",2023-08-12,"Edinburgh City","Queen of Sth",1,2,"A",1,0,"H",NA,NA,NA,"1-0","1-2",8,3,14,8,1,1,0,1,3,10,14,8,3,13,22,"3-10","Y","Y","N",2,1,2
"3045","SC2",2023-08-12,"Kelty Hearts","Hamilton",0,2,"A",0,0,"D",NA,NA,NA,"0-0","0-2",5,1,16,11,0,2,0,0,3,7,6,6,2,10,12,"3-7","Y","N","N",2,0,2
"3046","SC2",2023-08-19,"Edinburgh City","Hamilton",0,3,"A",0,1,"A",3.81,3.77,1.86,"0-1","0-3",9,1,23,9,0,2,1,0,3,8,11,6,3,11,17,"3-8","Y","Y","N",2,1,3
"3047","SC2",2023-08-19,"Kelty Hearts","Alloa",2,1,"H",1,0,"H",2.49,3.25,2.82,"1-0","2-1",7,3,9,3,2,6,0,0,2,2,16,9,3,4,25,"2-2","Y","Y","N",8,0,3
"3048","SC2",2023-08-19,"Montrose","Cove Rangers",0,3,"A",0,2,"A",2.5,3.41,2.7,"0-2","0-3",8,5,19,8,0,0,0,0,6,3,8,9,3,9,17,"6-3","Y","Y","N",0,0,3
"3049","SC2",2023-08-19,"Queen of Sth","Annan Athletic",3,1,"H",0,1,"A",1.58,4.16,5.23,"0-1","3-1",13,4,6,1,2,2,0,0,5,1,14,6,4,6,20,"5-1","Y","Y","Y",4,0,3
"3050","SC2",2023-08-22,"Falkirk","Stirling",3,0,"H",3,0,"H",1.66,3.97,4.46,"3-0","3-0",12,4,3,3,2,2,0,0,10,2,11,11,3,12,22,"10-2","Y","Y","N",4,0,3
"3051","SC2",2023-08-26,"Annan Athletic","Edinburgh City",3,2,"H",1,2,"A",2.11,3.45,3.32,"1-2","3-2",16,8,15,7,3,2,0,0,2,8,7,8,5,10,15,"2-8","Y","Y","Y",5,0,4
"3052","SC2",2023-08-26,"Cove Rangers","Queen of Sth",1,2,"A",0,2,"A",2.07,3.62,3.27,"0-2","1-2",15,3,6,2,1,2,1,1,6,5,12,14,3,11,26,"6-5","Y","Y","N",3,2,4
"3053","SC2",2023-08-26,"Hamilton","Montrose",1,0,"H",1,0,"H",1.43,4.58,6.8,"1-0","1-0",7,4,4,2,2,3,0,0,10,1,13,8,1,11,21,"10-1","N","N","N",5,0,4
"3054","SC2",2023-08-26,"Stirling","Kelty Hearts",1,0,"H",0,0,"D",1.9,3.72,3.71,"0-0","1-0",8,3,7,2,1,1,0,0,9,4,8,5,1,13,13,"9-4","N","N","N",2,0,4
"3055","SC2",2023-08-26,"Alloa","Falkirk",1,4,"A",0,2,"A",3.99,3.88,1.8,"0-2","1-4",6,4,14,7,3,2,0,0,2,9,9,13,5,11,22,"2-9","Y","Y","Y",5,0,4
"3056","SC2",2023-09-02,"Alloa","Cove Rangers",1,0,"H",1,0,"H",2.64,3.33,2.6,"1-0","1-0",10,5,9,3,3,1,0,0,5,3,10,10,1,8,20,"5-3","N","N","N",4,0,5
"3057","SC2",2023-09-02,"Edinburgh City","Falkirk",0,2,"A",0,1,"A",7.01,4.84,1.4,"0-1","0-2",2,0,28,12,4,0,0,0,4,7,12,7,2,11,19,"4-7","Y","N","N",4,0,5
"3058","SC2",2023-09-02,"Kelty Hearts","Annan Athletic",1,1,"D",0,0,"D",1.71,3.87,4.21,"0-0","1-1",6,3,11,2,1,2,0,0,2,3,8,6,2,5,14,"2-3","Y","N","N",3,0,5
"3059","SC2",2023-09-02,"Queen of Sth","Montrose",2,3,"A",0,2,"A",1.79,3.9,3.99,"0-2","2-3",10,6,6,4,1,1,0,0,4,5,6,8,5,9,14,"4-5","Y","Y","Y",2,0,5
"3060","SC2",2023-09-02,"Stirling","Hamilton",2,2,"D",1,2,"A",3.63,3.58,1.96,"1-2","2-2",8,5,17,7,2,0,0,0,1,7,15,7,4,8,22,"1-7","Y","Y","Y",2,0,5
"3061","SC2",2023-09-16,"Annan Athletic","Stirling",3,0,"H",1,0,"H",2.72,3.44,2.47,"1-0","3-0",14,8,11,3,1,3,0,0,4,9,9,14,3,13,23,"4-9","Y","Y","N",4,0,6
"3062","SC2",2023-09-16,"Cove Rangers","Kelty Hearts",2,2,"D",1,2,"A",1.94,3.61,3.65,"1-2","2-2",7,4,5,5,2,3,0,1,4,3,8,8,4,7,16,"4-3","Y","Y","Y",5,1,6
"3063","SC2",2023-09-16,"Falkirk","Queen of Sth",1,0,"H",0,0,"D",1.56,3.88,4.62,"0-0","1-0",11,4,4,0,0,2,0,0,5,1,9,9,1,6,18,"5-1","N","N","N",2,0,6
"3064","SC2",2023-09-16,"Hamilton","Alloa",2,1,"H",0,0,"D",1.56,4.2,5.4,"0-0","2-1",15,8,9,4,2,2,0,0,11,3,9,13,3,14,22,"11-3","Y","Y","N",4,0,6
"3065","SC2",2023-09-16,"Montrose","Edinburgh City",5,2,"H",4,0,"H",1.72,3.92,4.35,"4-0","5-2",15,8,14,7,2,4,0,0,7,5,9,18,7,12,27,"7-5","Y","Y","Y",6,0,6
"3066","SC2",2023-09-23,"Annan Athletic","Alloa",1,1,"D",0,1,"A",2.62,3.45,2.55,"0-1","1-1",15,8,8,2,2,1,0,0,7,0,9,15,2,7,24,"7-0","Y","N","N",3,0,7
"3067","SC2",2023-09-23,"Edinburgh City","Cove Rangers",2,2,"D",1,1,"D",4.34,4.11,1.69,"1-1","2-2",12,5,17,7,1,2,0,0,7,3,8,7,4,10,15,"7-3","Y","Y","Y",3,0,7
"3068","SC2",2023-09-23,"Montrose","Stirling",1,0,"H",0,0,"D",2.5,3.44,2.68,"0-0","1-0",5,3,4,0,3,4,0,0,5,5,11,13,1,10,24,"5-5","N","N","N",7,0,7
"3069","SC2",2023-09-23,"Queen of Sth","Hamilton",1,2,"A",1,1,"D",3.31,3.54,2.09,"1-1","1-2",7,1,16,8,5,1,0,0,1,6,21,11,3,7,32,"1-6","Y","Y","N",6,0,7
"3070","SC2",2023-09-23,"Kelty Hearts","Falkirk",1,5,"A",1,3,"A",4.9,4.02,1.64,"1-3","1-5",2,1,22,14,2,2,0,0,3,6,9,13,6,9,22,"3-6","Y","Y","Y",4,0,7
"3071","SC2",2023-09-29,"Hamilton","Annan Athletic",5,0,"H",1,0,"H",1.34,5.34,7.83,"1-0","5-0",16,6,2,1,1,1,0,0,4,4,13,7,5,8,20,"4-4","Y","Y","Y",2,0,8
"3072","SC2",2023-09-30,"Alloa","Edinburgh City",1,1,"D",0,0,"D",1.67,3.94,4.45,"0-0","1-1",14,6,6,3,2,2,0,0,7,5,11,8,2,12,19,"7-5","Y","N","N",4,0,8
"3073","SC2",2023-09-30,"Falkirk","Montrose",3,2,"H",0,0,"D",1.39,4.65,6.35,"0-0","3-2",21,7,10,3,2,3,0,0,13,5,12,8,5,18,20,"13-5","Y","Y","Y",5,0,8
"3074","SC2",2023-09-30,"Kelty Hearts","Queen of Sth",3,1,"H",1,1,"D",2.77,3.59,2.35,"1-1","3-1",8,3,14,4,3,2,0,0,5,6,18,14,4,11,32,"5-6","Y","Y","Y",5,0,8
"3075","SC2",2023-09-30,"Stirling","Cove Rangers",2,2,"D",1,0,"H",2.5,3.31,2.76,"1-0","2-2",11,7,9,4,2,0,0,1,2,4,8,7,4,6,15,"2-4","Y","Y","Y",2,1,8
"3076","SC2",2023-10-07,"Cove Rangers","Annan Athletic",3,2,"H",2,0,"H",1.63,3.97,4.41,"2-0","3-2",15,8,8,4,3,2,0,0,3,1,12,10,5,4,22,"3-1","Y","Y","Y",5,0,9
"3077","SC2",2023-10-07,"Edinburgh City","Kelty Hearts",1,4,"A",0,2,"A",3.13,3.59,2.14,"0-2","1-4",10,4,17,8,1,1,0,0,9,11,7,12,5,20,19,"9-11","Y","Y","Y",2,0,9
"3078","SC2",2023-10-07,"Montrose","Alloa",2,1,"H",1,0,"H",2.05,3.58,3.35,"1-0","2-1",7,5,12,5,1,3,0,0,4,7,11,16,3,11,27,"4-7","Y","Y","N",4,0,9
"3079","SC2",2023-10-07,"Queen of Sth","Stirling",0,1,"A",0,0,"D",1.93,3.77,3.55,"0-0","0-1",10,5,13,6,2,2,0,0,9,3,7,13,1,12,20,"9-3","N","N","N",4,0,9
"3080","SC2",2023-10-07,"Falkirk","Hamilton",0,0,"D",0,0,"D",1.96,3.56,3.64,"0-0","0-0",9,1,7,3,1,3,0,0,1,2,10,16,0,3,26,"1-2","N","N","N",4,0,9
"3081","SC2",2023-10-21,"Alloa","Kelty Hearts",3,1,"H",1,1,"D",2.3,3.66,2.8,"1-1","3-1",9,6,7,3,1,2,0,0,2,5,16,11,4,7,27,"2-5","Y","Y","Y",3,0,10
"3082","SC2",2023-10-21,"Annan Athletic","Queen of Sth",0,1,"A",0,1,"A",2.88,3.61,2.28,"0-1","0-1",16,4,9,4,3,4,0,0,5,2,12,10,1,7,22,"5-2","N","N","N",7,0,10
"3083","SC2",2023-10-21,"Hamilton","Edinburgh City",1,1,"D",1,0,"H",1.19,7.11,11.36,"1-0","1-1",16,5,7,1,3,2,0,0,13,0,6,8,2,13,14,"13-0","Y","N","N",5,0,10
"3084","SC2",2023-10-21,"Stirling","Falkirk",1,2,"A",1,1,"D",5.7,4.25,1.53,"1-1","1-2",2,1,16,7,6,5,0,0,2,6,16,16,3,8,32,"2-6","Y","Y","N",11,0,10
"3085","SC2",2023-10-28,"Edinburgh City","Annan Athletic",3,2,"H",2,1,"H",3.03,3.6,2.19,"2-1","3-2",5,4,12,6,2,2,0,0,4,2,13,13,5,6,26,"4-2","Y","Y","Y",4,0,10
"3086","SC2",2023-10-28,"Falkirk","Alloa",3,0,"H",3,0,"H",1.27,5.78,9.19,"3-0","3-0",21,8,3,0,1,3,0,0,12,1,9,12,3,13,21,"12-1","Y","Y","N",4,0,11
"3087","SC2",2023-10-28,"Kelty Hearts","Stirling",1,0,"H",0,0,"D",2.17,3.67,3.02,"0-0","1-0",7,3,6,2,1,1,0,1,9,8,8,8,1,17,16,"9-8","N","N","N",2,1,11
"3088","SC2",2023-10-28,"Queen of Sth","Cove Rangers",0,1,"A",0,0,"D",2.55,3.66,2.51,"0-0","0-1",7,2,13,5,1,0,0,0,2,4,13,8,1,6,21,"2-4","N","N","N",1,0,11
"3089","SC2",2023-10-28,"Montrose","Hamilton",0,3,"A",0,1,"A",4.48,4.09,1.68,"0-1","0-3",10,1,12,7,4,3,0,0,3,3,10,13,3,6,23,"3-3","Y","Y","N",7,0,11
"3090","SC2",2023-11-04,"Annan Athletic","Kelty Hearts",2,2,"D",1,1,"D",2.48,3.48,2.67,"1-1","2-2",7,3,8,4,3,2,0,0,4,17,13,5,4,21,18,"4-17","Y","Y","Y",5,0,11
"3091","SC2",2023-11-04,"Cove Rangers","Hamilton",1,0,"H",0,0,"D",3.4,3.63,2.02,"0-0","1-0",5,2,13,4,0,0,0,0,4,9,10,7,1,13,17,"4-9","N","N","N",0,0,12
"3092","SC2",2023-11-04,"Edinburgh City","Montrose",1,5,"A",1,2,"A",3.16,3.76,2.08,"1-2","1-5",4,1,13,8,5,2,0,0,5,7,17,15,6,12,32,"5-7","Y","Y","Y",7,0,12
"3093","SC2",2023-11-04,"Queen of Sth","Falkirk",1,1,"D",1,1,"D",6.89,4.68,1.42,"1-1","1-1",10,3,15,4,1,0,0,0,6,6,10,9,2,12,19,"6-6","Y","N","N",1,0,12
"3094","SC2",2023-11-04,"Stirling","Alloa",0,2,"A",0,1,"A",2.09,3.44,3.08,"0-1","0-2",8,2,14,6,2,1,0,0,5,6,12,7,2,11,19,"5-6","Y","N","N",3,0,12
"3095","SC2",2023-11-11,"Alloa","Queen of Sth",1,0,"H",0,0,"D",2.74,3.47,2.43,"0-0","1-0",8,4,7,2,1,3,0,0,3,7,6,7,1,10,13,"3-7","N","N","N",4,0,12
"3096","SC2",2023-11-11,"Falkirk","Edinburgh City",2,1,"H",1,1,"D",1.15,8.35,13.5,"1-1","2-1",18,7,6,1,1,7,0,0,5,2,15,14,3,7,29,"5-2","Y","Y","N",8,0,13
"3097","SC2",2023-11-11,"Hamilton","Stirling",5,0,"H",2,0,"H",1.4,4.79,7.01,"2-0","5-0",17,9,2,1,0,2,0,1,4,2,11,10,5,6,21,"4-2","Y","Y","Y",2,1,13
"3098","SC2",2023-11-11,"Kelty Hearts","Cove Rangers",0,1,"A",0,1,"A",2.7,3.54,2.43,"0-1","0-1",10,1,13,4,2,1,0,0,5,8,12,11,1,13,23,"5-8","N","N","N",3,0,13
"3099","SC2",2023-11-11,"Montrose","Annan Athletic",1,1,"D",0,1,"A",1.88,4.18,3.39,"0-1","1-1",15,2,12,4,4,3,0,0,4,4,9,10,2,8,19,"4-4","Y","N","N",7,0,13
"3100","SC2",2023-11-14,"Cove Rangers","Montrose",1,0,"H",1,0,"H",1.8,3.62,4.28,"1-0","1-0",7,4,6,3,1,3,0,0,5,7,6,12,1,12,18,"5-7","N","N","N",4,0,13
"3101","SC2",2023-11-18,"Cove Rangers","Stirling",3,1,"H",1,1,"D",1.58,4.11,5.33,"1-1","3-1",8,6,6,4,2,0,0,0,9,1,14,10,4,10,24,"9-1","Y","Y","Y",2,0,14
"3102","SC2",2023-11-18,"Edinburgh City","Alloa",3,0,"H",2,0,"H",3.89,3.83,1.83,"2-0","3-0",10,4,14,4,4,1,0,0,0,5,15,10,3,5,25,"0-5","Y","Y","N",5,0,14
"3103","SC2",2023-11-18,"Queen of Sth","Kelty Hearts",1,3,"A",1,1,"D",2.08,3.58,3.09,"1-1","1-3",11,6,11,4,2,1,0,0,7,5,9,10,4,12,19,"7-5","Y","Y","Y",3,0,14
"3104","SC2",2023-11-28,"Annan Athletic","Hamilton",1,2,"A",1,2,"A",5.24,4.3,1.56,"1-2","1-2",9,2,17,5,2,2,0,1,1,6,7,13,3,7,20,"1-6","Y","Y","N",4,1,14
"3105","SC2",2023-11-28,"Montrose","Falkirk",0,0,"D",0,0,"D",8.4,5.11,1.34,"0-0","0-0",5,1,10,3,2,4,0,0,5,7,13,16,0,12,29,"5-7","N","N","N",6,0,14
"3106","SC2",2023-12-02,"Hamilton","Queen of Sth",5,0,"H",3,0,"H",1.43,4.62,6.75,"3-0","5-0",20,11,5,1,1,3,0,1,12,2,2,8,5,14,10,"12-2","Y","Y","Y",4,1,15
"3107","SC3",2023-08-05,"Bonnyrigg Rose","Dumbarton",1,1,"D",0,1,"A",2.53,3.26,2.77,"0-1","1-1",9,4,13,6,3,2,0,0,10,4,13,12,2,14,25,"10-4","Y","N","N",5,0,1
"3108","SC3",2023-08-05,"East Fife","Peterhead",0,3,"A",0,1,"A",1.78,3.66,4.39,"0-1","0-3",5,3,10,6,2,3,0,0,4,4,10,12,3,8,22,"4-4","Y","Y","N",5,0,1
"3109","SC3",2023-08-05,"Elgin","Stranraer",0,1,"A",0,1,"A",2.56,3.38,2.65,"0-1","0-1",10,3,6,2,0,1,0,0,5,6,12,18,1,11,30,"5-6","N","N","N",1,0,1
"3110","SC3",2023-08-05,"Spartans","Clyde",1,1,"D",0,1,"A",1.59,3.64,4.05,"0-1","1-1",6,2,7,3,1,1,0,0,6,2,3,7,2,8,10,"6-2","Y","N","N",2,0,1
"3111","SC3",2023-08-05,"Stenhousemuir","Forfar",0,0,"D",0,0,"D",2.2,3.55,3.04,"0-0","0-0",12,3,9,5,2,2,0,0,6,7,12,10,0,13,22,"6-7","N","N","N",4,0,1
"3112","SC3",2023-08-12,"Clyde","Bonnyrigg Rose",0,2,"A",0,1,"A",NA,NA,NA,"0-1","0-2",6,1,9,5,0,2,0,0,4,5,6,10,2,9,16,"4-5","Y","N","N",2,0,2
"3113","SC3",2023-08-12,"Dumbarton","Spartans",1,1,"D",0,0,"D",NA,NA,NA,"0-0","1-1",3,2,2,1,1,3,0,0,4,7,7,5,2,11,12,"4-7","Y","N","N",4,0,2
"3114","SC3",2023-08-12,"Forfar","Elgin",0,0,"D",0,0,"D",1.79,3.58,4.44,"0-0","0-0",11,3,7,3,1,3,0,0,4,6,15,14,0,10,29,"4-6","N","N","N",4,0,2
"3115","SC3",2023-08-12,"Peterhead","Stenhousemuir",0,0,"D",0,0,"D",NA,NA,NA,"0-0","0-0",9,2,8,1,1,2,1,0,4,6,10,14,0,10,24,"4-6","N","N","N",3,1,2
"3116","SC3",2023-08-12,"Stranraer","East Fife",1,1,"D",0,0,"D",2.44,3.29,2.85,"0-0","1-1",3,3,14,8,2,1,1,0,6,6,8,11,2,12,19,"6-6","Y","N","N",3,1,2
"3117","SC3",2023-08-19,"Bonnyrigg Rose","Stranraer",1,1,"D",1,0,"H",2.55,3.32,2.7,"1-0","1-1",5,3,5,2,2,1,0,0,2,4,12,8,2,6,20,"2-4","Y","N","N",3,0,3
"3118","SC3",2023-08-19,"Clyde","Peterhead",1,2,"A",1,2,"A",2.64,3.55,2.39,"1-2","1-2",3,3,11,5,2,1,1,1,2,1,13,4,3,3,17,"2-1","Y","Y","N",3,2,3
"3119","SC3",2023-08-19,"Dumbarton","Forfar",3,1,"H",0,1,"A",2.66,3.32,2.58,"0-1","3-1",14,4,6,3,0,1,0,0,9,5,7,9,4,14,16,"9-5","Y","Y","Y",1,0,3
"3120","SC3",2023-08-19,"East Fife","Stenhousemuir",0,2,"A",0,1,"A",2.31,3.36,2.77,"0-1","0-2",6,3,6,4,2,3,0,0,6,3,9,14,2,9,23,"6-3","Y","N","N",5,0,3
"3121","SC3",2023-08-19,"Spartans","Elgin",2,1,"H",0,0,"D",1.61,3.93,4.75,"0-0","2-1",11,6,8,3,0,0,0,0,5,3,11,8,3,8,19,"5-3","Y","Y","N",0,0,3
"3122","SC3",2023-08-26,"Elgin","East Fife",1,1,"D",1,0,"H",2.91,3.33,2.38,"1-0","1-1",8,3,10,4,4,2,0,0,2,5,12,7,2,7,19,"2-5","Y","N","N",6,0,4
"3123","SC3",2023-08-26,"Forfar","Bonnyrigg Rose",1,2,"A",0,1,"A",2.21,3.19,3.34,"0-1","1-2",9,4,8,3,2,1,1,0,3,4,21,20,3,7,41,"3-4","Y","Y","N",3,1,4
"3124","SC3",2023-08-26,"Peterhead","Spartans",0,1,"A",0,0,"D",2.29,3.34,3.04,"0-0","0-1",5,2,11,6,4,1,0,0,3,5,10,8,1,8,18,"3-5","N","N","N",5,0,4
"3125","SC3",2023-08-26,"Stenhousemuir","Dumbarton",2,4,"A",0,4,"A",2.46,3.26,2.85,"0-4","2-4",10,5,12,8,4,5,0,1,9,7,9,12,6,16,21,"9-7","Y","Y","Y",9,1,4
"3126","SC3",2023-08-26,"Stranraer","Clyde",1,0,"H",0,0,"D",1.93,3.59,3.76,"0-0","1-0",15,3,9,4,1,1,0,0,7,3,11,9,1,10,20,"7-3","N","N","N",2,0,4
"3127","SC3",2023-09-02,"Bonnyrigg Rose","Elgin",5,1,"H",2,0,"H",1.74,3.65,4.66,"2-0","5-1",13,6,11,3,1,1,0,0,6,3,22,11,6,9,33,"6-3","Y","Y","Y",2,0,5
"3128","SC3",2023-09-02,"Clyde","Forfar",0,0,"D",0,0,"D",2.66,3.25,2.63,"0-0","0-0",7,5,7,1,2,2,0,0,3,2,14,12,0,5,26,"3-2","N","N","N",4,0,5
"3129","SC3",2023-09-02,"Dumbarton","East Fife",1,0,"H",0,0,"D",1.8,3.69,4.19,"0-0","1-0",10,3,7,2,1,2,0,0,3,4,13,15,1,7,28,"3-4","N","N","N",3,0,5
"3130","SC3",2023-09-02,"Spartans","Stenhousemuir",0,1,"A",0,0,"D",1.85,3.82,3.84,"0-0","0-1",7,2,9,4,1,0,0,1,10,3,6,7,1,13,13,"10-3","N","N","N",1,1,5
"3131","SC3",2023-09-02,"Stranraer","Peterhead",2,1,"H",2,0,"H",2.18,3.42,3.19,"2-0","2-1",14,7,11,5,3,3,0,0,6,5,11,18,3,11,29,"6-5","Y","Y","N",6,0,5
"3132","SC3",2023-09-16,"East Fife","Clyde",2,0,"H",1,0,"H",1.9,3.49,3.53,"1-0","2-0",9,4,6,3,2,2,0,0,4,0,10,17,2,4,27,"4-0","Y","N","N",4,0,6
"3133","SC3",2023-09-16,"Elgin","Dumbarton",2,0,"H",1,0,"H",3.56,3.48,2.01,"1-0","2-0",11,4,11,2,1,0,0,0,7,7,9,11,2,14,20,"7-7","Y","N","N",1,0,6
"3134","SC3",2023-09-16,"Forfar","Spartans",2,2,"D",1,2,"A",2.42,3.2,2.73,"1-2","2-2",8,6,12,7,3,2,0,0,5,4,11,8,4,9,19,"5-4","Y","Y","Y",5,0,6
"3135","SC3",2023-09-16,"Peterhead","Bonnyrigg Rose",2,1,"H",0,0,"D",2.58,3.22,2.73,"0-0","2-1",10,4,8,2,5,2,0,0,2,3,21,12,3,5,33,"2-3","Y","Y","N",7,0,6
"3136","SC3",2023-09-16,"Stenhousemuir","Stranraer",5,0,"H",2,0,"H",2.24,3.34,3.13,"2-0","5-0",10,8,3,2,2,3,0,0,8,3,9,10,5,11,19,"8-3","Y","Y","Y",5,0,6
"3137","SC3",2023-09-23,"Bonnyrigg Rose","Stenhousemuir",0,1,"A",0,0,"D",2.37,3.43,2.85,"0-0","0-1",8,3,11,5,5,3,0,0,4,2,13,15,1,6,28,"4-2","N","N","N",8,0,7
"3138","SC3",2023-09-23,"Clyde","Elgin",2,1,"H",2,0,"H",2.35,3.39,2.91,"2-0","2-1",11,4,13,2,2,2,0,0,7,2,7,8,3,9,15,"7-2","Y","Y","N",4,0,7
"3139","SC3",2023-09-23,"Dumbarton","Peterhead",0,1,"A",0,0,"D",2.16,3.42,3.22,"0-0","0-1",11,3,16,5,2,2,1,0,11,7,14,9,1,18,23,"11-7","N","N","N",4,1,7
"3140","SC3",2023-09-23,"Spartans","East Fife",2,2,"D",1,0,"H",1.98,3.36,3.83,"1-0","2-2",7,2,10,8,2,2,0,0,5,2,8,10,4,7,18,"5-2","Y","Y","Y",4,0,7
"3141","SC3",2023-09-23,"Stranraer","Forfar",0,2,"A",0,2,"A",2.3,3.3,3,"0-2","0-2",9,5,11,6,1,2,0,0,9,8,7,18,2,17,25,"9-8","Y","N","N",3,0,7
"3142","SC3",2023-09-30,"Dumbarton","Stranraer",3,1,"H",2,1,"H",1.83,3.62,4.12,"2-1","3-1",10,5,6,1,2,3,0,0,8,3,11,10,4,11,21,"8-3","Y","Y","Y",5,0,8
"3143","SC3",2023-09-30,"East Fife","Forfar",1,1,"D",1,0,"H",2.33,3.26,3.05,"1-0","1-1",2,1,9,3,1,2,0,0,4,3,15,17,2,7,32,"4-3","Y","N","N",3,0,8
"3144","SC3",2023-09-30,"Peterhead","Elgin",6,0,"H",2,0,"H",1.7,3.79,4.68,"2-0","6-0",13,8,4,1,0,5,0,0,4,2,9,15,6,6,24,"4-2","Y","Y","Y",5,0,8
"3145","SC3",2023-09-30,"Spartans","Bonnyrigg Rose",2,2,"D",0,1,"A",2.17,3.37,3.25,"0-1","2-2",7,3,9,4,2,1,0,0,6,4,15,11,4,10,26,"6-4","Y","Y","Y",3,0,8
"3146","SC3",2023-09-30,"Stenhousemuir","Clyde",2,2,"D",1,0,"H",1.6,3.98,5.34,"1-0","2-2",13,8,12,4,2,4,0,0,5,4,7,12,4,9,19,"5-4","Y","Y","Y",6,0,8
"3147","SC3",2023-10-07,"Clyde","Dumbarton",0,4,"A",0,2,"A",3.98,3.55,1.88,"0-2","0-4",10,4,11,6,2,2,0,0,6,5,11,11,4,11,22,"6-5","Y","Y","Y",4,0,9
"3148","SC3",2023-10-07,"Forfar","Peterhead",1,3,"A",0,2,"A",2.52,3.2,2.82,"0-2","1-3",12,6,10,5,2,1,0,0,8,2,8,14,4,10,22,"8-2","Y","Y","Y",3,0,9
"3149","SC3",2023-10-07,"Stranraer","Spartans",3,4,"A",1,2,"A",2.78,3.37,2.45,"1-2","3-4",10,5,14,6,1,0,0,0,11,4,13,9,7,15,22,"11-4","Y","Y","Y",1,0,9
"3150","SC3",2023-10-21,"Bonnyrigg Rose","Clyde",3,2,"H",1,2,"A",1.81,3.61,4.28,"1-2","3-2",9,6,13,6,1,2,0,0,2,7,7,14,5,9,21,"2-7","Y","Y","Y",3,0,9
"3151","SC3",2023-10-21,"East Fife","Stranraer",4,0,"H",2,0,"H",1.93,3.56,3.76,"2-0","4-0",12,6,0,0,2,1,0,0,5,7,10,11,4,12,21,"5-7","Y","Y","Y",3,0,9
"3152","SC3",2023-10-21,"Spartans","Dumbarton",2,0,"H",0,0,"D",2.4,3.38,2.84,"0-0","2-0",8,3,7,1,1,1,0,0,4,11,8,8,2,15,16,"4-11","Y","N","N",2,0,10
"3153","SC3",2023-10-24,"Elgin","Stenhousemuir",1,1,"D",0,1,"A",4.77,3.87,1.68,"0-1","1-1",11,2,11,4,3,2,0,1,5,5,13,15,2,10,28,"5-5","Y","N","N",5,1,10
"3154","SC3",2023-11-04,"Clyde","Spartans",1,2,"A",0,2,"A",3.79,3.67,1.89,"0-2","1-2",10,3,7,2,3,1,0,0,5,3,13,8,3,8,21,"5-3","Y","Y","N",4,0,10
"3155","SC3",2023-11-04,"Dumbarton","Bonnyrigg Rose",4,0,"H",2,0,"H",1.89,3.71,3.73,"2-0","4-0",12,7,15,3,3,1,0,0,6,9,8,10,4,15,18,"6-9","Y","Y","Y",4,0,10
"3156","SC3",2023-11-04,"Forfar","Stenhousemuir",1,3,"A",1,1,"D",3.25,3.39,2.17,"1-1","1-3",4,2,12,7,2,1,0,0,4,5,11,8,4,9,19,"4-5","Y","Y","Y",3,0,10
"3157","SC3",2023-11-04,"Peterhead","East Fife",2,0,"H",1,0,"H",2.08,3.4,3.45,"1-0","2-0",11,6,5,2,1,3,0,0,7,6,11,14,2,13,25,"7-6","Y","N","N",4,0,11
"3158","SC3",2023-11-04,"Stranraer","Elgin",3,1,"H",2,0,"H",1.75,3.7,3.96,"2-0","3-1",8,6,6,3,2,2,0,0,8,4,12,12,4,12,24,"8-4","Y","Y","Y",4,0,11
"3159","SC3",2023-11-11,"East Fife","Dumbarton",0,1,"A",0,1,"A",2.96,3.36,2.33,"0-1","0-1",5,2,6,4,1,3,0,0,4,9,10,11,1,13,21,"4-9","N","N","N",4,0,11
"3160","SC3",2023-11-11,"Elgin","Bonnyrigg Rose",2,0,"H",0,0,"D",3.52,3.49,2.03,"0-0","2-0",12,6,9,6,5,4,0,0,1,6,12,9,2,7,21,"1-6","Y","N","N",9,0,11
"3161","SC3",2023-11-11,"Forfar","Clyde",1,1,"D",0,0,"D",1.81,3.74,4.11,"0-0","1-1",15,6,13,4,1,0,0,0,4,5,13,14,2,9,27,"4-5","Y","N","N",1,0,11
"3162","SC3",2023-11-11,"Peterhead","Stranraer",3,2,"H",2,1,"H",1.75,3.89,4.25,"2-1","3-2",9,5,8,6,4,3,0,0,3,7,14,14,5,10,28,"3-7","Y","Y","Y",7,0,12
"3163","SC3",2023-11-11,"Stenhousemuir","Spartans",3,2,"H",0,1,"A",1.97,3.58,3.61,"0-1","3-2",12,5,9,4,4,1,0,0,6,6,13,14,5,12,27,"6-6","Y","Y","Y",5,0,12
"3164","SC3",2023-11-14,"Stenhousemuir","Peterhead",2,0,"H",2,0,"H",2.12,3.48,3.27,"2-0","2-0",16,4,10,3,2,4,0,0,1,5,14,16,2,6,30,"1-5","Y","N","N",6,0,12
"3165","SC3",2023-11-18,"Bonnyrigg Rose","Forfar",0,2,"A",0,1,"A",2.29,3.37,3.02,"0-1","0-2",6,2,8,5,0,2,0,0,4,4,7,11,2,8,18,"4-4","Y","N","N",2,0,12
"3166","SC3",2023-11-18,"Clyde","East Fife",0,4,"A",0,2,"A",3.46,3.45,2.06,"0-2","0-4",7,2,10,7,1,3,0,0,5,2,8,7,4,7,15,"5-2","Y","Y","Y",4,0,12
"3167","SC3",2023-11-18,"Dumbarton","Elgin",1,0,"H",0,0,"D",1.31,5.27,9.25,"0-0","1-0",8,2,7,2,1,3,0,0,2,2,11,11,1,4,22,"2-2","N","N","N",4,0,13
"3168","SC3",2023-11-18,"Spartans","Peterhead",1,2,"A",0,1,"A",2.3,3.5,2.91,"0-1","1-2",9,5,10,4,2,4,0,0,3,1,7,17,3,4,24,"3-1","Y","Y","N",6,0,13
"3169","SC3",2023-11-18,"Stranraer","Stenhousemuir",0,3,"A",0,2,"A",3.37,3.61,2.03,"0-2","0-3",6,3,6,3,2,1,0,0,10,2,8,7,3,12,15,"10-2","Y","Y","N",3,0,13
"3170","SC3",2023-11-21,"Bonnyrigg Rose","East Fife",4,2,"H",1,1,"D",3.13,3.12,2.03,"1-1","4-2",15,10,5,2,3,2,0,0,5,4,9,18,6,9,27,"5-4","Y","Y","Y",5,0,13
"3171","SC3",2023-11-21,"Elgin","Forfar",1,0,"H",1,0,"H",3.05,3.18,2.37,"1-0","1-0",6,3,10,3,2,0,0,0,5,3,19,10,1,8,29,"5-3","N","N","N",2,0,13
"3172","SC3",2023-12-02,"Forfar","Stranraer",1,1,"D",1,0,"H",2.11,3.54,3.26,"1-0","1-1",16,5,4,1,2,3,0,0,9,3,16,12,2,12,28,"9-3","Y","N","N",5,0,14
"3173","SC3",2023-12-02,"Stenhousemuir","Bonnyrigg Rose",1,0,"H",1,0,"H",1.66,3.87,4.95,"1-0","1-0",12,6,7,2,2,2,1,1,5,3,11,17,1,8,28,"5-3","N","N","N",4,2,14
"1102","SP1",2023-08-11,"Almeria","Vallecano",0,2,"A",0,2,"A",2.62,3.3,2.96,"0-2","0-2",19,5,10,4,1,3,0,0,8,3,16,25,2,11,41,"8-3","Y","N","N",4,0,1
"1103","SP1",2023-08-11,"Sevilla","Valencia",1,2,"A",0,0,"D",1.95,3.47,4.48,"0-0","1-2",9,3,10,3,3,2,1,0,8,1,15,17,3,9,32,"8-1","Y","Y","N",5,1,1
"1104","SP1",2023-08-12,"Sociedad","Girona",1,1,"D",1,0,"H",1.65,4.05,5.66,"1-0","1-1",15,2,6,1,2,5,0,0,4,1,22,9,2,5,31,"4-1","Y","N","N",7,0,1
"1105","SP1",2023-08-12,"Las Palmas","Mallorca",1,1,"D",1,0,"H",2.45,3.02,3.46,"1-0","1-1",5,2,12,2,3,2,0,0,3,6,11,21,2,9,32,"3-6","Y","N","N",5,0,1
"1106","SP1",2023-08-12,"Ath Bilbao","Real Madrid",0,2,"A",0,2,"A",3.43,3.58,2.19,"0-2","0-2",7,1,14,8,3,1,0,0,7,5,18,6,2,12,24,"7-5","Y","N","N",4,0,1
"1107","SP1",2023-08-13,"Celta","Osasuna",0,2,"A",0,1,"A",2.15,3.19,3.99,"0-1","0-2",11,1,11,5,1,1,0,0,7,2,11,15,2,9,26,"7-2","Y","N","N",2,0,1
"1108","SP1",2023-08-13,"Villarreal","Betis",1,2,"A",0,1,"A",1.81,3.98,4.43,"0-1","1-2",18,5,12,5,1,3,0,0,9,4,13,17,3,13,30,"9-4","Y","Y","N",4,0,1
"1109","SP1",2023-08-13,"Getafe","Barcelona",0,0,"D",0,0,"D",6.69,4.04,1.57,"0-0","0-0",5,2,14,4,8,2,1,1,3,4,20,11,0,7,31,"3-4","N","N","N",10,2,1
"1110","SP1",2023-08-14,"Cadiz","Alaves",1,0,"H",1,0,"H",2.25,3.08,3.86,"1-0","1-0",12,3,10,2,3,2,1,0,2,4,19,15,1,6,34,"2-4","N","N","N",5,1,1
"1111","SP1",2023-08-14,"Ath Madrid","Granada",3,1,"H",1,0,"H",1.31,5.76,10.3,"1-0","3-1",14,6,7,4,3,1,0,0,3,3,15,9,4,6,24,"3-3","Y","Y","Y",4,0,1
"1112","SP1",2023-08-18,"Mallorca","Villarreal",0,1,"A",0,0,"D",3.04,3.13,2.68,"0-0","0-1",8,1,15,3,2,4,0,0,6,5,12,11,1,11,23,"6-5","N","N","N",6,0,2
"1113","SP1",2023-08-18,"Valencia","Las Palmas",1,0,"H",0,0,"D",1.61,4.02,6.49,"0-0","1-0",9,4,7,1,0,0,0,0,6,4,12,6,1,10,18,"6-4","N","N","N",0,0,2
"1114","SP1",2023-08-19,"Sociedad","Celta",1,1,"D",1,0,"H",1.76,3.54,5.57,"1-0","1-1",11,2,17,6,2,1,0,0,9,7,12,12,2,16,24,"9-7","Y","N","N",3,0,2
"1115","SP1",2023-08-19,"Almeria","Real Madrid",1,3,"A",1,1,"D",8.15,5.11,1.4,"1-1","1-3",20,8,24,9,1,0,0,0,4,5,10,13,4,9,23,"4-5","Y","Y","Y",1,0,2
"1116","SP1",2023-08-19,"Osasuna","Ath Bilbao",0,2,"A",0,2,"A",2.89,3.1,2.79,"0-2","0-2",18,7,8,2,1,5,1,1,5,3,9,14,2,8,23,"5-3","Y","N","N",6,2,2
"1117","SP1",2023-08-20,"Girona","Getafe",3,0,"H",1,0,"H",2.06,3.22,4.31,"1-0","3-0",7,6,9,2,2,5,0,0,3,2,11,20,3,5,31,"3-2","Y","Y","N",7,0,2
"1118","SP1",2023-08-20,"Barcelona","Cadiz",2,0,"H",0,0,"D",1.21,6.9,14.96,"0-0","2-0",23,10,10,1,4,3,0,0,10,2,9,22,2,12,31,"10-2","Y","N","N",7,0,2
"1119","SP1",2023-08-20,"Betis","Ath Madrid",0,0,"D",0,0,"D",3.93,3.57,2.02,"0-0","0-0",14,0,5,1,2,1,0,0,2,7,10,8,0,9,18,"2-7","N","N","N",3,0,2
"1120","SP1",2023-08-21,"Alaves","Sevilla",4,3,"H",2,2,"D",3.45,3.1,2.41,"2-2","4-3",14,7,12,2,1,2,0,0,4,4,14,13,7,8,27,"4-4","Y","Y","Y",3,0,2
"1121","SP1",2023-08-21,"Granada","Vallecano",0,2,"A",0,0,"D",2.68,3.09,3.03,"0-0","0-2",14,7,17,9,2,1,1,0,5,6,14,11,2,11,25,"5-6","Y","N","N",3,1,2
"1122","SP1",2023-08-25,"Las Palmas","Sociedad",0,0,"D",0,0,"D",4.23,3.36,2.04,"0-0","0-0",11,5,8,1,1,4,0,0,5,7,7,29,0,12,36,"5-7","N","N","N",5,0,3
"1123","SP1",2023-08-25,"Celta","Real Madrid",0,1,"A",0,0,"D",4.93,3.97,1.75,"0-0","0-1",13,4,10,3,2,3,0,0,3,5,19,14,1,8,33,"3-5","N","N","N",5,0,3
"1124","SP1",2023-08-26,"Cadiz","Almeria",1,1,"D",0,0,"D",2.24,3.44,3.44,"0-0","1-1",11,3,5,2,0,5,1,1,7,3,16,22,2,10,38,"7-3","Y","N","N",5,2,3
"1125","SP1",2023-08-26,"Granada","Mallorca",3,2,"H",1,1,"D",2.71,3.03,3.05,"1-1","3-2",10,4,10,5,2,7,0,0,5,3,11,27,5,8,38,"5-3","Y","Y","Y",9,0,3
"1126","SP1",2023-08-26,"Sevilla","Girona",1,2,"A",1,1,"D",2.1,3.52,3.73,"1-1","1-2",21,4,8,3,2,1,0,0,6,6,11,18,3,12,29,"6-6","Y","Y","N",3,0,3
"1127","SP1",2023-08-27,"Villarreal","Barcelona",3,4,"A",2,2,"D",3.62,3.76,2.06,"2-2","3-4",13,6,21,11,3,3,0,0,2,6,12,14,7,8,26,"2-6","Y","Y","Y",6,0,3
"1128","SP1",2023-08-27,"Valencia","Osasuna",1,2,"A",0,1,"A",1.89,3.56,4.53,"0-1","1-2",16,4,7,2,3,4,0,0,6,3,13,12,3,9,25,"6-3","Y","Y","N",7,0,3
"1129","SP1",2023-08-27,"Ath Bilbao","Betis",4,2,"H",3,2,"H",1.96,3.7,4,"3-2","4-2",14,6,7,3,4,2,0,0,5,3,23,11,6,8,34,"5-3","Y","Y","Y",6,0,3
"1130","SP1",2023-08-28,"Getafe","Alaves",1,0,"H",0,0,"D",2.36,2.89,3.88,"0-0","1-0",15,4,16,2,1,2,0,0,4,5,13,15,1,9,28,"4-5","N","N","N",3,0,3
"1131","SP1",2023-08-28,"Vallecano","Ath Madrid",0,7,"A",0,3,"A",4.16,3.48,2,"0-3","0-7",12,3,17,10,4,3,0,0,8,3,19,17,7,11,36,"8-3","Y","Y","Y",7,0,3
"1132","SP1",2023-09-01,"Cadiz","Villarreal",3,1,"H",2,1,"H",3.43,3.59,2.21,"2-1","3-1",18,4,7,3,5,4,0,1,7,3,21,15,4,10,36,"7-3","Y","Y","Y",9,1,4
"1133","SP1",2023-09-01,"Almeria","Celta",2,3,"A",0,2,"A",3.04,3.33,2.55,"0-2","2-3",16,5,14,8,1,1,0,0,6,5,9,9,5,11,18,"6-5","Y","Y","Y",2,0,4
"1134","SP1",2023-09-02,"Sociedad","Granada",5,3,"H",2,1,"H",1.47,4.63,7.49,"2-1","5-3",15,6,8,5,1,5,0,0,2,5,15,14,8,7,29,"2-5","Y","Y","Y",6,0,4
"1135","SP1",2023-09-02,"Real Madrid","Getafe",2,1,"H",0,1,"A",1.34,5.13,10.76,"0-1","2-1",26,12,6,2,2,6,0,0,11,1,12,16,3,12,28,"11-1","Y","Y","N",8,0,4
"1136","SP1",2023-09-02,"Alaves","Valencia",1,0,"H",1,0,"H",2.96,2.99,2.82,"1-0","1-0",7,1,9,4,4,2,0,0,1,2,18,9,1,3,27,"1-2","N","N","N",6,0,4
"1137","SP1",2023-09-02,"Betis","Vallecano",1,0,"H",0,0,"D",1.98,3.55,4.14,"0-0","1-0",14,5,15,6,3,5,0,0,2,3,22,20,1,5,42,"2-3","N","N","N",8,0,4
"1138","SP1",2023-09-03,"Girona","Las Palmas",1,0,"H",0,0,"D",1.69,3.83,5.59,"0-0","1-0",11,6,10,5,3,3,0,0,3,5,15,10,1,8,25,"3-5","N","N","N",6,0,4
"1139","SP1",2023-09-03,"Mallorca","Ath Bilbao",0,0,"D",0,0,"D",3.3,3.11,2.49,"0-0","0-0",8,2,11,3,0,1,0,0,3,5,12,17,0,8,29,"3-5","N","N","N",1,0,4
"1140","SP1",2023-09-03,"Osasuna","Barcelona",1,2,"A",0,1,"A",5.37,4.17,1.65,"0-1","1-2",11,3,9,4,1,3,1,0,8,5,6,16,3,13,22,"8-5","Y","Y","N",4,1,4
"1141","SP1",2023-09-15,"Vallecano","Alaves",2,0,"H",1,0,"H",2.03,3.23,4.52,"1-0","2-0",20,11,9,1,2,3,0,0,5,3,15,14,2,8,29,"5-3","Y","N","N",5,0,4
"1142","SP1",2023-09-16,"Ath Bilbao","Cadiz",3,0,"H",0,0,"D",1.56,4.17,6.66,"0-0","3-0",20,9,5,4,1,4,0,0,5,4,10,20,3,9,30,"5-4","Y","Y","N",5,0,5
"1143","SP1",2023-09-16,"Valencia","Ath Madrid",3,0,"H",2,0,"H",3.93,3.41,2.08,"2-0","3-0",12,8,11,3,1,5,0,0,5,8,13,17,3,13,30,"5-8","Y","Y","N",6,0,5
"1144","SP1",2023-09-16,"Celta","Mallorca",0,1,"A",0,0,"D",2.08,3.13,4.4,"0-0","0-1",16,4,7,4,1,3,0,0,10,1,9,15,1,11,24,"10-1","N","N","N",4,0,5
"1145","SP1",2023-09-16,"Barcelona","Betis",5,0,"H",2,0,"H",1.38,5.4,8.04,"2-0","5-0",17,9,11,2,1,2,0,0,9,5,9,10,5,14,19,"9-5","Y","Y","Y",3,0,5
"1146","SP1",2023-09-17,"Getafe","Osasuna",3,2,"H",1,1,"D",2.65,2.93,3.24,"1-1","3-2",11,6,8,3,6,2,0,0,6,3,15,11,5,9,26,"6-3","Y","Y","Y",8,0,5
"1147","SP1",2023-09-17,"Villarreal","Almeria",2,1,"H",1,1,"D",1.48,4.98,6.38,"1-1","2-1",10,4,17,7,2,3,0,0,7,6,16,6,3,13,22,"7-6","Y","Y","N",5,0,5
"1148","SP1",2023-09-17,"Sevilla","Las Palmas",1,0,"H",0,0,"D",1.64,3.93,5.99,"0-0","1-0",26,9,12,2,3,5,0,0,7,3,13,12,1,10,25,"7-3","N","N","N",8,0,5
"1149","SP1",2023-09-17,"Real Madrid","Sociedad",2,1,"H",0,1,"A",1.69,3.97,5.31,"0-1","2-1",17,8,15,5,3,2,0,0,4,3,11,14,3,7,25,"4-3","Y","Y","N",5,0,5
"1150","SP1",2023-09-18,"Granada","Girona",2,4,"A",0,3,"A",2.78,3.44,2.65,"0-3","2-4",12,5,13,7,3,3,0,0,4,5,13,21,6,9,34,"4-5","Y","Y","Y",6,0,5
"1151","SP1",2023-09-22,"Alaves","Ath Bilbao",0,2,"A",0,1,"A",4.27,3.16,2.12,"0-1","0-2",15,5,11,3,2,2,0,0,3,4,13,9,2,7,22,"3-4","Y","N","N",4,0,5
"1152","SP1",2023-09-23,"Girona","Mallorca",5,3,"H",4,1,"H",1.94,3.39,4.54,"4-1","5-3",23,10,15,5,1,5,0,0,6,5,10,12,8,11,22,"6-5","Y","Y","Y",6,0,6
"1153","SP1",2023-09-23,"Osasuna","Sevilla",0,0,"D",0,0,"D",2.62,3.22,2.99,"0-0","0-0",16,2,15,3,2,3,0,0,7,4,11,7,0,11,18,"7-4","N","N","N",5,0,6
"1154","SP1",2023-09-23,"Barcelona","Celta",3,2,"H",0,1,"A",1.29,6.04,10.38,"0-1","3-2",15,6,13,7,2,1,0,0,2,3,10,11,5,5,21,"2-3","Y","Y","Y",3,0,6
"1155","SP1",2023-09-23,"Almeria","Valencia",2,2,"D",0,1,"A",3.11,3.53,2.36,"0-1","2-2",17,10,7,5,4,2,0,0,8,3,12,10,4,11,22,"8-3","Y","Y","Y",6,0,6
"1156","SP1",2023-09-24,"Sociedad","Getafe",4,3,"H",1,2,"A",1.56,3.82,7.76,"1-2","4-3",10,6,10,7,3,2,0,0,2,1,13,24,7,3,37,"2-1","Y","Y","Y",5,0,6
"1157","SP1",2023-09-24,"Vallecano","Villarreal",1,1,"D",1,1,"D",2.56,3.54,2.83,"1-1","1-1",11,6,13,6,2,3,0,1,2,8,20,18,2,10,38,"2-8","Y","N","N",5,1,6
"1158","SP1",2023-09-24,"Betis","Cadiz",1,1,"D",0,1,"A",1.86,3.62,4.64,"0-1","1-1",21,7,5,1,2,3,0,0,11,8,10,14,2,19,24,"11-8","Y","N","N",5,0,6
"1159","SP1",2023-09-24,"Las Palmas","Granada",1,0,"H",0,0,"D",2.05,3.56,3.87,"0-0","1-0",10,3,2,1,6,4,1,0,6,7,13,19,1,13,32,"6-7","N","N","N",10,1,6
"1160","SP1",2023-09-24,"Ath Madrid","Real Madrid",3,1,"H",2,1,"H",2.88,3.37,2.61,"2-1","3-1",10,4,20,5,1,3,0,0,6,11,13,10,4,17,23,"6-11","Y","Y","Y",4,0,6
"1161","SP1",2023-09-26,"Sevilla","Almeria",5,1,"H",3,0,"H",1.7,4.1,5.09,"3-0","5-1",18,9,10,1,3,2,0,0,9,4,15,16,6,13,31,"9-4","Y","Y","Y",5,0,6
"1162","SP1",2023-09-26,"Mallorca","Barcelona",2,2,"D",2,1,"H",6.98,4.53,1.51,"2-1","2-2",10,5,10,4,4,1,1,0,7,2,19,7,4,9,26,"7-2","Y","Y","Y",5,1,7
"1163","SP1",2023-09-27,"Ath Bilbao","Getafe",2,2,"D",1,0,"H",1.64,3.76,6.51,"1-0","2-2",9,4,13,5,5,6,1,0,5,4,9,19,4,9,28,"5-4","Y","Y","Y",11,1,7
"1164","SP1",2023-09-27,"Real Madrid","Las Palmas",2,0,"H",1,0,"H",1.21,7.24,13.67,"1-0","2-0",21,9,16,2,0,1,0,0,7,2,7,9,2,9,16,"7-2","Y","N","N",1,0,7
"1165","SP1",2023-09-27,"Villarreal","Girona",1,2,"A",0,0,"D",2.22,3.72,3.23,"0-0","1-2",14,3,17,5,3,2,0,0,5,6,9,11,3,11,20,"5-6","Y","Y","N",5,0,7
"1166","SP1",2023-09-27,"Cadiz","Vallecano",0,0,"D",0,0,"D",2.64,3.17,3,"0-0","0-0",9,2,9,4,5,6,0,1,1,2,16,13,0,3,29,"1-2","N","N","N",11,1,7
"1167","SP1",2023-09-27,"Valencia","Sociedad",0,1,"A",0,1,"A",2.68,3.18,2.94,"0-1","0-1",9,2,2,1,4,7,1,0,0,2,14,17,1,2,31,"0-2","N","N","N",11,1,7
"1168","SP1",2023-09-28,"Celta","Alaves",1,1,"D",1,0,"H",1.71,3.59,5.97,"1-0","1-1",8,0,21,11,5,3,1,0,2,8,9,11,2,10,20,"2-8","Y","N","N",8,1,7
"1169","SP1",2023-09-28,"Granada","Betis",1,1,"D",0,0,"D",3.11,3.53,2.36,"0-0","1-1",19,7,13,3,2,1,0,0,5,7,14,10,2,12,24,"5-7","Y","N","N",3,0,7
"1170","SP1",2023-09-28,"Osasuna","Ath Madrid",0,2,"A",0,1,"A",3.68,3.47,2.14,"0-1","0-2",13,2,4,3,3,3,1,1,7,2,14,4,2,9,18,"7-2","Y","N","N",6,2,7
"1171","SP1",2023-09-29,"Barcelona","Sevilla",1,0,"H",0,0,"D",1.39,5.36,7.97,"0-0","1-0",18,5,12,3,2,3,0,0,13,3,11,15,1,16,26,"13-3","N","N","N",5,0,7
"1172","SP1",2023-09-30,"Getafe","Villarreal",0,0,"D",0,0,"D",3,3.25,2.59,"0-0","0-0",22,9,3,0,2,4,0,1,6,4,19,11,0,10,30,"6-4","N","N","N",6,1,8
"1173","SP1",2023-09-30,"Vallecano","Mallorca",2,2,"D",1,1,"D",2.16,3.16,4.04,"1-1","2-2",19,5,9,4,2,5,0,0,5,0,12,20,4,5,32,"5-0","Y","Y","Y",7,0,8
"1174","SP1",2023-09-30,"Girona","Real Madrid",0,3,"A",0,2,"A",3.56,4.02,2,"0-2","0-3",13,3,14,7,2,2,0,1,1,4,13,14,3,5,27,"1-4","Y","Y","N",4,1,8
"1175","SP1",2023-09-30,"Sociedad","Ath Bilbao",3,0,"H",1,0,"H",2.26,3.3,3.53,"1-0","3-0",8,5,18,3,2,2,0,0,5,7,20,9,3,12,29,"5-7","Y","Y","N",4,0,8
"1176","SP1",2023-10-01,"Almeria","Granada",3,3,"D",3,0,"H",1.92,3.68,3.96,"3-0","3-3",17,5,19,4,2,1,0,0,1,5,18,14,6,6,32,"1-5","Y","Y","Y",3,0,8
"1177","SP1",2023-10-01,"Alaves","Osasuna",0,2,"A",0,1,"A",2.76,2.99,2.89,"0-1","0-2",17,3,10,3,2,3,1,0,4,2,13,13,2,6,26,"4-2","Y","N","N",5,1,8
"1178","SP1",2023-10-01,"Ath Madrid","Cadiz",3,2,"H",1,2,"A",1.35,4.99,8.91,"1-2","3-2",18,9,8,4,1,3,0,0,5,3,5,10,5,8,15,"5-3","Y","Y","Y",4,0,8
"1179","SP1",2023-10-01,"Betis","Valencia",3,0,"H",1,0,"H",2.31,3.29,3.26,"1-0","3-0",15,7,9,2,2,2,0,0,5,3,11,10,3,8,21,"5-3","Y","Y","N",4,0,8
"1180","SP1",2023-10-02,"Las Palmas","Celta",2,1,"H",0,0,"D",2.52,3.15,2.99,"0-0","2-1",16,5,11,3,2,1,0,0,4,5,13,14,3,9,27,"4-5","Y","Y","N",3,0,8
"1181","SP1",2023-10-06,"Ath Bilbao","Almeria",3,0,"H",1,0,"H",1.38,5.41,8.23,"1-0","3-0",23,9,4,1,2,0,0,0,6,2,11,7,3,8,18,"6-2","Y","Y","N",2,0,8
"1182","SP1",2023-10-07,"Cadiz","Girona",0,1,"A",0,0,"D",3.28,3.4,2.33,"0-0","0-1",8,2,20,5,1,3,1,0,5,5,12,13,1,10,25,"5-5","N","N","N",4,1,9
"1183","SP1",2023-10-07,"Real Madrid","Osasuna",4,0,"H",1,0,"H",1.3,5.95,10.38,"1-0","4-0",19,9,7,1,2,2,0,0,5,4,9,6,4,9,15,"5-4","Y","Y","Y",4,0,9
"1184","SP1",2023-10-07,"Mallorca","Valencia",1,1,"D",1,1,"D",2.54,3.05,3.26,"1-1","1-1",9,5,11,3,2,1,0,0,3,6,17,11,2,9,28,"3-6","Y","N","N",3,0,9
"1185","SP1",2023-10-07,"Sevilla","Vallecano",2,2,"D",0,2,"A",1.91,3.61,4.39,"0-2","2-2",22,6,7,4,5,2,0,0,12,2,16,19,4,14,35,"12-2","Y","Y","Y",7,0,9
"1186","SP1",2023-10-08,"Villarreal","Las Palmas",1,2,"A",0,1,"A",1.63,4.21,5.56,"0-1","1-2",9,4,8,5,4,4,0,0,7,2,17,7,3,9,24,"7-2","Y","Y","N",8,0,9
"1187","SP1",2023-10-08,"Ath Madrid","Sociedad",2,1,"H",1,0,"H",1.93,3.39,4.59,"1-0","2-1",14,5,13,4,3,3,0,0,1,4,9,12,3,5,21,"1-4","Y","Y","N",6,0,9
"1188","SP1",2023-10-08,"Alaves","Betis",1,1,"D",1,1,"D",2.93,3.2,2.68,"1-1","1-1",15,5,6,2,3,3,0,1,5,3,13,9,2,8,22,"5-3","Y","N","N",6,1,9
"1189","SP1",2023-10-08,"Celta","Getafe",2,2,"D",2,2,"D",2.07,3.23,4.23,"2-2","2-2",26,11,3,2,1,8,0,1,13,1,14,20,4,14,34,"13-1","Y","Y","Y",9,1,9
"1190","SP1",2023-10-08,"Granada","Barcelona",2,2,"D",2,1,"H",6.89,5.36,1.43,"2-1","2-2",7,2,22,10,4,1,0,0,1,11,12,7,4,12,19,"1-11","Y","Y","Y",5,0,9
"1191","SP1",2023-10-20,"Osasuna","Granada",2,0,"H",1,0,"H",1.72,3.99,5.13,"1-0","2-0",12,6,13,3,3,4,0,1,1,7,19,13,2,8,32,"1-7","Y","N","N",7,1,9
"1192","SP1",2023-10-21,"Sociedad","Mallorca",1,0,"H",0,0,"D",1.57,3.91,7.23,"0-0","1-0",14,6,18,7,3,3,0,0,2,5,14,16,1,7,30,"2-5","N","N","N",6,0,10
"1193","SP1",2023-10-21,"Getafe","Betis",1,1,"D",1,1,"D",2.51,3.11,3.25,"1-1","1-1",14,4,13,3,5,2,0,0,4,8,17,11,2,12,28,"4-8","Y","N","N",7,0,10
"1194","SP1",2023-10-21,"Sevilla","Real Madrid",1,1,"D",0,0,"D",4.18,3.91,1.87,"0-0","1-1",17,7,14,5,5,2,0,0,4,6,13,6,2,10,19,"4-6","Y","N","N",7,0,10
"1195","SP1",2023-10-21,"Celta","Ath Madrid",0,3,"A",0,1,"A",3.65,3.53,2.12,"0-1","0-3",16,3,12,7,3,2,1,0,7,5,10,10,3,12,20,"7-5","Y","Y","N",5,1,10
"1196","SP1",2023-10-22,"Las Palmas","Vallecano",0,1,"A",0,0,"D",2.71,3.12,2.96,"0-0","0-1",12,6,12,4,4,3,0,1,10,5,13,11,1,15,24,"10-5","N","N","N",7,1,10
"1197","SP1",2023-10-22,"Girona","Almeria",5,2,"H",3,2,"H",1.47,4.89,6.71,"3-2","5-2",19,8,9,5,1,2,0,0,9,6,11,14,7,15,25,"9-6","Y","Y","Y",3,0,10
"1198","SP1",2023-10-22,"Villarreal","Alaves",1,1,"D",0,0,"D",1.74,3.98,4.95,"0-0","1-1",12,3,16,7,4,3,0,0,9,3,15,10,2,12,25,"9-3","Y","N","N",7,0,10
"1199","SP1",2023-10-22,"Barcelona","Ath Bilbao",1,0,"H",0,0,"D",1.68,4.14,5.16,"0-0","1-0",12,7,10,3,3,3,0,0,4,7,11,18,1,11,29,"4-7","N","N","N",6,0,10
"1200","SP1",2023-10-23,"Valencia","Cadiz",2,0,"H",2,0,"H",1.78,3.6,5.29,"2-0","2-0",12,4,5,4,0,3,0,1,4,6,16,16,2,10,32,"4-6","Y","N","N",3,1,10
"1201","SP1",2023-10-27,"Girona","Celta",1,0,"H",0,0,"D",1.69,4.27,4.84,"0-0","1-0",12,2,4,2,3,2,0,0,10,1,15,12,1,11,27,"10-1","N","N","N",5,0,10
"1202","SP1",2023-10-28,"Almeria","Las Palmas",1,2,"A",0,1,"A",2.37,3.46,3.15,"0-1","1-2",10,4,10,3,3,1,0,0,3,2,13,19,3,5,32,"3-2","Y","Y","N",4,0,11
"1203","SP1",2023-10-28,"Barcelona","Real Madrid",1,2,"A",1,0,"H",2.55,3.66,2.76,"1-0","1-2",15,3,13,4,2,1,0,0,6,3,15,15,3,9,30,"6-3","Y","Y","N",3,0,11
"1204","SP1",2023-10-28,"Mallorca","Getafe",0,0,"D",0,0,"D",2.35,3.03,3.67,"0-0","0-0",15,4,8,0,0,1,0,0,8,3,10,25,0,11,35,"8-3","N","N","N",1,0,11
"1205","SP1",2023-10-28,"Cadiz","Sevilla",2,2,"D",2,1,"H",3.39,3.37,2.29,"2-1","2-2",10,5,20,10,6,4,0,0,2,4,17,12,4,6,29,"2-4","Y","Y","Y",10,0,11
"1206","SP1",2023-10-29,"Betis","Osasuna",2,1,"H",1,0,"H",2.1,3.4,3.89,"1-0","2-1",9,2,7,1,3,4,0,0,6,3,10,25,3,9,35,"6-3","Y","Y","N",7,0,11
"1207","SP1",2023-10-29,"Vallecano","Sociedad",2,2,"D",1,1,"D",3.34,3.11,2.46,"1-1","2-2",16,7,15,3,3,2,0,0,4,5,17,16,4,9,33,"4-5","Y","Y","Y",5,0,11
"1208","SP1",2023-10-29,"Ath Bilbao","Valencia",2,2,"D",1,0,"H",1.64,3.96,5.95,"1-0","2-2",12,7,11,5,3,1,0,0,10,4,11,10,4,14,21,"10-4","Y","Y","Y",4,0,11
"1209","SP1",2023-10-29,"Ath Madrid","Alaves",2,1,"H",2,0,"H",1.4,4.96,8.74,"2-0","2-1",11,7,8,1,3,2,0,0,4,4,10,11,3,8,21,"4-4","Y","Y","N",5,0,11
"1210","SP1",2023-10-30,"Granada","Villarreal",2,3,"A",2,3,"A",3.16,3.62,2.29,"2-3","2-3",18,8,6,5,0,4,0,0,4,1,14,15,5,5,29,"4-1","Y","Y","Y",4,0,11
"1211","SP1",2023-11-03,"Las Palmas","Ath Madrid",2,1,"H",0,0,"D",5.74,3.85,1.68,"0-0","2-1",9,3,13,5,0,3,0,0,3,4,12,9,3,7,21,"3-4","Y","Y","N",3,0,11
"1212","SP1",2023-11-04,"Osasuna","Girona",2,4,"A",1,1,"D",2.88,3.47,2.51,"1-1","2-4",15,3,11,4,5,3,0,0,2,7,14,10,6,9,24,"2-7","Y","Y","Y",8,0,12
"1213","SP1",2023-11-04,"Betis","Mallorca",2,0,"H",1,0,"H",1.93,3.37,4.52,"1-0","2-0",22,3,8,1,1,4,0,1,6,1,13,16,2,7,29,"6-1","Y","N","N",5,1,12
"1214","SP1",2023-11-04,"Celta","Sevilla",1,1,"D",1,0,"H",2.58,3.49,2.79,"1-0","1-1",15,3,13,5,2,5,1,0,4,6,14,10,2,10,24,"4-6","Y","N","N",7,1,12
"1215","SP1",2023-11-04,"Sociedad","Barcelona",0,1,"A",0,0,"D",3.37,3.55,2.2,"0-0","0-1",13,6,12,4,3,3,0,0,8,3,16,8,1,11,24,"8-3","N","N","N",6,0,12
"1216","SP1",2023-11-05,"Alaves","Almeria",1,0,"H",0,0,"D",1.78,3.8,4.75,"0-0","1-0",23,3,9,3,2,3,0,0,12,6,13,14,1,18,27,"12-6","N","N","N",5,0,12
"1217","SP1",2023-11-05,"Valencia","Granada",1,0,"H",1,0,"H",1.66,4.13,5.24,"1-0","1-0",11,2,6,1,3,5,0,0,0,4,20,15,1,4,35,"0-4","N","N","N",8,0,12
"1218","SP1",2023-11-05,"Villarreal","Ath Bilbao",2,3,"A",0,3,"A",3.06,3.58,2.34,"0-3","2-3",17,6,17,7,4,4,0,0,9,3,11,18,5,12,29,"9-3","Y","Y","Y",8,0,12
"1219","SP1",2023-11-05,"Real Madrid","Vallecano",0,0,"D",0,0,"D",1.27,6.24,10.53,"0-0","0-0",22,5,4,0,3,5,0,0,11,1,12,15,0,12,27,"11-1","N","N","N",8,0,12
"1220","SP1",2023-11-06,"Getafe","Cadiz",1,0,"H",0,0,"D",1.93,3.19,4.88,"0-0","1-0",13,3,6,2,7,1,1,0,6,3,18,12,1,9,30,"6-3","N","N","N",8,1,12
"1221","SP1",2023-11-10,"Ath Bilbao","Celta",4,3,"H",2,2,"D",1.69,4.17,5.04,"2-2","4-3",21,12,13,5,2,2,0,0,7,2,15,13,7,9,28,"7-2","Y","Y","Y",4,0,12
"1222","SP1",2023-11-11,"Vallecano","Girona",1,2,"A",1,1,"D",2.92,3.48,2.48,"1-1","1-2",22,9,19,7,1,2,0,0,8,3,15,13,3,11,28,"8-3","Y","Y","N",3,0,13
"1223","SP1",2023-11-11,"Almeria","Sociedad",1,3,"A",0,0,"D",4.83,4.01,1.72,"0-0","1-3",7,2,18,6,2,2,0,0,5,5,18,19,4,10,37,"5-5","Y","Y","Y",4,0,13
"1224","SP1",2023-11-11,"Granada","Getafe",1,1,"D",1,1,"D",2.58,3.16,3.04,"1-1","1-1",12,6,10,6,4,2,0,0,3,5,14,9,2,8,23,"3-5","Y","N","N",6,0,13
"1225","SP1",2023-11-11,"Osasuna","Las Palmas",1,1,"D",0,0,"D",2,3.25,4.42,"0-0","1-1",11,3,6,1,1,1,0,0,8,3,25,10,2,11,35,"8-3","Y","N","N",2,0,13
"1226","SP1",2023-11-11,"Real Madrid","Valencia",5,1,"H",2,0,"H",1.32,5.6,9.7,"2-0","5-1",16,7,10,4,1,3,0,0,4,4,7,26,6,8,33,"4-4","Y","Y","Y",4,0,13
"1227","SP1",2023-11-12,"Barcelona","Alaves",2,1,"H",0,1,"A",1.24,6.51,11.82,"0-1","2-1",11,6,8,1,2,1,0,0,2,1,11,10,3,3,21,"2-1","Y","Y","N",3,0,13
"1228","SP1",2023-11-12,"Sevilla","Betis",1,1,"D",0,0,"D",2.17,3.52,3.46,"0-0","1-1",13,4,14,6,1,1,0,0,9,5,18,14,2,14,32,"9-5","Y","N","N",2,0,13
"1229","SP1",2023-11-12,"Ath Madrid","Villarreal",3,1,"H",1,1,"D",1.38,5.43,7.71,"1-1","3-1",25,10,11,7,0,2,0,0,6,3,8,8,4,9,16,"6-3","Y","Y","Y",2,0,13
"1230","SP1",2023-11-24,"Alaves","Granada",3,1,"H",2,0,"H",1.76,3.74,5.15,"2-0","3-1",8,5,11,4,1,3,0,0,6,2,10,13,4,8,23,"6-2","Y","Y","Y",4,0,13
"1231","SP1",2023-11-25,"Vallecano","Barcelona",1,1,"D",1,0,"H",5.39,4.09,1.65,"1-0","1-1",10,4,15,4,3,4,0,0,1,4,23,13,2,5,36,"1-4","Y","N","N",7,0,13
"1232","SP1",2023-11-25,"Valencia","Celta",0,0,"D",0,0,"D",2.19,3.43,3.51,"0-0","0-0",8,0,13,1,3,2,0,0,5,7,13,7,0,12,20,"5-7","N","N","N",5,0,14
"1233","SP1",2023-11-25,"Getafe","Almeria",2,1,"H",2,1,"H",1.68,3.86,5.46,"2-1","2-1",18,5,13,4,2,4,0,0,3,6,12,8,3,9,20,"3-6","Y","Y","N",6,0,14
"1234","SP1",2023-11-25,"Ath Madrid","Mallorca",1,0,"H",0,0,"D",1.37,4.89,9.37,"0-0","1-0",20,3,8,1,0,0,0,0,7,3,8,19,1,10,27,"7-3","N","N","N",0,0,14
"1235","SP1",2023-11-26,"Villarreal","Osasuna",3,1,"H",0,0,"D",2.17,3.49,3.5,"0-0","3-1",10,3,15,7,0,0,0,0,2,4,9,14,4,6,23,"2-4","Y","Y","Y",0,0,14
"1236","SP1",2023-11-26,"Sociedad","Sevilla",2,1,"H",2,0,"H",1.76,3.76,4.92,"2-0","2-1",11,8,8,2,2,1,0,2,4,4,22,8,3,8,30,"4-4","Y","Y","N",3,2,14
"1237","SP1",2023-11-26,"Cadiz","Real Madrid",0,3,"A",0,1,"A",6.67,4.68,1.48,"0-1","0-3",13,4,14,5,3,3,0,0,4,4,16,16,3,8,32,"4-4","Y","Y","N",6,0,14
"1238","SP1",2023-11-26,"Betis","Las Palmas",1,0,"H",1,0,"H",1.65,3.91,5.66,"1-0","1-0",12,6,15,4,1,2,0,0,7,6,7,12,1,13,19,"7-6","N","N","N",3,0,14
"1239","SP1",2023-11-27,"Girona","Ath Bilbao",1,1,"D",0,0,"D",2.32,3.69,3.01,"0-0","1-1",12,2,13,6,1,1,0,0,2,6,8,16,2,8,24,"2-6","Y","N","N",2,0,14
"1240","SP1",2023-11-29,"Mallorca","Cadiz",1,1,"D",1,1,"D",1.99,3.21,4.56,"1-1","1-1",16,3,6,3,2,3,0,0,7,0,14,18,2,7,32,"7-0","Y","N","N",5,0,14
"1241","SP1",2023-12-01,"Las Palmas","Getafe",2,0,"H",1,0,"H",2.49,2.95,3.48,"1-0","2-0",11,6,12,4,0,5,0,1,4,4,11,9,2,8,20,"4-4","Y","N","N",5,1,14
"1242","SP1",2023-12-02,"Girona","Valencia",2,1,"H",0,0,"D",1.71,3.97,5,"0-0","2-1",9,5,9,3,2,3,0,0,3,2,6,7,3,5,13,"3-2","Y","Y","N",5,0,15
"1243","SP1",2023-12-02,"Ath Bilbao","Vallecano",4,0,"H",1,0,"H",1.57,4.32,5.92,"1-0","4-0",9,4,11,3,1,2,0,0,7,2,15,11,4,9,26,"7-2","Y","Y","Y",3,0,15
"1244","SP1",2023-12-02,"Real Madrid","Granada",2,0,"H",1,0,"H",1.16,8.84,14.66,"1-0","2-0",11,4,1,0,2,1,0,0,6,0,10,12,2,6,22,"6-0","Y","N","N",3,0,15
"1245","SP1",2023-12-02,"Osasuna","Sociedad",1,1,"D",1,1,"D",3.75,3.24,2.18,"1-1","1-1",9,3,17,5,3,3,0,0,1,8,12,10,2,9,22,"1-8","Y","N","N",6,0,15
"1246","SP1",2023-12-03,"Mallorca","Alaves",0,0,"D",0,0,"D",2.47,2.99,3.41,"0-0","0-0",7,3,7,4,4,2,0,0,5,4,16,15,0,9,31,"5-4","N","N","N",6,0,15
"1247","SP1",2023-12-03,"Almeria","Betis",0,0,"D",0,0,"D",3.36,3.66,2.16,"0-0","0-0",20,8,6,2,0,3,0,1,4,6,12,8,0,10,20,"4-6","N","N","N",3,1,15
"1248","SP1",2023-12-03,"Sevilla","Villarreal",1,1,"D",0,0,"D",2.05,3.73,3.58,"0-0","1-1",18,4,5,4,3,2,0,0,8,4,6,16,2,12,22,"8-4","Y","N","N",5,0,15
"1249","SP1",2023-12-03,"Barcelona","Ath Madrid",1,0,"H",1,0,"H",2.05,3.76,3.57,"1-0","1-0",13,2,9,4,5,4,0,0,7,2,17,12,1,9,29,"7-2","N","N","N",9,0,15
"1250","SP1",2023-12-04,"Celta","Cadiz",1,1,"D",0,1,"A",1.61,4.13,5.8,"0-1","1-1",26,7,2,1,1,6,0,1,12,1,14,18,2,13,32,"12-1","Y","N","N",7,1,15
"1251","SP2",2023-08-11,"Amorebieta","Levante",1,1,"D",0,1,"A",3.32,3.1,2.48,"0-1","1-1",11,3,7,2,0,3,0,0,8,2,20,18,2,10,38,"8-2","Y","N","N",3,0,1
"1252","SP2",2023-08-11,"Valladolid","Sp Gijon",2,0,"H",1,0,"H",1.93,3.36,4.67,"1-0","2-0",17,5,11,4,5,5,0,0,8,2,12,15,2,10,27,"8-2","Y","N","N",10,0,1
"1253","SP2",2023-08-12,"Santander","Eibar",4,0,"H",3,0,"H",3.05,2.98,2.74,"3-0","4-0",11,8,14,3,2,3,0,0,4,6,10,14,4,10,24,"4-6","Y","Y","Y",5,0,1
"1254","SP2",2023-08-12,"Zaragoza","Villarreal B",2,0,"H",0,0,"D",1.71,3.54,6.06,"0-0","2-0",16,7,11,2,2,4,0,0,4,0,9,8,2,4,17,"4-0","Y","N","N",6,0,1
"1255","SP2",2023-08-12,"Elche","Ferrol",0,1,"A",0,0,"D",NA,NA,NA,"0-0","0-1",14,1,10,2,0,2,0,0,4,4,13,15,1,8,28,"4-4","N","N","N",2,0,1
"1256","SP2",2023-08-13,"Burgos","Huesca",1,1,"D",1,1,"D",2.39,2.94,3.7,"1-1","1-1",19,5,4,2,2,4,0,0,6,5,5,14,2,11,19,"6-5","Y","N","N",6,0,1
"1257","SP2",2023-08-13,"Albacete","Espanol",1,1,"D",0,1,"A",3.09,3.26,2.52,"0-1","1-1",17,6,8,3,3,3,0,0,7,4,14,19,2,11,33,"7-4","Y","N","N",6,0,1
"1258","SP2",2023-08-13,"Cartagena","Eldense",0,1,"A",0,1,"A",2.2,3.11,3.96,"0-1","0-1",12,2,8,2,1,1,0,0,6,6,9,18,1,12,27,"6-6","N","N","N",2,0,1
"1259","SP2",2023-08-13,"Leganes","Andorra",0,1,"A",0,1,"A",2.38,2.97,3.69,"0-1","0-1",12,4,13,3,5,1,0,0,2,2,25,12,1,4,37,"2-2","N","N","N",6,0,1
"1260","SP2",2023-08-14,"Mirandes","Alcorcon",4,0,"H",2,0,"H",2.66,2.96,3.13,"2-0","4-0",17,6,18,6,1,1,0,0,2,5,14,6,4,7,20,"2-5","Y","Y","Y",2,0,1
"1261","SP2",2023-08-14,"Tenerife","Oviedo",1,0,"H",1,0,"H",2.15,2.99,4.28,"1-0","1-0",10,3,7,0,6,0,0,0,6,4,17,7,1,10,24,"6-4","N","N","N",6,0,1
"1262","SP2",2023-08-18,"Andorra","Cartagena",3,2,"H",0,0,"D",1.92,3.42,4.65,"0-0","3-2",17,5,5,3,2,4,0,0,6,0,14,11,5,6,25,"6-0","Y","Y","Y",6,0,2
"1263","SP2",2023-08-18,"Zaragoza","Valladolid",1,0,"H",1,0,"H",2.39,3.08,3.51,"1-0","1-0",12,5,11,5,3,2,0,0,5,0,10,14,1,5,24,"5-0","N","N","N",5,0,2
"1264","SP2",2023-08-19,"Eibar","Elche",2,1,"H",1,0,"H",2.25,3.06,3.89,"1-0","2-1",11,5,13,3,1,2,0,0,6,4,13,8,3,10,21,"6-4","Y","Y","N",3,0,2
"1265","SP2",2023-08-19,"Espanol","Santander",2,0,"H",1,0,"H",1.85,3.35,5.22,"1-0","2-0",20,6,12,2,1,2,0,0,6,7,23,17,2,13,40,"6-7","Y","N","N",3,0,2
"1266","SP2",2023-08-19,"Levante","Burgos",3,2,"H",2,1,"H",1.72,3.47,6.13,"2-1","3-2",18,11,16,8,4,3,0,0,4,4,19,7,5,8,26,"4-4","Y","Y","Y",7,0,2
"1267","SP2",2023-08-19,"Alcorcon","Leganes",0,2,"A",0,0,"D",2.61,2.92,3.31,"0-0","0-2",15,2,7,4,3,4,0,0,8,5,12,16,2,13,28,"8-5","Y","N","N",7,0,2
"1268","SP2",2023-08-20,"Oviedo","Ferrol",1,1,"D",0,1,"A",2.08,2.96,4.75,"0-1","1-1",16,3,5,1,2,1,0,1,6,3,8,12,2,9,20,"6-3","Y","N","N",3,1,2
"1269","SP2",2023-08-20,"Sp Gijon","Mirandes",3,0,"H",3,0,"H",1.88,3.37,4.94,"3-0","3-0",12,7,22,11,2,2,0,0,7,11,11,12,3,18,23,"7-11","Y","Y","N",4,0,2
"1270","SP2",2023-08-20,"Albacete","Amorebieta",2,2,"D",1,2,"A",1.64,3.56,6.99,"1-2","2-2",18,8,13,3,3,0,0,0,4,7,11,8,4,11,19,"4-7","Y","Y","Y",3,0,2
"1271","SP2",2023-08-21,"Villarreal B","Eldense",3,1,"H",2,1,"H",2.31,3.34,3.32,"2-1","3-1",13,6,11,3,2,1,0,0,2,5,17,17,4,7,34,"2-5","Y","Y","Y",3,0,2
"1272","SP2",2023-08-21,"Huesca","Tenerife",0,2,"A",0,1,"A",2.96,2.87,2.89,"0-1","0-2",12,4,11,5,0,4,0,0,4,2,7,18,2,6,25,"4-2","Y","N","N",4,0,2
"1273","SP2",2023-08-25,"Cartagena","Levante",0,1,"A",0,1,"A",2.98,3.13,2.69,"0-1","0-1",9,3,13,5,4,6,0,0,2,12,14,15,1,14,29,"2-12","N","N","N",10,0,3
"1274","SP2",2023-08-26,"Burgos","Oviedo",1,0,"H",1,0,"H",2.74,2.8,3.28,"1-0","1-0",16,5,9,3,4,4,0,1,4,3,13,16,1,7,29,"4-3","N","N","N",8,1,3
"1275","SP2",2023-08-26,"Tenerife","Zaragoza",0,1,"A",0,0,"D",2.23,2.89,4.27,"0-0","0-1",14,2,7,4,3,3,1,0,11,3,19,10,1,14,29,"11-3","N","N","N",6,1,3
"1276","SP2",2023-08-26,"Elche","Villarreal B",1,0,"H",1,0,"H",1.63,3.86,6.33,"1-0","1-0",19,8,12,3,2,0,0,0,4,4,14,8,1,8,22,"4-4","N","N","N",2,0,3
"1277","SP2",2023-08-26,"Valladolid","Alcorcon",0,2,"A",0,1,"A",1.79,3.44,5.49,"0-1","0-2",28,2,12,5,1,4,0,0,10,3,10,20,2,13,30,"10-3","Y","N","N",5,0,3
"1278","SP2",2023-08-27,"Ferrol","Sp Gijon",2,0,"H",0,0,"D",2.53,3.04,3.29,"0-0","2-0",13,3,6,1,0,2,0,0,4,4,12,16,2,8,28,"4-4","Y","N","N",2,0,3
"1279","SP2",2023-08-27,"Amorebieta","Andorra",3,0,"H",1,0,"H",3.35,3.1,2.46,"1-0","3-0",9,4,15,5,2,1,0,0,3,7,14,8,3,10,22,"3-7","Y","Y","N",3,0,3
"1280","SP2",2023-08-27,"Mirandes","Espanol",0,1,"A",0,0,"D",3.58,3.22,2.28,"0-0","0-1",5,1,17,4,4,2,0,0,4,7,12,13,1,11,25,"4-7","N","N","N",6,0,3
"1281","SP2",2023-08-27,"Leganes","Albacete",2,0,"H",1,0,"H",2.47,3.12,3.28,"1-0","2-0",11,2,12,3,3,2,0,0,2,5,9,15,2,7,24,"2-5","Y","N","N",5,0,3
"1282","SP2",2023-08-28,"Eldense","Eibar",2,1,"H",2,0,"H",2.96,3.04,2.73,"2-0","2-1",7,4,12,2,1,4,0,0,6,4,8,11,3,10,19,"6-4","Y","Y","N",5,0,3
"1283","SP2",2023-08-28,"Santander","Huesca",0,0,"D",0,0,"D",2.12,3.13,4.12,"0-0","0-0",10,0,14,0,5,5,0,0,12,6,16,16,0,18,32,"12-6","N","N","N",10,0,3
"1284","SP2",2023-09-01,"Alcorcon","Ferrol",1,1,"D",0,0,"D",2.34,2.99,3.77,"0-0","1-1",12,3,7,2,3,1,0,0,3,1,11,9,2,4,20,"3-1","Y","N","N",4,0,4
"1285","SP2",2023-09-01,"Albacete","Valladolid",2,0,"H",1,0,"H",2.11,3.31,3.97,"1-0","2-0",9,3,7,1,1,5,0,0,5,4,19,12,2,9,31,"5-4","Y","N","N",6,0,4
"1286","SP2",2023-09-02,"Sp Gijon","Burgos",2,1,"H",1,0,"H",2.1,3.12,4.32,"1-0","2-1",17,2,5,2,1,1,0,0,10,2,12,15,3,12,27,"10-2","Y","Y","N",2,0,4
"1287","SP2",2023-09-02,"Levante","Oviedo",1,1,"D",0,0,"D",1.86,3.39,5.06,"0-0","1-1",17,4,11,2,3,3,0,1,4,2,18,11,2,6,29,"4-2","Y","N","N",6,1,4
"1288","SP2",2023-09-02,"Elche","Santander",1,1,"D",1,0,"H",1.84,3.53,4.82,"1-0","1-1",22,6,12,6,0,3,1,0,8,1,11,16,2,9,27,"8-1","Y","N","N",3,1,4
"1289","SP2",2023-09-02,"Villarreal B","Cartagena",1,2,"A",1,0,"H",2.24,3.38,3.5,"1-0","1-2",17,6,12,5,2,3,0,0,3,7,9,14,3,10,23,"3-7","Y","Y","N",5,0,4
"1290","SP2",2023-09-03,"Andorra","Tenerife",0,1,"A",0,0,"D",2.29,3.07,3.73,"0-0","0-1",16,2,10,4,0,3,0,0,8,4,7,18,1,12,25,"8-4","N","N","N",3,0,4
"1291","SP2",2023-09-03,"Eibar","Leganes",0,1,"A",0,1,"A",2.07,3.15,4.39,"0-1","0-1",20,2,2,1,2,3,0,0,8,1,11,14,1,9,25,"8-1","N","N","N",5,0,4
"1292","SP2",2023-09-03,"Espanol","Amorebieta",3,2,"H",0,2,"A",1.62,3.76,6.71,"0-2","3-2",21,7,7,4,3,1,0,0,4,3,6,15,5,7,21,"4-3","Y","Y","Y",4,0,4
"1293","SP2",2023-09-03,"Zaragoza","Eldense",2,0,"H",1,0,"H",1.77,3.45,5.68,"1-0","2-0",13,1,8,3,2,1,0,0,1,3,6,13,2,4,19,"1-3","Y","N","N",3,0,4
"1294","SP2",2023-09-03,"Huesca","Mirandes",1,1,"D",0,0,"D",2.09,3.28,4.07,"0-0","1-1",15,3,13,3,5,5,1,0,9,5,15,10,2,14,25,"9-5","Y","N","N",10,1,4
"1295","SP2",2023-09-08,"Levante","Espanol",1,4,"A",1,2,"A",2.67,3.19,2.95,"1-2","1-4",15,3,17,10,0,0,1,0,5,3,13,13,5,8,26,"5-3","Y","Y","Y",0,1,5
"1296","SP2",2023-09-09,"Burgos","Eibar",1,0,"H",0,0,"D",3.13,2.99,2.68,"0-0","1-0",6,3,14,2,2,4,0,1,5,10,10,13,1,15,23,"5-10","N","N","N",6,1,5
"1297","SP2",2023-09-09,"Oviedo","Sp Gijon",0,0,"D",0,0,"D",2.36,2.96,3.77,"0-0","0-0",6,0,7,1,2,3,0,0,7,1,12,17,0,8,29,"7-1","N","N","N",5,0,5
"1298","SP2",2023-09-09,"Leganes","Huesca",2,0,"H",1,0,"H",2.04,3.09,4.65,"1-0","2-0",11,7,8,3,0,2,0,0,2,3,18,12,2,5,30,"2-3","Y","N","N",2,0,5
"1299","SP2",2023-09-09,"Tenerife","Albacete",2,0,"H",2,0,"H",2.18,3.08,4.09,"2-0","2-0",10,4,14,4,2,1,0,0,1,7,19,9,2,8,28,"1-7","Y","N","N",3,0,5
"1300","SP2",2023-09-10,"Ferrol","Villarreal B",2,2,"D",0,1,"A",1.97,3.33,4.54,"0-1","2-2",24,8,6,3,3,2,0,0,13,0,11,12,4,13,23,"13-0","Y","Y","Y",5,0,5
"1301","SP2",2023-09-10,"Santander","Amorebieta",1,0,"H",1,0,"H",1.85,3.58,4.73,"1-0","1-0",7,4,7,2,4,2,0,0,4,4,12,17,1,8,29,"4-4","N","N","N",6,0,5
"1302","SP2",2023-09-10,"Cartagena","Zaragoza",1,3,"A",1,2,"A",3.25,2.93,2.64,"1-2","1-3",19,5,9,5,2,2,0,0,6,4,11,6,4,10,17,"6-4","Y","Y","Y",4,0,5
"1303","SP2",2023-09-10,"Mirandes","Andorra",4,3,"H",2,0,"H",3.24,3.21,2.46,"2-0","4-3",17,6,25,7,1,3,0,0,3,3,9,11,7,6,20,"3-3","Y","Y","Y",4,0,5
"1304","SP2",2023-09-10,"Valladolid","Elche",1,1,"D",1,0,"H",2.33,3.03,3.71,"1-0","1-1",14,5,8,3,6,2,1,1,7,6,15,13,2,13,28,"7-6","Y","N","N",8,2,5
"1305","SP2",2023-09-11,"Eldense","Alcorcon",2,2,"D",0,0,"D",2.4,2.99,3.53,"0-0","2-2",17,3,13,4,0,3,0,1,5,2,14,7,4,7,21,"5-2","Y","Y","Y",3,1,5
"1306","SP2",2023-09-15,"Zaragoza","Santander",1,1,"D",1,1,"D",2.06,3.11,4.5,"1-1","1-1",6,2,12,4,2,5,0,0,6,6,21,16,2,12,37,"6-6","Y","N","N",7,0,6
"1307","SP2",2023-09-16,"Huesca","Villarreal B",2,2,"D",0,2,"A",2.07,3.23,4.24,"0-2","2-2",8,2,7,3,5,3,0,0,7,0,14,14,4,7,28,"7-0","Y","Y","Y",8,0,6
"1308","SP2",2023-09-16,"Alcorcon","Levante",0,2,"A",0,1,"A",2.96,3.08,2.74,"0-1","0-2",10,1,21,5,6,3,1,0,3,6,10,16,2,9,26,"3-6","Y","N","N",9,1,6
"1309","SP2",2023-09-16,"Valladolid","Cartagena",1,0,"H",0,0,"D",1.87,3.62,4.58,"0-0","1-0",22,8,9,4,3,1,0,0,9,3,14,14,1,12,28,"9-3","N","N","N",4,0,6
"1310","SP2",2023-09-16,"Albacete","Burgos",2,1,"H",1,0,"H",1.81,3.42,5.44,"1-0","2-1",19,5,12,3,1,2,0,0,3,6,16,8,3,9,24,"3-6","Y","Y","N",3,0,6
"1311","SP2",2023-09-17,"Amorebieta","Mirandes",2,0,"H",2,0,"H",2.31,3.31,3.41,"2-0","2-0",7,2,10,2,3,2,0,0,9,4,24,10,2,13,34,"9-4","Y","N","N",5,0,6
"1312","SP2",2023-09-17,"Eibar","Ferrol",2,0,"H",1,0,"H",1.82,3.42,5.31,"1-0","2-0",13,6,8,1,0,2,0,0,4,6,10,10,2,10,20,"4-6","Y","N","N",2,0,6
"1313","SP2",2023-09-17,"Elche","Leganes",1,0,"H",1,0,"H",1.85,3.37,5.22,"1-0","1-0",18,5,9,3,5,3,0,0,8,4,14,10,1,12,24,"8-4","N","N","N",8,0,6
"1314","SP2",2023-09-17,"Espanol","Eldense",3,3,"D",0,2,"A",1.49,4.29,7.86,"0-2","3-3",23,5,6,3,3,4,0,1,12,0,14,13,6,12,27,"12-0","Y","Y","Y",7,1,6
"1315","SP2",2023-09-17,"Sp Gijon","Tenerife",2,1,"H",1,1,"D",2.81,2.95,3.01,"1-1","2-1",10,4,8,1,2,5,0,0,6,4,12,16,3,10,28,"6-4","Y","Y","N",7,0,6
"1316","SP2",2023-09-18,"Andorra","Oviedo",1,0,"H",0,0,"D",2.22,3.08,3.85,"0-0","1-0",5,1,6,2,1,4,1,1,4,3,15,16,1,7,31,"4-3","N","N","N",5,2,6
"1317","SP2",2023-09-22,"Cartagena","Eibar",1,2,"A",0,1,"A",3.53,3.19,2.32,"0-1","1-2",7,4,11,5,2,5,1,0,5,6,10,23,3,11,33,"5-6","Y","Y","N",7,1,7
"1318","SP2",2023-09-23,"Andorra","Sp Gijon",0,0,"D",0,0,"D",2.27,2.99,3.94,"0-0","0-0",13,5,6,2,0,1,0,0,4,2,10,10,0,6,20,"4-2","N","N","N",1,0,7
"1319","SP2",2023-09-23,"Levante","Eldense",2,0,"H",1,0,"H",1.83,3.53,5.02,"1-0","2-0",17,7,10,2,1,2,0,0,5,2,11,15,2,7,26,"5-2","Y","N","N",3,0,7
"1320","SP2",2023-09-23,"Burgos","Elche",4,0,"H",2,0,"H",3.15,3.19,2.52,"2-0","4-0",16,9,12,1,3,1,0,0,4,1,11,12,4,5,23,"4-1","Y","Y","Y",4,0,7
"1321","SP2",2023-09-23,"Alcorcon","Huesca",0,2,"A",0,2,"A",2.29,3.1,3.72,"0-2","0-2",19,3,6,2,2,1,0,0,4,2,15,7,2,6,22,"4-2","Y","N","N",3,0,7
"1322","SP2",2023-09-23,"Santander","Albacete",2,1,"H",2,0,"H",2.36,3.26,3.37,"2-0","2-1",8,3,18,4,2,3,0,0,0,6,13,13,3,6,26,"0-6","Y","Y","N",5,0,7
"1323","SP2",2023-09-24,"Villarreal B","Amorebieta",3,1,"H",1,0,"H",2.04,3.56,3.9,"1-0","3-1",19,8,14,4,2,4,0,0,3,6,12,18,4,9,30,"3-6","Y","Y","Y",6,0,7
"1324","SP2",2023-09-24,"Oviedo","Valladolid",0,1,"A",0,0,"D",2.68,2.89,3.24,"0-0","0-1",10,3,16,5,1,3,0,0,6,6,14,13,1,12,27,"6-6","N","N","N",4,0,7
"1325","SP2",2023-09-24,"Mirandes","Leganes",1,3,"A",1,1,"D",2.78,2.83,3.19,"1-1","1-3",12,6,10,5,1,1,0,0,0,4,11,12,4,4,23,"0-4","Y","Y","Y",2,0,7
"1326","SP2",2023-09-25,"Ferrol","Zaragoza",1,0,"H",0,0,"D",2.9,3,2.82,"0-0","1-0",7,3,6,2,1,0,0,0,4,4,7,9,1,8,16,"4-4","N","N","N",1,0,7
"1327","SP2",2023-09-25,"Tenerife","Espanol",1,0,"H",1,0,"H",NA,NA,NA,"1-0","1-0",14,6,18,2,3,3,0,0,6,10,22,9,1,16,31,"6-10","N","N","N",6,0,7
"1328","SP2",2023-09-29,"Leganes","Santander",2,1,"H",1,0,"H",2.44,2.96,3.57,"1-0","2-1",9,4,16,2,4,3,0,0,4,11,14,5,3,15,19,"4-11","Y","Y","N",7,0,8
"1329","SP2",2023-09-30,"Eibar","Tenerife",3,0,"H",0,0,"D",2.06,3.13,4.45,"0-0","3-0",14,5,8,2,3,1,0,0,4,3,16,9,3,7,25,"4-3","Y","Y","N",4,0,8
"1330","SP2",2023-09-30,"Elche","Levante",0,0,"D",0,0,"D",2.47,3.31,3.12,"0-0","0-0",28,4,10,2,1,1,0,0,8,7,8,12,0,15,20,"8-7","N","N","N",2,0,8
"1331","SP2",2023-09-30,"Albacete","Andorra",3,1,"H",2,0,"H",2.25,3.27,3.62,"2-0","3-1",12,7,11,2,2,2,0,0,4,3,12,15,4,7,27,"4-3","Y","Y","Y",4,0,8
"1332","SP2",2023-09-30,"Villarreal B","Alcorcon",2,2,"D",1,2,"A",2.51,3.26,3.1,"1-2","2-2",25,8,10,5,2,3,0,0,7,5,16,13,4,12,29,"7-5","Y","Y","Y",5,0,8
"1333","SP2",2023-10-01,"Eldense","Oviedo",1,3,"A",0,3,"A",2.85,2.95,2.97,"0-3","1-3",10,4,10,4,1,0,0,0,6,4,18,10,4,10,28,"6-4","Y","Y","Y",1,0,8
"1334","SP2",2023-10-01,"Amorebieta","Cartagena",0,0,"D",0,0,"D",2.37,3.28,3.33,"0-0","0-0",5,2,8,1,2,2,0,0,3,2,14,10,0,5,24,"3-2","N","N","N",4,0,8
"1335","SP2",2023-10-01,"Valladolid","Burgos",3,0,"H",2,0,"H",1.79,3.6,5.2,"2-0","3-0",11,6,11,2,2,2,0,0,3,6,14,10,3,9,24,"3-6","Y","Y","N",4,0,8
"1336","SP2",2023-10-01,"Zaragoza","Mirandes",0,1,"A",0,0,"D",1.79,3.56,5.19,"0-0","0-1",8,2,8,0,2,4,1,0,6,2,10,11,1,8,21,"6-2","N","N","N",6,1,8
"1337","SP2",2023-10-01,"Huesca","Sp Gijon",0,1,"A",0,0,"D",2.35,3.05,3.64,"0-0","0-1",6,2,13,6,6,5,0,0,9,8,11,15,1,17,26,"9-8","N","N","N",11,0,8
"1338","SP2",2023-10-02,"Espanol","Ferrol",3,0,"H",1,0,"H",1.63,4.01,5.76,"1-0","3-0",10,3,6,2,2,2,0,1,6,0,22,13,3,6,35,"6-0","Y","Y","N",4,1,8
"1339","SP2",2023-10-03,"Alcorcon","Albacete",1,2,"A",0,1,"A",3.16,3.11,2.57,"0-1","1-2",23,6,9,4,0,6,0,0,6,1,10,11,3,7,21,"6-1","Y","Y","N",6,0,9
"1340","SP2",2023-10-03,"Levante","Villarreal B",1,1,"D",0,0,"D",1.72,3.99,5.06,"0-0","1-1",15,4,7,1,2,2,0,0,8,2,18,9,2,10,27,"8-2","Y","N","N",4,0,9
"1341","SP2",2023-10-03,"Tenerife","Santander",2,0,"H",0,0,"D",1.93,3.34,4.69,"0-0","2-0",21,6,9,3,1,4,0,0,7,4,18,7,2,11,25,"7-4","Y","N","N",5,0,9
"1342","SP2",2023-10-04,"Eldense","Valladolid",0,1,"A",0,1,"A",3.17,3.2,2.5,"0-1","0-1",4,0,8,2,1,4,0,0,3,2,16,18,1,5,34,"3-2","N","N","N",5,0,9
"1343","SP2",2023-10-04,"Oviedo","Huesca",1,0,"H",0,0,"D",1.99,3.15,4.8,"0-0","1-0",9,6,9,3,2,2,0,0,5,4,14,18,1,9,32,"5-4","N","N","N",4,0,9
"1344","SP2",2023-10-04,"Burgos","Leganes",1,0,"H",1,0,"H",2.36,3.01,3.66,"1-0","1-0",5,3,12,2,5,3,0,1,0,8,14,11,1,8,25,"0-8","N","N","N",8,1,9
"1345","SP2",2023-10-04,"Sp Gijon","Elche",2,0,"H",2,0,"H",2.54,3.18,3.12,"2-0","2-0",20,8,10,1,0,0,0,0,6,3,9,15,2,9,24,"6-3","Y","N","N",0,0,9
"1346","SP2",2023-10-05,"Andorra","Zaragoza",0,1,"A",0,1,"A",2.3,3.13,3.67,"0-1","0-1",5,0,5,3,2,4,1,0,4,0,9,16,1,4,25,"4-0","N","N","N",6,1,9
"1347","SP2",2023-10-05,"Mirandes","Eibar",1,3,"A",1,1,"D",3.59,3.1,2.35,"1-1","1-3",7,3,13,3,2,2,0,0,0,6,8,14,4,6,22,"0-6","Y","Y","Y",4,0,9
"1348","SP2",2023-10-05,"Cartagena","Espanol",0,2,"A",0,1,"A",3.81,3.63,2.04,"0-1","0-2",10,1,8,4,4,3,0,0,6,2,17,14,2,8,31,"6-2","Y","N","N",7,0,9
"1349","SP2",2023-10-05,"Ferrol","Amorebieta",1,0,"H",1,0,"H",1.85,3.5,4.75,"1-0","1-0",11,3,4,2,1,1,0,0,5,3,12,9,1,8,21,"5-3","N","N","N",2,0,9
"1350","SP2",2023-10-06,"Albacete","Levante",0,2,"A",0,1,"A",2.2,3.12,3.96,"0-1","0-2",14,4,10,7,0,1,0,0,6,3,11,11,2,9,22,"6-3","Y","N","N",1,0,10
"1351","SP2",2023-10-07,"Huesca","Eldense",0,1,"A",0,0,"D",2.28,3.03,3.87,"0-0","0-1",17,1,15,3,1,6,1,0,4,8,8,17,1,12,25,"4-8","N","N","N",7,1,10
"1352","SP2",2023-10-07,"Santander","Sp Gijon",3,2,"H",1,1,"D",2.33,3.15,3.56,"1-1","3-2",20,7,21,8,4,4,0,0,5,7,13,7,5,12,20,"5-7","Y","Y","Y",8,0,10
"1353","SP2",2023-10-07,"Leganes","Oviedo",0,0,"D",0,0,"D",2.48,2.85,3.67,"0-0","0-0",9,3,6,2,3,1,0,0,1,4,11,13,0,5,24,"1-4","N","N","N",4,0,10
"1354","SP2",2023-10-08,"Amorebieta","Eibar",1,2,"A",1,1,"D",4.27,3.27,2.05,"1-1","1-2",10,7,12,7,3,1,0,0,5,5,12,12,3,10,24,"5-5","Y","Y","N",4,0,10
"1355","SP2",2023-10-08,"Valladolid","Mirandes",3,2,"H",0,0,"D",1.65,3.83,6.14,"0-0","3-2",23,9,6,3,2,3,0,0,7,1,10,11,5,8,21,"7-1","Y","Y","Y",5,0,10
"1356","SP2",2023-10-08,"Ferrol","Cartagena",1,1,"D",0,1,"A",1.97,3.4,4.41,"0-1","1-1",12,5,11,4,0,5,0,0,4,6,11,19,2,10,30,"4-6","Y","N","N",5,0,10
"1357","SP2",2023-10-08,"Tenerife","Burgos",2,1,"H",0,0,"D",1.84,3.29,5.45,"0-0","2-1",8,2,14,6,3,4,1,0,4,6,12,15,3,10,27,"4-6","Y","Y","N",7,1,10
"1358","SP2",2023-10-08,"Zaragoza","Alcorcon",0,2,"A",0,1,"A",1.87,3.4,4.97,"0-1","0-2",15,5,11,2,5,4,0,0,7,1,12,18,2,8,30,"7-1","Y","N","N",9,0,10
"1359","SP2",2023-10-09,"Elche","Andorra",2,1,"H",1,0,"H",1.94,3.54,4.22,"1-0","2-1",24,9,4,1,0,0,0,0,10,4,13,15,3,14,28,"10-4","Y","Y","N",0,0,10
"1360","SP2",2023-10-09,"Villarreal B","Espanol",3,1,"H",2,1,"H",4.38,3.84,1.83,"2-1","3-1",17,7,16,4,1,4,0,0,7,9,17,12,4,16,29,"7-9","Y","Y","Y",5,0,10
"1361","SP2",2023-10-13,"Oviedo","Albacete",3,0,"H",0,0,"D",2.52,3.02,3.35,"0-0","3-0",9,3,12,2,1,4,0,1,6,2,10,14,3,8,24,"6-2","Y","Y","N",5,1,11
"1362","SP2",2023-10-14,"Mirandes","Tenerife",1,1,"D",1,1,"D",3.33,2.94,2.58,"1-1","1-1",9,3,9,4,3,3,0,0,5,2,10,14,2,7,24,"5-2","Y","N","N",6,0,11
"1363","SP2",2023-10-14,"Cartagena","Santander",2,3,"A",2,2,"D",2.43,3.12,3.37,"2-2","2-3",22,6,20,10,2,4,0,0,6,4,10,18,5,10,28,"6-4","Y","Y","Y",6,0,11
"1364","SP2",2023-10-14,"Sp Gijon","Zaragoza",2,2,"D",0,1,"A",2.25,3,4,"0-1","2-2",13,4,13,3,3,2,0,0,5,3,12,10,4,8,22,"5-3","Y","Y","Y",5,0,11
"1365","SP2",2023-10-14,"Espanol","Valladolid",2,0,"H",2,0,"H",1.99,3.58,4.04,"2-0","2-0",5,3,11,3,3,3,0,0,0,5,15,14,2,5,29,"0-5","Y","N","N",6,0,11
"1366","SP2",2023-10-15,"Burgos","Villarreal B",3,2,"H",0,0,"D",2.06,3.36,4.06,"0-0","3-2",11,4,12,3,0,4,0,0,9,2,13,8,5,11,21,"9-2","Y","Y","Y",4,0,11
"1367","SP2",2023-10-15,"Andorra","Alcorcon",2,0,"H",0,0,"D",2.15,3.09,4.17,"0-0","2-0",12,3,12,3,0,1,0,0,3,2,6,15,2,5,21,"3-2","Y","N","N",1,0,11
"1368","SP2",2023-10-15,"Eldense","Elche",1,1,"D",1,0,"H",3.46,3.27,2.31,"1-0","1-1",9,2,6,2,4,3,0,0,6,5,20,16,2,11,36,"6-5","Y","N","N",7,0,11
"1369","SP2",2023-10-15,"Eibar","Huesca",1,1,"D",0,1,"A",1.54,3.92,7.94,"0-1","1-1",14,2,5,2,1,3,0,0,6,1,8,14,2,7,22,"6-1","Y","N","N",4,0,11
"1370","SP2",2023-10-15,"Leganes","Amorebieta",6,0,"H",2,0,"H",1.96,3.25,4.73,"2-0","6-0",17,10,8,1,1,2,0,0,2,5,13,11,6,7,24,"2-5","Y","Y","Y",3,0,11
"1371","SP2",2023-10-16,"Levante","Ferrol",1,0,"H",0,0,"D",1.83,3.64,4.62,"0-0","1-0",9,4,13,1,4,1,0,0,3,3,13,11,1,6,24,"3-3","N","N","N",5,0,11
"1372","SP2",2023-10-20,"Espanol","Leganes",0,1,"A",0,0,"D",1.72,3.76,5.42,"0-0","0-1",12,3,13,4,2,4,0,0,4,1,12,13,1,5,25,"4-1","N","N","N",6,0,12
"1373","SP2",2023-10-21,"Amorebieta","Oviedo",0,0,"D",0,0,"D",3.44,2.98,2.49,"0-0","0-0",9,1,15,2,3,4,1,0,2,6,17,7,0,8,24,"2-6","N","N","N",7,1,12
"1374","SP2",2023-10-21,"Villarreal B","Mirandes",0,3,"A",0,1,"A",2.14,3.64,3.5,"0-1","0-3",15,3,7,3,1,1,0,0,8,1,8,13,3,9,21,"8-1","Y","Y","N",2,0,12
"1375","SP2",2023-10-21,"Tenerife","Levante",0,0,"D",0,0,"D",2.13,3.17,4.09,"0-0","0-0",17,4,8,1,3,2,0,0,3,3,14,13,0,6,27,"3-3","N","N","N",5,0,12
"1376","SP2",2023-10-21,"Zaragoza","Eibar",2,3,"A",2,0,"H",2.82,3.02,2.92,"2-0","2-3",13,5,10,6,4,3,0,0,3,5,9,14,5,8,23,"3-5","Y","Y","Y",7,0,12
"1377","SP2",2023-10-22,"Ferrol","Eldense",1,1,"D",0,0,"D",1.9,3.33,4.9,"0-0","1-1",14,3,11,3,0,2,0,0,8,4,12,16,2,12,28,"8-4","Y","N","N",2,0,12
"1378","SP2",2023-10-22,"Huesca","Elche",0,1,"A",0,1,"A",3.39,3.1,2.44,"0-1","0-1",7,1,4,3,3,3,0,0,4,1,16,20,1,5,36,"4-1","N","N","N",6,0,12
"1379","SP2",2023-10-22,"Albacete","Sp Gijon",1,3,"A",0,1,"A",2.21,3.28,3.69,"0-1","1-3",25,6,8,4,3,3,0,0,11,0,10,11,4,11,21,"11-0","Y","Y","Y",6,0,12
"1380","SP2",2023-10-22,"Santander","Burgos",3,0,"H",1,0,"H",2.31,3.22,3.53,"1-0","3-0",17,5,12,2,1,3,0,0,4,4,8,11,3,8,19,"4-4","Y","Y","N",4,0,12
"1381","SP2",2023-10-22,"Valladolid","Andorra",2,0,"H",2,0,"H",1.77,3.73,5.11,"2-0","2-0",10,4,16,4,5,2,0,0,6,6,16,10,2,12,26,"6-6","Y","N","N",7,0,12
"1382","SP2",2023-10-23,"Alcorcon","Cartagena",1,1,"D",1,0,"H",2.28,3.28,3.44,"1-0","1-1",18,2,16,6,1,3,0,0,6,7,7,9,2,13,16,"6-7","Y","N","N",4,0,12
"1383","SP2",2023-10-27,"Eibar","Valladolid",5,1,"H",2,0,"H",2.09,3.16,4.27,"2-0","5-1",23,13,10,2,1,0,0,0,2,1,13,12,6,3,25,"2-1","Y","Y","Y",1,0,13
"1384","SP2",2023-10-28,"Eldense","Amorebieta",2,0,"H",1,0,"H",2.04,3.36,4.17,"1-0","2-0",12,4,11,3,1,2,0,0,2,7,13,14,2,9,27,"2-7","Y","N","N",3,0,13
"1385","SP2",2023-10-28,"Andorra","Levante",2,0,"H",0,0,"D",2.73,3.12,2.93,"0-0","2-0",21,10,7,1,2,3,0,0,7,6,11,8,2,13,19,"7-6","Y","N","N",5,0,13
"1386","SP2",2023-10-28,"Sp Gijon","Espanol",2,0,"H",1,0,"H",2.56,3.29,3,"1-0","2-0",9,3,17,4,6,3,0,0,4,7,13,8,2,11,21,"4-7","Y","N","N",9,0,13
"1387","SP2",2023-10-28,"Elche","Tenerife",2,1,"H",0,0,"D",2.21,3.13,3.9,"0-0","2-1",9,4,8,1,0,6,0,0,4,4,11,16,3,8,27,"4-4","Y","Y","N",6,0,13
"1388","SP2",2023-10-29,"Mirandes","Cartagena",2,1,"H",0,0,"D",2.37,3.37,3.23,"0-0","2-1",13,4,14,5,0,3,0,0,4,5,9,14,3,9,23,"4-5","Y","Y","N",3,0,13
"1389","SP2",2023-10-29,"Huesca","Albacete",0,0,"D",0,0,"D",2.96,2.96,2.85,"0-0","0-0",8,1,8,5,1,1,0,0,6,1,11,13,0,7,24,"6-1","N","N","N",2,0,13
"1390","SP2",2023-10-29,"Leganes","Villarreal B",1,0,"H",0,0,"D",1.76,3.86,4.94,"0-0","1-0",10,5,8,3,2,2,0,1,7,0,11,16,1,7,27,"7-0","N","N","N",4,1,13
"1391","SP2",2023-10-29,"Oviedo","Alcorcon",2,0,"H",1,0,"H",1.97,3.31,4.58,"1-0","2-0",12,4,6,3,1,5,0,0,6,2,9,14,2,8,23,"6-2","Y","N","N",6,0,13
"1392","SP2",2023-10-29,"Santander","Ferrol",1,3,"A",1,2,"A",2.23,3.14,3.83,"1-2","1-3",11,5,17,8,1,5,0,0,5,4,12,22,4,9,34,"5-4","Y","Y","Y",6,0,13
"1393","SP2",2023-10-30,"Burgos","Zaragoza",1,1,"D",0,1,"A",2.55,2.99,3.26,"0-1","1-1",10,2,8,5,2,2,0,0,4,1,17,16,2,5,33,"4-1","Y","N","N",4,0,13
"1394","SP2",2023-11-03,"Espanol","Eibar",2,2,"D",1,1,"D",2.42,3.26,3.25,"1-1","2-2",13,5,13,4,1,1,0,0,4,4,9,7,4,8,16,"4-4","Y","Y","Y",2,0,14
"1395","SP2",2023-11-04,"Villarreal B","Sp Gijon",0,3,"A",0,1,"A",2.82,3.41,2.63,"0-1","0-3",22,6,10,6,0,0,0,0,9,4,15,9,3,13,24,"9-4","Y","Y","N",0,0,14
"1396","SP2",2023-11-04,"Levante","Mirandes",2,2,"D",1,1,"D",1.83,3.7,4.7,"1-1","2-2",10,5,10,4,4,3,2,0,2,6,19,11,4,8,30,"2-6","Y","Y","Y",7,2,14
"1397","SP2",2023-11-04,"Valladolid","Tenerife",2,0,"H",0,0,"D",1.99,3.27,4.53,"0-0","2-0",16,6,6,1,1,3,0,0,9,4,10,13,2,13,23,"9-4","Y","N","N",4,0,14
"1398","SP2",2023-11-04,"Albacete","Elche",1,1,"D",0,0,"D",2.28,3.38,3.4,"0-0","1-1",14,5,5,3,4,6,0,1,6,3,17,17,2,9,34,"6-3","Y","N","N",10,1,14
"1399","SP2",2023-11-05,"Ferrol","Andorra",1,0,"H",1,0,"H",2.37,3.2,3.42,"1-0","1-0",11,4,12,5,4,3,0,0,3,3,19,18,1,6,37,"3-3","N","N","N",7,0,14
"1400","SP2",2023-11-05,"Amorebieta","Huesca",0,1,"A",0,0,"D",2.59,2.94,3.32,"0-0","0-1",7,0,8,3,3,2,1,0,2,4,13,12,1,6,25,"2-4","N","N","N",5,1,14
"1401","SP2",2023-11-05,"Alcorcon","Santander",3,1,"H",1,0,"H",2.27,3.35,3.45,"1-0","3-1",17,6,10,3,3,1,0,0,3,3,18,7,4,6,25,"3-3","Y","Y","Y",4,0,14
"1402","SP2",2023-11-05,"Cartagena","Leganes",0,3,"A",0,0,"D",2.72,3.25,2.84,"0-0","0-3",11,1,8,5,1,2,0,0,3,5,15,10,3,8,25,"3-5","Y","Y","N",3,0,14
"1403","SP2",2023-11-05,"Eldense","Burgos",2,0,"H",1,0,"H",2.42,2.97,3.6,"1-0","2-0",15,5,9,2,2,2,0,0,7,7,11,8,2,14,19,"7-7","Y","N","N",4,0,14
"1404","SP2",2023-11-06,"Zaragoza","Oviedo",0,0,"D",0,0,"D",2.52,2.92,3.4,"0-0","0-0",19,5,13,2,1,1,0,0,7,4,17,13,0,11,30,"7-4","N","N","N",2,0,14
"1405","SP2",2023-11-10,"Leganes","Levante",2,1,"H",0,1,"A",2.01,3.24,4.47,"0-1","2-1",10,5,9,3,2,1,0,0,8,7,20,8,3,15,28,"8-7","Y","Y","N",3,0,15
"1406","SP2",2023-11-11,"Santander","Valladolid",2,3,"A",0,1,"A",2.63,3.28,2.92,"0-1","2-3",14,6,19,9,0,2,0,0,3,3,13,11,5,6,24,"3-3","Y","Y","Y",2,0,15
"1407","SP2",2023-11-11,"Elche","Zaragoza",2,0,"H",0,0,"D",1.96,3.4,4.44,"0-0","2-0",13,4,8,3,4,2,0,0,7,5,18,12,2,12,30,"7-5","Y","N","N",6,0,15
"1408","SP2",2023-11-11,"Mirandes","Ferrol",1,2,"A",0,2,"A",2.53,3.04,3.3,"0-2","1-2",17,7,10,3,1,1,0,0,6,2,4,12,3,8,16,"6-2","Y","Y","N",2,0,15
"1409","SP2",2023-11-11,"Sp Gijon","Amorebieta",1,1,"D",0,0,"D",1.42,4.6,9.06,"0-0","1-1",16,8,10,4,1,5,0,0,4,3,12,8,2,7,20,"4-3","Y","N","N",6,0,15
"1410","SP2",2023-11-12,"Burgos","Alcorcon",4,2,"H",0,2,"A",2.14,3.16,4.1,"0-2","4-2",15,7,9,3,1,0,0,0,5,2,14,7,6,7,21,"5-2","Y","Y","Y",1,0,15
"1411","SP2",2023-11-12,"Andorra","Eldense",1,3,"A",1,1,"D",1.87,3.59,4.64,"1-1","1-3",23,6,9,5,2,3,0,0,8,1,9,12,4,9,21,"8-1","Y","Y","Y",5,0,15
"1412","SP2",2023-11-12,"Huesca","Espanol",1,1,"D",0,0,"D",3.88,3.21,2.18,"0-0","1-1",19,5,6,1,2,4,0,0,7,1,8,18,2,8,26,"7-1","Y","N","N",6,0,15
"1413","SP2",2023-11-12,"Tenerife","Villarreal B",0,1,"A",0,1,"A",1.63,3.96,5.93,"0-1","0-1",20,5,13,6,3,5,0,1,8,4,15,14,1,12,29,"8-4","N","N","N",8,1,15
"1414","SP2",2023-11-12,"Eibar","Albacete",1,1,"D",1,0,"H",1.89,3.36,4.92,"1-0","1-1",12,6,16,6,1,1,0,0,3,7,15,15,2,10,30,"3-7","Y","N","N",2,0,15
"1415","SP2",2023-11-13,"Oviedo","Cartagena",1,1,"D",0,1,"A",1.78,3.39,5.56,"0-1","1-1",18,3,2,1,4,8,0,0,4,2,11,15,2,6,26,"4-2","Y","N","N",12,0,15
"1416","SP2",2023-11-17,"Valladolid","Leganes",1,1,"D",1,0,"H",2.25,2.95,4.09,"1-0","1-1",21,3,11,3,1,3,0,0,3,6,13,12,2,9,25,"3-6","Y","N","N",4,0,16
"1417","SP2",2023-11-18,"Alcorcon","Sp Gijon",0,0,"D",0,0,"D",3.33,3.17,2.43,"0-0","0-0",15,2,16,2,2,2,0,0,5,7,14,10,0,12,24,"5-7","N","N","N",4,0,16
"1418","SP2",2023-11-18,"Amorebieta","Tenerife",2,0,"H",1,0,"H",3.75,3.15,2.25,"1-0","2-0",5,3,23,6,1,4,1,1,3,14,8,9,2,17,17,"3-14","Y","N","N",5,2,16
"1419","SP2",2023-11-18,"Zaragoza","Huesca",0,2,"A",0,1,"A",2.06,3.01,4.71,"0-1","0-2",11,3,7,3,2,3,0,0,9,4,16,21,2,13,37,"9-4","Y","N","N",5,0,16
"1420","SP2",2023-11-18,"Espanol","Elche",2,0,"H",2,0,"H",2.12,3.44,3.76,"2-0","2-0",12,5,15,3,3,2,0,0,8,5,25,11,2,13,36,"8-5","Y","N","N",5,0,16
"1421","SP2",2023-11-19,"Ferrol","Burgos",1,1,"D",0,0,"D",2.13,3.09,3.79,"0-0","1-1",13,5,9,2,1,5,0,0,3,4,13,11,2,7,24,"3-4","Y","N","N",6,0,16
"1422","SP2",2023-11-19,"Eldense","Mirandes",2,2,"D",1,1,"D",2.2,3.19,3.48,"1-1","2-2",20,6,7,3,1,1,0,0,7,1,21,14,4,8,35,"7-1","Y","Y","Y",2,0,16
"1423","SP2",2023-11-19,"Oviedo","Eibar",2,1,"H",0,1,"A",3.17,2.84,2.58,"0-1","2-1",9,3,7,2,4,3,0,0,4,4,11,15,3,8,26,"4-4","Y","Y","N",7,0,16
"1424","SP2",2023-11-19,"Cartagena","Albacete",1,1,"D",1,0,"H",2.82,3.19,2.59,"1-0","1-1",9,2,18,2,1,2,0,0,2,9,9,20,2,11,29,"2-9","Y","N","N",3,0,16
"1425","SP2",2023-11-19,"Villarreal B","Andorra",0,0,"D",0,0,"D",2.54,3.46,2.9,"0-0","0-0",12,2,15,5,2,1,0,0,2,7,12,7,0,9,19,"2-7","N","N","N",3,0,16
"1426","SP2",2023-11-20,"Levante","Santander",2,4,"A",2,1,"H",2.02,3.36,3.71,"2-1","2-4",26,5,9,5,2,1,0,0,8,5,15,11,6,13,26,"8-5","Y","Y","Y",3,0,16
"1427","SP2",2023-11-24,"Huesca","Valladolid",0,1,"A",0,0,"D",3.34,2.93,2.59,"0-0","0-1",10,2,11,5,4,4,0,0,3,4,12,15,1,7,27,"3-4","N","N","N",8,0,17
"1428","SP2",2023-11-25,"Burgos","Andorra",0,0,"D",0,0,"D",2.21,3.29,3.68,"0-0","0-0",11,2,7,1,1,1,0,0,3,3,7,13,0,6,20,"3-3","N","N","N",2,0,17
"1429","SP2",2023-11-25,"Santander","Villarreal B",2,0,"H",1,0,"H",1.75,4.03,4.77,"1-0","2-0",10,4,7,0,3,4,0,0,4,3,17,20,2,7,37,"4-3","Y","N","N",7,0,17
"1430","SP2",2023-11-25,"Albacete","Zaragoza",1,0,"H",0,0,"D",1.92,3.41,4.68,"0-0","1-0",18,5,5,2,2,2,0,0,4,5,19,5,1,9,24,"4-5","N","N","N",4,0,17
"1431","SP2",2023-11-25,"Eibar","Levante",3,1,"H",1,1,"D",1.72,3.81,5.23,"1-1","3-1",20,7,12,7,3,1,0,0,10,3,12,12,4,13,24,"10-3","Y","Y","Y",4,0,17
"1432","SP2",2023-11-26,"Leganes","Ferrol",2,2,"D",2,2,"D",1.99,3.21,4.67,"2-2","2-2",22,5,3,3,1,2,0,1,5,2,13,4,4,7,17,"5-2","Y","Y","Y",3,1,17
"1433","SP2",2023-11-26,"Elche","Amorebieta",2,0,"H",0,0,"D",1.43,4.47,9.03,"0-0","2-0",11,4,11,4,2,2,0,0,4,9,11,18,2,13,29,"4-9","Y","N","N",4,0,17
"1434","SP2",2023-11-26,"Mirandes","Oviedo",2,1,"H",1,0,"H",3.33,2.98,2.55,"1-0","2-1",10,6,8,2,3,3,0,0,5,2,7,15,3,7,22,"5-2","Y","Y","N",6,0,17
"1435","SP2",2023-11-26,"Tenerife","Cartagena",1,1,"D",0,1,"A",1.88,3.32,5.04,"0-1","1-1",15,5,7,3,3,4,0,0,6,1,14,12,2,7,26,"6-1","Y","N","N",7,0,17
"1436","SP2",2023-11-26,"Espanol","Alcorcon",2,0,"H",1,0,"H",1.48,4.55,7.34,"1-0","2-0",24,9,6,2,2,2,0,1,8,2,16,11,2,10,27,"8-2","Y","N","N",4,1,17
"1437","SP2",2023-11-27,"Sp Gijon","Eldense",2,0,"H",1,0,"H",1.67,3.82,5.73,"1-0","2-0",17,7,13,3,1,2,0,0,5,2,13,16,2,7,29,"5-2","Y","N","N",3,0,17
"1438","SP2",2023-12-01,"Oviedo","Espanol",2,0,"H",1,0,"H",2.83,2.84,3.11,"1-0","2-0",16,5,7,2,5,3,0,0,7,4,16,24,2,11,40,"7-4","Y","N","N",8,0,18
"1439","SP2",2023-12-02,"Cartagena","Sp Gijon",1,0,"H",0,0,"D",3.19,3.09,2.39,"0-0","1-0",19,10,6,1,1,3,0,0,6,3,11,11,1,9,22,"6-3","N","N","N",4,0,18
"1440","SP2",2023-12-02,"Eldense","Tenerife",0,3,"A",0,1,"A",2.51,2.95,3.15,"0-1","0-3",13,1,4,3,1,1,0,0,9,1,14,14,3,10,28,"9-1","Y","Y","N",2,0,18
"1441","SP2",2023-12-02,"Zaragoza","Leganes",1,0,"H",1,0,"H",2.72,2.86,2.98,"1-0","1-0",10,2,5,0,2,1,0,0,4,4,17,11,1,8,28,"4-4","N","N","N",3,0,18
"1442","SP2",2023-12-02,"Levante","Valladolid",2,1,"H",2,1,"H",2.59,3.19,3.05,"2-1","2-1",19,7,11,3,4,3,0,0,12,6,16,13,3,18,29,"12-6","Y","Y","N",7,0,18
"1443","SP2",2023-12-03,"Andorra","Huesca",1,0,"H",0,0,"D",2.16,3.07,4.17,"0-0","1-0",8,4,8,1,2,2,0,0,6,3,11,12,1,9,23,"6-3","N","N","N",4,0,18
"1444","SP2",2023-12-03,"Alcorcon","Elche",0,2,"A",0,1,"A",3.21,3.1,2.54,"0-1","0-2",10,2,22,9,3,1,1,0,4,4,12,11,2,8,23,"4-4","Y","N","N",4,1,18
"1445","SP2",2023-12-03,"Ferrol","Albacete",5,4,"H",1,1,"D",2.51,2.94,3.17,"1-1","5-4",17,6,18,7,2,3,0,1,2,5,12,16,9,7,28,"2-5","Y","Y","Y",5,1,18
"1446","SP2",2023-12-03,"Mirandes","Santander",0,0,"D",0,0,"D",2.53,3.33,3.02,"0-0","0-0",13,5,12,3,4,4,0,0,9,10,14,17,0,19,31,"9-10","N","N","N",8,0,18
"1447","SP2",2023-12-03,"Amorebieta","Burgos",0,1,"A",0,1,"A",2.73,2.96,2.86,"0-1","0-1",14,3,6,4,2,0,0,0,7,6,10,7,1,13,17,"7-6","N","N","N",2,0,18
"1448","SP2",2023-12-04,"Villarreal B","Eibar",1,0,"H",0,0,"D",3.86,3.69,1.98,"0-0","1-0",26,8,6,0,1,0,0,1,9,0,10,6,1,9,16,"9-0","N","N","N",1,1,18
"2650","T1",2023-08-11,"Trabzonspor","Antalyaspor",1,0,"H",1,0,"H",1.92,3.81,4.06,"1-0","1-0",13,5,11,2,0,1,0,0,6,9,18,11,1,15,29,"6-9","N","N","N",1,0,1
"2651","T1",2023-08-12,"Kasimpasa","Ankaragucu",3,2,"H",1,0,"H",2.36,3.73,2.98,"1-0","3-2",15,5,9,3,1,0,0,0,3,5,8,15,5,8,23,"3-5","Y","Y","Y",1,0,1
"2652","T1",2023-08-12,"Konyaspor","Istanbulspor",1,1,"D",0,1,"A",1.8,3.93,4.55,"0-1","1-1",15,2,4,2,3,5,1,2,10,2,13,10,2,12,23,"10-2","Y","N","N",8,3,1
"2653","T1",2023-08-12,"Kayserispor","Galatasaray",0,0,"D",0,0,"D",5.15,4.41,1.64,"0-0","0-0",12,3,17,3,2,2,0,0,3,9,11,6,0,12,17,"3-9","N","N","N",4,0,1
"2654","T1",2023-08-12,"Pendikspor","Hatayspor",1,5,"A",0,2,"A",2.27,3.48,3.33,"0-2","1-5",6,4,15,9,0,1,0,0,4,2,10,18,6,6,28,"4-2","Y","Y","Y",1,0,1
"2655","T1",2023-08-13,"Sivasspor","Samsunspor",1,1,"D",1,0,"H",2.33,3.6,3.12,"1-0","1-1",6,2,11,3,2,1,0,0,4,5,11,11,2,9,22,"4-5","Y","N","N",3,0,1
"2656","T1",2023-08-13,"Ad. Demirspor","Rizespor",2,1,"H",1,0,"H",1.6,4.61,5.34,"1-0","2-1",9,6,13,4,6,6,0,0,4,5,15,14,3,9,29,"4-5","Y","Y","N",12,0,1
"2657","T1",2023-08-13,"Fenerbahce","Gaziantep",2,1,"H",2,1,"H",1.33,6.04,8.69,"2-1","2-1",21,5,4,1,0,6,0,1,3,1,13,12,3,4,25,"3-1","Y","Y","N",6,1,1
"2658","T1",2023-08-14,"Alanyaspor","Buyuksehyr",2,0,"H",1,0,"H",2.83,3.58,2.49,"1-0","2-0",11,4,8,3,5,4,0,1,4,5,15,14,2,9,29,"4-5","Y","N","N",9,1,1
"2659","T1",2023-08-14,"Karagumruk","Besiktas",0,1,"A",0,0,"D",4.53,4.58,1.67,"0-0","0-1",2,0,9,6,4,1,0,0,4,4,13,14,1,8,27,"4-4","N","N","N",5,0,1
"2660","T1",2023-08-18,"Antalyaspor","Konyaspor",1,1,"D",0,0,"D",2.3,3.61,3.16,"0-0","1-1",14,3,7,3,2,2,0,0,5,5,14,12,2,10,26,"5-5","Y","N","N",4,0,2
"2661","T1",2023-08-18,"Istanbulspor","Kayserispor",1,1,"D",0,0,"D",2.67,3.55,2.69,"0-0","1-1",7,3,9,4,1,0,0,0,4,6,11,11,2,10,22,"4-6","Y","N","N",1,0,2
"2662","T1",2023-08-19,"Rizespor","Alanyaspor",0,0,"D",0,0,"D",2.48,3.61,2.86,"0-0","0-0",10,3,8,2,3,3,0,1,3,3,12,13,0,6,25,"3-3","N","N","N",6,1,2
"2663","T1",2023-08-19,"Galatasaray","Trabzonspor",2,0,"H",1,0,"H",1.64,4.55,4.98,"1-0","2-0",15,5,5,1,4,3,0,0,7,1,21,3,2,8,24,"7-1","Y","N","N",7,0,2
"2664","T1",2023-08-19,"Hatayspor","Kasimpasa",0,0,"D",0,0,"D",2.49,3.6,2.87,"0-0","0-0",8,2,11,2,0,0,0,0,3,1,7,6,0,4,13,"3-1","N","N","N",0,0,2
"2665","T1",2023-08-20,"Buyuksehyr","Karagumruk",0,2,"A",0,2,"A",1.68,4.31,4.95,"0-2","0-2",15,5,9,2,3,4,0,0,5,4,11,14,2,9,25,"5-4","Y","N","N",7,0,2
"2666","T1",2023-08-20,"Besiktas","Pendikspor",1,1,"D",1,0,"H",1.24,6.75,11.71,"1-0","1-1",15,6,11,1,4,2,0,0,6,4,11,9,2,10,20,"6-4","Y","N","N",6,0,2
"2667","T1",2023-08-20,"Gaziantep","Sivasspor",1,3,"A",0,2,"A",2.71,3.73,2.56,"0-2","1-3",11,2,13,7,6,4,0,0,7,4,19,16,4,11,35,"7-4","Y","Y","Y",10,0,2
"2668","T1",2023-08-21,"Ankaragucu","Ad. Demirspor",1,1,"D",1,1,"D",2.72,3.63,2.56,"1-1","1-1",18,5,12,4,1,1,0,0,3,4,9,10,2,7,19,"3-4","Y","N","N",2,0,2
"2669","T1",2023-08-21,"Samsunspor","Fenerbahce",0,2,"A",0,0,"D",5.53,4.5,1.57,"0-0","0-2",5,1,13,6,1,1,0,0,2,5,11,10,2,7,21,"2-5","Y","N","N",2,0,2
"2670","T1",2023-08-25,"Konyaspor","Gaziantep",2,0,"H",0,0,"D",1.8,4.01,4.46,"0-0","2-0",17,8,8,3,1,2,0,0,10,2,9,8,2,12,17,"10-2","Y","N","N",3,0,3
"2671","T1",2023-08-26,"Kasimpasa","Pendikspor",1,1,"D",0,1,"A",1.79,3.85,4.71,"0-1","1-1",7,3,16,6,3,2,0,1,9,2,10,19,2,11,29,"9-2","Y","N","N",5,1,3
"2672","T1",2023-08-26,"Trabzonspor","Rizespor",2,3,"A",0,2,"A",1.51,4.72,6.34,"0-2","2-3",20,7,12,7,1,2,0,0,9,2,10,17,5,11,27,"9-2","Y","Y","Y",3,0,3
"2673","T1",2023-08-26,"Sivasspor","Antalyaspor",1,1,"D",1,1,"D",2.36,3.31,3.31,"1-1","1-1",6,2,8,4,3,3,0,0,3,4,11,15,2,7,26,"3-4","Y","N","N",6,0,3
"2674","T1",2023-08-27,"Karagumruk","Ankaragucu",1,1,"D",1,0,"H",2.38,3.47,3.13,"1-0","1-1",6,2,7,5,1,1,0,0,3,5,15,12,2,8,27,"3-5","Y","N","N",2,0,3
"2675","T1",2023-08-27,"Kayserispor","Samsunspor",2,1,"H",2,1,"H",2.53,3.53,2.87,"2-1","2-1",11,4,6,1,0,0,0,0,3,2,7,8,3,5,15,"3-2","Y","Y","N",0,0,3
"2676","T1",2023-08-27,"Alanyaspor","Hatayspor",0,0,"D",0,0,"D",1.99,3.84,3.77,"0-0","0-0",15,5,5,0,4,3,0,0,9,1,9,17,0,10,26,"9-1","N","N","N",7,0,3
"2677","T1",2023-09-01,"Kasimpasa","Trabzonspor",1,5,"A",0,3,"A",3.03,3.6,2.38,"0-3","1-5",19,6,7,6,3,3,0,0,9,3,10,16,6,12,26,"9-3","Y","Y","Y",6,0,3
"2678","T1",2023-09-01,"Rizespor","Karagumruk",1,0,"H",1,0,"H",1.76,4.1,3.34,"1-0","1-0",13,4,17,3,3,2,0,0,1,6,12,17,1,7,29,"1-6","N","N","N",5,0,3
"2679","T1",2023-09-02,"Buyuksehyr","Konyaspor",0,1,"A",0,0,"D",2.4,3.53,3.05,"0-0","0-1",11,2,13,5,4,2,1,0,2,4,13,13,1,6,26,"2-4","N","N","N",6,1,3
"2680","T1",2023-09-02,"Pendikspor","Alanyaspor",1,1,"D",0,0,"D",2.38,3.63,3.02,"0-0","1-1",10,3,8,4,2,2,0,0,8,4,9,14,2,12,23,"8-4","Y","N","N",4,0,4
"2681","T1",2023-09-02,"Antalyaspor","Kayserispor",1,1,"D",1,1,"D",1.94,3.87,3.91,"1-1","1-1",20,7,7,3,2,3,0,0,9,3,14,11,2,12,25,"9-3","Y","N","N",5,0,4
"2682","T1",2023-09-02,"Gaziantep","Galatasaray",0,3,"A",0,1,"A",7.45,5.13,1.42,"0-1","0-3",15,7,15,4,2,0,0,0,4,7,12,13,3,11,25,"4-7","Y","Y","N",2,0,4
"2683","T1",2023-09-03,"Besiktas","Sivasspor",2,0,"H",2,0,"H",1.45,4.72,7.56,"2-0","2-0",17,8,5,1,2,4,0,0,7,2,17,17,2,9,34,"7-2","Y","N","N",6,0,4
"2684","T1",2023-09-03,"Ankaragucu","Fenerbahce",0,1,"A",0,0,"D",5.03,4.08,1.7,"0-0","0-1",14,2,14,2,2,3,0,1,4,2,15,14,1,6,29,"4-2","N","N","N",5,1,4
"2685","T1",2023-09-03,"Hatayspor","Ad. Demirspor",3,3,"D",0,1,"A",3.45,3.62,2.16,"0-1","3-3",14,7,11,6,6,2,0,0,3,7,19,9,6,10,28,"3-7","Y","Y","Y",8,0,4
"2686","T1",2023-09-16,"Kayserispor","Gaziantep",2,0,"H",1,0,"H",1.89,3.79,4.21,"1-0","2-0",10,4,16,5,0,1,0,0,3,7,11,8,2,10,19,"3-7","Y","N","N",1,0,4
"2687","T1",2023-09-16,"Konyaspor","Rizespor",1,2,"A",1,0,"H",1.99,3.69,3.92,"1-0","1-2",6,4,11,2,2,1,0,0,2,4,12,14,3,6,26,"2-4","Y","Y","N",3,0,4
"2688","T1",2023-09-16,"Ad. Demirspor","Pendikspor",3,0,"H",2,0,"H",1.52,4.93,5.92,"2-0","3-0",18,7,15,5,0,3,0,0,6,6,8,6,3,12,14,"6-6","Y","Y","N",3,0,4
"2689","T1",2023-09-16,"Galatasaray","Samsunspor",4,2,"H",3,0,"H",1.34,5.78,8.87,"3-0","4-2",9,5,9,4,1,3,0,0,2,6,17,15,6,8,32,"2-6","Y","Y","Y",4,0,4
"2690","T1",2023-09-17,"Fenerbahce","Antalyaspor",3,2,"H",1,1,"D",1.4,5.41,7.66,"1-1","3-2",17,10,14,6,3,4,0,0,7,5,13,11,5,12,24,"7-5","Y","Y","Y",7,0,5
"2691","T1",2023-09-17,"Istanbulspor","Buyuksehyr",0,2,"A",0,0,"D",3.34,3.48,2.27,"0-0","0-2",5,0,20,8,4,0,0,0,0,7,15,9,2,7,24,"0-7","Y","N","N",4,0,5
"2692","T1",2023-09-17,"Alanyaspor","Kasimpasa",3,3,"D",2,1,"H",2.09,3.67,3.56,"2-1","3-3",13,6,17,3,0,0,0,0,5,7,9,11,6,12,20,"5-7","Y","Y","Y",0,0,5
"2693","T1",2023-09-17,"Trabzonspor","Besiktas",3,0,"H",2,0,"H",3.12,3.47,2.39,"2-0","3-0",8,5,7,1,4,1,0,0,2,7,15,11,3,9,26,"2-7","Y","Y","N",5,0,5
"2694","T1",2023-09-18,"Karagumruk","Hatayspor",0,0,"D",0,0,"D",1.99,3.63,3.89,"0-0","0-0",5,2,18,5,3,2,0,0,3,3,14,9,0,6,23,"3-3","N","N","N",5,0,5
"2695","T1",2023-09-18,"Sivasspor","Ankaragucu",1,3,"A",1,1,"D",2.42,3.4,3.08,"1-1","1-3",15,9,15,5,3,2,1,0,5,3,7,12,4,8,19,"5-3","Y","Y","Y",5,1,5
"2696","T1",2023-09-22,"Gaziantep","Istanbulspor",2,0,"H",0,0,"D",1.88,3.91,4.12,"0-0","2-0",13,2,5,0,1,5,0,0,8,4,11,13,2,12,24,"8-4","Y","N","N",6,0,5
"2697","T1",2023-09-23,"Pendikspor","Karagumruk",1,1,"D",1,0,"H",2.56,3.44,2.89,"1-0","1-1",8,4,10,4,0,1,0,0,5,4,13,10,2,9,23,"5-4","Y","N","N",1,0,5
"2698","T1",2023-09-23,"Rizespor","Sivasspor",1,1,"D",1,1,"D",2.29,3.39,3.37,"1-1","1-1",14,4,14,4,7,3,0,0,5,4,12,17,2,9,29,"5-4","Y","N","N",10,0,5
"2699","T1",2023-09-23,"Antalyaspor","Samsunspor",2,0,"H",2,0,"H",2.12,3.75,3.46,"2-0","2-0",7,3,9,1,2,1,0,0,1,4,22,11,2,5,33,"1-4","Y","N","N",3,0,5
"2700","T1",2023-09-23,"Buyuksehyr","Galatasaray",1,2,"A",0,1,"A",4.44,3.86,1.83,"0-1","1-2",6,2,17,4,3,2,0,0,2,4,18,15,3,6,33,"2-4","Y","Y","N",5,0,6
"2701","T1",2023-09-24,"Ankaragucu","Konyaspor",1,1,"D",1,1,"D",2.4,3.58,3.01,"1-1","1-1",15,1,7,1,1,1,0,0,4,2,15,8,2,6,23,"4-2","Y","N","N",2,0,6
"2702","T1",2023-09-24,"Besiktas","Kayserispor",2,1,"H",0,0,"D",1.4,5.2,8.13,"0-0","2-1",23,10,5,1,1,0,0,0,7,2,13,10,3,9,23,"7-2","Y","Y","N",1,0,6
"2703","T1",2023-09-24,"Alanyaspor","Fenerbahce",0,1,"A",0,1,"A",5.11,4.35,1.65,"0-1","0-1",2,1,14,7,2,6,0,0,4,5,15,14,1,9,29,"4-5","N","N","N",8,0,6
"2704","T1",2023-09-24,"Kasimpasa","Ad. Demirspor",2,1,"H",1,0,"H",3.2,3.83,2.2,"1-0","2-1",13,7,19,6,4,2,0,3,6,11,21,7,3,17,28,"6-11","Y","Y","N",6,3,6
"2705","T1",2023-09-25,"Hatayspor","Trabzonspor",3,2,"H",0,1,"A",3.05,3.68,2.3,"0-1","3-2",9,3,6,3,6,2,0,0,9,1,22,13,5,10,35,"9-1","Y","Y","Y",8,0,6
"2706","T1",2023-09-26,"Istanbulspor","Galatasaray",0,1,"A",0,1,"A",9.13,5.73,1.34,"0-1","0-1",4,3,17,7,1,2,0,0,3,4,12,16,1,7,28,"3-4","N","N","N",3,0,6
"2707","T1",2023-09-27,"Ad. Demirspor","Besiktas",4,2,"H",2,0,"H",3.37,3.93,2.09,"2-0","4-2",14,7,16,5,2,1,0,0,1,5,16,15,6,6,31,"1-5","Y","Y","Y",3,0,6
"2708","T1",2023-09-28,"Fenerbahce","Buyuksehyr",4,0,"H",3,0,"H",1.44,5.07,7.13,"3-0","4-0",16,8,6,0,4,1,0,0,14,2,22,9,4,16,31,"14-2","Y","Y","Y",5,0,6
"2709","T1",2023-09-29,"Samsunspor","Gaziantep",1,2,"A",0,2,"A",1.93,3.76,4.11,"0-2","1-2",18,2,4,3,2,3,0,0,9,2,13,12,3,11,25,"9-2","Y","Y","N",5,0,6
"2710","T1",2023-09-30,"Sivasspor","Hatayspor",0,0,"D",0,0,"D",2.08,3.57,3.74,"0-0","0-0",12,4,4,1,3,3,0,0,6,7,9,20,0,13,29,"6-7","N","N","N",6,0,7
"2711","T1",2023-09-30,"Istanbulspor","Antalyaspor",1,2,"A",1,0,"H",3.23,3.77,2.21,"1-0","1-2",4,3,17,5,2,3,0,0,4,8,8,17,3,12,25,"4-8","Y","Y","N",5,0,7
"2712","T1",2023-09-30,"Trabzonspor","Pendikspor",2,1,"H",2,1,"H",1.55,4.62,5.91,"2-1","2-1",11,3,9,4,2,1,1,0,4,2,19,8,3,6,27,"4-2","Y","Y","N",3,1,7
"2713","T1",2023-09-30,"Galatasaray","Ankaragucu",2,1,"H",0,0,"D",1.31,6.12,9.34,"0-0","2-1",34,13,7,2,0,3,0,0,12,3,11,10,3,15,21,"12-3","Y","Y","N",3,0,7
"2714","T1",2023-10-01,"Karagumruk","Kasimpasa",2,3,"A",1,3,"A",2.34,3.63,3.08,"1-3","2-3",13,4,4,3,3,3,0,0,8,0,9,14,5,8,23,"8-0","Y","Y","Y",6,0,7
"2715","T1",2023-10-01,"Fenerbahce","Rizespor",5,0,"H",1,0,"H",1.34,5.83,8.54,"1-0","5-0",23,11,5,1,1,3,0,0,8,2,10,15,5,10,25,"8-2","Y","Y","Y",4,0,7
"2716","T1",2023-10-01,"Ad. Demirspor","Alanyaspor",4,0,"H",1,0,"H",1.74,4.3,4.43,"1-0","4-0",15,7,9,1,2,3,0,0,7,3,11,14,4,10,25,"7-3","Y","Y","Y",5,0,7
"2717","T1",2023-10-01,"Konyaspor","Besiktas",0,2,"A",0,1,"A",3.51,3.7,2.11,"0-1","0-2",5,3,6,1,2,3,1,0,2,6,13,20,2,8,33,"2-6","Y","N","N",5,1,7
"2718","T1",2023-10-02,"Kayserispor","Buyuksehyr",0,0,"D",0,0,"D",2.6,3.39,2.83,"0-0","0-0",14,1,8,4,2,2,0,0,10,5,6,15,0,15,21,"10-5","N","N","N",4,0,7
"2719","T1",2023-10-06,"Ad. Demirspor","Trabzonspor",1,0,"H",1,0,"H",2.06,3.94,3.46,"1-0","1-0",13,8,18,3,5,3,0,0,3,3,17,9,1,6,26,"3-3","N","N","N",8,0,7
"2720","T1",2023-10-06,"Alanyaspor","Karagumruk",2,1,"H",1,0,"H",2.31,3.37,3.35,"1-0","2-1",6,3,10,4,4,1,0,0,3,6,16,16,3,9,32,"3-6","Y","Y","N",5,0,8
"2721","T1",2023-10-07,"Pendikspor","Sivasspor",2,3,"A",0,1,"A",2.74,3.47,2.67,"0-1","2-3",15,6,15,7,5,2,0,0,9,4,14,13,5,13,27,"9-4","Y","Y","Y",7,0,8
"2722","T1",2023-10-07,"Ankaragucu","Kayserispor",3,0,"H",0,0,"D",2.15,3.67,3.44,"0-0","3-0",12,8,4,1,0,0,0,0,1,3,1,10,3,4,11,"1-3","Y","Y","N",0,0,8
"2723","T1",2023-10-07,"Antalyaspor","Galatasaray",0,2,"A",0,0,"D",4.94,4.21,1.69,"0-0","0-2",12,4,11,7,1,3,0,0,3,7,15,21,2,10,36,"3-7","Y","N","N",4,0,8
"2724","T1",2023-10-07,"Buyuksehyr","Gaziantep",2,0,"H",2,0,"H",1.88,3.71,4.42,"2-0","2-0",8,3,12,1,0,0,0,0,5,7,12,10,2,12,22,"5-7","Y","N","N",0,0,8
"2725","T1",2023-10-08,"Rizespor","Samsunspor",1,0,"H",0,0,"D",2.17,3.68,3.34,"0-0","1-0",8,4,12,3,3,3,1,0,4,8,9,15,1,12,24,"4-8","N","N","N",6,1,8
"2726","T1",2023-10-08,"Besiktas","Istanbulspor",2,0,"H",1,0,"H",1.24,6.6,12.33,"1-0","2-0",17,5,4,2,2,2,0,0,4,4,12,10,2,8,22,"4-4","Y","N","N",4,0,8
"2727","T1",2023-10-08,"Hatayspor","Konyaspor",3,1,"H",1,1,"D",2.77,3.17,2.85,"1-1","3-1",10,5,8,5,2,0,0,0,3,2,19,10,4,5,29,"3-2","Y","Y","Y",2,0,8
"2728","T1",2023-10-08,"Kasimpasa","Fenerbahce",0,2,"A",0,2,"A",6.76,5.01,1.46,"0-2","0-2",6,1,20,7,5,0,0,0,1,8,13,12,2,9,25,"1-8","Y","N","N",5,0,8
"2729","T1",2023-10-21,"Kayserispor","Rizespor",3,1,"H",1,0,"H",2.28,3.33,3.17,"1-0","3-1",20,7,12,3,5,2,0,0,5,2,13,12,4,7,25,"5-2","Y","Y","Y",7,0,8
"2730","T1",2023-10-21,"Gaziantep","Antalyaspor",1,0,"H",0,0,"D",2.84,3.23,2.74,"0-0","1-0",10,2,8,2,1,2,0,0,6,4,16,14,1,10,30,"6-4","N","N","N",3,0,9
"2731","T1",2023-10-21,"Konyaspor","Pendikspor",1,2,"A",0,0,"D",1.78,3.82,4.82,"0-0","1-2",16,8,8,3,1,3,0,0,5,2,4,12,3,7,16,"5-2","Y","Y","N",4,0,9
"2732","T1",2023-10-21,"Galatasaray","Besiktas",2,1,"H",1,0,"H",1.64,4.44,5.11,"1-0","2-1",25,10,2,2,3,5,0,1,6,2,12,19,3,8,31,"6-2","Y","Y","N",8,1,9
"2733","T1",2023-10-22,"Sivasspor","Kasimpasa",0,1,"A",0,0,"D",2.28,3.57,3.24,"0-0","0-1",17,8,17,6,0,2,0,0,7,8,10,9,1,15,19,"7-8","N","N","N",2,0,9
"2734","T1",2023-10-22,"Istanbulspor","Ankaragucu",2,1,"H",1,1,"D",3.32,3.59,2.22,"1-1","2-1",7,3,9,1,0,3,0,0,2,5,14,14,3,7,28,"2-5","Y","Y","N",3,0,9
"2735","T1",2023-10-22,"Fenerbahce","Hatayspor",4,2,"H",3,0,"H",1.22,7.29,12.61,"3-0","4-2",17,6,8,5,1,4,0,0,7,5,10,14,6,12,24,"7-5","Y","Y","Y",5,0,9
"2736","T1",2023-10-22,"Samsunspor","Buyuksehyr",0,0,"D",0,0,"D",2.48,3.44,2.99,"0-0","0-0",20,5,7,0,2,2,0,0,8,0,17,8,0,8,25,"8-0","N","N","N",4,0,9
"2737","T1",2023-10-23,"Karagumruk","Ad. Demirspor",2,0,"H",0,0,"D",3.49,3.88,2.04,"0-0","2-0",10,6,11,5,0,1,0,0,5,4,18,8,2,9,26,"5-4","Y","N","N",1,0,9
"2738","T1",2023-10-23,"Trabzonspor","Alanyaspor",1,0,"H",0,0,"D",1.65,4.24,5.08,"0-0","1-0",14,3,15,3,1,2,0,0,7,5,15,4,1,12,19,"7-5","N","N","N",3,0,9
"2739","T1",2023-10-27,"Hatayspor","Kayserispor",1,2,"A",0,1,"A",2.29,3.46,3.3,"0-1","1-2",18,9,8,2,5,0,0,0,12,1,10,15,3,13,25,"12-1","Y","Y","N",5,0,9
"2740","T1",2023-10-27,"Kasimpasa","Istanbulspor",3,1,"H",1,0,"H",1.81,4.08,4.29,"1-0","3-1",19,11,17,6,2,2,0,0,8,5,13,11,4,13,24,"8-5","Y","Y","Y",4,0,10
"2741","T1",2023-10-28,"Alanyaspor","Sivasspor",1,2,"A",0,0,"D",2.17,3.63,3.43,"0-0","1-2",12,5,15,4,3,1,0,0,7,2,13,12,3,9,25,"7-2","Y","Y","N",4,0,10
"2742","T1",2023-10-28,"Ad. Demirspor","Konyaspor",3,0,"H",0,0,"D",1.7,4.34,4.69,"0-0","3-0",15,5,13,4,1,1,0,0,4,5,12,10,3,9,22,"4-5","Y","Y","N",2,0,10
"2743","T1",2023-10-28,"Rizespor","Galatasaray",0,1,"A",0,0,"D",5.88,4.68,1.54,"0-0","0-1",11,3,20,5,2,2,0,0,6,5,14,11,1,11,25,"6-5","N","N","N",4,0,10
"2744","T1",2023-10-29,"Karagumruk","Trabzonspor",0,0,"D",0,0,"D",3.07,3.51,2.4,"0-0","0-0",6,3,12,0,2,1,0,0,6,3,8,11,0,9,19,"6-3","N","N","N",3,0,10
"2745","T1",2023-10-29,"Ankaragucu","Samsunspor",2,0,"H",0,0,"D",2.39,3.51,3.07,"0-0","2-0",12,5,3,2,0,2,0,0,4,6,8,14,2,10,22,"4-6","Y","N","N",2,0,10
"2746","T1",2023-10-29,"Antalyaspor","Buyuksehyr",1,0,"H",1,0,"H",2.25,3.35,3.47,"1-0","1-0",11,1,8,3,3,5,0,0,7,5,20,19,1,12,39,"7-5","N","N","N",8,0,10
"2747","T1",2023-10-29,"Pendikspor","Fenerbahce",0,5,"A",0,2,"A",9.36,6.08,1.32,"0-2","0-5",2,0,19,10,1,2,0,0,0,7,7,11,5,7,18,"0-7","Y","Y","Y",3,0,10
"2748","T1",2023-10-30,"Besiktas","Gaziantep",2,0,"H",0,0,"D",1.38,5.21,8.18,"0-0","2-0",13,6,12,6,2,5,1,1,7,3,15,16,2,10,31,"7-3","Y","N","N",7,2,10
"2749","T1",2023-11-03,"Galatasaray","Kasimpasa",2,1,"H",1,0,"H",1.21,7.89,11.86,"1-0","2-1",13,3,12,5,2,3,0,0,5,3,11,12,3,8,23,"5-3","Y","Y","N",5,0,10
"2750","T1",2023-11-04,"Istanbulspor","Pendikspor",2,4,"A",1,2,"A",2.46,3.58,2.93,"1-2","2-4",15,4,22,11,2,3,0,0,4,7,14,8,6,11,22,"4-7","Y","Y","Y",5,0,11
"2751","T1",2023-11-04,"Samsunspor","Hatayspor",2,1,"H",0,1,"A",2.21,3.41,3.54,"0-1","2-1",15,6,10,3,3,7,0,1,12,4,7,16,3,16,23,"12-4","Y","Y","N",10,1,11
"2752","T1",2023-11-04,"Fenerbahce","Trabzonspor",2,3,"A",0,1,"A",1.35,5.58,9.05,"0-1","2-3",12,4,6,4,5,4,1,0,10,4,14,27,5,14,41,"10-4","Y","Y","Y",9,1,11
"2753","T1",2023-11-05,"Sivasspor","Ad. Demirspor",1,1,"D",1,0,"H",3.04,3.75,2.31,"1-0","1-1",19,10,14,4,1,3,0,0,5,6,14,15,2,11,29,"5-6","Y","N","N",4,0,11
"2754","T1",2023-11-05,"Buyuksehyr","Ankaragucu",3,3,"D",2,2,"D",2.2,3.41,3.58,"2-2","3-3",9,4,10,5,2,0,0,0,1,3,7,12,6,4,19,"1-3","Y","Y","Y",2,0,11
"2755","T1",2023-11-05,"Konyaspor","Karagumruk",1,1,"D",0,0,"D",2.15,3.53,3.58,"0-0","1-1",10,3,9,2,2,4,0,0,2,8,13,19,2,10,32,"2-8","Y","N","N",6,0,11
"2756","T1",2023-11-05,"Antalyaspor","Besiktas",3,2,"H",0,1,"A",3.26,3.56,2.27,"0-1","3-2",5,3,17,5,1,3,0,0,3,6,13,13,5,9,26,"3-6","Y","Y","Y",4,0,11
"2757","T1",2023-11-06,"Gaziantep","Rizespor",2,0,"H",1,0,"H",2.31,3.47,3.2,"1-0","2-0",9,5,14,2,3,1,0,0,3,5,8,8,2,8,16,"3-5","Y","N","N",4,0,11
"2758","T1",2023-11-06,"Kayserispor","Alanyaspor",1,0,"H",0,0,"D",2.16,3.49,3.52,"0-0","1-0",12,4,9,6,1,3,0,0,8,5,17,9,1,13,26,"8-5","N","N","N",4,0,11
"2759","T1",2023-11-08,"Samsunspor","Istanbulspor",2,1,"H",0,1,"A",1.9,3.81,4.1,"0-1","2-1",12,4,6,3,3,5,0,0,7,2,16,12,3,9,28,"7-2","Y","Y","N",8,0,11
"2760","T1",2023-11-10,"Ankaragucu","Antalyaspor",0,4,"A",0,2,"A",2.54,3.36,2.98,"0-2","0-4",10,2,21,9,3,0,0,0,2,5,9,11,4,7,20,"2-5","Y","Y","Y",3,0,12
"2761","T1",2023-11-10,"Trabzonspor","Konyaspor",2,1,"H",0,0,"D",1.68,3.99,5.48,"0-0","2-1",13,5,13,3,1,3,0,0,6,4,16,14,3,10,30,"6-4","Y","Y","N",4,0,12
"2762","T1",2023-11-11,"Kasimpasa","Kayserispor",3,4,"A",1,3,"A",2.32,3.66,3.09,"1-3","3-4",19,9,8,5,0,1,0,0,6,4,4,15,7,10,19,"6-4","Y","Y","Y",1,0,12
"2763","T1",2023-11-11,"Alanyaspor","Gaziantep",0,3,"A",0,2,"A",2.29,3.55,3.24,"0-2","0-3",13,3,9,5,3,1,0,0,8,1,12,10,3,9,22,"8-1","Y","Y","N",4,0,12
"2764","T1",2023-11-11,"Karagumruk","Sivasspor",3,0,"H",1,0,"H",2.25,3.4,3.44,"1-0","3-0",13,7,11,3,2,2,0,0,5,4,16,4,3,9,20,"5-4","Y","Y","N",4,0,12
"2765","T1",2023-11-11,"Hatayspor","Galatasaray",2,1,"H",1,1,"D",6.95,5.17,1.44,"1-1","2-1",6,4,18,6,2,1,0,0,2,9,16,11,3,11,27,"2-9","Y","Y","N",3,0,12
"2766","T1",2023-11-12,"Pendikspor","Samsunspor",1,0,"H",0,0,"D",3.1,3.51,2.38,"0-0","1-0",10,4,16,8,1,3,0,0,4,3,10,18,1,7,28,"4-3","N","N","N",4,0,12
"2767","T1",2023-11-12,"Besiktas","Buyuksehyr",1,0,"H",0,0,"D",1.79,3.93,4.58,"0-0","1-0",12,4,7,2,2,3,0,0,5,6,18,17,1,11,35,"5-6","N","N","N",5,0,12
"2768","T1",2023-11-12,"Rizespor","Istanbulspor",1,0,"H",1,0,"H",1.76,3.99,4.72,"1-0","1-0",8,3,7,0,1,0,0,0,6,6,17,7,1,12,24,"6-6","N","N","N",1,0,12
"2769","T1",2023-11-12,"Ad. Demirspor","Fenerbahce",0,0,"D",0,0,"D",3.6,4.21,1.94,"0-0","0-0",4,0,18,9,3,3,0,0,3,5,13,15,0,8,28,"3-5","N","N","N",6,0,12
"2770","T1",2023-11-25,"Istanbulspor","Hatayspor",2,1,"H",1,0,"H",3.26,3.61,2.25,"1-0","2-1",15,10,10,3,2,3,0,0,8,6,9,14,3,14,23,"8-6","Y","Y","N",5,0,13
"2771","T1",2023-11-25,"Gaziantep","Ankaragucu",0,1,"A",0,1,"A",2.19,3.39,3.6,"0-1","0-1",9,2,12,5,4,5,0,0,2,4,8,19,1,6,27,"2-4","N","N","N",9,0,13
"2772","T1",2023-11-25,"Konyaspor","Kasimpasa",2,0,"H",0,0,"D",2.01,3.71,3.82,"0-0","2-0",17,7,8,1,0,1,0,0,2,9,11,12,2,11,23,"2-9","Y","N","N",1,0,13
"2773","T1",2023-11-25,"Galatasaray","Alanyaspor",4,0,"H",2,0,"H",1.15,7.14,11.19,"2-0","4-0",26,11,4,1,1,1,0,0,9,3,12,8,4,12,20,"9-3","Y","Y","Y",2,0,13
"2774","T1",2023-11-26,"Kayserispor","Ad. Demirspor",1,1,"D",0,1,"A",2.67,4.03,2.47,"0-1","1-1",14,4,9,3,3,3,0,0,9,4,23,8,2,13,31,"9-4","Y","N","N",6,0,13
"2775","T1",2023-11-26,"Antalyaspor","Rizespor",0,0,"D",0,0,"D",1.86,3.7,4.5,"0-0","0-0",16,10,8,3,1,5,0,0,6,4,12,17,0,10,29,"6-4","N","N","N",6,0,13
"2776","T1",2023-11-26,"Samsunspor","Besiktas",1,2,"A",1,1,"D",3.41,3.56,2.19,"1-1","1-2",13,5,16,5,2,1,0,0,9,5,17,9,3,14,26,"9-5","Y","Y","N",3,0,13
"2777","T1",2023-11-26,"Fenerbahce","Karagumruk",2,1,"H",0,1,"A",1.24,6.94,11.63,"0-1","2-1",9,3,9,2,5,4,0,0,1,2,20,17,3,3,37,"1-2","Y","Y","N",9,0,13
"2778","T1",2023-11-27,"Buyuksehyr","Pendikspor",4,1,"H",1,1,"D",1.8,3.78,4.62,"1-1","4-1",10,5,12,3,1,2,0,0,7,4,13,14,5,11,27,"7-4","Y","Y","Y",3,0,13
"2779","T1",2023-11-27,"Sivasspor","Trabzonspor",3,3,"D",2,2,"D",3.51,3.35,2.18,"2-2","3-3",17,9,13,6,1,1,0,0,5,2,11,10,6,7,21,"5-2","Y","Y","Y",2,0,13
"2780","T1",2023-12-01,"Hatayspor","Antalyaspor",3,3,"D",1,1,"D",3.08,3.4,2.44,"1-1","3-3",14,8,13,7,2,2,0,0,6,5,14,5,6,11,19,"6-5","Y","Y","Y",4,0,14
"2781","T1",2023-12-01,"Karagumruk","Istanbulspor",3,0,"H",1,0,"H",1.7,3.89,5.36,"1-0","3-0",15,5,6,0,3,1,0,0,3,5,12,9,3,8,21,"3-5","Y","Y","N",4,0,14
"2782","T1",2023-12-02,"Alanyaspor","Konyaspor",2,2,"D",2,1,"H",2.27,3.36,3.15,"2-1","2-2",19,5,13,6,2,2,0,0,4,6,10,20,4,10,30,"4-6","Y","Y","Y",4,0,14
"2783","T1",2023-12-02,"Rizespor","Buyuksehyr",3,2,"H",2,2,"D",2.5,3.34,3.05,"2-2","3-2",19,7,16,9,2,3,0,0,6,5,10,13,5,11,23,"6-5","Y","Y","Y",5,0,14
"2784","T1",2023-12-02,"Ad. Demirspor","Samsunspor",2,3,"A",1,2,"A",1.74,4.44,4.34,"1-2","2-3",11,4,11,6,2,2,0,0,7,4,9,13,5,11,22,"7-4","Y","Y","Y",4,0,14
"2785","T1",2023-12-02,"Pendikspor","Galatasaray",0,2,"A",0,0,"D",9.28,6.01,1.32,"0-0","0-2",9,0,18,6,2,3,0,0,2,6,8,11,2,8,19,"2-6","Y","N","N",5,0,14
"2786","T1",2023-12-03,"Kasimpasa","Gaziantep",4,2,"H",3,0,"H",2.31,3.53,3.22,"3-0","4-2",24,7,15,4,5,5,1,0,5,6,19,13,6,11,32,"5-6","Y","Y","Y",10,1,14
"2787","T1",2023-12-03,"Trabzonspor","Kayserispor",0,1,"A",0,0,"D",1.79,3.92,4.58,"0-0","0-1",15,2,9,4,3,2,0,0,4,2,7,15,1,6,22,"4-2","N","N","N",5,0,14
"2788","T1",2023-12-03,"Ankaragucu","Besiktas",1,1,"D",1,0,"H",3.47,3.61,2.16,"1-0","1-1",11,4,9,4,1,1,0,0,1,5,19,10,2,6,29,"1-5","Y","N","N",2,0,14
"2789","T1",2023-12-04,"Fenerbahce","Sivasspor",4,1,"H",2,0,"H",1.23,6.95,11.81,"2-0","4-1",8,5,9,3,1,1,0,0,4,2,18,12,5,6,30,"4-2","Y","Y","Y",2,0,14
