"","Div","Date","HomeTeam","AwayTeam","FTHG","FTAG","FTR","HTHG","HTAG","HTR","PSH","PSD","PSA","HTCS","CS","HS","HST","AS","AST","HY","AY","HR","AR","HCO","ACO","HF","AF","TG","TC","TF","COSC","OV15","OV25","OV35","TY","TR","all_matchday"
"4334","B1",2023-07-28,"St. Gilloise","Anderlecht",2,0,"H",1,0,"H",2.22,3.63,3.24,"1-0","2-0",10,3,5,2,5,3,0,0,3,3,16,13,2,6,29,"3-3","Y","N","N",8,0,1
"4335","B1",2023-07-29,"Eupen","Westerlo",2,2,"D",1,0,"H",3.56,3.56,2.12,"1-0","2-2",13,6,22,5,1,0,0,0,1,4,14,7,4,5,21,"1-4","Y","Y","Y",1,0,1
"4336","B1",2023-07-29,"Charleroi","Oud-Heverlee Leuven",1,1,"D",1,0,"H",2.03,3.73,3.65,"1-0","1-1",4,2,19,5,3,1,1,0,2,6,7,12,2,8,19,"2-6","Y","N","N",4,1,1
"4337","B1",2023-07-29,"RWD Molenbeek","Genk",0,4,"A",0,3,"A",3.67,3.9,1.98,"0-3","0-4",10,4,28,10,1,0,0,0,2,6,11,11,4,8,22,"2-6","Y","Y","Y",1,0,1
"4338","B1",2023-07-30,"Antwerp","Cercle Brugge",1,0,"H",1,0,"H",1.85,3.6,4.36,"1-0","1-0",15,4,8,1,0,2,0,0,7,7,15,13,1,14,28,"7-7","N","N","N",2,0,1
"4339","B1",2023-07-30,"Gent","Kortrijk",3,2,"H",2,1,"H",1.33,5.51,8.63,"2-1","3-2",17,4,10,3,1,4,0,0,7,5,5,9,5,12,14,"7-5","Y","Y","Y",5,0,1
"4340","B1",2023-07-30,"Club Brugge","Mechelen",1,1,"D",0,1,"A",1.47,4.68,6.33,"0-1","1-1",21,5,9,2,2,2,1,0,4,3,8,9,2,7,17,"4-3","Y","N","N",4,1,1
"4341","B1",2023-07-30,"St Truiden","Standard",1,0,"H",0,0,"D",2.71,3.27,2.71,"0-0","1-0",11,3,7,3,1,1,0,0,3,2,13,11,1,5,24,"3-2","N","N","N",2,0,1
"4342","B1",2023-08-04,"Standard","St. Gilloise",0,1,"A",0,1,"A",3.87,3.67,1.98,"0-1","0-1",8,3,24,8,4,1,1,0,2,13,9,12,1,15,21,"2-13","N","N","N",5,1,2
"4343","B1",2023-08-05,"Genk","Eupen",0,1,"A",0,1,"A",1.29,6.28,9.53,"0-1","0-1",28,3,5,2,1,2,0,0,7,2,11,11,1,9,22,"7-2","N","N","N",3,0,2
"4344","B1",2023-08-05,"Cercle Brugge","Charleroi",2,0,"H",2,0,"H",1.92,3.8,3.98,"2-0","2-0",19,3,8,3,0,3,0,0,4,5,11,13,2,9,24,"4-5","Y","N","N",3,0,2
"4345","B1",2023-08-05,"Oud-Heverlee Leuven","RWD Molenbeek",1,2,"A",1,1,"D",1.82,4.01,4.23,"1-1","1-2",18,5,15,4,4,1,0,0,15,6,14,18,3,21,32,"15-6","Y","Y","N",5,0,2
"4346","B1",2023-08-06,"Anderlecht","Antwerp",1,0,"H",1,0,"H",2.65,3.7,2.55,"1-0","1-0",9,2,5,3,1,1,0,0,3,6,9,19,1,9,28,"3-6","N","N","N",2,0,2
"4347","B1",2023-08-06,"Mechelen","Gent",0,1,"A",0,0,"D",3.78,4.04,1.87,"0-0","0-1",14,2,12,3,2,3,0,0,7,3,14,14,1,10,28,"7-3","N","N","N",5,0,2
"4348","B1",2023-08-06,"Westerlo","Club Brugge",0,1,"A",0,1,"A",3.69,3.7,1.98,"0-1","0-1",11,3,20,8,1,0,0,0,4,5,7,9,1,9,16,"4-5","N","N","N",1,0,2
"4349","B1",2023-08-06,"Kortrijk","St Truiden",0,1,"A",0,0,"D",2.85,3.35,2.53,"0-0","0-1",8,1,14,4,1,2,0,0,0,14,10,12,1,14,22,"0-14","N","N","N",3,0,2
"4350","B1",2023-08-11,"Antwerp","Kortrijk",6,0,"H",4,0,"H",1.26,6.31,11.17,"4-0","6-0",25,9,4,1,0,2,0,0,4,1,8,11,6,5,19,"4-1","Y","Y","Y",2,0,3
"4351","B1",2023-08-12,"RWD Molenbeek","Mechelen",1,0,"H",0,0,"D",2.25,3.89,3.01,"0-0","1-0",18,8,9,4,3,1,0,0,7,4,12,11,1,11,23,"7-4","N","N","N",4,0,3
"4352","B1",2023-08-12,"St. Gilloise","Oud-Heverlee Leuven",5,1,"H",2,1,"H",1.51,4.42,6.74,"2-1","5-1",16,9,4,1,1,4,0,0,0,3,10,15,6,3,25,"0-3","Y","Y","Y",5,0,3
"4353","B1",2023-08-13,"St Truiden","Anderlecht",0,1,"A",0,0,"D",3.46,3.45,2.15,"0-0","0-1",14,5,9,3,4,5,0,1,6,1,13,15,1,7,28,"6-1","N","N","N",9,1,3
"4354","B1",2023-08-13,"Cercle Brugge","Genk",0,1,"A",0,0,"D",2.72,3.73,2.45,"0-0","0-1",13,2,10,3,2,3,0,0,5,3,8,20,1,8,28,"5-3","N","N","N",5,0,3
"4355","B1",2023-08-13,"Eupen","Club Brugge",0,5,"A",0,3,"A",5.62,4.33,1.56,"0-3","0-5",9,1,13,7,0,2,0,0,4,6,9,13,5,10,22,"4-6","Y","Y","Y",2,0,3
"4356","B1",2023-08-13,"Charleroi","Standard",1,1,"D",0,1,"A",2.07,3.64,3.47,"0-1","1-1",18,3,7,2,3,2,1,1,13,2,11,12,2,15,23,"13-2","Y","N","N",5,2,3
"4357","B1",2023-08-13,"Westerlo","Gent",1,3,"A",1,1,"D",3.56,3.96,1.95,"1-1","1-3",14,4,18,9,1,1,0,0,4,10,10,14,4,14,24,"4-10","Y","Y","Y",2,0,3
"4358","B1",2023-08-18,"Oud-Heverlee Leuven","Antwerp",1,1,"D",0,1,"A",4.93,4.24,1.67,"0-1","1-1",10,2,13,4,4,2,1,0,7,7,16,10,2,14,26,"7-7","Y","N","N",6,1,4
"4359","B1",2023-08-19,"Standard","Cercle Brugge",0,1,"A",0,0,"D",2.94,3.55,2.43,"0-0","0-1",7,3,16,4,2,2,0,0,3,2,10,11,1,5,21,"3-2","N","N","N",4,0,4
"4360","B1",2023-08-19,"Mechelen","St. Gilloise",4,0,"H",1,0,"H",4.29,4.01,1.81,"1-0","4-0",10,7,14,1,0,2,0,0,4,6,9,10,4,10,19,"4-6","Y","Y","Y",2,0,4
"4361","B1",2023-08-20,"Anderlecht","Westerlo",2,1,"H",1,0,"H",1.92,3.59,4.13,"1-0","2-1",24,7,18,3,1,3,0,0,6,2,7,13,3,8,20,"6-2","Y","Y","N",4,0,4
"4362","B1",2023-08-20,"Genk","Charleroi",0,0,"D",0,0,"D",1.59,4.53,5.02,"0-0","0-0",23,7,7,3,0,0,0,0,11,4,11,13,0,15,24,"11-4","N","N","N",0,0,4
"4363","B1",2023-08-20,"Gent","St Truiden",2,2,"D",1,2,"A",1.44,4.89,6.52,"1-2","2-2",19,5,14,3,2,2,0,0,7,2,11,9,4,9,20,"7-2","Y","Y","Y",4,0,4
"4364","B1",2023-08-20,"Club Brugge","RWD Molenbeek",7,1,"H",2,1,"H",1.29,5.77,9.29,"2-1","7-1",23,9,9,3,0,1,0,0,8,3,10,12,8,11,22,"8-3","Y","Y","Y",1,0,4
"4365","B1",2023-08-20,"Kortrijk","Eupen",1,3,"A",0,0,"D",2.33,3.77,2.85,"0-0","1-3",13,4,15,8,5,4,1,0,5,9,15,15,4,14,30,"5-9","Y","Y","Y",9,1,4
"4366","B1",2023-08-26,"Westerlo","Mechelen",2,3,"A",2,0,"H",2.25,3.83,3.04,"2-0","2-3",11,4,17,5,0,3,0,0,5,4,8,9,5,9,17,"5-4","Y","Y","Y",3,0,5
"4367","B1",2023-08-26,"Eupen","Oud-Heverlee Leuven",3,1,"H",1,0,"H",3.02,3.81,2.27,"1-0","3-1",17,4,22,5,1,2,0,0,3,5,15,9,4,8,24,"3-5","Y","Y","Y",3,0,5
"4368","B1",2023-08-26,"Kortrijk","Standard",1,1,"D",1,0,"H",3,3.65,2.35,"1-0","1-1",19,6,23,6,0,2,0,0,7,10,7,12,2,17,19,"7-10","Y","N","N",2,0,5
"4369","B1",2023-08-27,"St Truiden","Cercle Brugge",0,2,"A",0,0,"D",3.19,3.38,2.3,"0-0","0-2",20,4,25,8,1,1,0,0,8,8,8,18,2,16,26,"8-8","Y","N","N",2,0,5
"4370","B1",2023-08-27,"Anderlecht","Charleroi",2,1,"H",1,0,"H",1.72,4.11,4.43,"1-0","2-1",15,8,18,5,0,2,0,0,4,7,12,16,3,11,28,"4-7","Y","Y","N",2,0,5
"4371","B1",2023-09-01,"Oud-Heverlee Leuven","Kortrijk",3,0,"H",1,0,"H",1.63,4.61,4.83,"1-0","3-0",20,9,13,7,1,3,0,0,4,1,10,14,3,5,24,"4-1","Y","Y","N",4,0,5
"4372","B1",2023-09-02,"Cercle Brugge","Westerlo",2,1,"H",1,0,"H",1.58,4.43,5.54,"1-0","2-1",21,6,7,1,0,1,0,0,14,1,16,16,3,15,32,"14-1","Y","Y","N",1,0,5
"4373","B1",2023-09-02,"Mechelen","Eupen",1,0,"H",0,0,"D",1.78,4.13,4.21,"0-0","1-0",22,6,9,1,0,1,0,0,6,4,10,13,1,10,23,"6-4","N","N","N",1,0,5
"4374","B1",2023-09-02,"Standard","RWD Molenbeek",1,1,"D",1,1,"D",2.07,3.56,3.7,"1-1","1-1",11,4,8,3,1,3,0,0,5,0,9,22,2,5,31,"5-0","Y","N","N",4,0,6
"4375","B1",2023-09-03,"Gent","Club Brugge",2,1,"H",1,1,"D",2.41,3.77,2.79,"1-1","2-1",14,4,14,7,2,0,1,0,5,6,14,12,3,11,26,"5-6","Y","Y","N",2,1,6
"4376","B1",2023-09-03,"St. Gilloise","Antwerp",2,2,"D",1,2,"A",2.34,3.22,3.27,"1-2","2-2",24,7,8,5,1,2,0,0,8,4,9,12,4,12,21,"8-4","Y","Y","Y",3,0,6
"4377","B1",2023-09-03,"Genk","Anderlecht",1,1,"D",0,0,"D",1.97,3.56,3.87,"0-0","1-1",12,4,8,4,5,6,1,0,7,7,6,15,2,14,21,"7-7","Y","N","N",11,1,6
"4378","B1",2023-09-03,"Charleroi","St Truiden",1,1,"D",0,0,"D",2.23,3.43,3.28,"0-0","1-1",18,5,8,5,2,0,0,1,3,5,12,6,2,8,18,"3-5","Y","N","N",2,1,6
"4379","B1",2023-09-15,"Westerlo","Antwerp",0,3,"A",0,1,"A",5.39,4.45,1.6,"0-1","0-3",9,2,15,4,3,0,0,0,4,5,13,9,3,9,22,"4-5","Y","Y","N",3,0,6
"4380","B1",2023-09-16,"RWD Molenbeek","Cercle Brugge",2,1,"H",1,1,"D",4.18,4.22,1.79,"1-1","2-1",10,5,15,4,3,3,0,0,5,4,18,12,3,9,30,"5-4","Y","Y","N",6,0,6
"4381","B1",2023-09-16,"St. Gilloise","Genk",0,2,"A",0,1,"A",2,3.85,3.63,"0-1","0-2",25,4,7,2,1,6,0,0,7,3,15,15,2,10,30,"7-3","Y","N","N",7,0,6
"4382","B1",2023-09-16,"Club Brugge","Charleroi",4,2,"H",2,2,"D",1.41,5.26,7.15,"2-2","4-2",25,10,14,8,2,3,0,0,5,5,8,6,6,10,14,"5-5","Y","Y","Y",5,0,7
"4383","B1",2023-09-17,"Eupen","Standard",1,3,"A",0,2,"A",3.08,3.37,2.36,"0-2","1-3",13,3,16,6,1,4,0,1,6,6,5,12,4,12,17,"6-6","Y","Y","Y",5,1,7
"4384","B1",2023-09-17,"Kortrijk","Anderlecht",2,2,"D",1,1,"D",4.66,4.22,1.68,"1-1","2-2",9,4,18,6,5,1,1,1,3,11,13,6,4,14,19,"3-11","Y","Y","Y",6,2,7
"4385","B1",2023-09-17,"Oud-Heverlee Leuven","Gent",1,1,"D",1,1,"D",4.4,4.13,1.73,"1-1","1-1",9,2,22,4,4,3,0,0,3,16,7,11,2,19,18,"3-16","Y","N","N",7,0,7
"4386","B1",2023-09-17,"St Truiden","Mechelen",2,0,"H",1,0,"H",2.45,3.44,2.9,"1-0","2-0",16,4,13,7,1,2,0,0,1,7,8,12,2,8,20,"1-7","Y","N","N",3,0,7
"4387","B1",2023-09-22,"Standard","Westerlo",0,0,"D",0,0,"D",1.83,4.25,3.92,"0-0","0-0",14,5,3,2,0,3,0,0,5,2,6,23,0,7,29,"5-2","N","N","N",3,0,7
"4388","B1",2023-09-23,"Charleroi","Kortrijk",1,0,"H",1,0,"H",1.65,4.34,5.05,"1-0","1-0",14,5,13,3,2,1,0,0,8,7,16,13,1,15,29,"8-7","N","N","N",3,0,7
"4389","B1",2023-09-23,"Mechelen","Oud-Heverlee Leuven",1,2,"A",0,2,"A",1.93,3.81,3.9,"0-2","1-2",16,4,15,8,5,3,0,0,6,6,12,7,3,12,19,"6-6","Y","Y","N",8,0,7
"4390","B1",2023-09-23,"Antwerp","RWD Molenbeek",0,0,"D",0,0,"D",1.33,5.63,8.62,"0-0","0-0",14,3,5,1,0,1,0,0,9,1,4,14,0,10,18,"9-1","N","N","N",1,0,8
"4391","B1",2023-09-24,"Genk","St Truiden",3,3,"D",0,3,"A",1.58,4.34,5.35,"0-3","3-3",20,7,16,6,2,4,0,0,5,1,17,11,6,6,28,"5-1","Y","Y","Y",6,0,8
"4392","B1",2023-09-24,"Cercle Brugge","St. Gilloise",0,2,"A",0,1,"A",2.88,3.53,2.42,"0-1","0-2",6,1,15,7,3,3,1,0,3,2,8,17,2,5,25,"3-2","Y","N","N",6,1,8
"4393","B1",2023-09-24,"Anderlecht","Club Brugge",1,1,"D",1,0,"H",2.91,3.74,2.31,"1-0","1-1",8,1,9,3,1,1,0,0,3,3,12,11,2,6,23,"3-3","Y","N","N",2,0,8
"4394","B1",2023-09-24,"Gent","Eupen",2,1,"H",0,1,"A",1.28,5.94,9.23,"0-1","2-1",13,6,14,3,1,4,1,0,3,7,9,16,3,10,25,"3-7","Y","Y","N",5,1,8
"4395","B1",2023-09-27,"Antwerp","Gent",0,0,"D",0,0,"D",2.12,3.7,3.42,"0-0","0-0",14,4,6,2,3,1,0,0,6,0,10,4,0,6,14,"6-0","N","N","N",4,0,8
"4396","B1",2023-09-28,"RWD Molenbeek","St. Gilloise",2,3,"A",2,2,"D",4.79,4.22,1.66,"2-2","2-3",10,7,16,8,2,3,0,0,3,8,8,14,5,11,22,"3-8","Y","Y","Y",5,0,8
"4397","B1",2023-09-28,"Club Brugge","Genk",1,1,"D",0,1,"A",1.79,4.03,4.16,"0-1","1-1",18,3,15,5,4,1,0,0,10,3,16,7,2,13,23,"10-3","Y","N","N",5,0,8
"4398","B1",2023-09-29,"Kortrijk","Cercle Brugge",2,1,"H",0,0,"D",4.68,4.39,1.68,"0-0","2-1",10,4,10,2,3,1,0,0,3,7,13,19,3,10,32,"3-7","Y","Y","N",4,0,9
"4399","B1",2023-09-30,"Eupen","Anderlecht",1,3,"A",1,1,"D",4.48,3.99,1.78,"1-1","1-3",9,3,20,6,1,0,0,0,2,4,11,15,4,6,26,"2-4","Y","Y","Y",1,0,9
"4400","B1",2023-09-30,"Oud-Heverlee Leuven","Standard",1,2,"A",0,1,"A",2.38,3.69,2.92,"0-1","1-2",11,5,14,3,2,1,0,0,6,3,10,11,3,9,21,"6-3","Y","Y","N",3,0,9
"4401","B1",2023-09-30,"Mechelen","Antwerp",0,0,"D",0,0,"D",3.93,3.8,1.93,"0-0","0-0",14,3,22,4,0,1,0,0,5,13,3,5,0,18,8,"5-13","N","N","N",1,0,9
"4402","B1",2023-10-01,"St. Gilloise","Charleroi",3,1,"H",3,1,"H",1.57,4.43,5.34,"3-1","3-1",17,7,4,3,1,2,0,0,8,7,13,13,4,15,26,"8-7","Y","Y","Y",3,0,9
"4403","B1",2023-10-01,"Genk","Westerlo",3,3,"D",2,1,"H",1.45,4.87,6.35,"2-1","3-3",18,6,10,7,2,2,1,0,4,7,7,12,6,11,19,"4-7","Y","Y","Y",4,1,9
"4404","B1",2023-10-01,"Club Brugge","St Truiden",1,1,"D",0,0,"D",1.38,5.12,7.61,"0-0","1-1",20,7,12,3,3,1,0,0,11,4,12,8,2,15,20,"11-4","Y","N","N",4,0,9
"4405","B1",2023-10-01,"RWD Molenbeek","Gent",1,1,"D",1,1,"D",4.5,4.23,1.69,"1-1","1-1",9,3,19,9,3,1,0,0,4,4,9,10,2,8,19,"4-4","Y","N","N",4,0,9
"4406","B1",2023-10-06,"Charleroi","RWD Molenbeek",2,1,"H",0,0,"D",1.91,3.88,3.95,"0-0","2-1",22,7,6,3,1,3,0,1,14,2,9,7,3,16,16,"14-2","Y","Y","N",4,1,10
"4407","B1",2023-10-07,"Cercle Brugge","Oud-Heverlee Leuven",3,2,"H",2,2,"D",1.62,4.4,5.2,"2-2","3-2",18,7,13,5,2,3,0,0,6,6,9,9,5,12,18,"6-6","Y","Y","Y",5,0,10
"4408","B1",2023-10-07,"Westerlo","Kortrijk",1,0,"H",1,0,"H",1.85,4.29,3.79,"1-0","1-0",13,4,13,3,2,4,0,0,1,10,15,10,1,11,25,"1-10","N","N","N",6,0,10
"4409","B1",2023-10-07,"Anderlecht","Mechelen",3,1,"H",1,0,"H",1.75,4.05,4.58,"1-0","3-1",19,9,13,3,2,3,0,0,8,1,14,10,4,9,24,"8-1","Y","Y","Y",5,0,10
"4410","B1",2023-10-08,"Standard","Club Brugge",2,1,"H",1,0,"H",4.92,4.2,1.66,"1-0","2-1",7,5,16,7,4,1,0,0,1,6,13,14,3,7,27,"1-6","Y","Y","N",5,0,10
"4411","B1",2023-10-08,"Antwerp","Eupen",4,1,"H",2,1,"H",1.23,6.64,10.66,"2-1","4-1",27,12,5,2,0,2,0,0,8,2,8,10,5,10,18,"8-2","Y","Y","Y",2,0,10
"4412","B1",2023-10-08,"Gent","Genk",1,1,"D",0,0,"D",2.05,3.76,3.42,"0-0","1-1",18,9,20,6,1,3,0,0,4,9,9,14,2,13,23,"4-9","Y","N","N",4,0,10
"4413","B1",2023-10-08,"St Truiden","St. Gilloise",0,4,"A",0,2,"A",4.22,3.82,1.82,"0-2","0-4",9,1,12,7,1,4,0,0,3,5,3,15,4,8,18,"3-5","Y","Y","Y",5,0,10
"4414","B1",2023-10-20,"St. Gilloise","Eupen",4,1,"H",2,0,"H",1.2,7.49,13.66,"2-0","4-1",21,11,6,1,0,3,0,1,3,1,14,14,5,4,28,"3-1","Y","Y","Y",3,1,11
"4415","B1",2023-10-21,"Kortrijk","Club Brugge",1,0,"H",1,0,"H",7.22,5.36,1.4,"1-0","1-0",6,2,18,4,4,2,0,0,1,9,14,9,1,10,23,"1-9","N","N","N",6,0,11
"4416","B1",2023-10-21,"RWD Molenbeek","Westerlo",1,1,"D",0,0,"D",2.39,3.67,2.92,"0-0","1-1",12,6,9,5,2,2,0,0,7,4,10,8,2,11,18,"7-4","Y","N","N",4,0,11
"4417","B1",2023-10-21,"Charleroi","Antwerp",3,2,"H",0,0,"D",3.43,3.57,2.16,"0-0","3-2",10,5,11,5,2,2,0,0,5,2,6,12,5,7,18,"5-2","Y","Y","Y",4,0,11
"4418","B1",2023-10-22,"Genk","Mechelen",4,0,"H",2,0,"H",1.54,4.67,5.72,"2-0","4-0",19,9,10,3,1,2,0,0,4,3,6,10,4,7,16,"4-3","Y","Y","Y",3,0,11
"4419","B1",2023-10-22,"Cercle Brugge","Gent",2,0,"H",0,0,"D",2.65,3.71,2.52,"0-0","2-0",16,5,10,4,3,2,0,1,6,7,17,15,2,13,32,"6-7","Y","N","N",5,1,11
"4420","B1",2023-10-22,"Standard","Anderlecht",3,2,"H",0,2,"A",3.14,3.47,2.29,"0-2","3-2",15,8,13,7,2,3,0,0,3,8,12,14,5,11,26,"3-8","Y","Y","Y",5,0,11
"4421","B1",2023-10-22,"Oud-Heverlee Leuven","St Truiden",4,0,"H",2,0,"H",2.24,3.58,3.13,"2-0","4-0",11,4,18,3,1,3,0,0,3,7,9,12,4,10,21,"3-7","Y","Y","Y",4,0,11
"4422","B1",2023-10-27,"St Truiden","RWD Molenbeek",2,1,"H",0,0,"D",1.87,3.78,4.25,"0-0","2-1",9,5,10,3,0,0,0,0,4,0,9,7,3,4,16,"4-0","Y","Y","N",0,0,12
"4423","B1",2023-10-28,"Mechelen","Cercle Brugge",0,2,"A",0,0,"D",3.25,3.91,2.13,"0-0","0-2",11,7,22,4,1,3,0,0,8,3,13,15,2,11,28,"8-3","Y","N","N",4,0,12
"4424","B1",2023-10-28,"Eupen","Charleroi",2,0,"H",1,0,"H",3.54,3.77,2.06,"1-0","2-0",8,5,17,5,3,2,0,0,4,8,11,13,2,12,24,"4-8","Y","N","N",5,0,12
"4425","B1",2023-10-28,"Anderlecht","Oud-Heverlee Leuven",5,1,"H",2,1,"H",1.51,4.63,6.35,"2-1","5-1",18,9,13,7,1,1,0,0,5,1,13,13,6,6,26,"5-1","Y","Y","Y",2,0,12
"4426","B1",2023-10-29,"Club Brugge","Antwerp",2,1,"H",1,0,"H",1.98,3.77,3.63,"1-0","2-1",11,5,8,2,4,1,0,0,3,3,11,9,3,6,20,"3-3","Y","Y","N",5,0,12
"4427","B1",2023-10-29,"Westerlo","St. Gilloise",1,3,"A",1,1,"D",4.9,4.29,1.63,"1-1","1-3",12,4,22,7,1,1,0,0,5,8,11,10,4,13,21,"5-8","Y","Y","Y",2,0,12
"4428","B1",2023-10-29,"Gent","Standard",3,1,"H",3,0,"H",1.64,4.24,4.94,"3-0","3-1",18,9,12,7,2,2,0,0,4,4,16,15,4,8,31,"4-4","Y","Y","Y",4,0,12
"4429","B1",2023-10-29,"Kortrijk","Genk",0,3,"A",0,0,"D",5.98,4.69,1.49,"0-0","0-3",12,3,15,9,3,2,0,0,8,5,10,16,3,13,26,"8-5","Y","Y","N",5,0,12
"4430","B1",2023-11-03,"St Truiden","Eupen",1,1,"D",1,0,"H",1.65,4.2,5.18,"1-0","1-1",16,4,5,1,1,1,0,0,5,1,10,13,2,6,23,"5-1","Y","N","N",2,0,13
"4431","B1",2023-11-04,"RWD Molenbeek","Kortrijk",1,1,"D",1,1,"D",1.93,3.86,3.77,"1-1","1-1",9,5,5,2,3,1,0,0,4,2,14,7,2,6,21,"4-2","Y","N","N",4,0,13
"4432","B1",2023-11-04,"Oud-Heverlee Leuven","Westerlo",0,2,"A",0,0,"D",2.1,3.81,3.3,"0-0","0-2",10,2,10,6,3,7,0,0,7,7,11,13,2,14,24,"7-7","Y","N","N",10,0,13
"4433","B1",2023-11-04,"Antwerp","Genk",3,2,"H",3,1,"H",2.19,3.77,3.2,"3-1","3-2",14,5,17,8,3,4,0,0,5,5,13,12,5,10,25,"5-5","Y","Y","Y",7,0,13
"4434","B1",2023-11-05,"Cercle Brugge","Anderlecht",0,3,"A",0,2,"A",2.52,3.63,2.77,"0-2","0-3",16,2,7,5,2,3,0,0,7,1,14,13,3,8,27,"7-1","Y","Y","N",5,0,13
"4435","B1",2023-11-05,"Standard","Mechelen",1,1,"D",1,0,"H",1.69,4.08,4.71,"1-0","1-1",10,4,11,4,1,4,0,0,10,1,10,19,2,11,29,"10-1","Y","N","N",5,0,13
"4436","B1",2023-11-05,"St. Gilloise","Club Brugge",2,1,"H",1,0,"H",2.31,3.7,2.93,"1-0","2-1",19,6,5,2,3,4,0,0,9,4,11,6,3,13,17,"9-4","Y","Y","N",7,0,13
"4437","B1",2023-11-05,"Charleroi","Gent",1,3,"A",0,1,"A",3.39,3.68,2.09,"0-1","1-3",11,3,17,9,3,0,0,0,0,6,5,4,4,6,9,"0-6","Y","Y","Y",3,0,13
"4438","B1",2023-11-10,"Westerlo","St Truiden",3,3,"D",2,1,"H",2.65,3.52,2.69,"2-1","3-3",17,4,10,7,3,2,0,0,9,3,11,13,6,12,24,"9-3","Y","Y","Y",5,0,14
"4439","B1",2023-11-11,"Antwerp","Standard",6,0,"H",4,0,"H",1.63,4.28,5.29,"4-0","6-0",15,9,2,0,2,2,0,0,6,2,13,10,6,8,23,"6-2","Y","Y","Y",4,0,14
"4440","B1",2023-11-11,"Eupen","RWD Molenbeek",1,3,"A",1,1,"D",2.6,3.62,2.68,"1-1","1-3",11,4,20,10,1,4,0,0,8,5,12,14,4,13,26,"8-5","Y","Y","Y",5,0,14
"4441","B1",2023-11-11,"Mechelen","Charleroi",1,0,"H",0,0,"D",2.71,3.65,2.56,"0-0","1-0",19,7,6,3,2,1,0,1,8,2,11,10,1,10,21,"8-2","N","N","N",3,1,14
"4442","B1",2023-11-12,"Club Brugge","Cercle Brugge",0,0,"D",0,0,"D",1.72,4.09,4.47,"0-0","0-0",14,7,20,3,2,5,0,0,10,3,11,12,0,13,23,"10-3","N","N","N",7,0,14
"4443","B1",2023-11-12,"Genk","Oud-Heverlee Leuven",3,1,"H",1,0,"H",1.39,5.53,6.66,"1-0","3-1",18,6,6,3,2,4,0,0,3,2,14,19,4,5,33,"3-2","Y","Y","Y",6,0,14
"4444","B1",2023-11-12,"Gent","Anderlecht",1,1,"D",1,1,"D",2.19,3.63,3.2,"1-1","1-1",10,5,7,2,1,2,0,0,8,3,12,10,2,11,22,"8-3","Y","N","N",3,0,14
"4445","B1",2023-11-12,"St. Gilloise","Kortrijk",3,0,"H",2,0,"H",1.2,7.29,12.28,"2-0","3-0",18,8,11,1,2,1,0,0,6,6,10,9,3,12,19,"6-6","Y","Y","N",3,0,14
"4446","B1",2023-11-24,"St Truiden","Antwerp",1,1,"D",1,0,"H",4.1,3.67,1.93,"1-0","1-1",11,5,12,1,2,2,0,0,4,7,8,11,2,11,19,"4-7","Y","N","N",4,0,15
"4447","B1",2023-11-25,"Cercle Brugge","Eupen",2,0,"H",0,0,"D",1.38,5.15,7.14,"0-0","2-0",30,10,6,4,4,3,0,0,5,3,12,13,2,8,25,"5-3","Y","N","N",7,0,15
"4448","B1",2023-11-25,"Charleroi","Westerlo",3,2,"H",0,1,"A",1.85,3.79,4.12,"0-1","3-2",14,4,11,4,3,2,0,0,5,4,15,11,5,9,26,"5-4","Y","Y","Y",5,0,15
"4449","B1",2023-11-25,"Standard","Genk",1,0,"H",0,0,"D",3.7,3.89,1.93,"0-0","1-0",13,4,11,2,2,2,0,0,5,5,20,12,1,10,32,"5-5","N","N","N",4,0,15
"4450","B1",2023-11-26,"Gent","St. Gilloise",1,1,"D",1,0,"H",2.59,3.6,2.55,"1-0","1-1",11,3,12,4,2,3,0,0,5,8,8,14,2,13,22,"5-8","Y","N","N",5,0,15
"4451","B1",2023-11-26,"Oud-Heverlee Leuven","Club Brugge",0,1,"A",0,1,"A",4.37,4.2,1.68,"0-1","0-1",10,3,14,6,4,2,0,0,7,6,19,13,1,13,32,"7-6","N","N","N",6,0,15
"4452","B1",2023-11-26,"Anderlecht","RWD Molenbeek",2,1,"H",0,1,"A",1.39,4.87,7.22,"0-1","2-1",25,8,7,2,1,4,0,1,10,1,6,12,3,11,18,"10-1","Y","Y","N",5,1,15
"4453","B1",2023-11-26,"Kortrijk","Mechelen",0,3,"A",0,2,"A",3.01,3.4,2.34,"0-2","0-3",15,3,10,5,2,2,0,0,4,3,12,12,3,7,24,"4-3","Y","Y","N",4,0,15
"4454","B1",2023-12-01,"Westerlo","Anderlecht",1,3,"A",0,1,"A",5.13,3.88,1.71,"0-1","1-3",23,7,26,10,0,0,0,0,7,2,3,11,4,9,14,"7-2","Y","Y","Y",0,0,16
"4455","B1",2023-12-02,"RWD Molenbeek","Charleroi",0,0,"D",0,0,"D",2.88,3.4,2.55,"0-0","0-0",10,4,18,8,0,2,0,0,3,10,4,8,0,13,12,"3-10","N","N","N",2,0,16
"4456","B1",2023-12-02,"Eupen","Kortrijk",1,1,"D",0,0,"D",2.28,3.67,3.09,"0-0","1-1",14,3,14,3,1,1,0,0,7,11,14,10,2,18,24,"7-11","Y","N","N",2,0,16
"4457","B1",2023-12-02,"Antwerp","Oud-Heverlee Leuven",1,0,"H",1,0,"H",1.34,5.81,8.32,"1-0","1-0",18,5,10,4,0,3,0,0,7,6,6,9,1,13,15,"7-6","N","N","N",3,0,16
"4458","B1",2023-12-03,"Genk","Gent",2,2,"D",1,1,"D",2.21,3.75,3.19,"1-1","2-2",13,6,17,6,2,2,0,0,1,9,15,12,4,10,27,"1-9","Y","Y","Y",4,0,16
"4459","B1",2023-12-03,"Mechelen","St Truiden",0,2,"A",0,2,"A",2.22,3.38,3.36,"0-2","0-2",6,5,13,5,1,2,0,0,1,5,10,8,2,6,18,"1-5","Y","N","N",3,0,16
"4460","B1",2023-12-03,"Club Brugge","Standard",2,0,"H",1,0,"H",1.45,4.97,6.21,"1-0","2-0",13,5,7,2,2,2,0,0,4,3,13,10,2,7,23,"4-3","Y","N","N",4,0,16
"4461","B1",2023-12-03,"St. Gilloise","Cercle Brugge",2,1,"H",2,1,"H",1.65,4.06,5.14,"2-1","2-1",12,6,13,6,1,3,0,0,5,4,13,15,3,9,28,"5-4","Y","Y","N",4,0,16
"4462","B1",2023-12-08,"Kortrijk","Westerlo",1,2,"A",0,1,"A",2.87,3.38,2.57,"0-1","1-2",16,6,8,3,1,3,0,0,5,1,8,13,3,6,21,"5-1","Y","Y","N",4,0,17
"4463","B1",2023-12-09,"Cercle Brugge","Antwerp",1,3,"A",0,1,"A",2.79,3.44,2.61,"0-1","1-3",15,2,14,8,4,1,0,0,6,2,13,6,4,8,19,"6-2","Y","Y","Y",5,0,17
"4464","B1",2023-12-09,"St Truiden","Oud-Heverlee Leuven",1,1,"D",1,1,"D",1.83,4.11,4.09,"1-1","1-1",26,13,4,3,0,2,0,1,15,2,5,10,2,17,15,"15-2","Y","N","N",2,1,17
"4465","B1",2023-12-09,"Gent","RWD Molenbeek",4,0,"H",2,0,"H",1.33,6.02,8.28,"2-0","4-0",22,10,3,1,0,5,0,0,9,1,11,14,4,10,25,"9-1","Y","Y","Y",5,0,17
"4466","B1",2023-12-10,"Mechelen","Club Brugge",0,0,"D",0,0,"D",5.18,4.23,1.61,"0-0","0-0",9,4,13,2,3,5,0,0,2,9,11,9,0,11,20,"2-9","N","N","N",8,0,17
"4467","B1",2023-12-10,"Eupen","Genk",1,3,"A",0,1,"A",7.43,5.43,1.36,"0-1","1-3",11,4,18,10,0,2,0,0,8,8,12,8,4,16,20,"8-8","Y","Y","Y",2,0,17
"4468","B1",2023-12-10,"Anderlecht","Standard",2,2,"D",1,1,"D",1.56,4.28,5.79,"1-1","2-2",12,4,13,4,2,3,0,0,1,1,8,14,4,2,22,"1-1","Y","Y","Y",5,0,17
"4469","B1",2023-12-10,"Charleroi","St. Gilloise",1,3,"A",0,1,"A",5.36,4.07,1.62,"0-1","1-3",9,3,17,9,3,2,0,0,6,7,7,12,4,13,19,"6-7","Y","Y","Y",5,0,17
"4470","B1",2023-12-15,"Westerlo","Eupen",2,0,"H",0,0,"D",1.8,3.84,4.54,"0-0","2-0",20,4,15,7,3,1,0,0,4,4,15,8,2,8,23,"4-4","Y","N","N",4,0,18
"4471","B1",2023-12-16,"Oud-Heverlee Leuven","Cercle Brugge",1,2,"A",1,0,"H",4.09,4.27,1.79,"1-0","1-2",9,3,12,5,4,3,0,0,4,6,12,14,3,10,26,"4-6","Y","Y","N",7,0,18
"4472","B1",2023-12-16,"RWD Molenbeek","St Truiden",3,0,"H",1,0,"H",3.42,3.43,2.22,"1-0","3-0",7,6,12,1,3,2,0,0,4,4,14,8,3,8,22,"4-4","Y","Y","N",5,0,18
"4473","B1",2023-12-16,"Standard","Charleroi",0,0,"D",0,0,"D",2.16,3.52,3.48,"0-0","0-0",6,1,7,2,1,1,0,0,4,2,11,21,0,6,32,"4-2","N","N","N",2,0,18
"4474","B1",2023-12-17,"Club Brugge","Gent",2,0,"H",2,0,"H",1.68,4.2,4.89,"2-0","2-0",13,4,8,2,0,0,0,1,4,5,10,11,2,9,21,"4-5","Y","N","N",0,1,18
"4475","B1",2023-12-17,"St. Gilloise","Mechelen",1,0,"H",0,0,"D",1.33,5.4,8.6,"0-0","1-0",24,8,15,8,2,1,0,0,8,5,14,10,1,13,24,"8-5","N","N","N",3,0,18
"4476","B1",2023-12-17,"Antwerp","Anderlecht",1,1,"D",0,1,"A",1.99,3.57,3.8,"0-1","1-1",19,5,10,4,2,4,0,0,7,2,9,13,2,9,22,"7-2","Y","N","N",6,0,18
"4477","B1",2023-12-17,"Genk","Kortrijk",4,0,"H",1,0,"H",1.23,6.73,10.54,"1-0","4-0",27,9,5,1,0,2,0,0,7,2,7,12,4,9,19,"7-2","Y","Y","Y",2,0,18
"4478","B1",2023-12-20,"Cercle Brugge","Kortrijk",3,0,"H",1,0,"H",1.35,5.53,8.71,"1-0","3-0",24,13,6,1,2,3,0,0,7,5,8,14,3,12,22,"7-5","Y","Y","N",5,0,19
"4479","B1",2023-12-20,"Mechelen","Standard",3,0,"H",1,0,"H",2.57,3.36,2.89,"1-0","3-0",28,8,14,3,2,0,0,1,5,3,8,8,3,8,16,"5-3","Y","Y","N",2,1,19
"4480","B1",2023-12-21,"Gent","Oud-Heverlee Leuven",4,0,"H",1,0,"H",1.29,6.02,8.57,"1-0","4-0",21,6,9,2,0,1,0,0,8,3,6,12,4,11,18,"8-3","Y","Y","Y",1,0,19
"4481","B1",2023-12-22,"RWD Molenbeek","Club Brugge",1,6,"A",0,3,"A",8.5,5.2,1.37,"0-3","1-6",10,3,15,10,1,2,0,0,2,8,9,8,7,10,17,"2-8","Y","Y","Y",3,0,19
"4482","B1",2023-12-23,"Eupen","St. Gilloise",1,2,"A",0,2,"A",11.63,6.62,1.24,"0-2","1-2",1,1,20,8,5,1,0,0,3,14,15,8,3,17,23,"3-14","Y","Y","N",6,0,19
"4483","B1",2023-12-23,"Antwerp","Westerlo",2,2,"D",1,0,"H",1.37,5.38,8,"1-0","2-2",15,6,12,6,2,1,0,0,8,2,5,7,4,10,12,"8-2","Y","Y","Y",3,0,19
"4484","B1",2023-12-23,"St Truiden","Charleroi",1,0,"H",0,0,"D",2.32,3.34,3.3,"0-0","1-0",16,7,4,0,0,0,0,0,6,3,4,17,1,9,21,"6-3","N","N","N",0,0,19
"4485","B1",2023-12-23,"Anderlecht","Genk",2,1,"H",0,0,"D",2.35,3.58,3.04,"0-0","2-1",9,3,20,7,1,2,0,0,1,8,7,15,3,9,22,"1-8","Y","Y","N",3,0,19
"4486","B1",2023-12-26,"Genk","Antwerp",3,0,"H",1,0,"H",2.18,3.81,3.2,"1-0","3-0",16,8,3,1,1,3,0,0,3,3,8,9,3,6,17,"3-3","Y","Y","N",4,0,20
"4487","B1",2023-12-26,"Kortrijk","Gent",0,2,"A",0,1,"A",8.48,5.57,1.35,"0-1","0-2",7,3,20,9,1,1,0,0,4,5,9,10,2,9,19,"4-5","Y","N","N",2,0,20
"4488","B1",2023-12-26,"Oud-Heverlee Leuven","Eupen",3,0,"H",2,0,"H",1.85,3.99,4.09,"2-0","3-0",18,7,14,6,2,2,0,0,7,3,6,15,3,10,21,"7-3","Y","Y","N",4,0,20
"4489","B1",2023-12-26,"Westerlo","RWD Molenbeek",3,0,"H",1,0,"H",1.88,3.83,4.15,"1-0","3-0",13,3,11,4,0,0,0,1,6,0,7,12,3,6,19,"6-0","Y","Y","N",0,1,20
"4490","B1",2023-12-26,"Club Brugge","St. Gilloise",1,1,"D",0,1,"A",2.34,3.45,3.06,"0-1","1-1",9,2,7,3,1,5,0,1,6,0,15,14,2,6,29,"6-0","Y","N","N",6,1,20
"4491","B1",2023-12-27,"Standard","St Truiden",1,1,"D",0,0,"D",2.37,3.34,3.1,"0-0","1-1",11,2,18,8,1,3,0,0,4,4,14,14,2,8,28,"4-4","Y","N","N",4,0,20
"4492","B1",2023-12-27,"Anderlecht","Cercle Brugge",2,0,"H",1,0,"H",1.89,3.96,3.77,"1-0","2-0",7,4,19,7,1,1,0,0,2,12,9,13,2,14,22,"2-12","Y","N","N",2,0,20
"4493","B1",2023-12-27,"Charleroi","Mechelen",3,1,"H",2,0,"H",2.19,3.36,3.44,"2-0","3-1",16,6,11,5,2,1,0,0,5,7,10,9,4,12,19,"5-7","Y","Y","Y",3,0,20
"4494","B1",2024-01-19,"Gent","Mechelen",1,2,"A",0,1,"A",1.55,4.39,6.07,"0-1","1-2",23,7,9,2,2,4,0,0,8,4,4,15,3,12,19,"8-4","Y","Y","N",6,0,21
"4495","B1",2024-01-20,"Genk","Cercle Brugge",1,1,"D",0,1,"A",1.83,3.97,4.18,"0-1","1-1",12,3,19,6,2,2,0,0,4,5,15,15,2,9,30,"4-5","Y","N","N",4,0,21
"4496","B1",2024-01-20,"Standard","Kortrijk",0,1,"A",0,1,"A",1.56,4.28,6.11,"0-1","0-1",20,4,5,2,0,1,0,0,7,4,7,13,1,11,20,"7-4","N","N","N",1,0,21
"4497","B1",2024-01-20,"Club Brugge","Westerlo",3,0,"H",1,0,"H",1.27,6.25,9.94,"1-0","3-0",14,9,2,0,0,3,0,1,3,0,4,12,3,3,16,"3-0","Y","Y","N",3,1,21
"4498","B1",2024-01-21,"Antwerp","Charleroi",4,1,"H",2,0,"H",1.71,4.03,4.87,"2-0","4-1",20,8,8,5,1,2,0,0,5,6,7,12,5,11,19,"5-6","Y","Y","Y",3,0,21
"4499","B1",2024-01-21,"St. Gilloise","St Truiden",2,1,"H",1,1,"D",1.34,5.23,9.04,"1-1","2-1",16,5,5,2,2,5,0,0,7,1,5,9,3,8,14,"7-1","Y","Y","N",7,0,21
"4500","B1",2024-01-21,"Oud-Heverlee Leuven","Anderlecht",1,1,"D",1,0,"H",4.69,4.15,1.68,"1-0","1-1",8,4,12,4,2,2,0,0,5,3,8,10,2,8,18,"5-3","Y","N","N",4,0,21
"4501","B1",2024-01-24,"RWD Molenbeek","Eupen",0,1,"A",0,0,"D",1.87,3.74,4.07,"0-0","0-1",8,3,11,6,2,3,0,0,1,4,13,14,1,5,27,"1-4","N","N","N",5,0,21
"4502","B1",2024-01-26,"Cercle Brugge","Standard",1,1,"D",0,0,"D",1.53,4.52,6.17,"0-0","1-1",26,7,11,2,2,1,0,0,5,4,8,13,2,9,21,"5-4","Y","N","N",3,0,22
"4503","B1",2024-01-27,"Kortrijk","Oud-Heverlee Leuven",0,0,"D",0,0,"D",2.99,3.63,2.37,"0-0","0-0",13,3,8,2,3,1,0,0,6,5,7,16,0,11,23,"6-5","N","N","N",4,0,22
"4504","B1",2024-01-27,"Charleroi","Club Brugge",1,4,"A",0,3,"A",6.26,4.48,1.53,"0-3","1-4",14,6,17,7,0,1,0,0,3,5,10,11,5,8,21,"3-5","Y","Y","Y",1,0,22
"4505","B1",2024-01-27,"Gent","Westerlo",2,2,"D",1,1,"D",1.4,5.24,7.6,"1-1","2-2",14,5,11,6,3,7,0,0,5,3,16,19,4,8,35,"5-3","Y","Y","Y",10,0,22
"4506","B1",2024-01-28,"St Truiden","Genk",1,1,"D",0,1,"A",4.01,3.66,1.91,"0-1","1-1",12,4,10,3,2,4,0,2,5,7,13,14,2,12,27,"5-7","Y","N","N",6,2,22
"4507","B1",2024-01-28,"Eupen","Antwerp",1,0,"H",1,0,"H",7.52,5.27,1.37,"1-0","1-0",9,3,15,2,4,2,0,0,3,6,16,8,1,9,24,"3-6","N","N","N",6,0,22
"4508","B1",2024-01-28,"Anderlecht","St. Gilloise",2,2,"D",1,2,"A",3.21,3.67,2.17,"1-2","2-2",11,2,14,8,3,2,0,0,7,6,15,13,4,13,28,"7-6","Y","Y","Y",5,0,22
"4509","B1",2024-01-28,"Mechelen","RWD Molenbeek",3,1,"H",0,0,"D",1.72,3.84,4.8,"0-0","3-1",24,8,6,3,0,2,0,1,14,0,9,12,4,14,21,"14-0","Y","Y","Y",2,1,22
"4510","B1",2024-01-30,"Club Brugge","Kortrijk",3,3,"D",1,0,"H",1.12,10,21.28,"1-0","3-3",31,10,7,5,1,2,0,0,11,0,7,10,6,11,17,"11-0","Y","Y","Y",3,0,23
"4511","B1",2024-01-30,"Westerlo","Cercle Brugge",4,2,"H",4,1,"H",4.22,3.8,1.87,"4-1","4-2",9,5,14,3,3,5,1,0,2,6,10,25,6,8,35,"2-6","Y","Y","Y",8,1,23
"4512","B1",2024-01-31,"Charleroi","Eupen",1,0,"H",0,0,"D",1.68,4.04,5.13,"0-0","1-0",12,3,7,2,1,0,0,0,2,10,12,12,1,12,24,"2-10","N","N","N",1,0,23
"4513","B1",2024-01-31,"Oud-Heverlee Leuven","Genk",2,1,"H",0,0,"D",4.95,4.22,1.67,"0-0","2-1",12,4,15,2,2,5,0,0,2,4,15,21,3,6,36,"2-4","Y","Y","N",7,0,23
"4514","B1",2024-01-31,"St. Gilloise","RWD Molenbeek",3,2,"H",2,0,"H",1.19,7.65,13.86,"2-0","3-2",11,5,8,2,2,2,0,0,3,2,11,15,5,5,26,"3-2","Y","Y","Y",4,0,23
"4515","B1",2024-01-31,"Standard","Antwerp",0,1,"A",0,0,"D",3.9,3.89,1.92,"0-0","0-1",15,4,4,2,1,3,0,1,4,2,11,14,1,6,25,"4-2","N","N","N",4,1,23
"4516","B1",2024-02-01,"Mechelen","Anderlecht",2,2,"D",0,1,"A",3.28,3.48,2.21,"0-1","2-2",14,7,16,4,2,1,0,0,5,4,10,9,4,9,19,"5-4","Y","Y","Y",3,0,23
"4517","B1",2024-02-01,"St Truiden","Gent",4,1,"H",0,1,"A",3.58,3.62,2.04,"0-1","4-1",23,12,4,1,2,0,0,1,9,1,6,6,5,10,12,"9-1","Y","Y","Y",2,1,23
"4518","B1",2024-02-03,"RWD Molenbeek","Standard",2,2,"D",1,1,"D",3.14,3.33,2.42,"1-1","2-2",12,4,13,4,1,4,0,0,4,3,15,12,4,7,27,"4-3","Y","Y","Y",5,0,24
"4519","B1",2024-02-03,"Kortrijk","Charleroi",1,0,"H",1,0,"H",3.33,3.57,2.21,"1-0","1-0",11,4,7,1,1,1,0,0,5,4,10,20,1,9,30,"5-4","N","N","N",2,0,24
"4520","B1",2024-02-03,"Westerlo","Oud-Heverlee Leuven",0,3,"A",0,2,"A",2.06,3.77,3.54,"0-2","0-3",11,7,9,6,0,2,0,0,15,5,8,12,3,20,20,"15-5","Y","Y","N",2,0,24
"4521","B1",2024-02-03,"Genk","St. Gilloise",0,1,"A",0,0,"D",2.87,3.54,2.49,"0-0","0-1",10,3,12,4,1,4,0,0,8,3,18,13,1,11,31,"8-3","N","N","N",5,0,24
"4522","B1",2024-02-04,"Antwerp","Club Brugge",2,1,"H",0,0,"D",3.86,3.69,1.98,"0-0","2-1",11,3,13,4,2,4,0,1,5,9,9,18,3,14,27,"5-9","Y","Y","N",6,1,24
"4523","B1",2024-02-04,"Eupen","Mechelen",0,1,"A",0,0,"D",3.09,3.5,2.3,"0-0","0-1",18,5,4,1,1,0,1,0,8,4,17,8,1,12,25,"8-4","N","N","N",1,1,24
"4524","B1",2024-02-04,"Anderlecht","Gent",1,0,"H",1,0,"H",2.27,3.42,3.21,"1-0","1-0",11,3,13,4,1,4,0,0,5,5,6,12,1,10,18,"5-5","N","N","N",5,0,24
"4525","B1",2024-02-04,"Cercle Brugge","St Truiden",4,1,"H",2,0,"H",1.85,3.8,4.08,"2-0","4-1",17,6,6,3,2,2,0,0,6,8,17,8,5,14,25,"6-8","Y","Y","Y",4,0,24
"4526","B1",2024-02-09,"St Truiden","Kortrijk",1,0,"H",1,0,"H",1.53,4.44,6.28,"1-0","1-0",15,3,10,2,0,2,0,0,5,3,8,11,1,8,19,"5-3","N","N","N",2,0,25
"4527","B1",2024-02-10,"Standard","Oud-Heverlee Leuven",1,0,"H",1,0,"H",2,3.55,3.93,"1-0","1-0",11,5,8,2,3,3,0,0,7,9,10,18,1,16,28,"7-9","N","N","N",6,0,25
"4528","B1",2024-02-10,"St. Gilloise","Westerlo",2,2,"D",1,1,"D",1.26,6.27,10.93,"1-1","2-2",17,3,9,4,4,2,0,0,4,4,14,8,4,8,22,"4-4","Y","Y","Y",6,0,25
"4529","B1",2024-02-10,"Club Brugge","Eupen",4,0,"H",2,0,"H",1.22,7.44,11.44,"2-0","4-0",21,6,4,1,0,2,0,0,7,4,8,11,4,11,19,"7-4","Y","Y","Y",2,0,25
"4530","B1",2024-02-11,"RWD Molenbeek","Antwerp",0,4,"A",0,3,"A",5.54,4.29,1.61,"0-3","0-4",2,1,13,9,3,0,1,0,5,3,15,11,4,8,26,"5-3","Y","Y","Y",3,1,25
"4531","B1",2024-02-11,"Mechelen","Genk",1,1,"D",1,1,"D",3.67,3.67,1.99,"1-1","1-1",11,2,14,1,1,2,0,0,5,3,10,12,2,8,22,"5-3","Y","N","N",3,0,25
"4532","B1",2024-02-11,"Charleroi","Anderlecht",1,3,"A",1,2,"A",3.73,3.53,2.02,"1-2","1-3",16,6,8,4,0,0,0,0,5,2,11,7,4,7,18,"5-2","Y","Y","Y",0,0,25
"4533","B1",2024-02-11,"Gent","Cercle Brugge",1,2,"A",0,1,"A",2.18,3.73,3.13,"0-1","1-2",20,10,11,2,1,3,0,1,12,3,11,11,3,15,22,"12-3","Y","Y","N",4,1,25
"4534","B1",2024-02-16,"Westerlo","Standard",2,1,"H",1,1,"D",2.47,3.3,3.07,"1-1","2-1",13,5,12,2,1,1,0,0,3,5,14,10,3,8,24,"3-5","Y","Y","N",2,0,26
"4535","B1",2024-02-17,"Genk","RWD Molenbeek",3,1,"H",2,1,"H",1.26,6.23,10.85,"2-1","3-1",21,9,11,5,1,2,0,0,6,8,9,12,4,14,21,"6-8","Y","Y","Y",3,0,26
"4536","B1",2024-02-17,"Oud-Heverlee Leuven","Charleroi",0,0,"D",0,0,"D",2.46,3.32,3.08,"0-0","0-0",17,0,6,0,2,5,0,1,13,1,17,15,0,14,32,"13-1","N","N","N",7,1,26
"4537","B1",2024-02-17,"Antwerp","Mechelen",0,1,"A",0,0,"D",1.58,4.27,5.79,"0-0","0-1",15,3,6,4,2,2,0,0,6,2,9,12,1,8,21,"6-2","N","N","N",4,0,26
"4538","B1",2024-02-18,"Cercle Brugge","Club Brugge",1,1,"D",0,0,"D",3.35,3.72,2.09,"0-0","1-1",7,4,13,3,0,4,0,1,0,4,14,11,2,4,25,"0-4","Y","N","N",4,1,26
"4539","B1",2024-02-18,"Kortrijk","St. Gilloise",1,3,"A",0,2,"A",7.76,5.2,1.37,"0-2","1-3",6,2,18,9,4,1,0,0,5,6,11,15,4,11,26,"5-6","Y","Y","Y",5,0,26
"4540","B1",2024-02-18,"Anderlecht","St Truiden",4,1,"H",0,1,"A",1.61,4.22,5.28,"0-1","4-1",17,8,12,4,1,1,0,0,2,2,9,11,5,4,20,"2-2","Y","Y","Y",2,0,26
"4541","B1",2024-02-18,"Eupen","Gent",0,2,"A",0,1,"A",4.75,4.04,1.69,"0-1","0-2",4,3,8,4,3,1,0,0,4,3,18,14,2,7,32,"4-3","Y","N","N",4,0,26
"4542","B1",2024-02-23,"Charleroi","Genk",0,1,"A",0,0,"D",3.59,3.67,2.07,"0-0","0-1",6,4,19,7,2,2,0,0,3,6,14,13,1,9,27,"3-6","N","N","N",4,0,27
"4543","B1",2024-02-24,"RWD Molenbeek","Oud-Heverlee Leuven",1,1,"D",1,1,"D",2.87,3.43,2.54,"1-1","1-1",10,3,9,3,0,3,0,0,5,6,10,9,2,11,19,"5-6","Y","N","N",3,0,27
"4544","B1",2024-02-24,"St Truiden","Westerlo",1,0,"H",1,0,"H",2.08,3.58,3.65,"1-0","1-0",15,3,12,3,1,1,0,0,8,2,9,11,1,10,20,"8-2","N","N","N",2,0,27
"4545","B1",2024-02-24,"Mechelen","Kortrijk",3,0,"H",1,0,"H",1.66,4.07,5.34,"1-0","3-0",9,4,11,1,0,0,0,0,4,4,2,8,3,8,10,"4-4","Y","Y","N",0,0,27
"4546","B1",2024-02-25,"Club Brugge","Anderlecht",1,2,"A",1,0,"H",1.76,3.93,4.7,"1-0","1-2",16,6,11,6,0,4,0,0,5,3,14,16,3,8,30,"5-3","Y","Y","N",4,0,27
"4547","B1",2024-02-25,"Gent","Antwerp",2,2,"D",2,1,"H",2.53,3.4,2.81,"2-1","2-2",13,5,8,5,1,2,0,0,7,4,13,8,4,11,21,"7-4","Y","Y","Y",3,0,27
"4548","B1",2024-02-25,"St. Gilloise","Standard",2,1,"H",2,0,"H",1.39,4.94,7.61,"2-0","2-1",12,7,8,4,1,3,0,0,5,4,9,17,3,9,26,"5-4","Y","Y","N",4,0,27
"4549","B1",2024-02-25,"Eupen","Cercle Brugge",0,2,"A",0,0,"D",4.71,3.99,1.71,"0-0","0-2",12,1,17,8,2,3,0,0,5,4,10,12,2,9,22,"5-4","Y","N","N",5,0,27
"4550","B1",2024-03-01,"Westerlo","Charleroi",0,1,"A",0,0,"D",1.95,3.52,4.19,"0-0","0-1",15,3,7,1,1,4,0,0,5,1,11,12,1,6,23,"5-1","N","N","N",5,0,28
"4551","B1",2024-03-02,"Cercle Brugge","Mechelen",2,3,"A",2,2,"D",1.96,3.63,4.02,"2-2","2-3",12,5,15,6,1,2,0,0,7,6,9,9,5,13,18,"7-6","Y","Y","Y",3,0,28
"4552","B1",2024-03-02,"Oud-Heverlee Leuven","St. Gilloise",0,2,"A",0,1,"A",6.04,4.72,1.52,"0-1","0-2",9,2,9,2,3,3,0,0,4,6,10,11,2,10,21,"4-6","Y","N","N",6,0,28
"4553","B1",2024-03-02,"Standard","Gent",4,2,"H",1,1,"D",3.2,3.5,2.29,"1-1","4-2",19,7,11,7,3,1,0,1,9,5,13,10,6,14,23,"9-5","Y","Y","Y",4,1,28
"4554","B1",2024-03-03,"Genk","Club Brugge",0,3,"A",0,1,"A",3.09,3.67,2.28,"0-1","0-3",10,5,12,5,2,2,0,0,4,6,13,8,3,10,21,"4-6","Y","Y","N",4,0,28
"4555","B1",2024-03-03,"Antwerp","St Truiden",3,0,"H",0,0,"D",1.67,4.01,5.01,"0-0","3-0",19,11,4,0,0,0,0,0,11,3,13,15,3,14,28,"11-3","Y","Y","N",0,0,28
"4556","B1",2024-03-03,"Anderlecht","Eupen",1,0,"H",1,0,"H",1.29,5.72,9.87,"1-0","1-0",14,5,15,3,2,1,0,0,8,4,12,20,1,12,32,"8-4","N","N","N",3,0,28
"4557","B1",2024-03-03,"Kortrijk","RWD Molenbeek",3,2,"H",1,1,"D",2.48,3.39,2.89,"1-1","3-2",17,7,12,4,1,3,0,0,8,5,10,14,5,13,24,"8-5","Y","Y","Y",4,0,28
"4558","B1",2024-03-08,"Mechelen","Westerlo",3,1,"H",2,0,"H",1.96,3.46,4.23,"2-0","3-1",10,4,21,4,0,1,0,0,3,3,7,8,4,6,15,"3-3","Y","Y","Y",1,0,29
"4559","B1",2024-03-09,"Kortrijk","Antwerp",0,1,"A",0,1,"A",6.79,4.79,1.47,"0-1","0-1",3,1,15,5,0,1,0,0,3,10,9,10,1,13,19,"3-10","N","N","N",1,0,29
"4560","B1",2024-03-09,"Charleroi","Cercle Brugge",0,0,"D",0,0,"D",3.74,3.63,2.04,"0-0","0-0",6,2,11,2,1,1,0,1,2,8,15,17,0,10,32,"2-8","N","N","N",2,1,29
"4561","B1",2024-03-09,"RWD Molenbeek","Anderlecht",0,3,"A",0,3,"A",6.15,4.49,1.53,"0-3","0-3",10,2,11,5,3,1,0,0,4,3,11,9,3,7,20,"4-3","Y","Y","N",4,0,29
"4562","B1",2024-03-10,"Genk","Standard",1,0,"H",0,0,"D",1.63,4.23,5.44,"0-0","1-0",19,5,6,4,0,2,0,0,7,5,6,11,1,12,17,"7-5","N","N","N",2,0,29
"4563","B1",2024-03-10,"Club Brugge","Oud-Heverlee Leuven",3,1,"H",1,1,"D",1.29,6,9.06,"1-1","3-1",20,8,7,2,0,2,0,0,10,5,13,10,4,15,23,"10-5","Y","Y","Y",2,0,29
"4564","B1",2024-03-10,"St. Gilloise","Gent",1,1,"D",0,0,"D",1.65,4.11,5.02,"0-0","1-1",18,5,11,6,3,1,0,0,8,3,4,11,2,11,15,"8-3","Y","N","N",4,0,29
"4565","B1",2024-03-10,"Eupen","St Truiden",1,0,"H",1,0,"H",3.46,3.39,2.17,"1-0","1-0",7,2,17,5,3,1,0,0,4,3,12,15,1,7,27,"4-3","N","N","N",4,0,29
"4566","B1",2024-03-16,"Standard","Eupen",4,0,"H",2,0,"H",1.72,3.84,5.14,"2-0","4-0",13,5,9,5,0,0,0,0,5,5,2,17,4,10,19,"5-5","Y","Y","Y",0,0,30
"4567","B1",2024-03-16,"Anderlecht","Kortrijk",0,1,"A",0,0,"D",1.25,6.45,11.44,"0-0","0-1",17,5,11,4,1,2,0,0,5,6,7,13,1,11,20,"5-6","N","N","N",3,0,30
"4568","B1",2024-03-17,"St Truiden","Club Brugge",2,1,"H",0,1,"A",5.54,4.22,1.62,"0-1","2-1",13,5,19,8,0,1,0,0,4,8,5,10,3,12,15,"4-8","Y","Y","N",1,0,30
"4569","B1",2024-03-17,"Antwerp","St. Gilloise",1,1,"D",0,0,"D",2.66,3.53,2.6,"0-0","1-1",9,3,13,4,3,5,0,1,4,3,12,12,2,7,24,"4-3","Y","N","N",8,1,30
"4570","B1",2024-03-17,"Cercle Brugge","RWD Molenbeek",4,0,"H",2,0,"H",1.36,5.3,7.85,"2-0","4-0",20,8,4,1,1,4,0,1,11,4,6,11,4,15,17,"11-4","Y","Y","Y",5,1,30
"4571","B1",2024-03-17,"Gent","Charleroi",5,0,"H",2,0,"H",1.57,4.23,5.7,"2-0","5-0",13,9,12,5,0,2,0,0,1,6,8,10,5,7,18,"1-6","Y","Y","Y",2,0,30
"4572","B1",2024-03-17,"Oud-Heverlee Leuven","Mechelen",1,0,"H",0,0,"D",2.78,3.42,2.55,"0-0","1-0",14,4,16,5,4,1,0,0,3,6,14,9,1,9,23,"3-6","N","N","N",5,0,30
"4573","B1",2024-03-17,"Westerlo","Genk",1,1,"D",0,0,"D",3.87,3.35,2.05,"0-0","1-1",12,4,9,2,4,1,0,1,5,6,10,13,2,11,23,"5-6","Y","N","N",5,1,30
"2286","D1",2023-08-18,"Werder Bremen","Bayern Munich",0,4,"A",0,1,"A",8.59,6.36,1.33,"0-1","0-4",6,1,25,10,2,1,0,0,0,6,16,11,4,6,27,"0-6","Y","Y","Y",3,0,1
"2287","D1",2023-08-19,"Augsburg","Mgladbach",4,4,"D",3,3,"D",2.74,3.78,2.51,"3-3","4-4",20,8,9,6,1,2,0,0,8,7,9,14,8,15,23,"8-7","Y","Y","Y",3,0,1
"2288","D1",2023-08-19,"Hoffenheim","Freiburg",1,2,"A",0,2,"A",2.43,3.67,2.92,"0-2","1-2",24,5,17,8,0,1,0,0,4,2,9,9,3,6,18,"4-2","Y","Y","N",1,0,1
"2289","D1",2023-08-19,"Leverkusen","RB Leipzig",3,2,"H",2,1,"H",2.5,3.61,2.85,"2-1","3-2",11,7,13,6,1,2,0,0,4,5,13,10,5,9,23,"4-5","Y","Y","Y",3,0,1
"2290","D1",2023-08-19,"Stuttgart","Bochum",5,0,"H",2,0,"H",1.7,4.25,4.78,"2-0","5-0",19,9,4,1,1,1,0,0,7,0,5,12,5,7,17,"7-0","Y","Y","Y",2,0,1
"2291","D1",2023-08-19,"Wolfsburg","Heidenheim",2,0,"H",2,0,"H",1.62,4.49,5.24,"2-0","2-0",18,8,13,1,3,0,0,0,1,7,10,9,2,8,19,"1-7","Y","N","N",3,0,1
"2292","D1",2023-08-19,"Dortmund","FC Koln",1,0,"H",0,0,"D",1.41,5.42,7.25,"0-0","1-0",12,2,11,4,1,0,0,0,6,3,13,11,1,9,24,"6-3","N","N","N",1,0,1
"2293","D1",2023-08-20,"Union Berlin","Mainz",4,1,"H",2,0,"H",2.02,3.5,4.02,"2-0","4-1",12,7,9,3,1,5,0,0,3,1,15,16,5,4,31,"3-1","Y","Y","Y",6,0,1
"2294","D1",2023-08-20,"Ein Frankfurt","Darmstadt",1,0,"H",1,0,"H",1.4,5.42,7.44,"1-0","1-0",10,4,11,2,2,3,0,0,7,3,9,14,1,10,23,"7-3","N","N","N",5,0,1
"2295","D1",2023-08-25,"RB Leipzig","Stuttgart",5,1,"H",0,1,"A",1.53,4.69,6.14,"0-1","5-1",20,11,8,3,1,1,0,0,4,4,12,10,6,8,22,"4-4","Y","Y","Y",2,0,2
"2296","D1",2023-08-26,"Bochum","Dortmund",1,1,"D",1,0,"H",6.63,5.36,1.44,"1-0","1-1",17,6,13,3,2,1,0,0,5,4,21,7,2,9,28,"5-4","Y","N","N",3,0,2
"2297","D1",2023-08-26,"Darmstadt","Union Berlin",1,4,"A",1,3,"A",3.94,3.42,2.08,"1-3","1-4",18,6,12,6,2,2,0,1,3,5,15,12,5,8,27,"3-5","Y","Y","Y",4,1,2
"2298","D1",2023-08-26,"FC Koln","Wolfsburg",1,2,"A",0,0,"D",2.41,3.53,3.04,"0-0","1-2",14,2,9,6,1,5,0,0,6,1,6,10,3,7,16,"6-1","Y","Y","N",6,0,2
"2299","D1",2023-08-26,"Freiburg","Werder Bremen",1,0,"H",0,0,"D",1.72,4.15,4.76,"0-0","1-0",23,6,16,2,2,2,0,0,5,5,9,8,1,10,17,"5-5","N","N","N",4,0,2
"2300","D1",2023-08-26,"Heidenheim","Hoffenheim",2,3,"A",1,0,"H",2.96,3.81,2.34,"1-0","2-3",19,9,16,6,1,5,0,0,10,6,13,9,5,16,22,"10-6","Y","Y","Y",6,0,2
"2301","D1",2023-08-26,"Mgladbach","Leverkusen",0,3,"A",0,2,"A",3.73,4.2,1.91,"0-2","0-3",13,2,24,10,2,3,0,0,5,8,7,8,3,13,15,"5-8","Y","Y","N",5,0,2
"2302","D1",2023-08-27,"Mainz","Ein Frankfurt",1,1,"D",1,0,"H",2.39,3.74,2.92,"1-0","1-1",13,7,8,2,3,4,0,1,5,4,23,12,2,9,35,"5-4","Y","N","N",7,1,2
"2303","D1",2023-08-27,"Bayern Munich","Augsburg",3,1,"H",2,0,"H",1.09,14.24,22.48,"2-0","3-1",19,6,11,2,1,2,0,0,10,4,13,8,4,14,21,"10-4","Y","Y","Y",3,0,2
"2304","D1",2023-09-01,"Dortmund","Heidenheim",2,2,"D",2,0,"H",1.26,7.07,10.23,"2-0","2-2",20,9,15,6,3,3,0,0,3,6,9,22,4,9,31,"3-6","Y","Y","Y",6,0,3
"2305","D1",2023-09-02,"Augsburg","Bochum",2,2,"D",1,1,"D",2.09,3.67,3.61,"1-1","2-2",11,3,22,9,2,2,0,0,3,5,15,13,4,8,28,"3-5","Y","Y","Y",4,0,3
"2306","D1",2023-09-02,"Hoffenheim","Wolfsburg",3,1,"H",1,1,"D",2.48,3.86,2.73,"1-1","3-1",11,5,14,7,2,2,0,0,3,3,12,15,4,6,27,"3-3","Y","Y","Y",4,0,3
"2307","D1",2023-09-02,"Leverkusen","Darmstadt",5,1,"H",1,1,"D",1.2,7.79,13.72,"1-1","5-1",24,13,5,1,3,2,0,0,4,2,8,11,6,6,19,"4-2","Y","Y","Y",5,0,3
"2308","D1",2023-09-02,"Stuttgart","Freiburg",5,0,"H",3,0,"H",2.18,3.79,3.28,"3-0","5-0",13,6,11,5,1,1,0,0,2,4,9,10,5,6,19,"2-4","Y","Y","Y",2,0,3
"2309","D1",2023-09-02,"Werder Bremen","Mainz",4,0,"H",1,0,"H",2.76,3.55,2.61,"1-0","4-0",12,6,12,3,2,2,0,0,1,7,18,14,4,8,32,"1-7","Y","Y","Y",4,0,3
"2310","D1",2023-09-02,"Mgladbach","Bayern Munich",1,2,"A",1,0,"H",7.93,6.61,1.31,"1-0","1-2",8,3,25,9,0,2,0,0,1,15,5,20,3,16,25,"1-15","Y","Y","N",2,0,3
"2311","D1",2023-09-03,"Ein Frankfurt","FC Koln",1,1,"D",0,1,"A",2.18,3.49,3.54,"0-1","1-1",12,4,6,2,1,3,0,0,8,1,10,10,2,9,20,"8-1","Y","N","N",4,0,3
"2312","D1",2023-09-03,"Union Berlin","RB Leipzig",0,3,"A",0,0,"D",3.24,3.48,2.31,"0-0","0-3",4,1,15,8,3,1,1,0,3,7,16,9,3,10,25,"3-7","Y","Y","N",4,1,3
"2313","D1",2023-09-15,"Bayern Munich","Leverkusen",2,2,"D",1,1,"D",1.65,4.7,4.78,"1-1","2-2",15,9,12,5,0,3,0,0,7,4,6,6,4,11,12,"7-4","Y","Y","Y",3,0,4
"2314","D1",2023-09-16,"FC Koln","Hoffenheim",1,3,"A",0,2,"A",2.26,3.87,3.06,"0-2","1-3",17,7,17,5,4,4,1,0,13,4,15,14,4,17,29,"13-4","Y","Y","Y",8,1,4
"2315","D1",2023-09-16,"Freiburg","Dortmund",2,4,"A",2,1,"H",3.16,3.86,2.21,"2-1","2-4",14,4,14,6,2,3,1,0,6,8,12,16,6,14,28,"6-8","Y","Y","Y",5,1,4
"2316","D1",2023-09-16,"Mainz","Stuttgart",1,3,"A",0,0,"D",2.57,3.71,2.71,"0-0","1-3",15,3,16,6,1,2,0,0,6,4,12,9,4,10,21,"6-4","Y","Y","Y",3,0,4
"2317","D1",2023-09-16,"RB Leipzig","Augsburg",3,0,"H",3,0,"H",1.24,7.19,11.19,"3-0","3-0",9,6,16,4,0,0,0,0,1,6,16,12,3,7,28,"1-6","Y","Y","N",0,0,4
"2318","D1",2023-09-16,"Wolfsburg","Union Berlin",2,1,"H",2,1,"H",2.27,3.55,3.27,"2-1","2-1",8,3,17,5,1,0,0,0,3,7,6,8,3,10,14,"3-7","Y","Y","N",1,0,4
"2319","D1",2023-09-16,"Bochum","Ein Frankfurt",1,1,"D",0,0,"D",2.95,3.63,2.42,"0-0","1-1",24,10,8,6,3,2,0,0,8,2,13,14,2,10,27,"8-2","Y","N","N",5,0,4
"2320","D1",2023-09-17,"Heidenheim","Werder Bremen",4,2,"H",2,0,"H",2.39,3.88,2.85,"2-0","4-2",19,4,11,4,1,1,0,0,10,1,21,9,6,11,30,"10-1","Y","Y","Y",2,0,4
"2321","D1",2023-09-17,"Darmstadt","Mgladbach",3,3,"D",3,0,"H",3.01,3.74,2.34,"3-0","3-3",15,8,21,10,1,1,1,0,6,6,12,8,6,12,20,"6-6","Y","Y","Y",2,1,4
"2322","D1",2023-09-22,"Stuttgart","Darmstadt",3,1,"H",2,1,"H",1.4,5.24,8.18,"2-1","3-1",18,11,3,0,1,6,0,0,5,4,7,12,4,9,19,"5-4","Y","Y","Y",7,0,5
"2323","D1",2023-09-23,"Augsburg","Mainz",2,1,"H",2,1,"H",2.61,3.7,2.68,"2-1","2-1",6,3,13,3,2,3,1,0,3,4,16,14,3,7,30,"3-4","Y","Y","N",5,1,5
"2324","D1",2023-09-23,"Bayern Munich","Bochum",7,0,"H",4,0,"H",1.1,12.85,20.11,"4-0","7-0",26,16,4,1,0,1,0,0,8,1,8,10,7,9,18,"8-1","Y","Y","Y",1,0,5
"2325","D1",2023-09-23,"Dortmund","Wolfsburg",1,0,"H",0,0,"D",1.71,4.47,4.48,"0-0","1-0",18,4,8,2,0,1,0,0,5,3,9,14,1,8,23,"5-3","N","N","N",1,0,5
"2326","D1",2023-09-23,"Mgladbach","RB Leipzig",0,1,"A",0,0,"D",5.26,4.74,1.59,"0-0","0-1",13,1,8,4,1,1,0,0,11,6,14,7,1,17,21,"11-6","N","N","N",2,0,5
"2327","D1",2023-09-23,"Union Berlin","Hoffenheim",0,2,"A",0,2,"A",2.15,3.72,3.39,"0-2","0-2",22,6,11,4,1,3,0,0,11,6,11,13,2,17,24,"11-6","Y","N","N",4,0,5
"2328","D1",2023-09-23,"Werder Bremen","FC Koln",2,1,"H",1,1,"D",2.56,3.69,2.74,"1-1","2-1",17,6,13,5,2,1,0,0,9,8,18,16,3,17,34,"9-8","Y","Y","N",3,0,5
"2329","D1",2023-09-24,"Leverkusen","Heidenheim",4,1,"H",1,0,"H",1.23,7.35,11.42,"1-0","4-1",20,10,1,1,1,1,0,0,7,2,9,10,5,9,19,"7-2","Y","Y","Y",2,0,5
"2330","D1",2023-09-24,"Ein Frankfurt","Freiburg",0,0,"D",0,0,"D",2.16,3.66,3.42,"0-0","0-0",13,5,9,2,4,2,0,0,7,3,12,5,0,10,17,"7-3","N","N","N",6,0,5
"2331","D1",2023-09-29,"Hoffenheim","Dortmund",1,3,"A",1,2,"A",3.15,4.16,2.12,"1-2","1-3",15,5,6,5,3,4,0,1,4,3,14,16,4,7,30,"4-3","Y","Y","Y",7,1,6
"2332","D1",2023-09-30,"Bochum","Mgladbach",1,3,"A",0,3,"A",2.32,3.88,2.96,"0-3","1-3",23,5,25,9,2,3,0,0,5,10,12,12,4,15,24,"5-10","Y","Y","Y",5,0,6
"2333","D1",2023-09-30,"FC Koln","Stuttgart",0,2,"A",0,0,"D",2.89,3.64,2.46,"0-0","0-2",14,5,18,4,2,1,0,0,8,4,16,8,2,12,24,"8-4","Y","N","N",3,0,6
"2334","D1",2023-09-30,"Heidenheim","Union Berlin",1,0,"H",0,0,"D",3.05,3.72,2.32,"0-0","1-0",9,4,19,8,1,2,0,0,5,7,11,14,1,12,25,"5-7","N","N","N",3,0,6
"2335","D1",2023-09-30,"Mainz","Leverkusen",0,3,"A",0,1,"A",5.85,4.72,1.54,"0-1","0-3",10,3,6,3,4,1,0,0,3,1,13,11,3,4,24,"3-1","Y","Y","N",5,0,6
"2336","D1",2023-09-30,"Wolfsburg","Ein Frankfurt",2,0,"H",1,0,"H",2.11,3.53,3.68,"1-0","2-0",19,7,7,3,1,6,0,1,7,4,11,18,2,11,29,"7-4","Y","N","N",7,1,6
"2337","D1",2023-09-30,"RB Leipzig","Bayern Munich",2,2,"D",2,0,"H",3.73,4.2,1.91,"2-0","2-2",7,2,11,5,2,5,0,0,5,1,10,11,4,6,21,"5-1","Y","Y","Y",7,0,6
"2338","D1",2023-10-01,"Darmstadt","Werder Bremen",4,2,"H",2,0,"H",2.82,3.74,2.47,"2-0","4-2",14,5,10,7,3,2,0,0,2,4,19,19,6,6,38,"2-4","Y","Y","Y",5,0,6
"2339","D1",2023-10-01,"Freiburg","Augsburg",2,0,"H",1,0,"H",1.73,4.19,4.68,"1-0","2-0",7,3,13,4,2,2,0,0,2,3,13,17,2,5,30,"2-3","Y","N","N",4,0,6
"2340","D1",2023-10-06,"Mgladbach","Mainz",2,2,"D",1,1,"D",2.08,3.93,3.48,"1-1","2-2",20,9,13,7,3,1,0,0,10,3,9,9,4,13,18,"10-3","Y","Y","Y",4,0,7
"2341","D1",2023-10-07,"Augsburg","Darmstadt",1,2,"A",0,0,"D",1.92,3.9,3.98,"0-0","1-2",17,3,17,5,4,2,0,0,4,4,13,12,3,8,25,"4-4","Y","Y","N",6,0,7
"2342","D1",2023-10-07,"Dortmund","Union Berlin",4,2,"H",1,2,"A",1.61,4.51,5.28,"1-2","4-2",12,7,12,6,1,1,0,0,4,6,7,15,6,10,22,"4-6","Y","Y","Y",2,0,7
"2343","D1",2023-10-07,"RB Leipzig","Bochum",0,0,"D",0,0,"D",1.25,6.87,10.85,"0-0","0-0",18,5,9,2,2,4,0,0,9,1,10,13,0,10,23,"9-1","N","N","N",6,0,7
"2344","D1",2023-10-07,"Stuttgart","Wolfsburg",3,1,"H",0,1,"A",2.01,3.8,3.73,"0-1","3-1",13,7,12,5,1,3,0,0,5,6,13,14,4,11,27,"5-6","Y","Y","Y",4,0,7
"2345","D1",2023-10-07,"Werder Bremen","Hoffenheim",2,3,"A",1,2,"A",2.75,3.92,2.44,"1-2","2-3",13,3,11,4,5,4,0,0,4,4,15,6,5,8,21,"4-4","Y","Y","Y",9,0,7
"2346","D1",2023-10-08,"Leverkusen","FC Koln",3,0,"H",2,0,"H",1.34,5.68,9.07,"2-0","3-0",21,10,7,3,3,0,0,0,11,4,9,7,3,15,16,"11-4","Y","Y","N",3,0,7
"2347","D1",2023-10-08,"Bayern Munich","Freiburg",3,0,"H",2,0,"H",1.16,9.23,14.64,"2-0","3-0",21,5,2,0,1,0,0,0,7,1,7,8,3,8,15,"7-1","Y","Y","N",1,0,7
"2348","D1",2023-10-08,"Ein Frankfurt","Heidenheim",2,0,"H",1,0,"H",1.74,4.12,4.7,"1-0","2-0",12,6,7,2,2,3,0,0,3,6,14,10,2,9,24,"3-6","Y","N","N",5,0,7
"2349","D1",2023-10-20,"Dortmund","Werder Bremen",1,0,"H",0,0,"D",1.3,6.69,8.63,"0-0","1-0",22,5,6,1,1,5,0,0,10,4,5,10,1,14,15,"10-4","N","N","N",6,0,8
"2350","D1",2023-10-21,"Darmstadt","RB Leipzig",1,3,"A",1,2,"A",6.38,5.09,1.47,"1-2","1-3",16,3,10,7,6,3,0,0,6,0,16,12,4,6,28,"6-0","Y","Y","Y",9,0,8
"2351","D1",2023-10-21,"Freiburg","Bochum",2,1,"H",2,1,"H",1.76,4.02,4.73,"2-1","2-1",15,5,13,5,3,4,0,0,5,2,11,16,3,7,27,"5-2","Y","Y","N",7,0,8
"2352","D1",2023-10-21,"Hoffenheim","Ein Frankfurt",1,3,"A",1,3,"A",2.15,3.72,3.4,"1-3","1-3",14,5,13,5,3,0,0,0,6,3,7,7,4,9,14,"6-3","Y","Y","Y",3,0,8
"2353","D1",2023-10-21,"Union Berlin","Stuttgart",0,3,"A",0,1,"A",2.56,3.58,2.79,"0-1","0-3",10,2,10,5,2,1,0,0,4,2,12,12,3,6,24,"4-2","Y","Y","N",3,0,8
"2354","D1",2023-10-21,"Wolfsburg","Leverkusen",1,2,"A",1,1,"D",4.52,4.2,1.75,"1-1","1-2",18,7,13,6,3,5,0,0,4,3,15,14,3,7,29,"4-3","Y","Y","N",8,0,8
"2355","D1",2023-10-21,"Mainz","Bayern Munich",1,3,"A",1,2,"A",9.99,6.69,1.27,"1-2","1-3",14,3,12,5,3,2,0,0,2,7,12,10,4,9,22,"2-7","Y","Y","Y",5,0,8
"2356","D1",2023-10-22,"FC Koln","Mgladbach",3,1,"H",1,0,"H",2.37,3.77,2.93,"1-0","3-1",21,8,5,2,0,2,0,1,8,3,13,10,4,11,23,"8-3","Y","Y","Y",2,1,8
"2357","D1",2023-10-22,"Heidenheim","Augsburg",2,5,"A",2,3,"A",2.42,3.69,2.91,"2-3","2-5",16,5,9,6,3,2,0,0,6,5,11,11,7,11,22,"6-5","Y","Y","Y",5,0,8
"2358","D1",2023-10-27,"Bochum","Mainz",2,2,"D",1,0,"H",2.78,3.57,2.57,"1-0","2-2",10,4,10,4,3,3,0,0,5,4,14,21,4,9,35,"5-4","Y","Y","Y",6,0,9
"2359","D1",2023-10-28,"Augsburg","Wolfsburg",3,2,"H",1,2,"A",2.91,3.67,2.4,"1-2","3-2",9,5,13,6,6,4,1,0,5,5,19,14,5,10,33,"5-5","Y","Y","Y",10,1,9
"2360","D1",2023-10-28,"Bayern Munich","Darmstadt",8,0,"H",0,0,"D",1.07,16.22,27.11,"0-0","8-0",28,16,10,4,1,2,1,2,7,1,15,13,8,8,28,"7-1","Y","Y","Y",3,3,9
"2361","D1",2023-10-28,"Mgladbach","Heidenheim",2,1,"H",1,1,"D",1.8,4.26,4.16,"1-1","2-1",11,6,8,3,0,3,0,0,6,4,5,18,3,10,23,"6-4","Y","Y","N",3,0,9
"2362","D1",2023-10-28,"Stuttgart","Hoffenheim",2,3,"A",0,2,"A",1.88,4.15,3.82,"0-2","2-3",23,10,7,5,2,1,0,0,6,0,13,11,5,6,24,"6-0","Y","Y","Y",3,0,9
"2363","D1",2023-10-28,"Werder Bremen","Union Berlin",2,0,"H",1,0,"H",2.73,3.61,2.6,"1-0","2-0",9,3,7,2,1,4,0,1,3,3,12,14,2,6,26,"3-3","Y","N","N",5,1,9
"2364","D1",2023-10-28,"RB Leipzig","FC Koln",6,0,"H",4,0,"H",1.44,5.05,7.18,"4-0","6-0",24,13,6,1,2,4,0,1,11,1,8,13,6,12,21,"11-1","Y","Y","Y",6,1,9
"2365","D1",2023-10-29,"Ein Frankfurt","Dortmund",3,3,"D",2,1,"H",3.31,3.73,2.18,"2-1","3-3",11,7,14,4,3,2,0,0,0,4,11,10,6,4,21,"0-4","Y","Y","Y",5,0,9
"2366","D1",2023-10-29,"Leverkusen","Freiburg",2,1,"H",1,0,"H",1.29,6.08,10.27,"1-0","2-1",19,4,10,4,0,2,0,0,11,4,9,10,3,15,19,"11-4","Y","Y","N",2,0,9
"2367","D1",2023-11-03,"Darmstadt","Bochum",1,2,"A",1,1,"D",2.41,3.61,2.98,"1-1","1-2",15,4,9,4,2,5,1,0,11,2,7,16,3,13,23,"11-2","Y","Y","N",7,1,10
"2368","D1",2023-11-04,"FC Koln","Augsburg",1,1,"D",1,1,"D",2.32,3.75,2.97,"1-1","1-1",28,12,18,3,1,4,0,0,10,2,10,10,2,12,20,"10-2","Y","N","N",5,0,10
"2369","D1",2023-11-04,"Freiburg","Mgladbach",3,3,"D",1,3,"A",2.08,4,3.31,"1-3","3-3",15,8,10,5,2,2,0,0,8,2,7,10,6,10,17,"8-2","Y","Y","Y",4,0,10
"2370","D1",2023-11-04,"Hoffenheim","Leverkusen",2,3,"A",0,2,"A",4.92,4.9,1.59,"0-2","2-3",12,7,10,4,3,2,0,0,4,3,6,10,5,7,16,"4-3","Y","Y","Y",5,0,10
"2371","D1",2023-11-04,"Mainz","RB Leipzig",2,0,"H",0,0,"D",5.42,4.56,1.58,"0-0","2-0",10,3,10,2,3,1,0,0,2,7,13,9,2,9,22,"2-7","Y","N","N",4,0,10
"2372","D1",2023-11-04,"Union Berlin","Ein Frankfurt",0,3,"A",0,2,"A",2.57,3.21,3.01,"0-2","0-3",10,3,4,3,0,1,0,0,9,1,13,8,3,10,21,"9-1","Y","Y","N",1,0,10
"2373","D1",2023-11-04,"Dortmund","Bayern Munich",0,4,"A",0,2,"A",3.77,4.42,1.84,"0-2","0-4",15,1,14,8,3,2,0,0,3,2,14,6,4,5,20,"3-2","Y","Y","Y",5,0,10
"2374","D1",2023-11-05,"Wolfsburg","Werder Bremen",2,2,"D",1,1,"D",1.74,4.29,4.37,"1-1","2-2",15,5,13,4,4,1,1,0,5,2,14,17,4,7,31,"5-2","Y","Y","Y",5,1,10
"2375","D1",2023-11-05,"Heidenheim","Stuttgart",2,0,"H",0,0,"D",4.59,4.39,1.69,"0-0","2-0",19,2,14,2,2,2,0,0,9,6,7,13,2,15,20,"9-6","Y","N","N",4,0,10
"2376","D1",2023-11-10,"Mgladbach","Wolfsburg",4,0,"H",2,0,"H",2.41,3.75,2.89,"2-0","4-0",16,8,12,4,1,3,0,0,8,5,7,12,4,13,19,"8-5","Y","Y","Y",4,0,11
"2377","D1",2023-11-11,"Augsburg","Hoffenheim",1,1,"D",0,1,"A",2.62,3.92,2.52,"0-1","1-1",11,6,12,6,1,2,0,0,3,5,9,11,2,8,20,"3-5","Y","N","N",3,0,11
"2378","D1",2023-11-11,"Bayern Munich","Heidenheim",4,2,"H",2,0,"H",1.06,18.13,28.2,"2-0","4-2",18,8,7,2,1,0,0,0,7,2,8,8,6,9,16,"7-2","Y","Y","Y",1,0,11
"2379","D1",2023-11-11,"Darmstadt","Mainz",0,0,"D",0,0,"D",3.04,3.72,2.3,"0-0","0-0",9,3,9,0,3,3,0,0,0,5,20,15,0,5,35,"0-5","N","N","N",6,0,11
"2380","D1",2023-11-11,"Stuttgart","Dortmund",2,1,"H",1,1,"D",2.61,3.85,2.56,"1-1","2-1",22,10,5,1,2,3,0,0,6,1,13,16,3,7,29,"6-1","Y","Y","N",5,0,11
"2381","D1",2023-11-11,"Bochum","FC Koln",1,1,"D",1,0,"H",2.46,3.7,2.81,"1-0","1-1",25,9,10,6,4,1,0,0,3,3,14,19,2,6,33,"3-3","Y","N","N",5,0,11
"2382","D1",2023-11-12,"Leverkusen","Union Berlin",4,0,"H",1,0,"H",1.29,6.09,10.4,"1-0","4-0",19,10,2,2,0,1,0,0,10,1,8,5,4,11,13,"10-1","Y","Y","Y",1,0,11
"2383","D1",2023-11-12,"Werder Bremen","Ein Frankfurt",2,2,"D",1,0,"H",3.01,3.6,2.36,"1-0","2-2",14,5,14,3,1,3,0,0,3,7,3,10,4,10,13,"3-7","Y","Y","Y",4,0,11
"2384","D1",2023-11-12,"RB Leipzig","Freiburg",3,1,"H",1,1,"D",1.46,4.96,6.59,"1-1","3-1",15,6,9,3,2,0,0,0,7,3,10,12,4,10,22,"7-3","Y","Y","Y",2,0,11
"2385","D1",2023-11-24,"FC Koln","Bayern Munich",0,1,"A",0,1,"A",10.64,6.78,1.25,"0-1","0-1",6,2,19,5,0,1,0,0,3,12,6,4,1,15,10,"3-12","N","N","N",1,0,12
"2386","D1",2023-11-25,"Dortmund","Mgladbach",4,2,"H",3,2,"H",1.48,5.38,5.62,"3-2","4-2",20,13,10,3,1,2,0,0,5,4,11,11,6,9,22,"5-4","Y","Y","Y",3,0,12
"2387","D1",2023-11-25,"Freiburg","Darmstadt",1,1,"D",1,1,"D",1.57,4.42,5.65,"1-1","1-1",16,3,7,1,2,0,0,0,11,2,15,15,2,13,30,"11-2","Y","N","N",2,0,12
"2388","D1",2023-11-25,"Union Berlin","Augsburg",1,1,"D",0,1,"A",2.01,3.65,3.79,"0-1","1-1",16,6,11,2,2,2,0,0,3,4,10,15,2,7,25,"3-4","Y","N","N",4,0,12
"2389","D1",2023-11-25,"Werder Bremen","Leverkusen",0,3,"A",0,2,"A",6.3,5.25,1.45,"0-2","0-3",2,1,13,4,3,1,0,0,1,6,15,4,3,7,19,"1-6","Y","Y","N",4,0,12
"2390","D1",2023-11-25,"Wolfsburg","RB Leipzig",2,1,"H",1,0,"H",3.79,3.97,1.93,"1-0","2-1",10,4,26,10,4,2,0,0,1,12,18,11,3,13,29,"1-12","Y","Y","N",6,0,12
"2391","D1",2023-11-25,"Ein Frankfurt","Stuttgart",1,2,"A",1,2,"A",2.65,3.7,2.6,"1-2","1-2",14,1,11,5,0,1,0,0,4,2,14,8,3,6,22,"4-2","Y","Y","N",1,0,12
"2392","D1",2023-11-26,"Heidenheim","Bochum",0,0,"D",0,0,"D",2.23,3.81,3.09,"0-0","0-0",9,3,9,2,4,3,0,0,6,5,14,7,0,11,21,"6-5","N","N","N",7,0,12
"2393","D1",2023-11-26,"Hoffenheim","Mainz",1,1,"D",0,1,"A",1.85,4.08,4.01,"0-1","1-1",15,6,15,6,4,4,0,0,4,5,9,14,2,9,23,"4-5","Y","N","N",8,0,12
"2394","D1",2023-12-01,"Darmstadt","FC Koln",0,1,"A",0,0,"D",2.66,3.54,2.71,"0-0","0-1",11,1,11,6,1,3,0,0,1,6,12,12,1,7,24,"1-6","N","N","N",4,0,13
"2395","D1",2023-12-02,"Bochum","Wolfsburg",3,1,"H",2,1,"H",2.67,3.6,2.62,"2-1","3-1",19,9,15,6,6,2,0,0,6,6,14,13,4,12,27,"6-6","Y","Y","Y",8,0,13
"2396","D1",2023-12-02,"Mgladbach","Hoffenheim",2,1,"H",0,0,"D",2.26,4.13,2.87,"0-0","2-1",9,3,17,5,2,2,0,0,6,3,12,14,3,9,26,"6-3","Y","Y","N",4,0,13
"2397","D1",2023-12-02,"RB Leipzig","Heidenheim",2,1,"H",2,1,"H",1.24,7.2,10.19,"2-1","2-1",23,8,7,1,2,2,0,0,5,3,13,16,3,8,29,"5-3","Y","Y","N",4,0,13
"2398","D1",2023-12-02,"Stuttgart","Werder Bremen",2,0,"H",1,0,"H",1.4,5.24,7.66,"1-0","2-0",17,6,11,3,1,0,0,0,6,7,7,9,2,13,16,"6-7","Y","N","N",1,0,13
"2399","D1",2023-12-03,"Mainz","Freiburg",0,1,"A",0,0,"D",2.29,3.56,3.16,"0-0","0-1",19,6,13,5,1,1,0,0,14,3,16,11,1,17,27,"14-3","N","N","N",2,0,13
"2400","D1",2023-12-03,"Leverkusen","Dortmund",1,1,"D",0,1,"A",1.68,4.46,4.59,"0-1","1-1",22,6,6,2,3,2,0,0,16,1,12,12,2,17,24,"16-1","Y","N","N",5,0,13
"2401","D1",2023-12-03,"Augsburg","Ein Frankfurt",2,1,"H",1,0,"H",2.69,3.6,2.61,"1-0","2-1",9,4,12,6,1,1,0,0,2,4,9,10,3,6,19,"2-4","Y","Y","N",2,0,13
"2402","D1",2023-12-08,"Hoffenheim","Bochum",3,1,"H",2,0,"H",1.73,4.32,4.52,"2-0","3-1",18,7,22,5,3,2,0,0,4,5,18,11,4,9,29,"4-5","Y","Y","Y",5,0,13
"2403","D1",2023-12-09,"Ein Frankfurt","Bayern Munich",5,1,"H",3,1,"H",8.96,6.05,1.31,"3-1","5-1",14,6,17,6,1,2,0,0,1,9,8,7,6,10,15,"1-9","Y","Y","Y",3,0,14
"2404","D1",2023-12-09,"Heidenheim","Darmstadt",3,2,"H",1,0,"H",2.07,3.73,3.53,"1-0","3-2",16,7,20,7,2,2,0,0,8,3,17,13,5,11,30,"8-3","Y","Y","Y",4,0,14
"2405","D1",2023-12-09,"Union Berlin","Mgladbach",3,1,"H",1,0,"H",2.18,3.68,3.29,"1-0","3-1",16,6,13,4,1,3,0,0,6,7,9,8,4,13,17,"6-7","Y","Y","Y",4,0,14
"2406","D1",2023-12-09,"Werder Bremen","Augsburg",2,0,"H",1,0,"H",2.45,3.71,2.81,"1-0","2-0",12,5,11,1,1,2,0,0,5,2,13,9,2,7,22,"5-2","Y","N","N",3,0,14
"2407","D1",2023-12-09,"Wolfsburg","Freiburg",0,1,"A",0,0,"D",2.29,3.78,3,"0-0","0-1",10,3,4,1,1,4,0,0,5,3,11,16,1,8,27,"5-3","N","N","N",5,0,14
"2408","D1",2023-12-09,"Dortmund","RB Leipzig",2,3,"A",1,1,"D",2.59,3.87,2.57,"1-1","2-3",18,6,24,8,1,3,1,0,6,6,6,11,5,12,17,"6-6","Y","Y","Y",4,1,14
"2409","D1",2023-12-10,"Stuttgart","Leverkusen",1,1,"D",1,0,"H",2.84,3.82,2.38,"1-0","1-1",22,12,20,6,1,1,0,0,8,8,8,7,2,16,15,"8-8","Y","N","N",2,0,14
"2410","D1",2023-12-10,"FC Koln","Mainz",0,0,"D",0,0,"D",2.48,3.44,2.95,"0-0","0-0",7,3,13,5,2,4,0,0,1,7,10,10,0,8,20,"1-7","N","N","N",6,0,14
"2411","D1",2023-12-15,"Mgladbach","Werder Bremen",2,2,"D",1,1,"D",2.01,4.02,3.54,"1-1","2-2",15,4,10,5,4,2,0,0,4,3,10,12,4,7,22,"4-3","Y","Y","Y",6,0,14
"2412","D1",2023-12-16,"Augsburg","Dortmund",1,1,"D",1,1,"D",3.64,4.24,1.91,"1-1","1-1",20,4,24,6,2,1,0,0,4,7,13,4,2,11,17,"4-7","Y","N","N",3,0,15
"2413","D1",2023-12-16,"Bochum","Union Berlin",3,0,"H",1,0,"H",2.68,3.48,2.68,"1-0","3-0",21,7,10,2,2,2,0,0,6,4,12,13,3,10,25,"6-4","Y","Y","N",4,0,15
"2414","D1",2023-12-16,"Darmstadt","Wolfsburg",0,1,"A",0,0,"D",3.29,3.61,2.21,"0-0","0-1",14,4,11,3,2,0,0,1,7,7,16,10,1,14,26,"7-7","N","N","N",2,1,15
"2415","D1",2023-12-16,"Mainz","Heidenheim",0,1,"A",0,1,"A",1.67,4.23,4.93,"0-1","0-1",16,4,5,2,3,3,0,0,8,1,9,20,1,9,29,"8-1","N","N","N",6,0,15
"2416","D1",2023-12-16,"RB Leipzig","Hoffenheim",3,1,"H",1,1,"D",1.45,5.3,6.22,"1-1","3-1",23,11,10,4,3,2,0,0,9,2,11,9,4,11,20,"9-2","Y","Y","Y",5,0,15
"2417","D1",2023-12-17,"Freiburg","FC Koln",2,0,"H",0,0,"D",1.82,3.75,4.57,"0-0","2-0",23,7,7,1,1,4,0,1,5,2,13,10,2,7,23,"5-2","Y","N","N",5,1,15
"2418","D1",2023-12-17,"Leverkusen","Ein Frankfurt",3,0,"H",1,0,"H",1.36,5.67,7.93,"1-0","3-0",14,6,4,2,1,1,0,0,5,5,4,13,3,10,17,"5-5","Y","Y","N",2,0,15
"2419","D1",2023-12-17,"Bayern Munich","Stuttgart",3,0,"H",1,0,"H",1.44,5.56,6.06,"1-0","3-0",17,8,5,2,0,3,0,0,6,2,7,8,3,8,15,"6-2","Y","Y","N",3,0,15
"2420","D1",2023-12-19,"Werder Bremen","RB Leipzig",1,1,"D",0,0,"D",5.13,4.76,1.6,"0-0","1-1",11,3,18,9,4,2,0,0,1,4,15,9,2,5,24,"1-4","Y","N","N",6,0,15
"2421","D1",2023-12-19,"Dortmund","Mainz",1,1,"D",1,1,"D",1.57,4.84,5.33,"1-1","1-1",21,8,11,6,0,4,0,0,6,1,11,14,2,7,25,"6-1","Y","N","N",4,0,16
"2422","D1",2023-12-19,"Hoffenheim","Darmstadt",3,3,"D",2,1,"H",1.45,5.14,6.78,"2-1","3-3",13,4,14,3,2,4,0,0,8,3,9,15,6,11,24,"8-3","Y","Y","Y",6,0,16
"2423","D1",2023-12-20,"Union Berlin","FC Koln",2,0,"H",0,0,"D",1.95,3.59,4.09,"0-0","2-0",12,8,15,7,0,0,0,0,4,5,10,7,2,9,17,"4-5","Y","N","N",0,0,16
"2424","D1",2023-12-20,"Ein Frankfurt","Mgladbach",2,1,"H",0,1,"A",1.88,3.98,4,"0-1","2-1",15,7,7,2,1,6,0,1,8,2,11,14,3,10,25,"8-2","Y","Y","N",7,1,16
"2425","D1",2023-12-20,"Heidenheim","Freiburg",3,2,"H",0,1,"A",2.9,3.58,2.44,"0-1","3-2",14,3,10,4,3,4,0,0,7,4,20,12,5,11,32,"7-4","Y","Y","Y",7,0,16
"2426","D1",2023-12-20,"Leverkusen","Bochum",4,0,"H",3,0,"H",1.18,8.42,13.23,"3-0","4-0",15,8,6,1,0,2,0,0,4,3,7,12,4,7,19,"4-3","Y","Y","Y",2,0,16
"2427","D1",2023-12-20,"Stuttgart","Augsburg",3,0,"H",2,0,"H",1.37,5.46,7.98,"2-0","3-0",17,7,6,5,0,4,0,0,4,4,8,14,3,8,22,"4-4","Y","Y","N",4,0,16
"2428","D1",2023-12-20,"Wolfsburg","Bayern Munich",1,2,"A",1,2,"A",7.64,5.7,1.37,"1-2","1-2",5,4,20,7,4,2,0,0,0,6,14,12,3,6,26,"0-6","Y","Y","N",6,0,16
"2429","D1",2024-01-12,"Bayern Munich","Hoffenheim",3,0,"H",1,0,"H",1.15,9.94,16.13,"1-0","3-0",27,12,12,4,1,3,0,1,11,2,8,6,3,13,14,"11-2","Y","Y","N",4,1,16
"2430","D1",2024-01-13,"Augsburg","Leverkusen",0,1,"A",0,0,"D",5.74,4.65,1.54,"0-0","0-1",2,0,25,6,3,1,0,0,0,12,11,4,1,12,15,"0-12","N","N","N",4,0,17
"2431","D1",2024-01-13,"FC Koln","Heidenheim",1,1,"D",1,0,"H",2.1,3.67,3.51,"1-0","1-1",13,6,10,2,2,1,0,0,9,6,12,11,2,15,23,"9-6","Y","N","N",3,0,17
"2432","D1",2024-01-13,"Freiburg","Union Berlin",0,0,"D",0,0,"D",2.1,3.62,3.54,"0-0","0-0",14,4,8,4,0,2,0,0,4,3,7,9,0,7,16,"4-3","N","N","N",2,0,17
"2433","D1",2024-01-13,"Mainz","Wolfsburg",1,1,"D",0,1,"A",2.25,3.47,3.33,"0-1","1-1",12,4,9,4,3,4,0,0,7,3,21,16,2,10,37,"7-3","Y","N","N",7,0,17
"2434","D1",2024-01-13,"RB Leipzig","Ein Frankfurt",0,1,"A",0,1,"A",1.45,4.99,6.78,"0-1","0-1",26,7,5,1,0,2,0,0,15,4,7,16,1,19,23,"15-4","N","N","N",2,0,17
"2435","D1",2024-01-13,"Darmstadt","Dortmund",0,3,"A",0,1,"A",5.5,4.91,1.53,"0-1","0-3",10,2,17,8,1,3,0,0,3,4,10,13,3,7,23,"3-4","Y","Y","N",4,0,17
"2436","D1",2024-01-14,"Bochum","Werder Bremen",1,1,"D",0,0,"D",2.21,3.78,3.16,"0-0","1-1",13,4,15,4,6,5,0,0,3,4,14,14,2,7,28,"3-4","Y","N","N",11,0,17
"2437","D1",2024-01-14,"Mgladbach","Stuttgart",3,1,"H",2,0,"H",3.67,4.14,1.92,"2-0","3-1",8,4,14,2,3,3,0,0,0,3,7,11,4,3,18,"0-3","Y","Y","Y",6,0,17
"2438","D1",2024-01-20,"Bochum","Stuttgart",1,0,"H",0,0,"D",3.66,3.9,1.98,"0-0","1-0",6,1,17,4,5,3,0,0,1,7,16,16,1,8,32,"1-7","N","N","N",8,0,17
"2439","D1",2024-01-20,"Darmstadt","Ein Frankfurt",2,2,"D",0,1,"A",3.91,3.71,1.96,"0-1","2-2",13,3,7,4,1,1,0,0,4,1,11,7,4,5,18,"4-1","Y","Y","Y",2,0,18
"2440","D1",2024-01-20,"FC Koln","Dortmund",0,4,"A",0,1,"A",4.27,4.29,1.76,"0-1","0-4",16,5,11,7,2,2,0,0,13,4,16,7,4,17,23,"13-4","Y","Y","Y",4,0,18
"2441","D1",2024-01-20,"Freiburg","Hoffenheim",3,2,"H",1,0,"H",2.07,3.83,3.44,"1-0","3-2",16,8,16,4,3,3,1,0,2,2,18,10,5,4,28,"2-2","Y","Y","Y",6,1,18
"2442","D1",2024-01-20,"Heidenheim","Wolfsburg",1,1,"D",1,1,"D",2.78,3.5,2.58,"1-1","1-1",12,3,12,3,0,1,0,0,4,2,11,10,2,6,21,"4-2","Y","N","N",1,0,18
"2443","D1",2024-01-20,"RB Leipzig","Leverkusen",2,3,"A",1,0,"H",2.44,3.78,2.79,"1-0","2-3",11,6,18,5,2,3,0,0,1,9,11,11,5,10,22,"1-9","Y","Y","Y",5,0,18
"2444","D1",2024-01-21,"Bayern Munich","Werder Bremen",0,1,"A",0,0,"D",1.08,11.78,20.98,"0-0","0-1",21,6,8,3,2,1,0,0,10,2,12,7,1,12,19,"10-2","N","N","N",3,0,18
"2445","D1",2024-01-21,"Mgladbach","Augsburg",1,2,"A",1,0,"H",1.91,3.98,3.61,"1-0","1-2",18,4,15,7,1,2,0,0,5,7,10,20,3,12,30,"5-7","Y","Y","N",3,0,18
"2446","D1",2024-01-24,"Bayern Munich","Union Berlin",1,0,"H",0,0,"D",1.15,8.7,17.25,"0-0","1-0",24,10,4,1,2,4,0,0,12,1,5,9,1,13,14,"12-1","N","N","N",6,0,18
"2447","D1",2024-01-26,"Ein Frankfurt","Mainz",1,0,"H",0,0,"D",2.17,3.44,3.54,"0-0","1-0",13,4,7,0,2,1,0,0,2,1,10,12,1,3,22,"2-1","N","N","N",3,0,18
"2448","D1",2024-01-27,"Augsburg","Bayern Munich",2,3,"A",0,2,"A",8.77,5.99,1.31,"0-2","2-3",14,7,13,4,2,6,0,0,4,5,12,11,5,9,23,"4-5","Y","Y","Y",8,0,19
"2449","D1",2024-01-27,"Hoffenheim","Heidenheim",1,1,"D",1,1,"D",1.7,4.28,4.64,"1-1","1-1",20,8,15,3,4,0,0,0,9,5,11,13,2,14,24,"9-5","Y","N","N",4,0,19
"2450","D1",2024-01-27,"Stuttgart","RB Leipzig",5,2,"H",2,1,"H",2.75,3.82,2.45,"2-1","5-2",19,11,4,2,1,4,0,0,9,3,9,11,7,12,20,"9-3","Y","Y","Y",5,0,19
"2451","D1",2024-01-27,"Werder Bremen","Freiburg",3,1,"H",1,1,"D",2.45,3.52,2.94,"1-1","3-1",14,4,7,4,2,1,0,0,5,5,14,10,4,10,24,"5-5","Y","Y","Y",3,0,19
"2452","D1",2024-01-27,"Wolfsburg","FC Koln",1,1,"D",1,1,"D",1.83,3.83,4.41,"1-1","1-1",12,5,6,2,5,3,0,0,6,3,17,12,2,9,29,"6-3","Y","N","N",8,0,19
"2453","D1",2024-01-27,"Leverkusen","Mgladbach",0,0,"D",0,0,"D",1.27,6.56,9.6,"0-0","0-0",28,8,4,3,3,1,0,0,8,2,15,6,0,10,21,"8-2","N","N","N",4,0,19
"2454","D1",2024-01-28,"Union Berlin","Darmstadt",1,0,"H",0,0,"D",1.64,3.92,5.85,"0-0","1-0",19,6,15,1,3,2,0,0,4,3,13,9,1,7,22,"4-3","N","N","N",5,0,19
"2455","D1",2024-01-28,"Dortmund","Bochum",3,1,"H",1,1,"D",1.38,5.7,7.32,"1-1","3-1",15,6,10,4,1,3,0,0,8,4,10,16,4,12,26,"8-4","Y","Y","Y",4,0,19
"2456","D1",2024-02-02,"Heidenheim","Dortmund",0,0,"D",0,0,"D",3.99,4.34,1.82,"0-0","0-0",11,0,13,5,0,2,0,0,4,6,7,7,0,10,14,"4-6","N","N","N",2,0,19
"2457","D1",2024-02-03,"Bayern Munich","Mgladbach",3,1,"H",1,1,"D",1.15,9.2,16.53,"1-1","3-1",21,6,11,4,0,1,0,0,6,5,11,9,4,11,20,"6-5","Y","Y","Y",1,0,20
"2458","D1",2024-02-03,"Bochum","Augsburg",1,1,"D",1,0,"H",2.21,3.65,3.25,"1-0","1-1",9,4,12,6,3,1,0,0,3,5,17,14,2,8,31,"3-5","Y","N","N",4,0,20
"2459","D1",2024-02-03,"Darmstadt","Leverkusen",0,2,"A",0,1,"A",9.27,6.36,1.28,"0-1","0-2",8,6,18,7,2,2,0,0,4,3,14,8,2,7,22,"4-3","Y","N","N",4,0,20
"2460","D1",2024-02-03,"Freiburg","Stuttgart",1,3,"A",1,2,"A",3.15,3.79,2.21,"1-2","1-3",7,4,17,9,4,2,1,0,1,6,10,7,4,7,17,"1-6","Y","Y","Y",6,1,20
"2461","D1",2024-02-03,"Mainz","Werder Bremen",0,1,"A",0,1,"A",2.12,3.52,3.59,"0-1","0-1",20,5,6,1,4,3,0,0,11,1,22,16,1,12,38,"11-1","N","N","N",7,0,20
"2462","D1",2024-02-03,"FC Koln","Ein Frankfurt",2,0,"H",0,0,"D",3.31,3.47,2.26,"0-0","2-0",14,4,11,4,1,4,0,2,7,7,8,13,2,14,21,"7-7","Y","N","N",5,2,20
"2463","D1",2024-02-04,"Wolfsburg","Hoffenheim",2,2,"D",0,1,"A",2.14,3.83,3.28,"0-1","2-2",14,8,17,7,2,3,0,0,7,2,12,16,4,9,28,"7-2","Y","Y","Y",5,0,20
"2464","D1",2024-02-04,"RB Leipzig","Union Berlin",2,0,"H",1,0,"H",1.4,4.98,7.93,"1-0","2-0",16,6,10,2,1,2,0,1,5,4,13,11,2,9,24,"5-4","Y","N","N",3,1,20
"2465","D1",2024-02-07,"Mainz","Union Berlin",1,1,"D",1,1,"D",2.22,3.29,3.58,"1-1","1-1",16,7,15,4,2,4,0,0,8,3,14,15,2,11,29,"8-3","Y","N","N",6,0,20
"2466","D1",2024-02-09,"Dortmund","Freiburg",3,0,"H",2,0,"H",1.47,5.13,6.36,"2-0","3-0",17,8,6,3,2,0,0,0,5,3,13,7,3,8,20,"5-3","Y","Y","N",2,0,21
"2467","D1",2024-02-10,"Augsburg","RB Leipzig",2,2,"D",1,1,"D",4.19,4.26,1.78,"1-1","2-2",11,4,9,6,5,1,0,0,1,3,15,10,4,4,25,"1-3","Y","Y","Y",6,0,21
"2468","D1",2024-02-10,"Ein Frankfurt","Bochum",1,1,"D",1,1,"D",1.76,3.82,4.86,"1-1","1-1",8,2,14,5,2,2,0,0,8,3,6,12,2,11,18,"8-3","Y","N","N",4,0,21
"2469","D1",2024-02-10,"Mgladbach","Darmstadt",0,0,"D",0,0,"D",1.61,4.33,5.44,"0-0","0-0",22,8,10,1,0,5,0,0,7,2,11,15,0,9,26,"7-2","N","N","N",5,0,21
"2470","D1",2024-02-10,"Union Berlin","Wolfsburg",1,0,"H",1,0,"H",2.35,3.37,3.22,"1-0","1-0",7,2,15,5,1,2,0,0,6,10,12,9,1,16,21,"6-10","N","N","N",3,0,21
"2471","D1",2024-02-10,"Werder Bremen","Heidenheim",1,2,"A",1,2,"A",1.86,3.79,4.25,"1-2","1-2",14,3,10,3,1,2,0,0,5,10,10,13,3,15,23,"5-10","Y","Y","N",3,0,21
"2472","D1",2024-02-10,"Leverkusen","Bayern Munich",3,0,"H",1,0,"H",2.68,3.9,2.47,"1-0","3-0",14,8,8,1,3,2,0,0,4,6,13,13,3,10,26,"4-6","Y","Y","N",5,0,21
"2473","D1",2024-02-11,"Stuttgart","Mainz",3,1,"H",2,0,"H",1.44,4.77,7.45,"2-0","3-1",10,7,16,6,1,1,0,0,4,5,7,9,4,9,16,"4-5","Y","Y","Y",2,0,21
"2474","D1",2024-02-11,"Hoffenheim","FC Koln",1,1,"D",0,0,"D",1.86,3.9,4.12,"0-0","1-1",10,4,5,1,3,4,0,0,10,3,12,13,2,13,25,"10-3","Y","N","N",7,0,21
"2475","D1",2024-02-16,"FC Koln","Werder Bremen",0,1,"A",0,0,"D",2.57,3.38,2.92,"0-0","0-1",10,2,13,4,4,4,0,0,5,3,16,11,1,8,27,"5-3","N","N","N",8,0,22
"2476","D1",2024-02-17,"Darmstadt","Stuttgart",1,2,"A",0,1,"A",6.88,4.89,1.45,"0-1","1-2",21,9,13,4,4,5,0,1,5,3,15,14,3,8,29,"5-3","Y","Y","N",9,1,22
"2477","D1",2024-02-17,"Heidenheim","Leverkusen",1,2,"A",0,1,"A",8.03,5.8,1.35,"0-1","1-2",6,3,17,4,2,1,0,0,4,5,15,5,3,9,20,"4-5","Y","Y","N",3,0,22
"2478","D1",2024-02-17,"Hoffenheim","Union Berlin",0,1,"A",0,0,"D",2.06,3.71,3.58,"0-0","0-1",16,4,10,3,3,4,1,1,6,2,10,7,1,8,17,"6-2","N","N","N",7,2,22
"2479","D1",2024-02-17,"Mainz","Augsburg",1,0,"H",1,0,"H",2.03,3.66,3.72,"1-0","1-0",19,4,10,4,3,2,0,1,7,7,8,16,1,14,24,"7-7","N","N","N",5,1,22
"2480","D1",2024-02-17,"Wolfsburg","Dortmund",1,1,"D",0,1,"A",3.32,3.79,2.13,"0-1","1-1",9,4,12,5,3,1,0,0,5,3,18,5,2,8,23,"5-3","Y","N","N",4,0,22
"2481","D1",2024-02-17,"RB Leipzig","Mgladbach",2,0,"H",1,0,"H",1.38,5.63,7.27,"1-0","2-0",16,9,13,0,1,5,0,0,8,4,12,13,2,12,25,"8-4","Y","N","N",6,0,22
"2482","D1",2024-02-18,"Freiburg","Ein Frankfurt",3,3,"D",2,2,"D",2.33,3.38,3.24,"2-2","3-3",13,8,10,6,0,0,0,0,6,1,8,10,6,7,18,"6-1","Y","Y","Y",0,0,22
"2483","D1",2024-02-18,"Bochum","Bayern Munich",3,2,"H",2,1,"H",8.13,5.93,1.34,"2-1","3-2",14,5,26,10,2,4,0,1,4,9,12,10,5,13,22,"4-9","Y","Y","Y",6,1,22
"2484","D1",2024-02-23,"Leverkusen","Mainz",2,1,"H",1,1,"D",1.26,6.53,12.14,"1-1","2-1",18,7,13,4,3,5,0,1,11,2,14,16,3,13,30,"11-2","Y","Y","N",8,1,23
"2485","D1",2024-02-24,"Mgladbach","Bochum",5,2,"H",2,0,"H",2.02,3.77,3.65,"2-0","5-2",22,6,15,5,2,4,0,0,5,6,13,13,7,11,26,"5-6","Y","Y","Y",6,0,23
"2486","D1",2024-02-24,"Stuttgart","FC Koln",1,1,"D",0,0,"D",1.32,5.75,9.52,"0-0","1-1",13,5,12,6,1,0,0,0,9,4,11,13,2,13,24,"9-4","Y","N","N",1,0,23
"2487","D1",2024-02-24,"Union Berlin","Heidenheim",2,2,"D",2,1,"H",2.04,3.49,3.89,"2-1","2-2",12,3,9,4,2,1,0,0,4,2,9,12,4,6,21,"4-2","Y","Y","Y",3,0,23
"2488","D1",2024-02-24,"Werder Bremen","Darmstadt",1,1,"D",1,1,"D",1.69,3.94,5.22,"1-1","1-1",13,4,11,3,3,4,0,0,4,6,10,13,2,10,23,"4-6","Y","N","N",7,0,23
"2489","D1",2024-02-24,"Bayern Munich","RB Leipzig",2,1,"H",0,0,"D",1.7,4.4,4.53,"0-0","2-1",16,4,11,5,3,3,0,0,6,4,11,10,3,10,21,"6-4","Y","Y","N",6,0,23
"2490","D1",2024-02-25,"Ein Frankfurt","Wolfsburg",2,2,"D",1,2,"A",2.29,3.48,3.24,"1-2","2-2",12,5,14,8,2,1,0,0,5,3,9,7,4,8,16,"5-3","Y","Y","Y",3,0,23
"2491","D1",2024-02-25,"Dortmund","Hoffenheim",2,3,"A",2,1,"H",1.51,5.16,5.52,"2-1","2-3",19,7,7,5,2,3,0,0,10,3,7,10,5,13,17,"10-3","Y","Y","Y",5,0,23
"2492","D1",2024-02-25,"Augsburg","Freiburg",2,1,"H",0,1,"A",2.28,3.66,3.11,"0-1","2-1",21,8,5,1,3,1,0,0,10,2,16,11,3,12,27,"10-2","Y","Y","N",4,0,23
"2493","D1",2024-03-01,"Freiburg","Bayern Munich",2,2,"D",1,1,"D",6.11,4.86,1.51,"1-1","2-2",17,5,21,9,1,2,0,0,3,6,11,7,4,9,18,"3-6","Y","Y","Y",3,0,24
"2494","D1",2024-03-02,"Bochum","RB Leipzig",1,4,"A",1,1,"D",4.76,4.44,1.66,"1-1","1-4",15,4,10,4,3,2,1,0,2,5,13,10,5,7,23,"2-5","Y","Y","Y",5,1,24
"2495","D1",2024-03-02,"Darmstadt","Augsburg",0,6,"A",0,5,"A",2.93,3.47,2.48,"0-5","0-6",10,5,21,6,2,0,0,0,3,6,4,12,6,9,16,"3-6","Y","Y","Y",2,0,24
"2496","D1",2024-03-02,"Heidenheim","Ein Frankfurt",1,2,"A",0,1,"A",2.84,3.39,2.59,"0-1","1-2",16,3,11,6,1,4,0,0,7,3,6,10,3,10,16,"7-3","Y","Y","N",5,0,24
"2497","D1",2024-03-02,"Mainz","Mgladbach",1,1,"D",1,0,"H",1.98,3.81,3.73,"1-0","1-1",21,5,14,5,5,1,1,0,12,6,12,15,2,18,27,"12-6","Y","N","N",6,1,24
"2498","D1",2024-03-02,"Union Berlin","Dortmund",0,2,"A",0,1,"A",3.44,3.62,2.14,"0-1","0-2",13,5,12,7,2,1,0,0,8,7,11,8,2,15,19,"8-7","Y","N","N",3,0,24
"2499","D1",2024-03-02,"Wolfsburg","Stuttgart",2,3,"A",0,1,"A",3.34,3.56,2.2,"0-1","2-3",12,2,7,3,3,2,0,0,5,4,20,12,5,9,32,"5-4","Y","Y","Y",5,0,24
"2500","D1",2024-03-03,"FC Koln","Leverkusen",0,2,"A",0,1,"A",8.08,5.15,1.39,"0-1","0-2",6,0,17,6,2,2,1,0,1,9,10,9,2,10,19,"1-9","Y","N","N",4,1,24
"2501","D1",2024-03-03,"Hoffenheim","Werder Bremen",2,1,"H",2,0,"H",1.97,3.87,3.72,"2-0","2-1",14,7,18,8,5,1,1,0,3,3,11,10,3,6,21,"3-3","Y","Y","N",6,1,24
"2502","D1",2024-03-08,"Stuttgart","Union Berlin",2,0,"H",1,0,"H",1.48,4.62,7.08,"1-0","2-0",14,5,10,4,1,2,0,1,4,3,7,14,2,7,21,"4-3","Y","N","N",3,1,25
"2503","D1",2024-03-09,"Augsburg","Heidenheim",1,0,"H",1,0,"H",1.88,3.89,4.07,"1-0","1-0",8,4,6,1,1,3,0,0,5,2,14,20,1,7,34,"5-2","N","N","N",4,0,25
"2504","D1",2024-03-09,"Bayern Munich","Mainz",8,1,"H",3,1,"H",1.23,6.97,11.21,"3-1","8-1",25,12,13,3,1,1,0,0,6,7,8,7,9,13,15,"6-7","Y","Y","Y",2,0,25
"2505","D1",2024-03-09,"Mgladbach","FC Koln",3,3,"D",1,1,"D",1.85,3.77,4.32,"1-1","3-3",16,5,12,5,3,4,0,0,8,3,15,15,6,11,30,"8-3","Y","Y","Y",7,0,25
"2506","D1",2024-03-09,"RB Leipzig","Darmstadt",2,0,"H",1,0,"H",1.15,8.79,16.82,"1-0","2-0",28,8,9,4,0,3,0,0,8,4,3,14,2,12,17,"8-4","Y","N","N",3,0,25
"2507","D1",2024-03-09,"Werder Bremen","Dortmund",1,2,"A",0,2,"A",3.87,4.06,1.88,"0-2","1-2",15,5,13,6,1,2,0,1,10,4,6,8,3,14,14,"10-4","Y","Y","N",3,1,25
"2508","D1",2024-03-10,"Bochum","Freiburg",1,2,"A",0,1,"A",2.27,3.65,3.13,"0-1","1-2",18,6,9,5,3,7,0,0,12,5,11,11,3,17,22,"12-5","Y","Y","N",10,0,25
"2509","D1",2024-03-10,"Ein Frankfurt","Hoffenheim",3,1,"H",1,1,"D",2.06,3.9,3.43,"1-1","3-1",17,7,6,2,2,3,0,2,5,1,11,10,4,6,21,"5-1","Y","Y","Y",5,2,25
"2510","D1",2024-03-10,"Leverkusen","Wolfsburg",2,0,"H",1,0,"H",1.32,5.89,9.05,"1-0","2-0",19,7,2,1,1,3,0,1,9,2,6,7,2,11,13,"9-2","Y","N","N",4,1,25
"2511","D1",2024-03-15,"FC Koln","RB Leipzig",1,5,"A",1,1,"D",6.61,4.86,1.48,"1-1","1-5",9,2,23,7,2,2,0,0,3,6,11,12,6,9,23,"3-6","Y","Y","Y",4,0,26
"2512","D1",2024-03-16,"Darmstadt","Bayern Munich",2,5,"A",1,2,"A",17.12,9.56,1.14,"1-2","2-5",7,3,26,6,1,0,0,0,2,9,9,6,7,11,15,"2-9","Y","Y","Y",1,0,26
"2513","D1",2024-03-16,"Heidenheim","Mgladbach",1,1,"D",0,1,"A",2.49,3.63,2.8,"0-1","1-1",16,5,6,2,1,3,0,0,10,4,16,8,2,14,24,"10-4","Y","N","N",4,0,26
"2514","D1",2024-03-16,"Mainz","Bochum",2,0,"H",1,0,"H",1.79,3.88,4.58,"1-0","2-0",13,4,11,4,4,3,0,0,7,6,15,15,2,13,30,"7-6","Y","N","N",7,0,26
"2515","D1",2024-03-16,"Union Berlin","Werder Bremen",2,1,"H",0,0,"D",2.02,3.64,3.79,"0-0","2-1",11,5,10,2,3,5,0,0,4,3,16,16,3,7,32,"4-3","Y","Y","N",8,0,26
"2516","D1",2024-03-16,"Wolfsburg","Augsburg",1,3,"A",1,1,"D",2.12,3.65,3.46,"1-1","1-3",15,4,14,5,1,3,1,0,8,6,12,19,4,14,31,"8-6","Y","Y","Y",4,1,26
"2517","D1",2024-03-16,"Hoffenheim","Stuttgart",0,3,"A",0,2,"A",3.77,4.23,1.88,"0-2","0-3",8,1,25,12,1,0,0,0,5,6,8,12,3,11,20,"5-6","Y","Y","N",1,0,26
"2518","D1",2024-03-17,"Freiburg","Leverkusen",2,3,"A",1,2,"A",5.92,4.39,1.56,"1-2","2-3",9,3,18,7,1,0,0,0,2,8,13,6,5,10,19,"2-8","Y","Y","Y",1,0,26
"2519","D1",2024-03-17,"Dortmund","Ein Frankfurt",3,1,"H",1,1,"D",1.63,4.47,5.01,"1-1","3-1",16,6,8,6,1,2,0,0,8,3,5,9,4,11,14,"8-3","Y","Y","Y",3,0,26
"2520","D2",2023-07-28,"Hamburg","Schalke 04",5,3,"H",1,2,"A",2.43,3.81,2.83,"1-2","5-3",31,14,11,6,3,3,0,1,9,3,10,13,8,12,23,"9-3","Y","Y","Y",6,1,1
"2521","D2",2023-07-29,"Hannover","Elversberg",2,2,"D",1,2,"A",2.12,3.88,3.34,"1-2","2-2",10,4,23,9,3,4,0,0,3,6,5,18,4,9,23,"3-6","Y","Y","Y",7,0,1
"2522","D2",2023-07-29,"Kaiserslautern","St Pauli",1,2,"A",0,0,"D",3.19,3.5,2.33,"0-0","1-2",10,3,14,5,2,1,0,0,3,5,11,10,3,8,21,"3-5","Y","Y","N",3,0,1
"2523","D2",2023-07-29,"Osnabruck","Karlsruhe",2,3,"A",1,2,"A",2.94,3.75,2.38,"1-2","2-3",18,7,14,8,3,2,1,0,4,9,11,9,5,13,20,"4-9","Y","Y","Y",5,1,1
"2524","D2",2023-07-29,"Wehen","Magdeburg",1,1,"D",0,1,"A",2.91,3.8,2.37,"0-1","1-1",9,1,11,3,2,3,1,0,3,2,10,18,2,5,28,"3-2","Y","N","N",5,1,1
"2525","D2",2023-07-29,"Fortuna Dusseldorf","Hertha",1,0,"H",0,0,"D",2.32,3.59,3.13,"0-0","1-0",9,2,12,4,3,2,0,0,7,8,13,11,1,15,24,"7-8","N","N","N",5,0,1
"2526","D2",2023-07-30,"Braunschweig","Holstein Kiel",0,1,"A",0,0,"D",2.66,3.83,2.56,"0-0","0-1",9,2,15,4,3,1,1,0,4,10,10,13,1,14,23,"4-10","N","N","N",4,1,1
"2527","D2",2023-07-30,"Greuther Furth","Paderborn",5,0,"H",3,0,"H",2.46,3.71,2.85,"3-0","5-0",24,11,7,0,1,1,0,1,5,2,9,5,5,7,14,"5-2","Y","Y","Y",2,1,1
"2528","D2",2023-07-30,"Hansa Rostock","Nurnberg",2,0,"H",1,0,"H",2.62,3.23,2.97,"1-0","2-0",14,4,18,7,3,4,0,0,6,6,15,13,2,12,28,"6-6","Y","N","N",7,0,1
"2529","D2",2023-08-04,"Hertha","Wehen",0,1,"A",0,0,"D",1.57,4.43,5.89,"0-0","0-1",21,8,12,5,2,3,0,0,6,4,9,9,1,10,18,"6-4","N","N","N",5,0,2
"2530","D2",2023-08-04,"Paderborn","Osnabruck",1,1,"D",0,0,"D",1.6,4.38,5.68,"0-0","1-1",15,5,15,5,1,0,0,0,7,7,11,12,2,14,23,"7-7","Y","N","N",1,0,2
"2531","D2",2023-08-05,"Elversberg","Hansa Rostock",1,2,"A",0,0,"D",2.15,3.72,3.4,"0-0","1-2",13,4,17,5,3,4,0,0,7,2,12,15,3,9,27,"7-2","Y","Y","N",7,0,2
"2532","D2",2023-08-05,"Holstein Kiel","Greuther Furth",2,1,"H",0,0,"D",2.47,3.85,2.75,"0-0","2-1",9,4,15,2,2,2,0,0,8,5,14,16,3,13,30,"8-5","Y","Y","N",4,0,2
"2533","D2",2023-08-05,"St Pauli","Fortuna Dusseldorf",0,0,"D",0,0,"D",1.97,3.73,3.96,"0-0","0-0",13,5,10,3,2,1,1,0,4,8,11,8,0,12,19,"4-8","N","N","N",3,1,2
"2534","D2",2023-08-05,"Schalke 04","Kaiserslautern",3,0,"H",1,0,"H",1.69,4.07,5.12,"1-0","3-0",16,8,10,4,1,3,0,2,8,7,14,12,3,15,26,"8-7","Y","Y","N",4,2,2
"2535","D2",2023-08-06,"Karlsruhe","Hamburg",2,2,"D",1,0,"H",2.87,4.16,2.28,"1-0","2-2",17,4,13,7,3,2,0,0,7,3,6,14,4,10,20,"7-3","Y","Y","Y",5,0,2
"2536","D2",2023-08-06,"Magdeburg","Braunschweig",2,1,"H",2,0,"H",1.81,4.06,4.35,"2-0","2-1",14,5,9,4,1,3,0,0,1,5,7,20,3,6,27,"1-5","Y","Y","N",4,0,2
"2537","D2",2023-08-06,"Nurnberg","Hannover",2,2,"D",0,2,"A",2.39,3.64,2.99,"0-2","2-2",8,3,19,6,6,2,0,0,5,7,20,14,4,12,34,"5-7","Y","Y","Y",8,0,2
"2538","D2",2023-08-18,"Kaiserslautern","Elversberg",3,2,"H",1,0,"H",2.32,3.65,3.09,"1-0","3-2",20,8,21,9,3,1,0,0,4,6,11,12,5,10,23,"4-6","Y","Y","Y",4,0,3
"2539","D2",2023-08-18,"Wehen","Karlsruhe",1,0,"H",1,0,"H",3.07,3.82,2.27,"1-0","1-0",11,4,15,7,3,1,0,0,2,7,14,2,1,9,16,"2-7","N","N","N",4,0,3
"2540","D2",2023-08-19,"Fortuna Dusseldorf","Paderborn",1,2,"A",0,1,"A",2.11,3.94,3.32,"0-1","1-2",26,6,10,6,0,3,0,0,12,1,6,20,3,13,26,"12-1","Y","Y","N",3,0,3
"2541","D2",2023-08-19,"Greuther Furth","St Pauli",0,0,"D",0,0,"D",2.66,3.59,2.68,"0-0","0-0",16,2,6,1,1,5,0,0,2,1,11,17,0,3,28,"2-1","N","N","N",6,0,3
"2542","D2",2023-08-19,"Hansa Rostock","Hannover",1,2,"A",0,1,"A",2.63,3.63,2.69,"0-1","1-2",10,2,8,2,3,1,0,0,4,5,13,11,3,9,24,"4-5","Y","Y","N",4,0,3
"2543","D2",2023-08-19,"Hamburg","Hertha",3,0,"H",2,0,"H",1.9,4.17,3.79,"2-0","3-0",27,7,11,2,2,2,0,0,4,2,10,7,3,6,17,"4-2","Y","Y","N",4,0,3
"2544","D2",2023-08-20,"Braunschweig","Schalke 04",1,0,"H",1,0,"H",3.61,3.87,2.03,"1-0","1-0",17,6,11,3,3,0,1,0,6,4,15,12,1,10,27,"6-4","N","N","N",3,1,3
"2545","D2",2023-08-20,"Holstein Kiel","Magdeburg",2,4,"A",1,2,"A",2.45,3.82,2.8,"1-2","2-4",17,8,18,10,1,2,0,0,6,3,23,12,6,9,35,"6-3","Y","Y","Y",3,0,3
"2546","D2",2023-08-20,"Osnabruck","Nurnberg",2,3,"A",0,1,"A",2.6,3.4,2.86,"0-1","2-3",15,3,20,7,2,2,0,0,3,12,13,8,5,15,21,"3-12","Y","Y","Y",4,0,3
"2547","D2",2023-08-25,"Paderborn","Kaiserslautern",1,2,"A",0,0,"D",2.21,3.84,3.17,"0-0","1-2",15,5,12,3,2,5,0,0,1,2,17,12,3,3,29,"1-2","Y","Y","N",7,0,4
"2548","D2",2023-08-25,"Schalke 04","Holstein Kiel",0,2,"A",0,1,"A",1.95,4.19,3.61,"0-1","0-2",13,4,14,5,1,1,1,0,3,7,11,13,2,10,24,"3-7","Y","N","N",2,1,4
"2549","D2",2023-08-26,"Elversberg","Fortuna Dusseldorf",0,5,"A",0,3,"A",2.86,3.87,2.38,"0-3","0-5",13,4,15,8,1,3,0,0,8,6,6,9,5,14,15,"8-6","Y","Y","Y",4,0,4
"2550","D2",2023-08-26,"Hansa Rostock","Osnabruck",2,1,"H",1,1,"D",2.12,3.7,3.49,"1-1","2-1",12,5,13,3,3,0,0,0,4,5,17,10,3,9,27,"4-5","Y","Y","N",3,0,4
"2551","D2",2023-08-26,"Hertha","Greuther Furth",5,0,"H",2,0,"H",2.55,3.71,2.73,"2-0","5-0",14,7,17,6,1,1,0,0,5,8,18,9,5,13,27,"5-8","Y","Y","Y",2,0,4
"2552","D2",2023-08-26,"Hannover","Hamburg",0,1,"A",0,0,"D",3.42,4.12,2.03,"0-0","0-1",19,5,11,4,1,4,0,1,3,3,13,13,1,6,26,"3-3","N","N","N",5,1,4
"2553","D2",2023-08-27,"Karlsruhe","Braunschweig",2,0,"H",1,0,"H",1.76,4.3,4.36,"1-0","2-0",22,9,9,0,1,1,0,1,6,4,11,4,2,10,15,"6-4","Y","N","N",2,1,4
"2554","D2",2023-08-27,"Nurnberg","Wehen",2,1,"H",0,0,"D",2.09,3.68,3.59,"0-0","2-1",13,4,15,2,2,6,1,2,10,6,12,17,3,16,29,"10-6","Y","Y","N",8,3,4
"2555","D2",2023-08-27,"St Pauli","Magdeburg",0,0,"D",0,0,"D",1.96,3.96,3.76,"0-0","0-0",26,12,5,2,2,3,0,0,11,3,9,9,0,14,18,"11-3","N","N","N",5,0,4
"2556","D2",2023-09-01,"Braunschweig","St Pauli",1,1,"D",0,0,"D",4.04,3.76,1.94,"0-0","1-1",9,1,19,5,2,3,0,0,3,5,11,11,2,8,22,"3-5","Y","N","N",5,0,5
"2557","D2",2023-09-01,"Fortuna Dusseldorf","Karlsruhe",3,1,"H",1,1,"D",2.25,3.89,3.06,"1-1","3-1",19,5,10,8,1,3,0,0,7,7,8,10,4,14,18,"7-7","Y","Y","Y",4,0,5
"2558","D2",2023-09-02,"Holstein Kiel","Paderborn",2,1,"H",1,1,"D",2.32,4.18,2.8,"1-1","2-1",19,6,13,2,3,3,0,0,6,8,9,9,3,14,18,"6-8","Y","Y","N",6,0,5
"2559","D2",2023-09-02,"Magdeburg","Hertha",6,4,"H",2,3,"A",2.31,4,2.9,"2-3","6-4",23,12,12,7,2,3,0,0,4,3,6,9,10,7,15,"4-3","Y","Y","Y",5,0,5
"2560","D2",2023-09-02,"Wehen","Schalke 04",1,1,"D",0,0,"D",3.32,3.88,2.13,"0-0","1-1",14,3,15,5,4,2,0,0,3,7,17,10,2,10,27,"3-7","Y","N","N",6,0,5
"2561","D2",2023-09-02,"Kaiserslautern","Nurnberg",3,1,"H",3,1,"H",2.24,3.73,3.19,"3-1","3-1",12,4,18,4,1,2,0,1,4,7,12,14,4,11,26,"4-7","Y","Y","Y",3,1,5
"2562","D2",2023-09-03,"Greuther Furth","Hannover",1,3,"A",0,2,"A",2.04,4.12,3.38,"0-2","1-3",19,5,6,5,1,2,0,0,9,2,11,11,4,11,22,"9-2","Y","Y","Y",3,0,5
"2563","D2",2023-09-03,"Hamburg","Hansa Rostock",2,0,"H",1,0,"H",1.52,4.94,5.86,"1-0","2-0",17,11,7,3,2,5,0,0,3,5,14,15,2,8,29,"3-5","Y","N","N",7,0,5
"2564","D2",2023-09-03,"Osnabruck","Elversberg",0,1,"A",0,0,"D",2.44,3.98,2.73,"0-0","0-1",9,4,10,2,1,2,0,0,6,2,16,13,1,8,29,"6-2","N","N","N",3,0,5
"2565","D2",2023-09-15,"Nurnberg","Greuther Furth",1,1,"D",1,1,"D",2.7,3.62,2.62,"1-1","1-1",18,4,9,2,2,3,0,0,6,5,14,17,2,11,31,"6-5","Y","N","N",5,0,6
"2566","D2",2023-09-15,"Paderborn","Wehen",2,1,"H",0,1,"A",1.77,4.21,4.39,"0-1","2-1",17,7,12,5,3,2,0,0,5,1,14,12,3,6,26,"5-1","Y","Y","N",5,0,6
"2567","D2",2023-09-16,"Elversberg","Hamburg",2,1,"H",1,0,"H",4.2,4.49,1.76,"1-0","2-1",16,7,13,6,3,2,0,0,7,6,12,9,3,13,21,"7-6","Y","Y","N",5,0,6
"2568","D2",2023-09-16,"Hansa Rostock","Fortuna Dusseldorf",1,3,"A",1,2,"A",3.36,3.51,2.25,"1-2","1-3",23,4,20,5,2,2,0,0,10,8,11,9,4,18,20,"10-8","Y","Y","Y",4,0,6
"2569","D2",2023-09-16,"Karlsruhe","Kaiserslautern",1,1,"D",1,1,"D",2.08,3.8,3.51,"1-1","1-1",19,6,14,7,0,1,0,0,9,3,10,14,2,12,24,"9-3","Y","N","N",1,0,6
"2570","D2",2023-09-16,"Schalke 04","Magdeburg",4,3,"H",1,2,"A",2.21,3.95,3.1,"1-2","4-3",19,9,12,6,4,4,0,1,9,4,22,12,7,13,34,"9-4","Y","Y","Y",8,1,6
"2571","D2",2023-09-17,"Hannover","Osnabruck",7,0,"H",2,0,"H",1.88,4.02,4.03,"2-0","7-0",24,15,6,3,0,2,0,1,5,3,13,9,7,8,22,"5-3","Y","Y","Y",2,1,6
"2572","D2",2023-09-17,"Hertha","Braunschweig",3,0,"H",2,0,"H",1.63,4.45,5.15,"2-0","3-0",15,8,14,4,2,0,0,0,4,9,11,11,3,13,22,"4-9","Y","Y","N",2,0,6
"2573","D2",2023-09-17,"St Pauli","Holstein Kiel",5,1,"H",3,0,"H",1.89,3.91,4.08,"3-0","5-1",18,7,13,4,3,3,0,0,3,1,13,16,6,4,29,"3-1","Y","Y","Y",6,0,6
"2574","D2",2023-09-22,"Magdeburg","Paderborn",1,1,"D",0,1,"A",2.21,4.05,3.04,"0-1","1-1",11,3,14,4,4,1,0,0,2,6,14,12,2,8,26,"2-6","Y","N","N",5,0,7
"2575","D2",2023-09-22,"Osnabruck","Hamburg",2,1,"H",2,1,"H",4.5,4.74,1.67,"2-1","2-1",18,9,8,3,5,6,0,0,13,7,10,15,3,20,25,"13-7","Y","Y","N",11,0,7
"2576","D2",2023-09-23,"Braunschweig","Nurnberg",2,2,"D",1,2,"A",2.94,3.68,2.41,"1-2","2-2",14,5,11,5,2,2,0,0,2,3,17,15,4,5,32,"2-3","Y","Y","Y",4,0,7
"2577","D2",2023-09-23,"Greuther Furth","Karlsruhe",4,3,"H",3,3,"D",2.27,3.89,3.03,"3-3","4-3",9,6,17,5,3,5,1,0,9,4,10,12,7,13,22,"9-4","Y","Y","Y",8,1,7
"2578","D2",2023-09-23,"Wehen","Elversberg",0,2,"A",0,1,"A",2.67,3.82,2.55,"0-1","0-2",16,3,13,5,4,4,0,0,7,3,13,17,2,10,30,"7-3","Y","N","N",8,0,7
"2579","D2",2023-09-23,"St Pauli","Schalke 04",3,1,"H",1,1,"D",1.89,3.73,4.28,"1-1","3-1",19,8,10,3,1,4,0,0,4,2,3,19,4,6,22,"4-2","Y","Y","Y",5,0,7
"2580","D2",2023-09-24,"Fortuna Dusseldorf","Hannover",1,1,"D",0,1,"A",1.93,4.12,3.7,"0-1","1-1",17,5,6,2,2,3,0,0,5,2,7,10,2,7,17,"5-2","Y","N","N",5,0,7
"2581","D2",2023-09-24,"Holstein Kiel","Hertha",2,3,"A",0,2,"A",2.75,3.68,2.55,"0-2","2-3",16,5,11,7,4,3,1,0,2,4,19,13,5,6,32,"2-4","Y","Y","Y",7,1,7
"2582","D2",2023-09-24,"Kaiserslautern","Hansa Rostock",3,1,"H",2,1,"H",2.11,3.39,3.83,"2-1","3-1",22,11,18,2,2,2,0,0,6,10,9,15,4,16,24,"6-10","Y","Y","Y",4,0,7
"2583","D2",2023-09-29,"Hamburg","Fortuna Dusseldorf",1,0,"H",0,0,"D",2.11,4.16,3.18,"0-0","1-0",10,4,8,2,3,6,0,1,8,3,10,14,1,11,24,"8-3","N","N","N",9,1,8
"2584","D2",2023-09-29,"Paderborn","Schalke 04",3,1,"H",1,0,"H",2.28,3.85,3.04,"1-0","3-1",11,6,13,2,1,3,0,0,2,10,10,9,4,12,19,"2-10","Y","Y","Y",4,0,8
"2585","D2",2023-09-30,"Hannover","Wehen",2,0,"H",1,0,"H",1.71,4.35,4.6,"1-0","2-0",17,5,12,3,0,2,0,0,4,6,13,15,2,10,28,"4-6","Y","N","N",2,0,8
"2586","D2",2023-09-30,"Hansa Rostock","Braunschweig",1,0,"H",0,0,"D",2.03,3.73,3.75,"0-0","1-0",19,6,20,0,3,1,0,0,7,5,20,10,1,12,30,"7-5","N","N","N",4,0,8
"2587","D2",2023-09-30,"Karlsruhe","Holstein Kiel",0,2,"A",0,2,"A",2.1,4.04,3.29,"0-2","0-2",14,4,12,5,0,4,0,0,7,9,4,16,2,16,20,"7-9","Y","N","N",4,0,8
"2588","D2",2023-09-30,"Hertha","St Pauli",1,2,"A",0,1,"A",2.71,3.68,2.59,"0-1","1-2",8,3,24,5,2,0,0,0,7,3,11,5,3,10,16,"7-3","Y","Y","N",2,0,8
"2589","D2",2023-10-01,"Elversberg","Greuther Furth",1,1,"D",1,1,"D",2.48,3.94,2.7,"1-1","1-1",11,4,15,5,1,1,0,0,2,8,13,19,2,10,32,"2-8","Y","N","N",2,0,8
"2590","D2",2023-10-01,"Nurnberg","Magdeburg",1,0,"H",0,0,"D",2.67,3.78,2.57,"0-0","1-0",16,6,13,1,6,5,0,0,7,3,14,21,1,10,35,"7-3","N","N","N",11,0,8
"2591","D2",2023-10-01,"Osnabruck","Kaiserslautern",2,2,"D",2,1,"H",2.77,3.67,2.54,"2-1","2-2",9,4,32,13,4,3,0,0,4,13,15,13,4,17,28,"4-13","Y","Y","Y",7,0,8
"2592","D2",2023-10-06,"Fortuna Dusseldorf","Osnabruck",1,1,"D",0,0,"D",1.59,4.64,5.36,"0-0","1-1",19,4,9,3,5,3,0,0,8,1,13,11,2,9,24,"8-1","Y","N","N",8,0,9
"2593","D2",2023-10-06,"Kaiserslautern","Hannover",3,1,"H",1,1,"D",2.34,3.62,3.08,"1-1","3-1",16,11,11,4,4,2,0,1,5,2,13,17,4,7,30,"5-2","Y","Y","Y",6,1,9
"2594","D2",2023-10-07,"Greuther Furth","Hansa Rostock",1,0,"H",1,0,"H",1.8,3.89,4.6,"1-0","1-0",9,4,8,2,1,7,0,0,8,2,11,16,1,10,27,"8-2","N","N","N",8,0,9
"2595","D2",2023-10-07,"Magdeburg","Karlsruhe",1,1,"D",0,1,"A",2.3,4.05,2.89,"0-1","1-1",19,5,2,2,3,2,0,0,7,1,4,12,2,8,16,"7-1","Y","N","N",5,0,9
"2596","D2",2023-10-07,"Wehen","Hamburg",1,1,"D",0,0,"D",4.61,4.6,1.68,"0-0","1-1",6,2,23,5,2,2,0,0,4,13,11,3,2,17,14,"4-13","Y","N","N",4,0,9
"2597","D2",2023-10-07,"St Pauli","Nurnberg",5,1,"H",1,1,"D",1.61,4.32,5.6,"1-1","5-1",20,7,7,3,4,1,0,0,8,4,7,11,6,12,18,"8-4","Y","Y","Y",5,0,9
"2598","D2",2023-10-08,"Braunschweig","Paderborn",1,3,"A",1,2,"A",3.13,3.86,2.22,"1-2","1-3",24,4,11,6,3,0,0,0,13,4,9,9,4,17,18,"13-4","Y","Y","Y",3,0,9
"2599","D2",2023-10-08,"Holstein Kiel","Elversberg",1,1,"D",1,0,"H",2.15,4.11,3.13,"1-0","1-1",23,7,9,4,1,1,0,0,11,2,13,16,2,13,29,"11-2","Y","N","N",2,0,9
"2600","D2",2023-10-08,"Schalke 04","Hertha",1,2,"A",0,1,"A",2.3,4.04,2.89,"0-1","1-2",16,6,16,4,2,3,1,0,11,5,15,14,3,16,29,"11-5","Y","Y","N",5,1,9
"2601","D2",2023-10-20,"Elversberg","Braunschweig",3,0,"H",2,0,"H",1.9,4.14,3.84,"2-0","3-0",13,7,7,4,0,1,0,0,6,1,12,9,3,7,21,"6-1","Y","Y","N",1,0,10
"2602","D2",2023-10-20,"Hannover","Magdeburg",2,1,"H",1,0,"H",2.16,3.95,3.21,"1-0","2-1",14,4,13,8,2,3,0,0,6,9,9,14,3,15,23,"6-9","Y","Y","N",5,0,10
"2603","D2",2023-10-21,"Hamburg","Greuther Furth",2,0,"H",2,0,"H",1.68,4.52,4.68,"2-0","2-0",17,4,14,3,2,4,0,0,6,7,12,12,2,13,24,"6-7","Y","N","N",6,0,10
"2604","D2",2023-10-21,"Osnabruck","Wehen",0,2,"A",0,1,"A",2.31,3.64,3.13,"0-1","0-2",19,5,14,5,3,1,0,0,2,3,14,17,2,5,31,"2-3","Y","N","N",4,0,10
"2605","D2",2023-10-21,"Paderborn","St Pauli",2,2,"D",1,0,"H",3.21,3.95,2.16,"1-0","2-2",6,3,17,3,0,1,0,0,3,6,7,11,4,9,18,"3-6","Y","Y","Y",1,0,10
"2606","D2",2023-10-21,"Fortuna Dusseldorf","Kaiserslautern",4,3,"H",1,3,"A",1.91,3.91,4,"1-3","4-3",20,5,16,8,4,1,0,0,6,5,12,8,7,11,20,"6-5","Y","Y","Y",5,0,10
"2607","D2",2023-10-22,"Hansa Rostock","Holstein Kiel",1,3,"A",1,1,"D",2.83,3.59,2.53,"1-1","1-3",22,9,10,5,1,4,0,1,9,2,13,14,4,11,27,"9-2","Y","Y","Y",5,1,10
"2608","D2",2023-10-22,"Karlsruhe","Schalke 04",3,0,"H",2,0,"H",2.4,3.79,2.88,"2-0","3-0",12,5,9,3,1,1,0,0,7,5,13,13,3,12,26,"7-5","Y","Y","N",2,0,10
"2609","D2",2023-10-22,"Nurnberg","Hertha",3,1,"H",0,1,"A",2.77,3.77,2.49,"0-1","3-1",18,7,14,6,3,2,1,1,11,5,13,11,4,16,24,"11-5","Y","Y","Y",5,2,10
"2610","D2",2023-10-27,"Braunschweig","Fortuna Dusseldorf",1,4,"A",0,2,"A",4.01,3.97,1.89,"0-2","1-4",16,5,12,6,2,1,0,0,8,4,12,6,5,12,18,"8-4","Y","Y","Y",3,0,11
"2611","D2",2023-10-27,"Greuther Furth","Osnabruck",4,0,"H",1,0,"H",1.76,4.32,4.32,"1-0","4-0",13,6,5,2,0,3,0,0,10,1,15,15,4,11,30,"10-1","Y","Y","Y",3,0,11
"2612","D2",2023-10-28,"Hertha","Paderborn",3,1,"H",2,0,"H",2.25,3.95,3.02,"2-0","3-1",11,5,16,6,5,1,1,0,3,9,13,14,4,12,27,"3-9","Y","Y","Y",6,1,11
"2613","D2",2023-10-28,"Schalke 04","Hannover",3,2,"H",1,0,"H",2.34,4.06,2.82,"1-0","3-2",11,6,14,3,4,1,0,0,4,5,15,15,5,9,30,"4-5","Y","Y","Y",5,0,11
"2614","D2",2023-10-28,"St Pauli","Karlsruhe",2,1,"H",0,1,"A",1.66,4.36,5.01,"0-1","2-1",20,9,6,3,1,2,0,0,7,3,10,10,3,10,20,"7-3","Y","Y","N",3,0,11
"2615","D2",2023-10-28,"Kaiserslautern","Hamburg",3,3,"D",2,1,"H",3.07,3.96,2.23,"2-1","3-3",13,5,20,9,1,4,0,0,3,4,8,15,6,7,23,"3-4","Y","Y","Y",5,0,11
"2616","D2",2023-10-29,"Holstein Kiel","Nurnberg",0,2,"A",0,0,"D",2.11,3.89,3.37,"0-0","0-2",14,1,21,5,2,4,0,0,7,3,12,8,2,10,20,"7-3","Y","N","N",6,0,11
"2617","D2",2023-10-29,"Magdeburg","Elversberg",1,2,"A",0,2,"A",2.13,3.92,3.29,"0-2","1-2",18,5,8,4,2,2,0,0,5,3,12,14,3,8,26,"5-3","Y","Y","N",4,0,11
"2618","D2",2023-10-29,"Wehen","Hansa Rostock",1,0,"H",0,0,"D",2.33,3.51,3.19,"0-0","1-0",16,6,16,4,1,0,0,0,9,11,7,9,1,20,16,"9-11","N","N","N",1,0,11
"2619","D2",2023-11-03,"Elversberg","St Pauli",0,2,"A",0,2,"A",3.65,3.88,2.01,"0-2","0-2",7,2,10,4,2,1,0,0,6,3,10,7,2,9,17,"6-3","Y","N","N",3,0,12
"2620","D2",2023-11-03,"Fortuna Dusseldorf","Wehen",1,3,"A",0,3,"A",1.58,4.67,5.46,"0-3","1-3",25,7,11,5,4,5,0,0,6,6,14,6,4,12,20,"6-6","Y","Y","Y",9,0,12
"2621","D2",2023-11-04,"Kaiserslautern","Greuther Furth",0,2,"A",0,1,"A",2.15,3.72,3.4,"0-1","0-2",18,2,13,6,3,2,1,0,9,3,8,13,2,12,21,"9-3","Y","N","N",5,1,12
"2622","D2",2023-11-04,"Nurnberg","Schalke 04",1,2,"A",0,1,"A",2.25,3.84,3.09,"0-1","1-2",15,4,11,4,4,2,0,0,4,7,9,18,3,11,27,"4-7","Y","Y","N",6,0,12
"2623","D2",2023-11-04,"Osnabruck","Holstein Kiel",1,1,"D",0,0,"D",2.91,3.88,2.35,"0-0","1-1",14,4,16,9,1,3,0,0,6,5,19,15,2,11,34,"6-5","Y","N","N",4,0,12
"2624","D2",2023-11-04,"Hamburg","Magdeburg",2,0,"H",1,0,"H",1.57,5.02,5.15,"1-0","2-0",16,7,13,4,1,2,0,1,4,6,18,10,2,10,28,"4-6","Y","N","N",3,1,12
"2625","D2",2023-11-05,"Hannover","Braunschweig",2,0,"H",2,0,"H",1.59,4.51,5.56,"2-0","2-0",12,6,0,0,2,7,0,1,2,5,10,13,2,7,23,"2-5","Y","N","N",9,1,12
"2626","D2",2023-11-05,"Hansa Rostock","Hertha",0,0,"D",0,0,"D",3.06,3.68,2.33,"0-0","0-0",8,2,16,2,2,2,0,0,7,5,17,11,0,12,28,"7-5","N","N","N",4,0,12
"2627","D2",2023-11-05,"Karlsruhe","Paderborn",0,3,"A",0,1,"A",2.19,3.77,3.27,"0-1","0-3",16,7,11,5,4,1,0,0,2,3,10,10,3,5,20,"2-3","Y","Y","N",5,0,12
"2628","D2",2023-11-10,"Schalke 04","Elversberg",1,2,"A",1,2,"A",2.14,3.86,3.3,"1-2","1-2",22,3,13,5,3,2,0,0,8,2,11,11,3,10,22,"8-2","Y","Y","N",5,0,13
"2629","D2",2023-11-10,"St Pauli","Hannover",0,0,"D",0,0,"D",1.66,4.14,5.31,"0-0","0-0",13,2,2,0,2,4,0,0,7,1,12,15,0,8,27,"7-1","N","N","N",6,0,13
"2630","D2",2023-11-11,"Braunschweig","Osnabruck",3,2,"H",1,1,"D",2.32,3.56,3.16,"1-1","3-2",16,8,6,3,3,5,0,1,4,4,18,12,5,8,30,"4-4","Y","Y","Y",8,1,13
"2631","D2",2023-11-11,"Holstein Kiel","Hamburg",4,2,"H",1,0,"H",3.43,4.03,2.05,"1-0","4-2",16,8,15,7,2,2,0,0,7,6,13,13,6,13,26,"7-6","Y","Y","Y",4,0,13
"2632","D2",2023-11-11,"Paderborn","Nurnberg",1,3,"A",0,3,"A",2.13,3.87,3.33,"0-3","1-3",24,9,12,8,2,1,0,1,12,2,17,8,4,14,25,"12-2","Y","Y","Y",3,1,13
"2633","D2",2023-11-11,"Hertha","Karlsruhe",2,2,"D",2,1,"H",2,4.01,3.57,"2-1","2-2",10,3,12,4,0,2,0,0,6,9,17,13,4,15,30,"6-9","Y","Y","Y",2,0,13
"2634","D2",2023-11-12,"Greuther Furth","Fortuna Dusseldorf",1,0,"H",0,0,"D",2.3,3.64,3.15,"0-0","1-0",9,4,12,3,4,3,0,0,3,7,16,13,1,10,29,"3-7","N","N","N",7,0,13
"2635","D2",2023-11-12,"Magdeburg","Hansa Rostock",1,2,"A",1,0,"H",1.81,4.07,4.32,"1-0","1-2",16,8,16,5,3,2,0,0,13,2,6,15,3,15,21,"13-2","Y","Y","N",5,0,13
"2636","D2",2023-11-12,"Wehen","Kaiserslautern",2,1,"H",0,1,"A",2.93,3.78,2.37,"0-1","2-1",12,6,5,1,0,2,0,0,5,2,16,14,3,7,30,"5-2","Y","Y","N",2,0,13
"2637","D2",2023-11-24,"Hamburg","Braunschweig",2,1,"H",2,0,"H",1.31,6.18,9.49,"2-0","2-1",16,5,14,3,1,2,0,0,7,4,11,10,3,11,21,"7-4","Y","Y","N",3,0,14
"2638","D2",2023-11-24,"Hannover","Hertha",2,2,"D",0,2,"A",2.28,3.61,3.21,"0-2","2-2",18,6,8,4,0,1,0,0,9,1,10,16,4,10,26,"9-1","Y","Y","Y",1,0,14
"2639","D2",2023-11-25,"Elversberg","Paderborn",4,1,"H",1,1,"D",2.48,3.88,2.72,"1-1","4-1",15,9,9,4,2,3,0,0,4,3,10,13,5,7,23,"4-3","Y","Y","Y",5,0,14
"2640","D2",2023-11-25,"Hansa Rostock","St Pauli",2,3,"A",1,3,"A",5,4.08,1.71,"1-3","2-3",16,4,18,9,2,1,0,0,2,1,19,10,5,3,29,"2-1","Y","Y","Y",3,0,14
"2641","D2",2023-11-25,"Osnabruck","Magdeburg",0,2,"A",0,0,"D",3.16,3.83,2.22,"0-0","0-2",12,3,13,6,2,2,0,0,5,8,10,13,2,13,23,"5-8","Y","N","N",4,0,14
"2642","D2",2023-11-25,"Fortuna Dusseldorf","Schalke 04",5,3,"H",3,0,"H",1.88,4,4.03,"3-0","5-3",13,9,11,7,1,2,0,0,6,8,8,9,8,14,17,"6-8","Y","Y","Y",3,0,14
"2643","D2",2023-11-26,"Greuther Furth","Wehen",2,0,"H",1,0,"H",1.75,4.14,4.58,"1-0","2-0",23,7,14,6,3,5,0,0,7,6,7,18,2,13,25,"7-6","Y","N","N",8,0,14
"2644","D2",2023-11-26,"Kaiserslautern","Holstein Kiel",0,3,"A",0,2,"A",2.2,3.85,3.18,"0-2","0-3",13,5,11,6,1,1,0,0,6,10,9,11,3,16,20,"6-10","Y","Y","N",2,0,14
"2645","D2",2023-11-26,"Karlsruhe","Nurnberg",4,1,"H",1,0,"H",2.29,3.88,3,"1-0","4-1",19,8,12,3,2,3,0,0,6,8,10,9,5,14,19,"6-8","Y","Y","Y",5,0,14
"2646","D2",2023-12-01,"Schalke 04","Osnabruck",4,0,"H",1,0,"H",1.56,4.52,5.91,"1-0","4-0",14,5,8,2,2,2,0,0,3,0,15,11,4,3,26,"3-0","Y","Y","Y",4,0,15
"2647","D2",2023-12-01,"St Pauli","Hamburg",2,2,"D",2,0,"H",1.91,3.92,4,"2-0","2-2",16,5,6,3,1,3,0,0,9,3,5,13,4,12,18,"9-3","Y","Y","Y",4,0,15
"2648","D2",2023-12-02,"Braunschweig","Greuther Furth",0,1,"A",0,1,"A",3.76,3.66,2.04,"0-1","0-1",13,6,7,1,4,3,0,0,2,5,7,16,1,7,23,"2-5","N","N","N",7,0,15
"2649","D2",2023-12-02,"Holstein Kiel","Wehen",3,2,"H",2,0,"H",1.85,4.19,4,"2-0","3-2",23,9,13,4,1,2,0,0,11,3,7,10,5,14,17,"11-3","Y","Y","Y",3,0,15
"2650","D2",2023-12-02,"Nurnberg","Fortuna Dusseldorf",0,5,"A",0,3,"A",2.81,3.7,2.49,"0-3","0-5",4,1,14,7,2,3,0,0,2,5,10,6,5,7,16,"2-5","Y","Y","Y",5,0,15
"2651","D2",2023-12-02,"Magdeburg","Kaiserslautern",4,1,"H",1,1,"D",2.09,3.94,3.38,"1-1","4-1",18,11,19,5,3,1,0,0,6,2,9,14,5,8,23,"6-2","Y","Y","Y",4,0,15
"2652","D2",2023-12-03,"Hertha","Elversberg",5,1,"H",2,1,"H",1.96,4.04,3.67,"2-1","5-1",14,6,15,5,0,2,0,0,3,4,7,8,6,7,15,"3-4","Y","Y","Y",2,0,15
"2653","D2",2023-12-03,"Karlsruhe","Hansa Rostock",2,2,"D",1,2,"A",1.77,3.94,4.74,"1-2","2-2",17,7,17,7,2,1,0,0,8,5,6,11,4,13,17,"8-5","Y","Y","Y",3,0,15
"2654","D2",2023-12-03,"Paderborn","Hannover",1,0,"H",0,0,"D",2.41,3.71,2.92,"0-0","1-0",21,6,8,1,1,2,0,1,6,5,18,13,1,11,31,"6-5","N","N","N",3,1,15
"2655","D2",2023-12-08,"Hannover","Karlsruhe",2,2,"D",0,1,"A",2.06,3.68,3.67,"0-1","2-2",18,7,15,7,1,0,0,0,5,4,10,13,4,9,23,"5-4","Y","Y","Y",1,0,16
"2656","D2",2023-12-08,"Wehen","Braunschweig",1,3,"A",1,0,"H",1.93,3.85,3.98,"1-0","1-3",10,2,13,8,2,1,0,0,4,7,10,7,4,11,17,"4-7","Y","Y","Y",3,0,16
"2657","D2",2023-12-09,"Greuther Furth","Magdeburg",1,1,"D",0,0,"D",1.95,3.94,3.81,"0-0","1-1",16,6,11,8,1,4,0,0,7,3,20,17,2,10,37,"7-3","Y","N","N",5,0,16
"2658","D2",2023-12-09,"Hamburg","Paderborn",1,2,"A",1,1,"D",1.64,4.77,4.77,"1-1","1-2",18,6,11,4,2,1,1,1,8,4,16,8,3,12,24,"8-4","Y","Y","N",3,2,16
"2659","D2",2023-12-09,"Kaiserslautern","Hertha",1,2,"A",1,0,"H",2.39,3.84,2.87,"1-0","1-2",12,4,10,5,1,3,1,0,9,6,8,21,3,15,29,"9-6","Y","Y","N",4,1,16
"2660","D2",2023-12-09,"Osnabruck","St Pauli",1,1,"D",0,1,"A",6.7,4.42,1.52,"0-1","1-1",9,3,19,4,4,0,1,0,9,10,11,10,2,19,21,"9-10","Y","N","N",4,1,16
"2661","D2",2023-12-10,"Elversberg","Nurnberg",0,1,"A",0,0,"D",2,3.99,3.6,"0-0","0-1",19,3,10,3,3,4,0,0,9,4,11,13,1,13,24,"9-4","N","N","N",7,0,16
"2662","D2",2023-12-10,"Fortuna Dusseldorf","Holstein Kiel",0,1,"A",0,1,"A",1.99,4.05,3.59,"0-1","0-1",15,2,12,6,2,0,0,0,9,3,11,10,1,12,21,"9-3","N","N","N",2,0,16
"2663","D2",2023-12-10,"Hansa Rostock","Schalke 04",0,2,"A",0,0,"D",2.83,3.72,2.47,"0-0","0-2",3,0,18,3,1,2,1,0,3,4,16,13,2,7,29,"3-4","Y","N","N",3,1,16
"2664","D2",2023-12-15,"Paderborn","Hansa Rostock",3,0,"H",1,0,"H",1.64,4.28,5.36,"1-0","3-0",24,11,8,1,4,3,0,1,12,2,7,13,3,14,20,"12-2","Y","Y","N",7,1,17
"2665","D2",2023-12-15,"Schalke 04","Greuther Furth",2,2,"D",1,0,"H",2.24,3.63,3.28,"1-0","2-2",12,8,11,8,4,1,1,0,2,3,14,14,4,5,28,"2-3","Y","Y","Y",5,1,17
"2666","D2",2023-12-16,"Hertha","Osnabruck",0,0,"D",0,0,"D",1.45,4.97,7.01,"0-0","0-0",12,6,8,2,3,3,1,0,4,7,18,16,0,11,34,"4-7","N","N","N",6,1,17
"2667","D2",2023-12-16,"Magdeburg","Fortuna Dusseldorf",2,3,"A",2,0,"H",2.5,3.87,2.71,"2-0","2-3",19,6,12,5,2,3,0,0,7,2,9,17,5,9,26,"7-2","Y","Y","Y",5,0,17
"2668","D2",2023-12-16,"Nurnberg","Hamburg",0,2,"A",0,0,"D",3.14,4.29,2.09,"0-0","0-2",12,2,14,4,1,5,0,0,4,6,9,18,2,10,27,"4-6","Y","N","N",6,0,17
"2669","D2",2023-12-16,"Holstein Kiel","Hannover",3,0,"H",3,0,"H",2.33,3.85,2.96,"3-0","3-0",11,6,11,1,2,2,0,1,2,4,11,12,3,6,23,"2-4","Y","Y","N",4,1,17
"2670","D2",2023-12-17,"Braunschweig","Kaiserslautern",2,1,"H",1,1,"D",2.84,3.62,2.5,"1-1","2-1",17,6,11,0,1,3,0,0,4,6,7,11,3,10,18,"4-6","Y","Y","N",4,0,17
"2671","D2",2023-12-17,"Karlsruhe","Elversberg",3,2,"H",2,1,"H",2.22,3.9,3.12,"2-1","3-2",17,7,11,5,2,2,0,0,5,1,9,14,5,6,23,"5-1","Y","Y","Y",4,0,17
"2672","D2",2023-12-17,"St Pauli","Wehen",1,1,"D",0,0,"D",1.35,5.59,8.99,"0-0","1-1",28,5,5,2,2,3,0,0,12,2,8,9,2,14,17,"12-2","Y","N","N",5,0,17
"2673","D2",2024-01-19,"Holstein Kiel","Braunschweig",1,2,"A",1,1,"D",1.73,4.03,4.91,"1-1","1-2",22,9,15,5,1,2,0,0,6,3,12,6,3,9,18,"6-3","Y","Y","N",3,0,18
"2674","D2",2024-01-19,"Karlsruhe","Osnabruck",2,1,"H",1,1,"D",1.6,4.43,5.54,"1-1","2-1",16,4,14,4,1,2,0,0,7,2,13,10,3,9,23,"7-2","Y","Y","N",3,0,18
"2675","D2",2024-01-20,"Elversberg","Hannover",2,2,"D",0,1,"A",2.5,3.47,2.94,"0-1","2-2",8,2,9,3,1,0,0,0,6,4,6,12,4,10,18,"6-4","Y","Y","Y",1,0,18
"2676","D2",2024-01-20,"Nurnberg","Hansa Rostock",3,0,"H",2,0,"H",1.96,3.78,3.94,"2-0","3-0",8,4,9,2,0,0,0,0,2,5,7,18,3,7,25,"2-5","Y","Y","N",0,0,18
"2677","D2",2024-01-20,"St Pauli","Kaiserslautern",2,0,"H",1,0,"H",1.5,4.69,6.63,"1-0","2-0",20,9,13,3,3,2,0,0,4,4,7,10,2,8,17,"4-4","Y","N","N",5,0,18
"2678","D2",2024-01-20,"Schalke 04","Hamburg",0,2,"A",0,2,"A",2.67,3.94,2.5,"0-2","0-2",27,4,8,6,3,2,0,0,11,5,13,10,2,16,23,"11-5","Y","N","N",5,0,18
"2679","D2",2024-01-21,"Hertha","Fortuna Dusseldorf",2,2,"D",2,1,"H",2.52,3.8,2.71,"2-1","2-2",10,4,9,2,6,1,0,0,1,4,22,13,4,5,35,"1-4","Y","Y","Y",7,0,18
"2680","D2",2024-01-21,"Magdeburg","Wehen",1,0,"H",0,0,"D",1.7,4.28,4.81,"0-0","1-0",12,3,9,3,3,5,0,1,9,1,12,15,1,10,27,"9-1","N","N","N",8,1,18
"2681","D2",2024-01-21,"Paderborn","Greuther Furth",0,1,"A",0,1,"A",2.27,3.77,3.1,"0-1","0-1",17,8,13,3,1,2,0,0,6,5,8,11,1,11,19,"6-5","N","N","N",3,0,18
"2682","D2",2024-01-26,"Hannover","Nurnberg",3,0,"H",2,0,"H",1.91,3.69,4.26,"2-0","3-0",30,11,12,1,2,1,0,0,7,5,14,8,3,12,22,"7-5","Y","Y","N",3,0,19
"2683","D2",2024-01-26,"Kaiserslautern","Schalke 04",4,1,"H",1,0,"H",2.6,3.56,2.77,"1-0","4-1",15,6,11,5,1,3,0,0,4,1,14,13,5,5,27,"4-1","Y","Y","Y",4,0,19
"2684","D2",2024-01-27,"Hansa Rostock","Elversberg",2,1,"H",0,1,"A",2.98,3.65,2.39,"0-1","2-1",11,4,21,2,2,3,0,1,2,11,14,9,3,13,23,"2-11","Y","Y","N",5,1,19
"2685","D2",2024-01-27,"Osnabruck","Paderborn",0,0,"D",0,0,"D",3.49,3.69,2.12,"0-0","0-0",17,2,8,2,3,4,0,1,11,6,9,15,0,17,24,"11-6","N","N","N",7,1,19
"2686","D2",2024-01-27,"Wehen","Hertha",3,1,"H",1,0,"H",3,3.78,2.33,"1-0","3-1",17,7,15,7,0,2,0,0,3,10,8,7,4,13,15,"3-10","Y","Y","Y",2,0,19
"2687","D2",2024-01-27,"Fortuna Dusseldorf","St Pauli",1,2,"A",0,2,"A",2.76,3.61,2.58,"0-2","1-2",11,4,14,8,2,2,0,0,2,4,12,10,3,6,22,"2-4","Y","Y","N",4,0,19
"2688","D2",2024-01-28,"Braunschweig","Magdeburg",1,0,"H",1,0,"H",2.73,3.64,2.59,"1-0","1-0",14,7,8,4,1,5,0,1,3,2,8,15,1,5,23,"3-2","N","N","N",6,1,19
"2689","D2",2024-01-28,"Greuther Furth","Holstein Kiel",2,1,"H",0,0,"D",2.11,3.7,3.53,"0-0","2-1",22,6,11,2,3,5,0,0,10,5,9,15,3,15,24,"10-5","Y","Y","N",8,0,19
"2690","D2",2024-01-28,"Hamburg","Karlsruhe",3,4,"A",2,2,"D",1.68,4.53,4.7,"2-2","3-4",18,10,13,6,1,2,0,0,11,2,8,11,7,13,19,"11-2","Y","Y","Y",3,0,19
"2691","D2",2024-02-02,"Karlsruhe","Wehen",2,2,"D",1,0,"H",1.7,4.4,4.67,"1-0","2-2",11,4,22,7,1,2,0,0,4,3,8,8,4,7,16,"4-3","Y","Y","Y",3,0,20
"2692","D2",2024-02-02,"Magdeburg","Holstein Kiel",1,1,"D",0,1,"A",2.63,3.73,2.63,"0-1","1-1",21,9,8,3,2,3,0,0,12,4,7,12,2,16,19,"12-4","Y","N","N",5,0,20
"2693","D2",2024-02-03,"Nurnberg","Osnabruck",2,2,"D",1,1,"D",1.83,3.91,4.37,"1-1","2-2",15,8,20,7,3,2,0,0,5,6,11,10,4,11,21,"5-6","Y","Y","Y",5,0,20
"2694","D2",2024-02-03,"Schalke 04","Braunschweig",1,0,"H",0,0,"D",1.85,3.96,4.24,"0-0","1-0",18,7,8,1,2,2,0,0,3,5,8,7,1,8,15,"3-5","N","N","N",4,0,20
"2695","D2",2024-02-03,"St Pauli","Greuther Furth",3,2,"H",2,1,"H",1.78,3.94,4.71,"2-1","3-2",19,13,7,3,1,2,0,0,7,3,17,17,5,10,34,"7-3","Y","Y","Y",3,0,20
"2696","D2",2024-02-03,"Hertha","Hamburg",1,2,"A",0,0,"D",3.19,3.87,2.19,"0-0","1-2",7,3,16,5,5,2,0,0,4,6,21,13,3,10,34,"4-6","Y","Y","N",7,0,20
"2697","D2",2024-02-04,"Elversberg","Kaiserslautern",2,1,"H",1,1,"D",2.22,3.69,3.26,"1-1","2-1",8,4,13,3,3,1,0,0,3,4,11,10,3,7,21,"3-4","Y","Y","N",4,0,20
"2698","D2",2024-02-04,"Hannover","Hansa Rostock",2,1,"H",1,1,"D",1.61,4.25,5.77,"1-1","2-1",15,5,10,4,4,2,1,0,6,6,13,13,3,12,26,"6-6","Y","Y","N",6,1,20
"2699","D2",2024-02-04,"Paderborn","Fortuna Dusseldorf",4,3,"H",3,0,"H",2.62,3.68,2.68,"3-0","4-3",11,4,13,6,1,1,0,0,5,7,8,10,7,12,18,"5-7","Y","Y","Y",2,0,20
"2700","D2",2024-02-09,"Hamburg","Hannover",3,4,"A",1,3,"A",1.76,4.18,4.5,"1-3","3-4",17,3,13,4,2,2,2,0,10,7,13,14,7,17,27,"10-7","Y","Y","Y",4,2,21
"2701","D2",2024-02-09,"Wehen","Nurnberg",1,1,"D",0,0,"D",2,3.84,3.72,"0-0","1-1",8,3,16,7,1,1,0,0,2,11,9,10,2,13,19,"2-11","Y","N","N",2,0,21
"2702","D2",2024-02-10,"Braunschweig","Karlsruhe",2,0,"H",1,0,"H",2.52,3.66,2.8,"1-0","2-0",13,8,15,7,2,2,0,0,5,11,6,13,2,16,19,"5-11","Y","N","N",4,0,21
"2703","D2",2024-02-10,"Fortuna Dusseldorf","Elversberg",1,1,"D",1,0,"H",1.8,4.07,4.36,"1-0","1-1",13,4,9,3,2,1,0,0,5,2,14,9,2,7,23,"5-2","Y","N","N",3,0,21
"2704","D2",2024-02-10,"Magdeburg","St Pauli",1,0,"H",0,0,"D",4.54,3.91,1.81,"0-0","1-0",9,5,11,4,1,2,0,0,2,4,6,11,1,6,17,"2-4","N","N","N",3,0,21
"2705","D2",2024-02-10,"Kaiserslautern","Paderborn",1,2,"A",1,0,"H",2.31,3.72,3.07,"1-0","1-2",12,3,8,2,3,2,0,0,4,2,14,11,3,6,25,"4-2","Y","Y","N",5,0,21
"2706","D2",2024-02-11,"Greuther Furth","Hertha",1,2,"A",0,1,"A",2.01,3.69,3.84,"0-1","1-2",16,7,13,7,2,4,0,1,2,3,10,14,3,5,24,"2-3","Y","Y","N",6,1,21
"2707","D2",2024-02-11,"Holstein Kiel","Schalke 04",1,0,"H",0,0,"D",2.37,3.8,2.92,"0-0","1-0",22,6,7,2,1,3,0,0,10,4,7,9,1,14,16,"10-4","N","N","N",4,0,21
"2708","D2",2024-02-11,"Osnabruck","Hansa Rostock",0,0,"D",0,0,"D",2.4,3.54,3.04,"0-0","0-0",25,7,8,1,3,2,0,0,9,2,9,23,0,11,32,"9-2","N","N","N",5,0,21
"2709","D2",2024-02-16,"Hannover","Greuther Furth",2,1,"H",0,1,"A",2.21,3.56,3.4,"0-1","2-1",9,3,14,5,2,1,0,0,7,5,16,14,3,12,30,"7-5","Y","Y","N",3,0,22
"2710","D2",2024-02-16,"Hertha","Magdeburg",3,2,"H",2,1,"H",2.38,3.81,2.89,"2-1","3-2",22,12,14,7,2,4,0,1,9,4,16,8,5,13,24,"9-4","Y","Y","Y",6,1,22
"2711","D2",2024-02-17,"Hansa Rostock","Hamburg",2,2,"D",0,1,"A",4.75,4.41,1.68,"0-1","2-2",10,7,13,4,4,2,0,0,1,1,20,13,4,2,33,"1-1","Y","Y","Y",6,0,22
"2712","D2",2024-02-17,"Paderborn","Holstein Kiel",0,4,"A",0,2,"A",2.42,3.78,2.86,"0-2","0-4",10,3,12,6,3,3,1,0,6,6,11,12,4,12,23,"6-6","Y","Y","Y",6,1,22
"2713","D2",2024-02-17,"Schalke 04","Wehen",1,0,"H",0,0,"D",1.78,3.88,4.74,"0-0","1-0",10,3,11,3,2,2,0,0,8,3,10,8,1,11,18,"8-3","N","N","N",4,0,22
"2714","D2",2024-02-17,"Karlsruhe","Fortuna Dusseldorf",2,2,"D",0,1,"A",2.7,3.63,2.62,"0-1","2-2",10,2,9,3,2,2,0,0,7,4,7,13,4,11,20,"7-4","Y","Y","Y",4,0,22
"2715","D2",2024-02-18,"Elversberg","Osnabruck",3,1,"H",3,0,"H",1.85,4.19,3.98,"3-0","3-1",11,5,11,4,3,2,0,0,5,5,12,13,4,10,25,"5-5","Y","Y","Y",5,0,22
"2716","D2",2024-02-18,"Nurnberg","Kaiserslautern",1,1,"D",0,1,"A",2.53,3.84,2.69,"0-1","1-1",7,4,20,4,5,3,0,0,8,9,13,12,2,17,25,"8-9","Y","N","N",8,0,22
"2717","D2",2024-02-18,"St Pauli","Braunschweig",1,0,"H",1,0,"H",1.39,4.82,9.47,"1-0","1-0",10,4,9,2,3,2,1,0,5,4,7,11,1,9,18,"5-4","N","N","N",5,1,22
"2718","D2",2024-02-23,"Holstein Kiel","St Pauli",3,4,"A",0,3,"A",3.19,3.49,2.34,"0-3","3-4",12,6,11,5,1,1,0,0,3,1,8,8,7,4,16,"3-1","Y","Y","Y",2,0,23
"2719","D2",2024-02-23,"Wehen","Paderborn",1,2,"A",1,1,"D",2.88,3.64,2.47,"1-1","1-2",5,1,16,4,2,2,0,0,2,7,11,7,3,9,18,"2-7","Y","Y","N",4,0,23
"2720","D2",2024-02-24,"Braunschweig","Hertha",1,1,"D",1,0,"H",2.58,3.6,2.76,"1-0","1-1",9,3,12,2,2,0,1,0,5,4,13,11,2,9,24,"5-4","Y","N","N",2,1,23
"2721","D2",2024-02-24,"Kaiserslautern","Karlsruhe",0,4,"A",0,0,"D",2.13,3.76,3.42,"0-0","0-4",8,4,8,6,3,1,0,0,6,4,8,13,4,10,21,"6-4","Y","Y","Y",4,0,23
"2722","D2",2024-02-24,"Osnabruck","Hannover",1,0,"H",0,0,"D",3.86,3.84,1.96,"0-0","1-0",9,4,16,6,2,3,0,0,3,8,15,11,1,11,26,"3-8","N","N","N",5,0,23
"2723","D2",2024-02-24,"Magdeburg","Schalke 04",3,0,"H",3,0,"H",2.27,3.72,3.14,"3-0","3-0",17,4,15,4,0,0,0,0,4,4,4,12,3,8,16,"4-4","Y","Y","N",0,0,23
"2724","D2",2024-02-25,"Fortuna Dusseldorf","Hansa Rostock",2,0,"H",2,0,"H",1.44,4.97,7.3,"2-0","2-0",17,10,14,3,1,0,0,0,2,7,3,10,2,9,13,"2-7","Y","N","N",1,0,23
"2725","D2",2024-02-25,"Greuther Furth","Nurnberg",2,1,"H",1,1,"D",1.75,4.13,4.61,"1-1","2-1",18,7,3,1,3,4,0,1,13,0,16,11,3,13,27,"13-0","Y","Y","N",7,1,23
"2726","D2",2024-02-25,"Hamburg","Elversberg",1,0,"H",0,0,"D",1.63,4.35,5.32,"0-0","1-0",16,7,12,4,2,1,0,0,5,5,8,6,1,10,14,"5-5","N","N","N",3,0,23
"2727","D2",2024-03-01,"Hertha","Holstein Kiel",2,2,"D",2,0,"H",2.61,3.71,2.67,"2-0","2-2",11,7,15,3,3,3,0,0,5,5,10,9,4,10,19,"5-5","Y","Y","Y",6,0,24
"2728","D2",2024-03-01,"Schalke 04","St Pauli",3,1,"H",1,0,"H",3.93,3.51,2.04,"1-0","3-1",14,6,7,4,3,0,0,0,6,4,14,12,4,10,26,"6-4","Y","Y","Y",3,0,24
"2729","D2",2024-03-02,"Hannover","Fortuna Dusseldorf",2,2,"D",0,2,"A",2.51,3.54,2.88,"0-2","2-2",21,8,7,3,4,0,0,0,8,4,10,10,4,12,20,"8-4","Y","Y","Y",4,0,24
"2730","D2",2024-03-02,"Hansa Rostock","Kaiserslautern",0,3,"A",0,1,"A",2.9,3.5,2.52,"0-1","0-3",7,2,20,10,3,1,1,0,2,7,15,9,3,9,24,"2-7","Y","Y","N",4,1,24
"2731","D2",2024-03-02,"Nurnberg","Braunschweig",2,1,"H",2,0,"H",2.46,3.52,2.96,"2-0","2-1",15,5,10,2,3,2,0,0,5,4,5,11,3,9,16,"5-4","Y","Y","N",5,0,24
"2732","D2",2024-03-02,"Karlsruhe","Greuther Furth",4,0,"H",1,0,"H",2.25,3.69,3.2,"1-0","4-0",19,8,11,5,3,1,0,0,5,4,13,12,4,9,25,"5-4","Y","Y","Y",4,0,24
"2733","D2",2024-03-03,"Elversberg","Wehen",0,3,"A",0,1,"A",1.85,4,4.17,"0-1","0-3",10,3,14,5,3,2,0,0,8,4,10,12,3,12,22,"8-4","Y","Y","N",5,0,24
"2734","D2",2024-03-03,"Hamburg","Osnabruck",1,2,"A",1,1,"D",1.41,5.33,7.52,"1-1","1-2",13,3,3,2,4,4,0,1,11,5,16,10,3,16,26,"11-5","Y","Y","N",8,1,24
"2735","D2",2024-03-03,"Paderborn","Magdeburg",0,0,"D",0,0,"D",2.28,3.77,3.09,"0-0","0-0",16,5,4,1,1,1,0,1,13,3,14,12,0,16,26,"13-3","N","N","N",2,1,24
"2736","D2",2024-03-08,"Braunschweig","Hansa Rostock",0,1,"A",0,0,"D",1.76,3.74,5.14,"0-0","0-1",12,3,15,2,4,3,0,0,4,4,15,15,1,8,30,"4-4","N","N","N",7,0,25
"2737","D2",2024-03-08,"Fortuna Dusseldorf","Hamburg",2,0,"H",1,0,"H",2.45,3.79,2.81,"1-0","2-0",8,4,11,0,2,2,0,1,4,1,14,6,2,5,20,"4-1","Y","N","N",4,1,25
"2738","D2",2024-03-09,"Holstein Kiel","Karlsruhe",1,0,"H",0,0,"D",2.16,3.83,3.29,"0-0","1-0",18,9,14,4,1,2,0,0,8,8,15,14,1,16,29,"8-8","N","N","N",3,0,25
"2739","D2",2024-03-09,"Schalke 04","Paderborn",3,3,"D",1,0,"H",2.25,3.75,3.16,"1-0","3-3",17,5,15,6,2,1,0,0,7,4,17,8,6,11,25,"7-4","Y","Y","Y",3,0,25
"2740","D2",2024-03-09,"Wehen","Hannover",1,1,"D",1,0,"H",3.31,3.62,2.22,"1-0","1-1",10,4,14,2,1,1,0,0,2,3,8,7,2,5,15,"2-3","Y","N","N",2,0,25
"2741","D2",2024-03-09,"Magdeburg","Nurnberg",0,1,"A",0,0,"D",1.7,4.3,4.72,"0-0","0-1",13,4,6,1,1,1,0,0,8,2,7,11,1,10,18,"8-2","N","N","N",2,0,25
"2742","D2",2024-03-10,"Greuther Furth","Elversberg",1,4,"A",0,1,"A",1.91,3.98,3.95,"0-1","1-4",7,3,19,12,4,2,1,0,2,2,16,11,5,4,27,"2-2","Y","Y","Y",6,1,25
"2743","D2",2024-03-10,"Kaiserslautern","Osnabruck",3,2,"H",0,0,"D",1.83,3.91,4.43,"0-0","3-2",13,9,6,4,2,2,0,0,11,6,14,13,5,17,27,"11-6","Y","Y","Y",4,0,25
"2744","D2",2024-03-10,"St Pauli","Hertha",2,0,"H",2,0,"H",1.71,4.1,4.97,"2-0","2-0",15,3,4,0,1,1,0,0,7,6,6,12,2,13,18,"7-6","Y","N","N",2,0,25
"2745","D2",2024-03-15,"Osnabruck","Fortuna Dusseldorf",0,4,"A",0,1,"A",3.71,3.83,2.01,"0-1","0-4",11,0,16,9,1,2,0,0,4,3,9,12,4,7,21,"4-3","Y","Y","Y",3,0,26
"2746","D2",2024-03-15,"Paderborn","Braunschweig",1,2,"A",0,0,"D",1.93,3.8,4.02,"0-0","1-2",21,6,11,3,1,2,0,0,10,1,13,7,3,11,20,"10-1","Y","Y","N",3,0,26
"2747","D2",2024-03-16,"Elversberg","Holstein Kiel",0,2,"A",0,1,"A",2.96,3.85,2.32,"0-1","0-2",11,3,14,5,1,1,0,0,4,7,11,7,2,11,18,"4-7","Y","N","N",2,0,26
"2748","D2",2024-03-16,"Hansa Rostock","Greuther Furth",1,0,"H",1,0,"H",3.2,3.61,2.28,"1-0","1-0",13,4,16,4,1,1,0,0,3,8,19,11,1,11,30,"3-8","N","N","N",2,0,26
"2749","D2",2024-03-16,"Nurnberg","St Pauli",0,2,"A",0,1,"A",4.84,4.06,1.73,"0-1","0-2",2,1,16,4,0,2,0,0,1,11,7,10,2,12,17,"1-11","Y","N","N",2,0,26
"2750","D2",2024-03-16,"Hannover","Kaiserslautern",1,1,"D",0,0,"D",1.91,3.81,4.11,"0-0","1-1",9,2,7,6,3,2,0,0,3,3,13,8,2,6,21,"3-3","Y","N","N",5,0,26
"2751","D2",2024-03-17,"Hamburg","Wehen",3,0,"H",1,0,"H",1.51,4.84,6.19,"1-0","3-0",17,8,10,4,1,1,0,0,9,2,12,12,3,11,24,"9-2","Y","Y","N",2,0,26
"2752","D2",2024-03-17,"Hertha","Schalke 04",5,2,"H",3,2,"H",2.38,3.53,3.08,"3-2","5-2",17,10,12,7,0,1,0,0,8,5,10,7,7,13,17,"8-5","Y","Y","Y",1,0,26
"2753","D2",2024-03-17,"Karlsruhe","Magdeburg",7,0,"H",4,0,"H",1.98,3.95,3.69,"4-0","7-0",24,11,8,2,0,1,0,0,9,4,12,9,7,13,21,"9-4","Y","Y","Y",1,0,26
"1","E0",2023-08-11,"Burnley","Man City",0,3,"A",0,2,"A",8.58,5.51,1.37,"0-2","0-3",6,1,17,8,0,0,1,0,6,5,11,8,3,11,19,"6-5","Y","Y","N",0,1,1
"2","E0",2023-08-12,"Arsenal","Nottm Forest",2,1,"H",2,0,"H",1.18,7.86,15.67,"2-0","2-1",15,7,6,2,2,2,0,0,8,3,12,12,3,11,24,"8-3","Y","Y","N",4,0,1
"3","E0",2023-08-12,"Bournemouth","West Ham",1,1,"D",0,0,"D",2.7,3.47,2.71,"0-0","1-1",14,5,16,3,1,4,0,0,10,4,9,14,2,14,23,"10-4","Y","N","N",5,0,1
"4","E0",2023-08-12,"Brighton","Luton",4,1,"H",1,0,"H",1.33,5.65,9.61,"1-0","4-1",27,12,9,3,2,2,0,0,6,7,11,12,5,13,23,"6-7","Y","Y","Y",4,0,1
"5","E0",2023-08-12,"Everton","Fulham",0,1,"A",0,0,"D",2.27,3.45,3.35,"0-0","0-1",19,9,9,2,0,2,0,0,10,4,12,6,1,14,18,"10-4","N","N","N",2,0,1
"6","E0",2023-08-12,"Sheffield United","Crystal Palace",0,1,"A",0,0,"D",3.28,3.22,2.43,"0-0","0-1",8,1,24,8,3,0,0,0,5,5,18,11,1,10,29,"5-5","N","N","N",3,0,1
"7","E0",2023-08-12,"Newcastle","Aston Villa",5,1,"H",2,1,"H",1.77,3.92,4.77,"2-1","5-1",17,13,16,6,4,4,0,0,6,5,12,17,6,11,29,"6-5","Y","Y","Y",8,0,1
"8","E0",2023-08-13,"Brentford","Tottenham",2,2,"D",2,2,"D",2.76,3.65,2.55,"2-2","2-2",11,6,18,6,1,4,0,0,3,6,12,13,4,9,25,"3-6","Y","Y","Y",5,0,1
"9","E0",2023-08-13,"Chelsea","Liverpool",1,1,"D",1,1,"D",2.97,3.64,2.4,"1-1","1-1",10,4,13,1,3,3,0,0,4,4,5,12,2,8,17,"4-4","Y","N","N",6,0,1
"10","E0",2023-08-14,"Man United","Wolves",1,0,"H",0,0,"D",1.32,5.79,9.66,"0-0","1-0",15,3,23,6,2,3,0,0,8,7,14,10,1,15,24,"8-7","N","N","N",5,0,1
"11","E0",2023-08-18,"Nottm Forest","Sheffield United",2,1,"H",1,0,"H",1.97,3.48,4.37,"1-0","2-1",16,4,7,3,2,3,0,0,6,7,5,9,3,13,14,"6-7","Y","Y","N",5,0,2
"12","E0",2023-08-19,"Fulham","Brentford",0,3,"A",0,1,"A",2.76,3.43,2.67,"0-1","0-3",10,2,17,8,2,2,1,0,5,5,13,12,3,10,25,"5-5","Y","Y","N",4,1,2
"13","E0",2023-08-19,"Liverpool","Bournemouth",3,1,"H",2,1,"H",1.23,7.14,11.46,"2-1","3-1",26,10,13,5,1,3,1,0,10,2,11,13,4,12,24,"10-2","Y","Y","Y",4,1,2
"14","E0",2023-08-19,"Wolves","Brighton",1,4,"A",0,1,"A",4.12,3.92,1.88,"0-1","1-4",16,5,16,8,3,6,1,0,5,3,14,11,5,8,25,"5-3","Y","Y","Y",9,1,2
"15","E0",2023-08-19,"Tottenham","Man United",2,0,"H",0,0,"D",2.85,3.82,2.41,"0-0","2-0",17,6,22,6,1,3,0,0,5,6,9,8,2,11,17,"5-6","Y","N","N",4,0,2
"16","E0",2023-08-19,"Man City","Newcastle",1,0,"H",1,0,"H",1.73,4.1,4.8,"1-0","1-0",14,4,7,1,1,5,0,0,3,0,12,11,1,3,23,"3-0","N","N","N",6,0,2
"17","E0",2023-08-20,"Aston Villa","Everton",4,0,"H",2,0,"H",1.72,3.99,5.06,"2-0","4-0",13,7,9,2,3,4,0,0,7,6,8,12,4,13,20,"7-6","Y","Y","Y",7,0,2
"18","E0",2023-08-20,"West Ham","Chelsea",3,1,"H",1,1,"D",3.68,3.57,2.1,"1-1","3-1",12,6,17,4,2,3,1,0,3,9,12,9,4,12,21,"3-9","Y","Y","Y",5,1,2
"19","E0",2023-08-21,"Crystal Palace","Arsenal",0,1,"A",0,0,"D",5.73,4.12,1.63,"0-0","0-1",14,2,14,3,2,1,0,1,1,8,14,10,1,9,24,"1-8","N","N","N",3,1,2
"20","E0",2023-08-25,"Chelsea","Luton",3,0,"H",1,0,"H",1.3,6.08,10.68,"1-0","3-0",19,8,11,1,2,3,0,0,6,4,15,12,3,10,27,"6-4","Y","Y","N",5,0,2
"21","E0",2023-08-26,"Bournemouth","Tottenham",0,2,"A",0,1,"A",3.72,4.04,1.95,"0-1","0-2",11,3,17,6,1,3,0,0,6,2,18,11,2,8,29,"6-2","Y","N","N",4,0,3
"22","E0",2023-08-26,"Arsenal","Fulham",2,2,"D",0,1,"A",1.24,6.07,15.25,"0-1","2-2",19,11,8,3,0,3,0,1,8,3,6,5,4,11,11,"8-3","Y","Y","Y",3,1,3
"23","E0",2023-08-26,"Brentford","Crystal Palace",1,1,"D",1,0,"H",2.17,3.43,3.62,"1-0","1-1",12,1,15,5,0,0,0,0,8,6,9,15,2,14,24,"8-6","Y","N","N",0,0,3
"24","E0",2023-08-26,"Everton","Wolves",0,1,"A",0,0,"D",2.34,3.32,3.34,"0-0","0-1",15,7,11,2,3,4,0,0,7,0,10,14,1,7,24,"7-0","N","N","N",7,0,3
"25","E0",2023-08-26,"Man United","Nottm Forest",3,2,"H",1,2,"A",1.32,5.98,9.11,"1-2","3-2",18,9,9,4,4,4,0,1,11,3,13,11,5,14,24,"11-3","Y","Y","Y",8,1,3
"26","E0",2023-08-26,"Brighton","West Ham",1,3,"A",0,1,"A",1.54,4.74,5.81,"0-1","1-3",25,10,12,3,1,3,0,0,17,4,10,9,4,21,19,"17-4","Y","Y","Y",4,0,3
"27","E0",2023-08-27,"Burnley","Aston Villa",1,3,"A",0,2,"A",3.39,3.65,2.18,"0-2","1-3",9,2,16,6,2,0,0,0,4,6,12,11,4,10,23,"4-6","Y","Y","Y",2,0,3
"28","E0",2023-08-27,"Sheffield United","Man City",1,2,"A",0,0,"D",16.72,7.73,1.18,"0-0","1-2",6,2,30,9,3,0,0,0,1,12,11,2,3,13,13,"1-12","Y","Y","N",3,0,3
"29","E0",2023-08-27,"Newcastle","Liverpool",1,2,"A",1,0,"H",2.2,3.95,3.13,"1-0","1-2",23,8,9,4,1,2,0,1,5,9,16,10,3,14,26,"5-9","Y","Y","N",3,1,3
"30","E0",2023-09-01,"Luton","West Ham",1,2,"A",0,1,"A",4.82,4.04,1.75,"0-1","1-2",16,1,9,3,1,1,0,0,9,6,8,13,3,15,21,"9-6","Y","Y","N",2,0,3
"31","E0",2023-09-02,"Sheffield United","Everton",2,2,"D",2,1,"H",3.06,3.27,2.53,"2-1","2-2",13,8,16,6,1,2,0,0,4,6,11,13,4,10,24,"4-6","Y","Y","Y",3,0,4
"32","E0",2023-09-02,"Brentford","Bournemouth",2,2,"D",1,1,"D",1.75,4.14,4.62,"1-1","2-2",21,7,12,5,1,2,0,0,5,2,6,13,4,7,19,"5-2","Y","Y","Y",3,0,4
"33","E0",2023-09-02,"Burnley","Tottenham",2,5,"A",1,2,"A",3.97,4.04,1.88,"1-2","2-5",16,4,20,10,4,3,0,0,7,4,15,9,7,11,24,"7-4","Y","Y","Y",7,0,4
"34","E0",2023-09-02,"Chelsea","Nottm Forest",0,1,"A",0,0,"D",1.39,5.1,8.62,"0-0","0-1",21,2,7,3,3,4,0,0,8,0,10,9,1,8,19,"8-0","N","N","N",7,0,4
"35","E0",2023-09-02,"Man City","Fulham",5,1,"H",2,1,"H",1.15,8.93,18.11,"2-1","5-1",7,5,6,4,2,4,0,0,4,5,12,12,6,9,24,"4-5","Y","Y","Y",6,0,4
"36","E0",2023-09-02,"Brighton","Newcastle",3,1,"H",1,0,"H",2.59,3.94,2.58,"1-0","3-1",15,6,9,2,4,4,0,0,5,3,14,17,4,8,31,"5-3","Y","Y","Y",8,0,4
"37","E0",2023-09-03,"Crystal Palace","Wolves",3,2,"H",0,0,"D",1.97,3.5,4.25,"0-0","3-2",16,11,12,4,1,3,0,0,4,2,12,12,5,6,24,"4-2","Y","Y","Y",4,0,4
"38","E0",2023-09-03,"Liverpool","Aston Villa",3,0,"H",2,0,"H",1.68,4.61,4.6,"2-0","3-0",17,4,9,3,0,1,0,0,7,3,12,7,3,10,19,"7-3","Y","Y","N",1,0,4
"39","E0",2023-09-03,"Arsenal","Man United",3,1,"H",1,1,"D",1.77,4.08,4.55,"1-1","3-1",17,5,10,2,2,3,0,0,12,3,8,7,4,15,15,"12-3","Y","Y","Y",5,0,4
"40","E0",2023-09-16,"Wolves","Liverpool",1,3,"A",1,0,"H",6.66,4.98,1.47,"1-0","1-3",11,2,16,6,1,3,0,0,4,4,10,4,4,8,14,"4-4","Y","Y","Y",4,0,4
"41","E0",2023-09-16,"Aston Villa","Crystal Palace",3,1,"H",0,0,"D",1.93,3.76,4.1,"0-0","3-1",16,5,6,3,5,3,0,0,4,2,13,9,4,6,22,"4-2","Y","Y","Y",8,0,5
"42","E0",2023-09-16,"Fulham","Luton",1,0,"H",0,0,"D",1.68,4.03,5.31,"0-0","1-0",13,2,7,2,2,2,0,0,6,2,6,14,1,8,20,"6-2","N","N","N",4,0,5
"43","E0",2023-09-16,"Man United","Brighton",1,3,"A",0,1,"A",2.25,4.02,2.99,"0-1","1-3",14,4,10,8,2,2,0,0,8,1,8,9,4,9,17,"8-1","Y","Y","Y",4,0,5
"44","E0",2023-09-16,"Tottenham","Sheffield United",2,1,"H",0,0,"D",1.29,6.08,10.21,"0-0","2-1",28,10,7,5,6,5,0,1,15,2,13,14,3,17,27,"15-2","Y","Y","N",11,1,5
"45","E0",2023-09-16,"West Ham","Man City",1,3,"A",1,0,"H",6.58,4.7,1.5,"1-0","1-3",6,3,29,15,3,2,0,0,4,11,7,11,4,15,18,"4-11","Y","Y","Y",5,0,5
"46","E0",2023-09-16,"Newcastle","Brentford",1,0,"H",0,0,"D",1.54,4.47,6.3,"0-0","1-0",9,2,11,2,3,5,0,0,8,3,8,12,1,11,20,"8-3","N","N","N",8,0,5
"47","E0",2023-09-17,"Bournemouth","Chelsea",0,0,"D",0,0,"D",4.39,4.05,1.8,"0-0","0-0",13,4,14,6,1,5,0,0,1,7,15,20,0,8,35,"1-7","N","N","N",6,0,5
"48","E0",2023-09-17,"Everton","Arsenal",0,1,"A",0,0,"D",6.3,4.54,1.53,"0-0","0-1",8,1,13,4,1,1,0,0,1,11,12,10,1,12,22,"1-11","N","N","N",2,0,5
"49","E0",2023-09-18,"Nottm Forest","Burnley",1,1,"D",0,1,"A",2.23,3.58,3.33,"0-1","1-1",14,4,10,3,2,3,0,1,5,4,16,10,2,9,26,"5-4","Y","N","N",5,1,5
"50","E0",2023-09-23,"Crystal Palace","Fulham",0,0,"D",0,0,"D",1.99,3.54,4.11,"0-0","0-0",7,3,10,5,3,2,0,0,3,2,10,15,0,5,25,"3-2","N","N","N",5,0,5
"51","E0",2023-09-23,"Luton","Wolves",1,1,"D",0,0,"D",3.26,3.47,2.31,"0-0","1-1",20,4,3,3,0,2,0,1,10,1,12,17,2,11,29,"10-1","Y","N","N",2,1,6
"52","E0",2023-09-23,"Man City","Nottm Forest",2,0,"H",2,0,"H",1.15,9.04,17.91,"2-0","2-0",7,4,10,3,3,7,1,0,6,6,5,17,2,12,22,"6-6","Y","N","N",10,1,6
"53","E0",2023-09-23,"Brentford","Everton",1,3,"A",1,1,"D",1.81,3.8,4.67,"1-1","1-3",12,2,18,6,2,2,0,0,1,4,9,12,4,5,21,"1-4","Y","Y","Y",4,0,6
"54","E0",2023-09-23,"Burnley","Man United",0,1,"A",0,1,"A",4.28,4.31,1.77,"0-1","0-1",12,4,11,4,1,2,0,0,9,5,6,12,1,14,18,"9-5","N","N","N",3,0,6
"55","E0",2023-09-24,"Arsenal","Tottenham",2,2,"D",1,1,"D",1.68,4.45,4.69,"1-1","2-2",13,6,13,5,3,4,0,0,11,4,12,19,4,15,31,"11-4","Y","Y","Y",7,0,6
"56","E0",2023-09-24,"Brighton","Bournemouth",3,1,"H",1,1,"D",1.41,5.08,7.9,"1-1","3-1",13,4,12,4,3,3,0,0,4,4,12,17,4,8,29,"4-4","Y","Y","Y",6,0,6
"57","E0",2023-09-24,"Chelsea","Aston Villa",0,1,"A",0,0,"D",1.93,3.9,3.93,"0-0","0-1",10,4,15,7,2,3,0,0,5,11,9,11,1,16,20,"5-11","N","N","N",5,0,6
"58","E0",2023-09-24,"Liverpool","West Ham",3,1,"H",1,1,"D",1.4,5.67,7.21,"1-1","3-1",22,7,11,4,0,2,0,0,7,4,12,13,4,11,25,"7-4","Y","Y","Y",2,0,6
"59","E0",2023-09-24,"Sheffield United","Newcastle",0,8,"A",0,3,"A",7.05,4.98,1.45,"0-3","0-8",9,1,22,15,3,0,0,0,2,6,12,8,8,8,20,"2-6","Y","Y","Y",3,0,6
"60","E0",2023-09-30,"Aston Villa","Brighton",6,1,"H",3,0,"H",2.58,3.96,2.58,"3-0","6-1",19,9,11,3,4,4,0,0,1,3,19,21,7,4,40,"1-3","Y","Y","Y",8,0,6
"61","E0",2023-09-30,"Bournemouth","Arsenal",0,4,"A",0,2,"A",5.59,4.77,1.56,"0-2","0-4",8,1,15,8,0,1,0,0,6,6,11,10,4,12,21,"6-6","Y","Y","Y",1,0,7
"62","E0",2023-09-30,"Everton","Luton",1,2,"A",1,2,"A",1.62,3.94,6.24,"1-2","1-2",23,5,9,2,0,1,0,0,3,6,8,10,3,9,18,"3-6","Y","Y","N",1,0,7
"63","E0",2023-09-30,"Man United","Crystal Palace",0,1,"A",0,1,"A",1.57,4.36,5.96,"0-1","0-1",19,4,8,2,3,2,0,0,10,4,10,8,1,14,18,"10-4","N","N","N",5,0,7
"64","E0",2023-09-30,"Newcastle","Burnley",2,0,"H",1,0,"H",1.34,5.67,9.15,"1-0","2-0",20,8,8,2,1,3,0,0,5,3,7,15,2,8,22,"5-3","Y","N","N",4,0,7
"65","E0",2023-09-30,"West Ham","Sheffield United",2,0,"H",2,0,"H",1.44,4.94,7.44,"2-0","2-0",20,9,16,2,1,1,0,0,7,4,6,9,2,11,15,"7-4","Y","N","N",2,0,7
"66","E0",2023-09-30,"Wolves","Man City",2,1,"H",1,0,"H",9.61,5.75,1.33,"1-0","2-1",3,1,23,8,5,4,0,0,0,6,18,12,3,6,30,"0-6","Y","Y","N",9,0,7
"67","E0",2023-09-30,"Tottenham","Liverpool",2,1,"H",1,1,"D",2.98,4.12,2.23,"1-1","2-1",24,8,12,4,5,4,0,2,12,5,11,17,3,17,28,"12-5","Y","Y","N",9,2,7
"68","E0",2023-10-01,"Nottm Forest","Brentford",1,1,"D",0,0,"D",2.84,3.29,2.69,"0-0","1-1",6,1,18,5,1,2,1,0,1,11,6,10,2,12,16,"1-11","Y","N","N",3,1,7
"69","E0",2023-10-02,"Fulham","Chelsea",0,2,"A",0,2,"A",3.93,3.45,2.06,"0-2","0-2",10,3,11,4,1,4,0,0,8,1,15,12,2,9,27,"8-1","Y","N","N",5,0,7
"70","E0",2023-10-03,"Luton","Burnley",1,2,"A",0,1,"A",2.94,3.23,2.65,"0-1","1-2",18,3,14,4,4,2,0,0,7,6,14,6,3,13,20,"7-6","Y","Y","N",6,0,7
"71","E0",2023-10-07,"Luton","Tottenham",0,1,"A",0,0,"D",6.91,4.98,1.46,"0-0","0-1",12,2,15,4,2,1,0,1,5,6,16,7,1,11,23,"5-6","N","N","N",3,1,8
"72","E0",2023-10-07,"Burnley","Chelsea",1,4,"A",1,1,"D",4.58,3.98,1.78,"1-1","1-4",10,3,9,5,2,4,0,0,7,3,11,8,5,10,19,"7-3","Y","Y","Y",6,0,8
"73","E0",2023-10-07,"Everton","Bournemouth",3,0,"H",2,0,"H",1.99,3.71,3.88,"2-0","3-0",25,8,11,4,1,2,0,0,8,7,14,15,3,15,29,"8-7","Y","Y","N",3,0,8
"74","E0",2023-10-07,"Fulham","Sheffield United",3,1,"H",0,0,"D",1.64,4,5.9,"0-0","3-1",20,6,5,2,1,2,0,0,9,4,8,10,4,13,18,"9-4","Y","Y","Y",3,0,8
"75","E0",2023-10-07,"Man United","Brentford",2,1,"H",0,1,"A",1.7,4.23,4.87,"0-1","2-1",21,8,11,3,0,5,0,0,7,5,10,17,3,12,27,"7-5","Y","Y","N",5,0,8
"76","E0",2023-10-07,"Crystal Palace","Nottm Forest",0,0,"D",0,0,"D",2.26,3.3,3.54,"0-0","0-0",8,2,16,5,0,1,0,0,3,7,7,12,0,10,19,"3-7","N","N","N",1,0,8
"77","E0",2023-10-08,"Brighton","Liverpool",2,2,"D",1,2,"A",3.14,4.02,2.17,"1-2","2-2",14,3,14,4,1,2,0,0,8,1,12,20,4,9,32,"8-1","Y","Y","Y",3,0,8
"78","E0",2023-10-08,"West Ham","Newcastle",2,2,"D",1,0,"H",3.41,3.79,2.12,"1-0","2-2",5,3,10,3,3,3,0,0,4,2,11,18,4,6,29,"4-2","Y","Y","Y",6,0,8
"79","E0",2023-10-08,"Wolves","Aston Villa",1,1,"D",0,0,"D",3.39,3.64,2.18,"0-0","1-1",8,3,18,4,2,2,1,0,2,10,19,9,2,12,28,"2-10","Y","N","N",4,1,8
"80","E0",2023-10-08,"Arsenal","Man City",1,0,"H",0,0,"D",2.99,3.49,2.46,"0-0","1-0",12,2,4,1,2,3,0,0,5,4,8,7,1,9,15,"5-4","N","N","N",5,0,8
"81","E0",2023-10-21,"Liverpool","Everton",2,0,"H",0,0,"D",1.37,5.77,7.65,"0-0","2-0",26,6,6,1,1,1,0,1,12,4,9,9,2,16,18,"12-4","Y","N","N",2,1,9
"82","E0",2023-10-21,"Bournemouth","Wolves",1,2,"A",1,0,"H",2.45,3.49,3.01,"1-0","1-2",7,4,20,7,2,6,1,0,3,12,15,10,3,15,25,"3-12","Y","Y","N",8,1,9
"83","E0",2023-10-21,"Brentford","Burnley",3,0,"H",1,0,"H",1.87,3.77,4.37,"1-0","3-0",23,10,6,1,5,2,0,1,5,5,14,12,3,10,26,"5-5","Y","Y","N",7,1,9
"84","E0",2023-10-21,"Man City","Brighton",2,1,"H",2,0,"H",1.42,5.45,6.93,"2-0","2-1",10,6,5,3,2,2,1,0,2,2,9,11,3,4,20,"2-2","Y","Y","N",4,1,9
"85","E0",2023-10-21,"Newcastle","Crystal Palace",4,0,"H",3,0,"H",1.46,4.63,7.7,"3-0","4-0",10,7,17,3,2,3,0,0,6,8,7,12,4,14,19,"6-8","Y","Y","Y",5,0,9
"86","E0",2023-10-21,"Nottm Forest","Luton",2,2,"D",0,0,"D",1.7,3.89,5.43,"0-0","2-2",19,8,13,4,3,0,0,0,4,2,12,11,4,6,23,"4-2","Y","Y","Y",3,0,9
"87","E0",2023-10-21,"Chelsea","Arsenal",2,2,"D",1,0,"H",3.33,3.5,2.26,"1-0","2-2",11,5,13,3,3,3,0,0,2,7,7,14,4,9,21,"2-7","Y","Y","Y",6,0,9
"88","E0",2023-10-21,"Sheffield United","Man United",1,2,"A",1,1,"D",7.57,5.24,1.41,"1-1","1-2",12,6,14,5,3,1,0,0,5,4,12,10,3,9,22,"5-4","Y","Y","N",4,0,9
"89","E0",2023-10-22,"Aston Villa","West Ham",4,1,"H",1,0,"H",1.9,3.93,4.01,"1-0","4-1",15,7,14,4,0,1,0,0,8,7,9,15,5,15,24,"8-7","Y","Y","Y",1,0,9
"90","E0",2023-10-23,"Tottenham","Fulham",2,0,"H",1,0,"H",1.51,4.85,6.06,"1-0","2-0",15,5,10,3,2,0,0,0,3,5,10,14,2,8,24,"3-5","Y","N","N",2,0,9
"91","E0",2023-10-27,"Crystal Palace","Tottenham",1,2,"A",0,0,"D",4.7,3.84,1.79,"0-0","1-2",13,3,10,1,2,1,0,0,11,2,19,11,3,13,30,"11-2","Y","Y","N",3,0,10
"92","E0",2023-10-28,"Chelsea","Brentford",0,2,"A",0,0,"D",1.66,4.15,5.32,"0-0","0-2",17,2,7,5,1,4,0,0,10,1,12,7,2,11,19,"10-1","Y","N","N",5,0,10
"93","E0",2023-10-28,"Arsenal","Sheffield United",5,0,"H",1,0,"H",1.13,10.16,21.31,"1-0","5-0",13,8,2,0,0,3,0,0,6,1,9,13,5,7,22,"6-1","Y","Y","Y",3,0,10
"94","E0",2023-10-28,"Bournemouth","Burnley",2,1,"H",1,1,"D",2.1,3.76,3.49,"1-1","2-1",13,6,6,3,2,3,0,0,10,5,9,12,3,15,21,"10-5","Y","Y","N",5,0,10
"95","E0",2023-10-28,"Wolves","Newcastle",2,2,"D",1,2,"A",4.22,3.99,1.84,"1-2","2-2",11,6,13,5,1,4,0,0,8,7,13,15,4,15,28,"8-7","Y","Y","Y",5,0,10
"96","E0",2023-10-29,"West Ham","Everton",0,1,"A",0,0,"D",2.18,3.62,3.41,"0-0","0-1",12,2,10,4,4,1,0,0,4,3,7,11,1,7,18,"4-3","N","N","N",5,0,10
"97","E0",2023-10-29,"Aston Villa","Luton",3,1,"H",1,0,"H",1.28,6.23,10.8,"1-0","3-1",17,6,7,1,3,2,0,0,6,4,11,10,4,10,21,"6-4","Y","Y","Y",5,0,10
"98","E0",2023-10-29,"Brighton","Fulham",1,1,"D",1,0,"H",1.59,4.65,5.36,"1-0","1-1",18,7,10,5,0,3,0,0,7,3,12,8,2,10,20,"7-3","Y","N","N",3,0,10
"99","E0",2023-10-29,"Liverpool","Nottm Forest",3,0,"H",2,0,"H",1.27,6.51,10.09,"2-0","3-0",21,8,9,1,2,3,0,0,8,3,9,13,3,11,22,"8-3","Y","Y","N",5,0,10
"100","E0",2023-10-29,"Man United","Man City",0,3,"A",0,1,"A",5.16,4.07,1.69,"0-1","0-3",7,3,21,10,4,1,0,0,7,12,9,4,3,19,13,"7-12","Y","Y","N",5,0,10
"101","E0",2023-11-04,"Fulham","Man United",0,1,"A",0,0,"D",3.22,3.68,2.22,"0-0","0-1",18,3,12,5,5,2,0,0,9,4,9,15,1,13,24,"9-4","N","N","N",7,0,11
"102","E0",2023-11-04,"Brentford","West Ham",3,2,"H",1,2,"A",2.07,3.74,3.52,"1-2","3-2",16,4,12,2,1,4,0,0,4,3,12,14,5,7,26,"4-3","Y","Y","Y",5,0,11
"103","E0",2023-11-04,"Burnley","Crystal Palace",0,2,"A",0,1,"A",2.89,3.24,2.65,"0-1","0-2",17,5,4,3,0,5,0,0,12,1,9,12,2,13,21,"12-1","Y","N","N",5,0,11
"104","E0",2023-11-04,"Everton","Brighton",1,1,"D",1,0,"H",3.1,3.87,2.21,"1-0","1-1",10,4,7,2,4,2,0,0,3,3,15,5,2,6,20,"3-3","Y","N","N",6,0,11
"105","E0",2023-11-04,"Man City","Bournemouth",6,1,"H",3,0,"H",1.08,12.84,29.22,"3-0","6-1",21,8,5,1,0,1,0,0,12,1,8,9,7,13,17,"12-1","Y","Y","Y",1,0,11
"106","E0",2023-11-04,"Sheffield United","Wolves",2,1,"H",0,0,"D",3.91,3.68,1.97,"0-0","2-1",11,2,10,3,2,3,0,0,4,4,13,10,3,8,23,"4-4","Y","Y","N",5,0,11
"107","E0",2023-11-04,"Newcastle","Arsenal",1,0,"H",0,0,"D",2.83,3.41,2.59,"0-0","1-0",9,2,14,1,5,1,0,0,0,11,14,9,1,11,23,"0-11","N","N","N",6,0,11
"108","E0",2023-11-05,"Nottm Forest","Aston Villa",2,0,"H",1,0,"H",4.17,3.76,1.89,"1-0","2-0",5,3,13,3,1,1,0,0,0,10,6,9,2,10,15,"0-10","Y","N","N",2,0,11
"109","E0",2023-11-05,"Luton","Liverpool",1,1,"D",0,0,"D",11.23,6.76,1.24,"0-0","1-1",8,5,24,6,1,1,0,0,4,7,7,13,2,11,20,"4-7","Y","N","N",2,0,11
"110","E0",2023-11-06,"Tottenham","Chelsea",1,4,"A",1,1,"D",2.14,3.73,3.34,"1-1","1-4",8,5,17,8,1,5,2,0,1,6,12,21,5,7,33,"1-6","Y","Y","Y",6,2,11
"111","E0",2023-11-11,"Wolves","Tottenham",2,1,"H",0,1,"A",3.11,3.78,2.23,"0-1","2-1",17,4,6,2,4,3,0,0,11,3,19,15,3,14,34,"11-3","Y","Y","N",7,0,12
"112","E0",2023-11-11,"Arsenal","Burnley",3,1,"H",1,0,"H",1.19,7.47,14.74,"1-0","3-1",16,6,8,5,0,1,1,0,3,3,8,9,4,6,17,"3-3","Y","Y","Y",1,1,12
"113","E0",2023-11-11,"Crystal Palace","Everton",2,3,"A",1,1,"D",2.45,3.2,3.19,"1-1","2-3",13,4,8,4,1,4,0,0,9,2,9,18,5,11,27,"9-2","Y","Y","Y",5,0,12
"114","E0",2023-11-11,"Man United","Luton",1,0,"H",0,0,"D",1.31,5.86,9.36,"0-0","1-0",15,4,10,4,0,2,0,0,11,3,9,11,1,14,20,"11-3","N","N","N",2,0,12
"115","E0",2023-11-11,"Bournemouth","Newcastle",2,0,"H",0,0,"D",4.52,4.06,1.76,"0-0","2-0",19,10,8,5,2,1,0,0,6,5,10,4,2,11,14,"6-5","Y","N","N",3,0,12
"116","E0",2023-11-12,"Aston Villa","Fulham",3,1,"H",2,0,"H",1.6,4.27,5.67,"2-0","3-1",12,6,9,5,2,5,0,0,2,2,4,17,4,4,21,"2-2","Y","Y","Y",7,0,12
"117","E0",2023-11-12,"Brighton","Sheffield United",1,1,"D",1,0,"H",1.24,6.8,11.28,"1-0","1-1",11,6,9,1,3,2,1,0,6,3,13,16,2,9,29,"6-3","Y","N","N",5,1,12
"118","E0",2023-11-12,"Liverpool","Brentford",3,0,"H",1,0,"H",1.41,5.26,7.17,"1-0","3-0",17,10,16,3,1,2,0,0,6,8,16,12,3,14,28,"6-8","Y","Y","N",3,0,12
"119","E0",2023-11-12,"West Ham","Nottm Forest",3,2,"H",1,1,"D",1.89,3.79,4.1,"1-1","3-2",16,6,10,5,2,2,0,0,9,4,9,12,5,13,21,"9-4","Y","Y","Y",4,0,12
"120","E0",2023-11-12,"Chelsea","Man City",4,4,"D",2,2,"D",4.92,3.8,1.75,"2-2","4-4",17,9,15,10,5,3,0,0,3,3,12,15,8,6,27,"3-3","Y","Y","Y",8,0,12
"121","E0",2023-11-25,"Man City","Liverpool",1,1,"D",1,0,"H",1.75,4.37,4.24,"1-0","1-1",16,5,8,3,1,3,0,0,9,6,9,11,2,15,20,"9-6","Y","N","N",4,0,13
"122","E0",2023-11-25,"Burnley","West Ham",1,2,"A",0,0,"D",3.58,3.54,2.12,"0-0","1-2",11,5,11,3,1,3,0,0,4,5,11,7,3,9,18,"4-5","Y","Y","N",4,0,13
"123","E0",2023-11-25,"Luton","Crystal Palace",2,1,"H",0,0,"D",3.7,3.41,2.13,"0-0","2-1",8,3,16,8,6,1,0,0,4,5,15,12,3,9,27,"4-5","Y","Y","N",7,0,13
"124","E0",2023-11-25,"Newcastle","Chelsea",4,1,"H",1,1,"D",2.65,3.46,2.73,"1-1","4-1",14,5,7,4,4,4,0,1,4,2,13,19,5,6,32,"4-2","Y","Y","Y",8,1,13
"125","E0",2023-11-25,"Nottm Forest","Brighton",2,3,"A",1,2,"A",3.32,3.63,2.19,"1-2","2-3",18,5,11,5,2,4,0,1,6,4,12,7,5,10,19,"6-4","Y","Y","Y",6,1,13
"126","E0",2023-11-25,"Sheffield United","Bournemouth",1,3,"A",0,2,"A",3.36,3.54,2.2,"0-2","1-3",10,2,23,11,4,1,0,0,4,7,6,8,4,11,14,"4-7","Y","Y","Y",5,0,13
"127","E0",2023-11-25,"Brentford","Arsenal",0,1,"A",0,0,"D",4.74,3.82,1.78,"0-0","0-1",9,3,15,4,1,1,0,0,1,8,9,7,1,9,16,"1-8","N","N","N",2,0,13
"128","E0",2023-11-26,"Tottenham","Aston Villa",1,2,"A",1,1,"D",2.36,3.93,2.82,"1-1","1-2",18,8,15,5,0,4,0,0,9,3,11,13,3,12,24,"9-3","Y","Y","N",4,0,13
"129","E0",2023-11-26,"Everton","Man United",0,3,"A",0,1,"A",2.75,3.51,2.6,"0-1","0-3",24,6,9,4,3,0,0,0,6,5,10,8,3,11,18,"6-5","Y","Y","N",3,0,13
"130","E0",2023-11-27,"Fulham","Wolves",3,2,"H",1,1,"D",2.45,3.37,3.05,"1-1","3-2",12,6,10,6,2,2,0,0,6,2,13,13,5,8,26,"6-2","Y","Y","Y",4,0,13
"131","E0",2023-12-02,"Arsenal","Wolves",2,1,"H",2,0,"H",1.29,5.9,10.82,"2-0","2-1",19,6,6,3,1,2,0,0,4,0,10,10,3,4,20,"4-0","Y","Y","N",3,0,14
"132","E0",2023-12-02,"Brentford","Luton",3,1,"H",0,0,"D",1.45,4.83,7.07,"0-0","3-1",27,6,7,1,1,2,0,0,7,5,10,8,4,12,18,"7-5","Y","Y","Y",3,0,14
"133","E0",2023-12-02,"Burnley","Sheffield United",5,0,"H",2,0,"H",1.83,3.63,4.65,"2-0","5-0",19,7,6,3,2,5,0,1,6,1,9,12,5,7,21,"6-1","Y","Y","Y",7,1,14
"134","E0",2023-12-02,"Nottm Forest","Everton",0,1,"A",0,0,"D",2.85,3.31,2.64,"0-0","0-1",13,2,12,3,1,0,0,0,4,3,15,14,1,7,29,"4-3","N","N","N",1,0,14
"135","E0",2023-12-02,"Newcastle","Man United",1,0,"H",0,0,"D",1.9,3.87,4,"0-0","1-0",22,4,8,1,1,2,0,0,7,3,6,13,1,10,19,"7-3","N","N","N",3,0,14
"136","E0",2023-12-03,"Bournemouth","Aston Villa",2,2,"D",1,1,"D",3.56,4.07,1.97,"1-1","2-2",15,7,11,3,5,3,0,0,7,7,16,12,4,14,28,"7-7","Y","Y","Y",8,0,14
"137","E0",2023-12-03,"Chelsea","Brighton",3,2,"H",2,1,"H",1.75,4.21,4.4,"2-1","3-2",8,5,18,9,3,5,1,0,5,8,16,12,5,13,28,"5-8","Y","Y","Y",8,1,14
"138","E0",2023-12-03,"Liverpool","Fulham",4,3,"H",2,2,"D",1.25,6.76,10.35,"2-2","4-3",26,12,9,5,0,0,0,0,3,4,6,7,7,7,13,"3-4","Y","Y","Y",0,0,14
"139","E0",2023-12-03,"West Ham","Crystal Palace",1,1,"D",1,0,"H",2.01,3.56,3.92,"1-0","1-1",9,3,9,2,2,0,0,0,2,3,17,7,2,5,24,"2-3","Y","N","N",2,0,14
"140","E0",2023-12-03,"Man City","Tottenham",3,3,"D",2,1,"H",1.27,6.42,9.75,"2-1","3-3",18,4,8,4,4,4,0,0,10,8,14,14,6,18,28,"10-8","Y","Y","Y",8,0,14
"141","E0",2023-12-05,"Wolves","Burnley",1,0,"H",1,0,"H",1.92,3.6,4.35,"1-0","1-0",7,4,12,3,2,4,0,0,6,8,11,15,1,14,26,"6-8","N","N","N",6,0,15
"142","E0",2023-12-05,"Luton","Arsenal",3,4,"A",1,2,"A",14.73,6.77,1.22,"1-2","3-4",6,4,23,9,2,1,0,0,3,8,14,7,7,11,21,"3-8","Y","Y","Y",3,0,15
"143","E0",2023-12-06,"Brighton","Brentford",2,1,"H",1,1,"D",1.94,3.89,3.79,"1-1","2-1",18,7,8,2,3,1,0,0,7,3,10,8,3,10,18,"7-3","Y","Y","N",4,0,15
"144","E0",2023-12-06,"Crystal Palace","Bournemouth",0,2,"A",0,1,"A",2.3,3.45,3.23,"0-1","0-2",16,3,11,4,1,3,0,0,3,9,10,17,2,12,27,"3-9","Y","N","N",4,0,15
"145","E0",2023-12-06,"Fulham","Nottm Forest",5,0,"H",2,0,"H",2.06,3.5,3.81,"2-0","5-0",14,6,4,1,0,1,0,0,6,1,7,10,5,7,17,"6-1","Y","Y","Y",1,0,15
"146","E0",2023-12-06,"Sheffield United","Liverpool",0,2,"A",0,1,"A",14.14,7.68,1.19,"0-1","0-2",6,1,15,8,2,3,0,0,2,12,12,8,2,14,20,"2-12","Y","N","N",5,0,15
"147","E0",2023-12-06,"Aston Villa","Man City",1,0,"H",0,0,"D",4.35,4.29,1.75,"0-0","1-0",22,7,2,2,2,2,0,0,6,0,13,13,1,6,26,"6-0","N","N","N",4,0,15
"148","E0",2023-12-06,"Man United","Chelsea",2,1,"H",1,1,"D",2.88,3.67,2.42,"1-1","2-1",28,9,13,3,4,0,0,0,12,4,12,12,3,16,24,"12-4","Y","Y","N",4,0,15
"149","E0",2023-12-07,"Everton","Newcastle",3,0,"H",0,0,"D",3.17,3.41,2.36,"0-0","3-0",21,6,13,3,3,0,0,0,5,2,18,8,3,7,26,"5-2","Y","Y","N",3,0,15
"150","E0",2023-12-07,"Tottenham","West Ham",1,2,"A",1,0,"H",1.8,4.31,4.04,"1-0","1-2",23,7,11,5,3,3,0,0,8,4,11,12,3,12,23,"8-4","Y","Y","N",6,0,15
"151","E0",2023-12-09,"Crystal Palace","Liverpool",1,2,"A",0,0,"D",6.3,4.59,1.51,"0-0","1-2",8,4,14,2,5,2,1,0,6,5,17,17,3,11,34,"6-5","Y","Y","N",7,1,16
"152","E0",2023-12-09,"Brighton","Burnley",1,1,"D",0,1,"A",1.5,4.69,6.31,"0-1","1-1",29,11,6,3,0,4,0,0,9,1,5,8,2,10,13,"9-1","Y","N","N",4,0,16
"153","E0",2023-12-09,"Man United","Bournemouth",0,3,"A",0,1,"A",1.55,4.7,5.52,"0-1","0-3",20,3,10,4,3,1,0,0,10,4,7,10,3,14,17,"10-4","Y","Y","N",4,0,16
"154","E0",2023-12-09,"Sheffield United","Brentford",1,0,"H",1,0,"H",4.47,3.84,1.81,"1-0","1-0",9,4,10,4,5,1,0,0,3,4,14,13,1,7,27,"3-4","N","N","N",6,0,16
"155","E0",2023-12-09,"Wolves","Nottm Forest",1,1,"D",1,1,"D",1.89,3.56,4.44,"1-1","1-1",10,4,8,2,0,1,0,0,4,3,9,11,2,7,20,"4-3","Y","N","N",1,0,16
"156","E0",2023-12-09,"Aston Villa","Arsenal",1,0,"H",1,0,"H",3.43,3.69,2.12,"1-0","1-0",10,3,12,5,4,2,0,0,3,3,16,11,1,6,27,"3-3","N","N","N",6,0,16
"157","E0",2023-12-10,"Everton","Chelsea",2,0,"H",0,0,"D",3.03,3.59,2.36,"0-0","2-0",9,5,16,4,2,2,0,0,4,8,12,12,2,12,24,"4-8","Y","N","N",4,0,16
"158","E0",2023-12-10,"Fulham","West Ham",5,0,"H",3,0,"H",2.44,3.4,3.03,"3-0","5-0",14,8,9,5,2,1,0,0,3,6,5,10,5,9,15,"3-6","Y","Y","Y",3,0,16
"159","E0",2023-12-10,"Luton","Man City",1,2,"A",1,0,"H",18.31,10.09,1.13,"1-0","1-2",4,2,18,6,2,1,0,0,6,3,16,6,3,9,22,"6-3","Y","Y","N",3,0,16
"160","E0",2023-12-10,"Tottenham","Newcastle",4,1,"H",2,0,"H",2.23,3.84,3.08,"2-0","4-1",23,12,9,3,1,3,0,0,3,6,10,12,5,9,22,"3-6","Y","Y","Y",4,0,16
"161","E0",2023-12-15,"Nottm Forest","Tottenham",0,2,"A",0,1,"A",4.51,4.14,1.76,"0-1","0-2",15,1,12,6,2,4,0,1,6,4,16,11,2,10,27,"6-4","Y","N","N",6,1,17
"162","E0",2023-12-16,"Chelsea","Sheffield United",2,0,"H",0,0,"D",1.24,6.69,11.68,"0-0","2-0",15,6,6,1,1,3,0,0,7,6,9,14,2,13,23,"7-6","Y","N","N",4,0,17
"163","E0",2023-12-16,"Man City","Crystal Palace",2,2,"D",1,0,"H",1.17,7.98,15.35,"1-0","2-2",19,9,5,2,1,1,0,0,6,1,12,9,4,7,21,"6-1","Y","Y","Y",2,0,17
"164","E0",2023-12-16,"Newcastle","Fulham",3,0,"H",0,0,"D",1.87,3.94,4.04,"0-0","3-0",27,10,6,4,0,2,0,1,5,1,7,12,3,6,19,"5-1","Y","Y","N",2,1,17
"165","E0",2023-12-16,"Burnley","Everton",0,2,"A",0,2,"A",3.66,3.44,2.13,"0-2","0-2",14,2,9,6,0,1,0,0,8,6,9,8,2,14,17,"8-6","Y","N","N",1,0,17
"166","E0",2023-12-17,"Arsenal","Brighton",2,0,"H",0,0,"D",1.48,4.76,6.67,"0-0","2-0",26,9,6,1,1,3,0,0,10,1,11,9,2,11,20,"10-1","Y","N","N",4,0,17
"167","E0",2023-12-17,"Brentford","Aston Villa",1,2,"A",1,0,"H",3.24,3.73,2.19,"1-0","1-2",4,3,15,5,6,4,1,1,7,12,19,6,3,19,25,"7-12","Y","Y","N",10,2,17
"168","E0",2023-12-17,"West Ham","Wolves",3,0,"H",2,0,"H",2.12,3.62,3.5,"2-0","3-0",13,4,14,3,3,1,0,0,6,6,12,15,3,12,27,"6-6","Y","Y","N",4,0,17
"169","E0",2023-12-17,"Liverpool","Man United",0,0,"D",0,0,"D",1.32,5.99,8.37,"0-0","0-0",34,8,6,1,2,4,0,1,12,0,13,8,0,12,21,"12-0","N","N","N",6,1,17
"170","E0",2023-12-21,"Crystal Palace","Brighton",1,1,"D",1,0,"H",3.4,3.47,2.22,"1-0","1-1",11,3,18,6,5,2,0,0,3,1,12,11,2,4,23,"3-1","Y","N","N",7,0,17
"171","E0",2023-12-22,"Aston Villa","Sheffield United",1,1,"D",0,0,"D",1.24,6.98,11.3,"0-0","1-1",12,4,5,2,3,3,0,0,9,1,11,16,2,10,27,"9-1","Y","N","N",6,0,18
"172","E0",2023-12-23,"West Ham","Man United",2,0,"H",0,0,"D",2.65,3.65,2.62,"0-0","2-0",12,5,11,3,2,3,0,0,4,4,13,15,2,8,28,"4-4","Y","N","N",5,0,18
"173","E0",2023-12-23,"Fulham","Burnley",0,2,"A",0,0,"D",1.7,3.96,5.12,"0-0","0-2",19,5,7,2,2,1,0,0,8,6,5,17,2,14,22,"8-6","Y","N","N",3,0,18
"174","E0",2023-12-23,"Luton","Newcastle",1,0,"H",1,0,"H",4.91,4.36,1.65,"1-0","1-0",16,5,15,2,2,1,0,0,6,7,11,5,1,13,16,"6-7","N","N","N",3,0,18
"175","E0",2023-12-23,"Nottm Forest","Bournemouth",2,3,"A",0,0,"D",2.74,3.52,2.61,"0-0","2-3",11,5,18,7,0,3,1,0,6,6,10,10,5,12,20,"6-6","Y","Y","Y",3,1,18
"176","E0",2023-12-23,"Tottenham","Everton",2,1,"H",2,0,"H",1.8,4.29,4.05,"2-0","2-1",13,6,18,8,1,4,0,0,3,8,6,18,3,11,24,"3-8","Y","Y","N",5,0,18
"177","E0",2023-12-23,"Liverpool","Arsenal",1,1,"D",1,1,"D",2.47,3.63,2.84,"1-1","1-1",13,3,13,2,2,5,0,0,4,5,13,14,2,9,27,"4-5","Y","N","N",7,0,18
"178","E0",2023-12-24,"Wolves","Chelsea",2,1,"H",0,0,"D",3.77,3.76,1.99,"0-0","2-1",14,6,16,5,3,5,0,0,10,6,11,9,3,16,20,"10-6","Y","Y","N",8,0,18
"179","E0",2023-12-26,"Newcastle","Nottm Forest",1,3,"A",1,1,"D",1.51,4.42,6.64,"1-1","1-3",19,7,15,6,3,3,0,0,10,2,10,11,4,12,21,"10-2","Y","Y","Y",6,0,18
"180","E0",2023-12-26,"Bournemouth","Fulham",3,0,"H",1,0,"H",2.22,3.69,3.2,"1-0","3-0",16,4,8,3,0,2,0,0,6,5,10,10,3,11,20,"6-5","Y","Y","N",2,0,18
"181","E0",2023-12-26,"Sheffield United","Luton",2,3,"A",0,1,"A",2.46,3.32,3.07,"0-1","2-3",21,6,12,4,5,0,0,0,9,4,13,13,5,13,26,"9-4","Y","Y","Y",5,0,19
"182","E0",2023-12-26,"Burnley","Liverpool",0,2,"A",0,1,"A",8.02,5.32,1.38,"0-1","0-2",9,0,19,10,2,1,0,0,4,4,7,10,2,8,17,"4-4","Y","N","N",3,0,19
"183","E0",2023-12-26,"Man United","Aston Villa",3,2,"H",0,2,"A",2.68,3.62,2.61,"0-2","3-2",13,7,10,4,1,3,0,0,3,6,10,10,5,9,20,"3-6","Y","Y","Y",4,0,19
"184","E0",2023-12-27,"Brentford","Wolves",1,4,"A",1,3,"A",1.94,3.66,4.07,"1-3","1-4",14,4,11,5,1,1,0,0,8,2,5,14,5,10,19,"8-2","Y","Y","Y",2,0,19
"185","E0",2023-12-27,"Chelsea","Crystal Palace",2,1,"H",1,1,"D",1.72,3.89,5.06,"1-1","2-1",9,4,13,5,3,2,0,0,4,3,13,16,3,7,29,"4-3","Y","Y","N",5,0,19
"186","E0",2023-12-27,"Everton","Man City",1,3,"A",1,0,"H",6.32,4.1,1.57,"1-0","1-3",7,2,23,9,4,2,0,0,8,4,13,5,4,12,18,"8-4","Y","Y","Y",6,0,19
"187","E0",2023-12-28,"Brighton","Tottenham",4,2,"H",2,0,"H",2.53,4.05,2.56,"2-0","4-2",15,9,19,3,3,2,0,0,7,6,18,6,6,13,24,"7-6","Y","Y","Y",5,0,19
"188","E0",2023-12-28,"Arsenal","West Ham",0,2,"A",0,1,"A",1.36,5.49,8.28,"0-1","0-2",30,8,6,3,2,0,0,0,10,3,8,8,2,13,16,"10-3","Y","N","N",2,0,19
"189","E0",2023-12-30,"Luton","Chelsea",2,3,"A",0,2,"A",6.05,4.65,1.52,"0-2","2-3",15,6,12,8,2,2,0,0,7,2,14,21,5,9,35,"7-2","Y","Y","Y",4,0,19
"190","E0",2023-12-30,"Aston Villa","Burnley",3,2,"H",2,1,"H",1.38,5.29,8.1,"2-1","3-2",19,7,9,5,4,1,0,1,6,2,9,14,5,8,23,"6-2","Y","Y","Y",5,1,19
"191","E0",2023-12-30,"Crystal Palace","Brentford",3,1,"H",2,1,"H",2.22,3.3,3.58,"2-1","3-1",13,6,9,4,0,1,0,0,7,4,14,10,4,11,24,"7-4","Y","Y","Y",1,0,20
"192","E0",2023-12-30,"Man City","Sheffield United",2,0,"H",1,0,"H",1.07,14.55,28.9,"1-0","2-0",18,4,4,2,1,1,0,0,12,2,5,6,2,14,11,"12-2","Y","N","N",2,0,20
"193","E0",2023-12-30,"Wolves","Everton",3,0,"H",1,0,"H",2.67,3.41,2.74,"1-0","3-0",12,6,10,0,2,3,0,0,5,2,9,14,3,7,23,"5-2","Y","Y","N",5,0,20
"194","E0",2023-12-30,"Nottm Forest","Man United",2,1,"H",0,0,"D",3.33,3.72,2.15,"0-0","2-1",8,2,10,5,2,4,0,0,4,5,9,11,3,9,20,"4-5","Y","Y","N",6,0,20
"195","E0",2023-12-31,"Fulham","Arsenal",2,1,"H",1,1,"D",5.94,4.29,1.57,"1-1","2-1",15,4,13,3,4,1,0,0,5,4,11,10,3,9,21,"5-4","Y","Y","N",5,0,20
"196","E0",2023-12-31,"Tottenham","Bournemouth",3,1,"H",1,0,"H",1.77,4.42,4.08,"1-0","3-1",12,6,24,4,3,3,0,0,4,13,9,18,4,17,27,"4-13","Y","Y","Y",6,0,20
"197","E0",2024-01-01,"Liverpool","Newcastle",4,2,"H",0,0,"D",1.45,4.96,6.69,"0-0","4-2",34,15,5,3,3,5,0,0,7,3,16,15,6,10,31,"7-3","Y","Y","Y",8,0,20
"198","E0",2024-01-02,"West Ham","Brighton",0,0,"D",0,0,"D",2.52,3.68,2.74,"0-0","0-0",6,2,22,8,1,0,0,0,2,0,4,6,0,2,10,"2-0","N","N","N",1,0,20
"199","E0",2024-01-12,"Burnley","Luton",1,1,"D",1,0,"H",2.06,3.58,3.8,"1-0","1-1",13,7,14,5,1,0,0,0,2,8,7,12,2,10,19,"2-8","Y","N","N",1,0,20
"200","E0",2024-01-13,"Chelsea","Fulham",1,0,"H",1,0,"H",1.65,4.22,5.13,"1-0","1-0",17,3,14,4,5,1,0,0,6,4,13,9,1,10,22,"6-4","N","N","N",6,0,20
"201","E0",2024-01-13,"Newcastle","Man City",2,3,"A",2,1,"H",5.63,4.53,1.56,"2-1","2-3",12,5,27,11,1,2,0,0,3,13,7,7,5,16,14,"3-13","Y","Y","Y",3,0,21
"202","E0",2024-01-14,"Everton","Aston Villa",0,0,"D",0,0,"D",2.81,3.62,2.49,"0-0","0-0",10,2,16,5,1,4,0,0,4,5,13,14,0,9,27,"4-5","N","N","N",5,0,21
"203","E0",2024-01-14,"Man United","Tottenham",2,2,"D",2,1,"H",2.22,3.97,3.01,"2-1","2-2",9,2,16,6,2,1,0,0,8,13,8,5,4,21,13,"8-13","Y","Y","Y",3,0,21
"204","E0",2024-01-20,"Arsenal","Crystal Palace",5,0,"H",2,0,"H",1.29,5.85,10.86,"2-0","5-0",21,6,12,5,0,0,0,0,6,7,8,12,5,13,20,"6-7","Y","Y","Y",0,0,21
"205","E0",2024-01-20,"Brentford","Nottm Forest",3,2,"H",1,1,"D",1.85,3.83,4.29,"1-1","3-2",11,5,12,3,1,3,0,0,6,4,10,14,5,10,24,"6-4","Y","Y","Y",4,0,21
"206","E0",2024-01-21,"Sheffield United","West Ham",2,2,"D",1,1,"D",3.45,3.47,2.2,"1-1","2-2",21,6,16,5,3,1,1,1,4,1,11,10,4,5,21,"4-1","Y","Y","Y",4,2,21
"207","E0",2024-01-21,"Bournemouth","Liverpool",0,4,"A",0,0,"D",4.41,4.36,1.72,"0-0","0-4",11,1,14,7,1,2,0,0,8,5,9,12,4,13,21,"8-5","Y","Y","Y",3,0,21
"208","E0",2024-01-22,"Brighton","Wolves",0,0,"D",0,0,"D",1.66,4.28,5.01,"0-0","0-0",11,4,8,3,1,4,0,0,8,2,10,13,0,10,23,"8-2","N","N","N",5,0,21
"209","E0",2024-01-30,"Nottm Forest","Arsenal",1,2,"A",0,0,"D",7.77,5.14,1.4,"0-0","1-2",9,3,19,3,0,1,0,0,2,11,6,7,3,13,13,"2-11","Y","Y","N",1,0,21
"210","E0",2024-01-30,"Fulham","Everton",0,0,"D",0,0,"D",2.46,3.32,3.08,"0-0","0-0",25,6,21,4,1,2,0,0,15,6,6,13,0,21,19,"15-6","N","N","N",3,0,21
"211","E0",2024-01-30,"Luton","Brighton",4,0,"H",3,0,"H",4.43,4.06,1.78,"3-0","4-0",18,8,9,2,2,2,0,0,7,4,13,14,4,11,27,"7-4","Y","Y","Y",4,0,22
"212","E0",2024-01-30,"Crystal Palace","Sheffield United",3,2,"H",2,2,"D",1.64,3.93,5.81,"2-2","3-2",12,4,9,5,1,4,0,0,11,1,8,18,5,12,26,"11-1","Y","Y","Y",5,0,22
"213","E0",2024-01-30,"Aston Villa","Newcastle",1,3,"A",0,2,"A",1.85,4.05,4.02,"0-2","1-3",12,6,14,5,4,1,0,0,8,7,14,12,4,15,26,"8-7","Y","Y","Y",5,0,22
"214","E0",2024-01-31,"Man City","Burnley",3,1,"H",2,0,"H",1.11,12.41,18.6,"2-0","3-1",14,4,8,3,2,2,0,0,7,3,3,13,4,10,16,"7-3","Y","Y","Y",4,0,22
"215","E0",2024-01-31,"Tottenham","Brentford",3,2,"H",0,1,"A",1.69,4.32,4.7,"0-1","3-2",19,5,9,5,2,3,0,0,5,3,13,15,5,8,28,"5-3","Y","Y","Y",5,0,22
"216","E0",2024-01-31,"Liverpool","Chelsea",4,1,"H",2,0,"H",1.58,4.64,5.29,"2-0","4-1",28,13,4,3,2,4,0,0,8,1,15,16,5,9,31,"8-1","Y","Y","Y",6,0,22
"217","E0",2024-02-01,"West Ham","Bournemouth",1,1,"D",0,1,"A",2.45,3.71,2.8,"0-1","1-1",9,3,9,4,1,3,0,0,1,5,13,11,2,6,24,"1-5","Y","N","N",4,0,22
"218","E0",2024-02-01,"Wolves","Man United",3,4,"A",0,2,"A",2.7,3.51,2.64,"0-2","3-4",16,7,21,8,2,5,0,0,4,5,10,10,7,9,20,"4-5","Y","Y","Y",7,0,22
"219","E0",2024-02-03,"Everton","Tottenham",2,2,"D",1,2,"A",2.97,3.71,2.34,"1-2","2-2",14,5,9,6,3,0,0,0,9,5,8,14,4,14,22,"9-5","Y","Y","Y",3,0,22
"220","E0",2024-02-03,"Brighton","Crystal Palace",4,1,"H",3,0,"H",1.71,4.04,4.85,"3-0","4-1",13,6,7,5,1,3,0,0,3,2,8,14,5,5,22,"3-2","Y","Y","Y",4,0,22
"221","E0",2024-02-03,"Burnley","Fulham",2,2,"D",0,2,"A",2.98,3.5,2.43,"0-2","2-2",12,4,15,7,2,2,0,0,2,13,11,7,4,15,18,"2-13","Y","Y","Y",4,0,23
"222","E0",2024-02-03,"Newcastle","Luton",4,4,"D",2,2,"D",1.42,5.07,7.23,"2-2","4-4",19,6,11,8,2,2,0,0,8,2,13,16,8,10,29,"8-2","Y","Y","Y",4,0,23
"223","E0",2024-02-03,"Sheffield United","Aston Villa",0,5,"A",0,4,"A",5.02,4.36,1.65,"0-4","0-5",10,5,14,10,1,0,0,0,3,4,10,7,5,7,17,"3-4","Y","Y","Y",1,0,23
"224","E0",2024-02-04,"Bournemouth","Nottm Forest",1,1,"D",1,1,"D",1.71,4.2,4.68,"1-1","1-1",9,2,8,6,3,2,1,0,11,6,19,12,2,17,31,"11-6","Y","N","N",5,1,23
"225","E0",2024-02-04,"Chelsea","Wolves",2,4,"A",1,2,"A",1.63,4.29,5.27,"1-2","2-4",15,6,14,7,3,2,0,0,10,1,15,11,6,11,26,"10-1","Y","Y","Y",5,0,23
"226","E0",2024-02-04,"Man United","West Ham",3,0,"H",1,0,"H",1.65,4.31,5.05,"1-0","3-0",12,5,22,3,0,1,0,0,5,8,10,5,3,13,15,"5-8","Y","Y","N",1,0,23
"227","E0",2024-02-04,"Arsenal","Liverpool",3,1,"H",1,1,"D",2.24,3.72,3.15,"1-1","3-1",15,7,10,1,6,2,0,1,2,4,11,11,4,6,22,"2-4","Y","Y","Y",8,1,23
"228","E0",2024-02-05,"Brentford","Man City",1,3,"A",1,1,"D",7.44,5.09,1.41,"1-1","1-3",9,3,25,15,1,0,0,0,8,13,2,4,4,21,6,"8-13","Y","Y","Y",1,0,23
"229","E0",2024-02-10,"Man City","Everton",2,0,"H",0,0,"D",1.19,7.68,13.24,"0-0","2-0",19,3,5,1,0,2,0,0,9,0,6,11,2,9,17,"9-0","Y","N","N",2,0,23
"230","E0",2024-02-10,"Fulham","Bournemouth",3,1,"H",2,0,"H",2.46,3.6,2.87,"2-0","3-1",7,6,25,4,1,2,0,0,1,14,11,11,4,15,22,"1-14","Y","Y","Y",3,0,23
"231","E0",2024-02-10,"Liverpool","Burnley",3,1,"H",1,1,"D",1.16,8.71,15.08,"1-1","3-1",25,10,9,4,3,2,0,0,9,3,11,13,4,12,24,"9-3","Y","Y","Y",5,0,24
"232","E0",2024-02-10,"Luton","Sheffield United",1,3,"A",0,2,"A",1.79,3.85,4.6,"0-2","1-3",20,5,7,3,1,2,0,0,13,1,7,12,4,14,19,"13-1","Y","Y","Y",3,0,24
"233","E0",2024-02-10,"Tottenham","Brighton",2,1,"H",0,1,"A",1.81,4.35,3.92,"0-1","2-1",16,6,6,3,2,3,0,0,9,6,14,13,3,15,27,"9-6","Y","Y","N",5,0,24
"234","E0",2024-02-10,"Wolves","Brentford",0,2,"A",0,1,"A",2.14,3.65,3.42,"0-1","0-2",17,5,9,6,2,3,0,0,7,4,11,9,2,11,20,"7-4","Y","N","N",5,0,24
"235","E0",2024-02-10,"Nottm Forest","Newcastle",2,3,"A",2,2,"D",3.29,3.81,2.14,"2-2","2-3",13,3,7,5,1,2,0,0,4,4,9,6,5,8,15,"4-4","Y","Y","Y",3,0,24
"236","E0",2024-02-11,"West Ham","Arsenal",0,6,"A",0,4,"A",5.95,4.4,1.56,"0-4","0-6",5,1,25,12,4,0,0,0,2,6,17,11,6,8,28,"2-6","Y","Y","Y",4,0,24
"237","E0",2024-02-11,"Aston Villa","Man United",1,2,"A",0,1,"A",2.16,3.91,3.18,"0-1","1-2",23,10,17,5,3,2,0,0,10,8,9,7,3,18,16,"10-8","Y","Y","N",5,0,24
"238","E0",2024-02-12,"Crystal Palace","Chelsea",1,3,"A",1,0,"H",4.25,3.86,1.85,"1-0","1-3",13,4,14,5,2,2,0,0,1,7,14,7,4,8,21,"1-7","Y","Y","Y",4,0,24
"239","E0",2024-02-17,"Brentford","Liverpool",1,4,"A",0,1,"A",5.27,4.59,1.59,"0-1","1-4",15,6,15,8,2,1,0,0,1,6,4,18,5,7,22,"1-6","Y","Y","Y",3,0,24
"240","E0",2024-02-17,"Burnley","Arsenal",0,5,"A",0,2,"A",9.78,5.73,1.31,"0-2","0-5",8,0,16,7,2,1,0,0,4,6,11,8,5,10,19,"4-6","Y","Y","Y",3,0,24
"241","E0",2024-02-17,"Fulham","Aston Villa",1,2,"A",0,1,"A",2.97,3.76,2.32,"0-1","1-2",15,4,12,3,5,2,0,0,4,4,11,6,3,8,17,"4-4","Y","Y","N",7,0,25
"242","E0",2024-02-17,"Newcastle","Bournemouth",2,2,"D",0,0,"D",1.87,4.15,3.84,"0-0","2-2",17,5,12,7,1,3,0,0,4,2,9,22,4,6,31,"4-2","Y","Y","Y",4,0,25
"243","E0",2024-02-17,"Nottm Forest","West Ham",2,0,"H",1,0,"H",2.47,3.5,2.92,"1-0","2-0",19,8,10,3,4,4,0,1,5,3,13,15,2,8,28,"5-3","Y","N","N",8,1,25
"244","E0",2024-02-17,"Tottenham","Wolves",1,2,"A",0,1,"A",1.55,4.87,5.36,"0-1","1-2",15,4,12,7,0,1,0,0,10,4,8,13,3,14,21,"10-4","Y","Y","N",1,0,25
"245","E0",2024-02-17,"Man City","Chelsea",1,1,"D",0,1,"A",1.34,5.71,8.37,"0-1","1-1",31,5,9,6,1,3,0,0,12,1,7,12,2,13,19,"12-1","Y","N","N",4,0,25
"246","E0",2024-02-18,"Sheffield United","Brighton",0,5,"A",0,2,"A",4.99,4.4,1.64,"0-2","0-5",6,1,24,10,1,4,1,0,5,10,3,5,5,15,8,"5-10","Y","Y","Y",5,1,25
"247","E0",2024-02-18,"Luton","Man United",1,2,"A",1,2,"A",4.17,4.13,1.81,"1-2","1-2",22,4,21,9,3,5,0,0,8,6,7,21,3,14,28,"8-6","Y","Y","N",8,0,25
"248","E0",2024-02-19,"Everton","Crystal Palace",1,1,"D",0,0,"D",1.72,3.79,5.26,"0-0","1-1",19,4,10,4,0,2,0,0,3,6,8,12,2,9,20,"3-6","Y","N","N",2,0,25
"249","E0",2024-02-20,"Man City","Brentford",1,0,"H",0,0,"D",1.17,8.67,15.04,"0-0","1-0",25,11,6,2,2,4,0,0,10,1,12,6,1,11,18,"10-1","N","N","N",6,0,25
"250","E0",2024-02-21,"Liverpool","Luton",4,1,"H",0,1,"A",1.19,7.94,12.93,"0-1","4-1",29,13,12,3,1,4,0,0,13,4,15,14,5,17,29,"13-4","Y","Y","Y",5,0,25
"251","E0",2024-02-24,"Aston Villa","Nottm Forest",4,2,"H",3,1,"H",1.57,4.52,5.55,"3-1","4-2",16,6,10,3,1,2,0,0,7,2,7,16,6,9,23,"7-2","Y","Y","Y",3,0,26
"252","E0",2024-02-24,"Brighton","Everton",1,1,"D",0,0,"D",1.82,4.04,4.2,"0-0","1-1",23,7,6,3,2,3,1,0,11,3,9,14,2,14,23,"11-3","Y","N","N",5,1,26
"253","E0",2024-02-24,"Crystal Palace","Burnley",3,0,"H",0,0,"D",2.03,3.45,3.98,"0-0","3-0",15,6,2,0,3,1,0,1,12,3,8,13,3,15,21,"12-3","Y","Y","N",4,1,26
"254","E0",2024-02-24,"Man United","Fulham",1,2,"A",0,0,"D",1.61,4.48,5.21,"0-0","1-2",21,9,17,5,2,5,0,0,10,9,6,11,3,19,17,"10-9","Y","Y","N",7,0,26
"255","E0",2024-02-24,"Bournemouth","Man City",0,1,"A",0,1,"A",7.2,5.14,1.42,"0-1","0-1",13,4,15,6,2,2,0,0,3,8,14,6,1,11,20,"3-8","N","N","N",4,0,26
"256","E0",2024-02-24,"Arsenal","Newcastle",4,1,"H",2,0,"H",1.4,5.32,7.33,"2-0","4-1",18,8,3,2,1,0,0,0,9,0,15,6,5,9,21,"9-0","Y","Y","Y",1,0,26
"257","E0",2024-02-25,"Wolves","Sheffield United",1,0,"H",1,0,"H",1.43,4.66,7,"1-0","1-0",13,2,12,4,2,1,0,0,5,6,8,4,1,11,12,"5-6","N","N","N",3,0,26
"258","E0",2024-02-26,"West Ham","Brentford",4,2,"H",2,1,"H",2.57,3.68,2.68,"2-1","4-2",17,6,14,8,1,2,0,0,1,7,5,9,6,8,14,"1-7","Y","Y","Y",3,0,26
"259","E0",2024-03-02,"Brentford","Chelsea",2,2,"D",0,1,"A",3.04,3.95,2.21,"0-1","2-2",14,5,17,6,3,1,0,0,0,6,10,9,4,6,19,"0-6","Y","Y","Y",4,0,26
"260","E0",2024-03-02,"Everton","West Ham",1,3,"A",0,0,"D",2.1,3.57,3.62,"0-0","1-3",22,11,12,5,1,2,0,0,4,5,9,6,4,9,15,"4-5","Y","Y","Y",3,0,26
"261","E0",2024-03-02,"Fulham","Brighton",3,0,"H",2,0,"H",2.6,3.59,2.7,"2-0","3-0",12,5,15,5,1,2,0,0,2,6,16,10,3,8,26,"2-6","Y","Y","N",3,0,27
"262","E0",2024-03-02,"Newcastle","Wolves",3,0,"H",2,0,"H",1.89,4.01,3.89,"2-0","3-0",14,7,12,3,0,1,0,0,3,5,8,11,3,8,19,"3-5","Y","Y","N",1,0,27
"263","E0",2024-03-02,"Nottm Forest","Liverpool",0,1,"A",0,0,"D",5.69,4.73,1.54,"0-0","0-1",8,2,22,2,2,2,0,0,3,12,11,12,1,15,23,"3-12","N","N","N",4,0,27
"264","E0",2024-03-02,"Tottenham","Crystal Palace",3,1,"H",0,0,"D",1.52,4.51,6.26,"0-0","3-1",14,6,4,1,1,2,0,0,11,1,7,16,4,12,23,"11-1","Y","Y","Y",3,0,27
"265","E0",2024-03-02,"Luton","Aston Villa",2,3,"A",0,2,"A",4.34,4.44,1.72,"0-2","2-3",13,5,12,8,1,4,0,0,8,6,8,19,5,14,27,"8-6","Y","Y","Y",5,0,27
"266","E0",2024-03-03,"Burnley","Bournemouth",0,2,"A",0,1,"A",3.79,3.83,1.96,"0-1","0-2",20,6,10,3,2,4,0,0,7,2,8,13,2,9,21,"7-2","Y","N","N",6,0,27
"267","E0",2024-03-03,"Man City","Man United",3,1,"H",0,1,"A",1.27,6.39,10.06,"0-1","3-1",27,8,3,1,0,1,0,0,15,2,5,10,4,17,15,"15-2","Y","Y","Y",1,0,27
"268","E0",2024-03-04,"Sheffield United","Arsenal",0,6,"A",0,5,"A",16.74,8.18,1.16,"0-5","0-6",4,0,22,10,1,0,0,0,0,7,11,4,6,7,15,"0-7","Y","Y","Y",1,0,27
"269","E0",2024-03-09,"Man United","Everton",2,0,"H",2,0,"H",1.84,3.93,4.2,"2-0","2-0",15,8,23,6,1,2,0,0,5,8,13,11,2,13,24,"5-8","Y","N","N",3,0,27
"270","E0",2024-03-09,"Bournemouth","Sheffield United",2,2,"D",0,1,"A",1.35,5.55,8.52,"0-1","2-2",32,12,13,9,3,5,0,0,10,3,12,11,4,13,23,"10-3","Y","Y","Y",8,0,27
"271","E0",2024-03-09,"Crystal Palace","Luton",1,1,"D",1,0,"H",1.77,3.95,4.58,"1-0","1-1",21,4,8,2,2,3,0,0,8,6,20,11,2,14,31,"8-6","Y","N","N",5,0,28
"272","E0",2024-03-09,"Wolves","Fulham",2,1,"H",0,0,"D",2.52,3.46,2.88,"0-0","2-1",8,3,23,6,2,2,0,0,3,4,7,11,3,7,18,"3-4","Y","Y","N",4,0,28
"273","E0",2024-03-09,"Arsenal","Brentford",2,1,"H",1,1,"D",1.23,6.96,11.44,"1-1","2-1",17,6,9,4,2,4,0,0,10,4,9,10,3,14,19,"10-4","Y","Y","N",6,0,28
"274","E0",2024-03-10,"Aston Villa","Tottenham",0,4,"A",0,0,"D",2.47,3.98,2.65,"0-0","0-4",10,1,9,5,0,2,1,0,6,4,11,15,4,10,26,"6-4","Y","Y","Y",2,1,28
"275","E0",2024-03-10,"Brighton","Nottm Forest",1,0,"H",1,0,"H",1.81,4.01,4.26,"1-0","1-0",10,3,9,4,4,4,0,0,6,3,14,14,1,9,28,"6-3","N","N","N",8,0,28
"276","E0",2024-03-10,"West Ham","Burnley",2,2,"D",0,2,"A",1.69,4.06,5.04,"0-2","2-2",22,4,11,4,2,4,0,0,4,4,11,18,4,8,29,"4-4","Y","Y","Y",6,0,28
"277","E0",2024-03-10,"Liverpool","Man City",1,1,"D",0,1,"A",3.02,3.8,2.28,"0-1","1-1",19,6,10,6,0,3,0,0,7,4,6,10,2,11,16,"7-4","Y","N","N",3,0,28
"278","E0",2024-03-11,"Chelsea","Newcastle",3,2,"H",1,1,"D",1.96,4.07,3.59,"1-1","3-2",12,8,11,3,3,1,0,0,0,4,12,7,5,4,19,"0-4","Y","Y","Y",4,0,28
"279","E0",2024-03-13,"Bournemouth","Luton",4,3,"H",0,3,"A",1.51,4.71,6.18,"0-3","4-3",24,10,8,4,1,2,0,0,11,3,16,11,7,14,27,"11-3","Y","Y","Y",3,0,28
"280","E0",2024-03-16,"Burnley","Brentford",2,1,"H",1,0,"H",3.23,3.72,2.2,"1-0","2-1",17,6,9,5,2,4,0,1,5,4,14,17,3,9,31,"5-4","Y","Y","N",6,1,28
"281","E0",2024-03-16,"Luton","Nottm Forest",1,1,"D",0,1,"A",2.83,3.69,2.44,"0-1","1-1",10,4,16,6,1,2,0,0,6,7,10,17,2,13,27,"6-7","Y","N","N",3,0,29
"282","E0",2024-03-16,"Fulham","Tottenham",3,0,"H",1,0,"H",3.42,4.09,2.01,"1-0","3-0",16,7,14,5,2,3,0,0,4,5,9,10,3,9,19,"4-5","Y","Y","N",5,0,29
"283","E0",2024-03-17,"West Ham","Aston Villa",1,1,"D",1,0,"H",2.66,3.82,2.52,"1-0","1-1",13,5,13,5,3,3,0,0,7,11,13,12,2,18,25,"7-11","Y","N","N",6,0,29
"284","E1",2023-08-04,"Sheffield Weds","Southampton",1,2,"A",0,1,"A",3.3,3.44,2.3,"0-1","1-2",8,1,23,7,4,4,0,0,3,6,12,10,3,9,22,"3-6","Y","Y","N",8,0,1
"285","E1",2023-08-05,"Blackburn","West Brom",2,1,"H",2,0,"H",2.92,3.24,2.65,"2-0","2-1",12,3,14,4,4,3,0,0,6,5,11,11,3,11,22,"6-5","Y","Y","N",7,0,1
"286","E1",2023-08-05,"Bristol City","Preston",1,1,"D",0,0,"D",2.13,3.45,3.72,"0-0","1-1",5,2,11,3,0,1,0,0,2,4,10,11,2,6,21,"2-4","Y","N","N",1,0,1
"287","E1",2023-08-05,"Middlesbrough","Millwall",0,1,"A",0,0,"D",2.05,3.48,3.96,"0-0","0-1",16,2,12,2,1,3,0,0,12,6,3,8,1,18,11,"12-6","N","N","N",4,0,1
"288","E1",2023-08-05,"Norwich","Hull",2,1,"H",1,1,"D",1.8,3.71,4.87,"1-1","2-1",28,5,8,3,2,5,0,0,9,4,14,12,3,13,26,"9-4","Y","Y","N",7,0,1
"289","E1",2023-08-05,"Plymouth","Huddersfield",3,1,"H",1,1,"D",2.19,3.46,3.55,"1-1","3-1",14,7,15,3,1,0,0,0,2,9,9,15,4,11,24,"2-9","Y","Y","Y",1,0,1
"290","E1",2023-08-05,"Stoke","Rotherham",4,1,"H",3,0,"H",1.65,4,5.74,"3-0","4-1",15,6,6,3,5,3,0,1,10,2,12,10,5,12,22,"10-2","Y","Y","Y",8,1,1
"291","E1",2023-08-05,"Swansea","Birmingham",1,1,"D",0,1,"A",1.9,3.65,4.37,"0-1","1-1",11,6,11,5,1,4,0,0,5,5,9,12,2,10,21,"5-5","Y","N","N",5,0,1
"292","E1",2023-08-05,"Watford","QPR",4,0,"H",4,0,"H",1.88,3.69,4.39,"4-0","4-0",23,12,4,1,1,2,0,0,8,2,8,15,4,10,23,"8-2","Y","Y","Y",3,0,1
"293","E1",2023-08-06,"Leicester","Coventry",2,1,"H",0,0,"D",1.6,4.24,5.9,"0-0","2-1",20,7,20,6,3,2,0,0,6,8,11,13,3,14,24,"6-8","Y","Y","N",5,0,1
"294","E1",2023-08-06,"Leeds","Cardiff",2,2,"D",0,2,"A",1.47,4.76,7.04,"0-2","2-2",25,6,7,2,2,1,0,0,10,0,8,10,4,10,18,"10-0","Y","Y","Y",3,0,1
"295","E1",2023-08-06,"Sunderland","Ipswich",1,2,"A",0,1,"A",2.53,3.36,2.99,"0-1","1-2",20,4,13,5,1,3,1,0,11,4,10,13,3,15,23,"11-4","Y","Y","N",4,1,1
"296","E1",2023-08-12,"Coventry","Middlesbrough",3,0,"H",1,0,"H",2.45,3.45,3.04,"1-0","3-0",12,5,14,2,1,1,0,0,7,7,5,8,3,14,13,"7-7","Y","Y","N",2,0,2
"297","E1",2023-08-12,"Birmingham","Leeds",1,0,"H",0,0,"D",3.43,3.59,2.19,"0-0","1-0",10,2,7,1,1,2,0,0,7,4,13,10,1,11,23,"7-4","N","N","N",3,0,2
"298","E1",2023-08-12,"Cardiff","QPR",1,2,"A",0,1,"A",2,3.58,4.01,"0-1","1-2",15,4,7,3,2,2,0,0,13,7,8,13,3,20,21,"13-7","Y","Y","N",4,0,2
"299","E1",2023-08-12,"Huddersfield","Leicester",0,1,"A",0,0,"D",4.66,3.93,1.78,"0-0","0-1",13,3,17,6,1,4,0,0,5,4,15,8,1,9,23,"5-4","N","N","N",5,0,2
"300","E1",2023-08-12,"Hull","Sheffield Weds",4,2,"H",1,1,"D",2.37,3.42,3.19,"1-1","4-2",16,7,6,2,1,3,0,0,9,1,7,22,6,10,29,"9-1","Y","Y","Y",4,0,2
"301","E1",2023-08-12,"Ipswich","Stoke",2,0,"H",1,0,"H",2.16,3.6,3.47,"1-0","2-0",22,10,9,2,3,1,0,0,7,3,12,17,2,10,29,"7-3","Y","N","N",4,0,2
"302","E1",2023-08-12,"Millwall","Bristol City",0,1,"A",0,0,"D",1.91,3.66,4.32,"0-0","0-1",10,2,13,1,1,3,0,0,1,5,13,11,1,6,24,"1-5","N","N","N",4,0,2
"303","E1",2023-08-12,"Preston","Sunderland",2,1,"H",1,1,"D",2.81,3.41,2.64,"1-1","2-1",11,2,13,4,3,1,0,0,5,12,17,8,3,17,25,"5-12","Y","Y","N",4,0,2
"304","E1",2023-08-12,"Rotherham","Blackburn",2,2,"D",1,0,"H",3.09,3.4,2.44,"1-0","2-2",9,3,21,6,3,1,1,0,5,9,9,8,4,14,17,"5-9","Y","Y","Y",4,1,2
"305","E1",2023-08-12,"Southampton","Norwich",4,4,"D",2,3,"A",1.87,3.77,4.35,"2-3","4-4",31,11,15,6,7,4,0,0,13,4,12,13,8,17,25,"13-4","Y","Y","Y",11,0,2
"306","E1",2023-08-12,"Watford","Plymouth",0,0,"D",0,0,"D",1.72,4.01,4.96,"0-0","0-0",20,3,13,5,0,2,0,0,12,3,16,10,0,15,26,"12-3","N","N","N",2,0,2
"307","E1",2023-08-12,"West Brom","Swansea",3,2,"H",1,0,"H",2.1,3.57,3.68,"1-0","3-2",11,3,13,4,3,4,0,0,4,8,10,10,5,12,20,"4-8","Y","Y","Y",7,0,2
"308","E1",2023-08-18,"Leeds","West Brom",1,1,"D",0,0,"D",2.16,3.56,3.52,"0-0","1-1",16,4,4,2,4,5,0,0,4,3,10,9,2,7,19,"4-3","Y","N","N",9,0,3
"309","E1",2023-08-19,"Plymouth","Southampton",1,2,"A",0,0,"D",3.88,3.98,1.93,"0-0","1-2",15,2,19,9,2,4,0,0,5,10,11,15,3,15,26,"5-10","Y","Y","N",6,0,3
"310","E1",2023-08-19,"Blackburn","Hull",1,2,"A",0,0,"D",1.93,3.77,4.04,"0-0","1-2",14,3,19,5,1,3,1,0,2,8,12,7,3,10,19,"2-8","Y","Y","N",4,1,3
"311","E1",2023-08-19,"Bristol City","Birmingham",0,2,"A",0,1,"A",2.29,3.27,3.5,"0-1","0-2",19,0,16,6,0,2,1,0,8,4,12,10,2,12,22,"8-4","Y","N","N",2,1,3
"312","E1",2023-08-19,"Leicester","Cardiff",2,1,"H",1,1,"D",1.54,4.49,6.29,"1-1","2-1",15,6,10,4,1,4,0,1,10,4,11,10,3,14,21,"10-4","Y","Y","N",5,1,3
"313","E1",2023-08-19,"Middlesbrough","Huddersfield",1,1,"D",0,0,"D",1.78,4.01,4.61,"0-0","1-1",17,7,16,2,1,3,0,0,7,8,10,10,2,15,20,"7-8","Y","N","N",4,0,3
"314","E1",2023-08-19,"QPR","Ipswich",0,1,"A",0,0,"D",4.51,3.63,1.88,"0-0","0-1",10,4,16,3,4,1,0,0,5,4,15,10,1,9,25,"5-4","N","N","N",5,0,3
"315","E1",2023-08-19,"Sheffield Weds","Preston",0,1,"A",0,0,"D",2.61,3.24,2.99,"0-0","0-1",8,3,5,2,1,1,0,0,0,4,14,16,1,4,30,"0-4","N","N","N",2,0,3
"316","E1",2023-08-19,"Stoke","Watford",1,0,"H",0,0,"D",2.25,3.53,3.34,"0-0","1-0",13,2,10,3,4,1,0,0,7,2,21,10,1,9,31,"7-2","N","N","N",5,0,3
"317","E1",2023-08-19,"Sunderland","Rotherham",2,1,"H",1,1,"D",1.66,4.18,5.32,"1-1","2-1",11,4,4,1,2,1,0,0,5,0,11,10,3,5,21,"5-0","Y","Y","N",3,0,3
"318","E1",2023-08-19,"Swansea","Coventry",1,1,"D",1,1,"D",2.43,3.53,3.01,"1-1","1-1",7,3,11,2,2,1,0,0,3,8,12,10,2,11,22,"3-8","Y","N","N",3,0,3
"319","E1",2023-08-20,"Norwich","Millwall",3,1,"H",1,0,"H",2.12,3.56,3.62,"1-0","3-1",20,5,10,2,2,1,0,0,6,3,3,13,4,9,16,"6-3","Y","Y","Y",3,0,3
"320","E1",2023-08-25,"Hull","Bristol City",1,1,"D",1,0,"H",2.41,3.41,3.13,"1-0","1-1",13,9,19,5,1,2,0,0,4,5,5,13,2,9,18,"4-5","Y","N","N",3,0,4
"321","E1",2023-08-26,"Birmingham","Plymouth",2,1,"H",1,0,"H",1.88,3.66,4.46,"1-0","2-1",13,4,16,8,2,1,0,0,10,10,17,5,3,20,22,"10-10","Y","Y","N",3,0,4
"322","E1",2023-08-26,"Cardiff","Sheffield Weds",2,1,"H",0,0,"D",2.13,3.44,3.74,"0-0","2-1",12,4,11,2,0,5,0,0,5,10,6,20,3,15,26,"5-10","Y","Y","N",5,0,4
"323","E1",2023-08-26,"Coventry","Sunderland",0,0,"D",0,0,"D",2.15,3.54,3.57,"0-0","0-0",17,6,15,2,1,4,0,0,4,7,11,7,0,11,18,"4-7","N","N","N",5,0,4
"324","E1",2023-08-26,"Huddersfield","Norwich",0,4,"A",0,2,"A",3.37,3.74,2.15,"0-2","0-4",18,5,9,5,3,1,0,0,5,3,10,8,4,8,18,"5-3","Y","Y","Y",4,0,4
"325","E1",2023-08-26,"Ipswich","Leeds",3,4,"A",2,3,"A",2.39,3.37,3.2,"2-3","3-4",21,6,14,9,3,2,0,0,8,4,12,8,7,12,20,"8-4","Y","Y","Y",5,0,4
"326","E1",2023-08-26,"Millwall","Stoke",1,0,"H",1,0,"H",2.43,3.27,3.22,"1-0","1-0",17,7,20,2,1,5,0,0,6,7,15,7,1,13,22,"6-7","N","N","N",6,0,4
"327","E1",2023-08-26,"Preston","Swansea",2,1,"H",0,1,"A",2.66,3.35,2.84,"0-1","2-1",11,3,10,1,2,1,0,0,6,4,12,7,3,10,19,"6-4","Y","Y","N",3,0,4
"328","E1",2023-08-26,"Rotherham","Leicester",1,2,"A",0,1,"A",5.53,4.21,1.63,"0-1","1-2",8,1,15,7,2,2,0,0,5,4,15,10,3,9,25,"5-4","Y","Y","N",4,0,4
"329","E1",2023-08-26,"Southampton","QPR",2,1,"H",1,1,"D",1.37,5.47,8.46,"1-1","2-1",7,3,11,5,4,2,0,0,4,3,8,14,3,7,22,"4-3","Y","Y","N",6,0,4
"330","E1",2023-08-26,"West Brom","Middlesbrough",4,2,"H",2,1,"H",2.3,3.52,3.24,"2-1","4-2",7,4,15,5,2,1,0,1,4,2,10,9,6,6,19,"4-2","Y","Y","Y",3,1,4
"331","E1",2023-08-27,"Watford","Blackburn",0,1,"A",0,0,"D",2.12,3.65,3.55,"0-0","0-1",24,4,5,3,3,2,0,0,8,4,8,5,1,12,13,"8-4","N","N","N",5,0,4
"332","E1",2023-09-02,"Birmingham","Millwall",1,1,"D",0,1,"A",2.46,3.21,3.23,"0-1","1-1",17,4,9,3,1,2,0,0,1,3,9,18,2,4,27,"1-3","Y","N","N",3,0,5
"333","E1",2023-09-02,"Sunderland","Southampton",5,0,"H",3,0,"H",2.84,3.65,2.49,"3-0","5-0",18,10,13,2,2,2,0,0,5,8,20,10,5,13,30,"5-8","Y","Y","Y",4,0,5
"334","E1",2023-09-02,"Swansea","Bristol City",1,2,"A",1,0,"H",2.17,3.64,3.42,"1-0","1-2",12,4,16,4,3,2,0,0,4,8,13,17,3,12,30,"4-8","Y","Y","N",5,0,5
"335","E1",2023-09-02,"Coventry","Watford",3,3,"D",1,1,"D",2.17,3.62,3.44,"1-1","3-3",16,7,14,5,3,3,0,0,9,6,10,16,6,15,26,"9-6","Y","Y","Y",6,0,5
"336","E1",2023-09-02,"Ipswich","Cardiff",3,2,"H",0,1,"A",1.67,4.16,5.25,"0-1","3-2",19,7,13,5,4,3,0,0,6,3,7,14,5,9,21,"6-3","Y","Y","Y",7,0,5
"337","E1",2023-09-02,"Leeds","Sheffield Weds",0,0,"D",0,0,"D",1.45,5.05,6.95,"0-0","0-0",16,4,10,5,1,2,0,0,5,3,8,9,0,8,17,"5-3","N","N","N",3,0,5
"338","E1",2023-09-02,"Leicester","Hull",0,1,"A",0,1,"A",1.54,4.67,5.95,"0-1","0-1",21,1,7,4,3,5,0,0,8,3,16,12,1,11,28,"8-3","N","N","N",8,0,5
"339","E1",2023-09-02,"Middlesbrough","QPR",0,2,"A",0,1,"A",1.6,4.43,5.61,"0-1","0-2",16,9,11,3,1,2,0,0,7,5,9,11,2,12,20,"7-5","Y","N","N",3,0,5
"340","E1",2023-09-02,"Plymouth","Blackburn",3,0,"H",1,0,"H",2.72,3.79,2.52,"1-0","3-0",23,9,20,4,2,1,0,0,9,9,5,6,3,18,11,"9-9","Y","Y","N",3,0,5
"341","E1",2023-09-02,"Rotherham","Norwich",2,1,"H",2,0,"H",4.85,4,1.74,"2-0","2-1",9,3,17,5,2,1,0,0,2,6,12,10,3,8,22,"2-6","Y","Y","N",3,0,5
"342","E1",2023-09-02,"Stoke","Preston",0,2,"A",0,0,"D",1.96,3.5,4.28,"0-0","0-2",18,1,7,3,3,4,0,0,9,0,15,17,2,9,32,"9-0","Y","N","N",7,0,5
"343","E1",2023-09-02,"West Brom","Huddersfield",1,2,"A",0,1,"A",1.72,4.08,4.89,"0-1","1-2",10,5,14,4,1,1,0,0,4,9,9,9,3,13,18,"4-9","Y","Y","N",2,0,5
"344","E1",2023-09-15,"Hull","Coventry",1,1,"D",0,1,"A",2.88,3.48,2.54,"0-1","1-1",18,4,8,2,2,5,0,0,9,3,7,21,2,12,28,"9-3","Y","N","N",7,0,6
"345","E1",2023-09-15,"Southampton","Leicester",1,4,"A",1,3,"A",2.52,3.6,2.83,"1-3","1-4",19,8,15,8,2,4,1,0,9,3,11,12,5,12,23,"9-3","Y","Y","Y",6,1,6
"346","E1",2023-09-16,"Blackburn","Middlesbrough",2,1,"H",1,0,"H",2.55,3.66,2.77,"1-0","2-1",15,8,21,6,1,2,0,0,5,9,11,10,3,14,21,"5-9","Y","Y","N",3,0,6
"347","E1",2023-09-16,"Bristol City","West Brom",0,0,"D",0,0,"D",2.47,3.43,3.01,"0-0","0-0",14,3,14,0,2,2,0,0,7,7,10,5,0,14,15,"7-7","N","N","N",4,0,6
"348","E1",2023-09-16,"Huddersfield","Rotherham",2,0,"H",1,0,"H",1.87,3.7,4.44,"1-0","2-0",15,5,7,3,1,1,0,0,2,5,10,17,2,7,27,"2-5","Y","N","N",2,0,6
"349","E1",2023-09-16,"Norwich","Stoke",1,0,"H",1,0,"H",1.92,3.83,4.04,"1-0","1-0",13,5,13,2,2,2,0,0,5,3,7,14,1,8,21,"5-3","N","N","N",4,0,6
"350","E1",2023-09-16,"Preston","Plymouth",2,1,"H",2,0,"H",2,3.71,3.84,"2-0","2-1",9,5,18,7,3,1,0,0,4,14,14,11,3,18,25,"4-14","Y","Y","N",4,0,6
"351","E1",2023-09-16,"QPR","Sunderland",1,3,"A",1,1,"D",3.33,3.56,2.24,"1-1","1-3",5,3,22,8,2,0,1,0,0,8,12,3,4,8,15,"0-8","Y","Y","Y",2,1,6
"352","E1",2023-09-16,"Sheffield Weds","Ipswich",0,1,"A",0,1,"A",3.89,3.53,2.05,"0-1","0-1",6,0,13,6,3,4,0,0,7,1,17,13,1,8,30,"7-1","N","N","N",7,0,6
"353","E1",2023-09-16,"Watford","Birmingham",2,0,"H",0,0,"D",2.04,3.48,3.98,"0-0","2-0",12,4,8,3,1,5,0,1,8,1,16,17,2,9,33,"8-1","Y","N","N",6,1,6
"354","E1",2023-09-16,"Cardiff","Swansea",2,0,"H",0,0,"D",2.63,3.39,2.85,"0-0","2-0",13,7,9,3,1,1,0,0,2,2,13,11,2,4,24,"2-2","Y","N","N",2,0,6
"355","E1",2023-09-17,"Millwall","Leeds",0,3,"A",0,1,"A",3.13,3.4,2.42,"0-1","0-3",12,3,14,3,0,0,0,0,8,9,13,9,3,17,22,"8-9","Y","Y","N",0,0,6
"356","E1",2023-09-19,"Bristol City","Plymouth",4,1,"H",3,1,"H",1.78,4.15,4.44,"3-1","4-1",17,6,6,2,3,0,0,0,7,1,9,13,5,8,22,"7-1","Y","Y","Y",3,0,7
"357","E1",2023-09-19,"Cardiff","Coventry",3,2,"H",1,1,"D",2.75,3.4,2.7,"1-1","3-2",8,3,7,3,2,3,0,0,3,5,7,8,5,8,15,"3-5","Y","Y","Y",5,0,7
"358","E1",2023-09-19,"Preston","Birmingham",2,1,"H",0,0,"D",2.4,3.2,3.35,"0-0","2-1",10,3,16,4,2,1,0,0,5,2,11,13,3,7,24,"5-2","Y","Y","N",3,0,7
"359","E1",2023-09-19,"QPR","Swansea",1,1,"D",0,1,"A",2.75,3.44,2.68,"0-1","1-1",11,3,8,3,1,1,0,1,4,6,12,17,2,10,29,"4-6","Y","N","N",2,1,7
"360","E1",2023-09-19,"Southampton","Ipswich",0,1,"A",0,1,"A",2.32,3.74,3.05,"0-1","0-1",13,3,11,3,2,2,0,0,9,3,9,13,1,12,22,"9-3","N","N","N",4,0,7
"361","E1",2023-09-19,"Sheffield Weds","Middlesbrough",1,1,"D",1,0,"H",3.46,3.6,2.17,"1-0","1-1",9,2,10,3,2,1,0,0,3,4,13,8,2,7,21,"3-4","Y","N","N",3,0,7
"362","E1",2023-09-20,"Blackburn","Sunderland",1,3,"A",1,2,"A",2.32,3.76,3.02,"1-2","1-3",22,6,13,4,5,3,0,0,8,4,14,11,4,12,25,"8-4","Y","Y","Y",8,0,7
"363","E1",2023-09-20,"Huddersfield","Stoke",2,2,"D",1,1,"D",2.83,3.45,2.6,"1-1","2-2",10,6,18,3,2,2,0,0,5,8,10,6,4,13,16,"5-8","Y","Y","Y",4,0,7
"364","E1",2023-09-20,"Hull","Leeds",0,0,"D",0,0,"D",3.9,3.73,1.98,"0-0","0-0",9,0,17,4,3,2,0,1,5,6,7,15,0,11,22,"5-6","N","N","N",5,1,7
"365","E1",2023-09-20,"Millwall","Rotherham",3,0,"H",1,0,"H",1.73,3.86,5.17,"1-0","3-0",20,8,5,1,1,1,0,0,6,1,12,16,3,7,28,"6-1","Y","Y","N",2,0,7
"366","E1",2023-09-20,"Watford","West Brom",2,2,"D",2,2,"D",2.22,3.49,3.45,"2-2","2-2",12,4,7,5,2,1,0,0,3,2,8,9,4,5,17,"3-2","Y","Y","Y",3,0,7
"367","E1",2023-09-20,"Norwich","Leicester",0,2,"A",0,1,"A",2.67,3.73,2.6,"0-1","0-2",15,2,10,3,3,4,0,0,10,1,14,15,2,11,29,"10-1","Y","N","N",7,0,7
"368","E1",2023-09-22,"Birmingham","QPR",0,0,"D",0,0,"D",1.86,3.61,4.65,"0-0","0-0",12,4,8,4,3,2,0,0,6,7,13,13,0,13,26,"6-7","N","N","N",5,0,8
"369","E1",2023-09-23,"Ipswich","Blackburn",4,3,"H",3,1,"H",1.7,4.26,4.77,"3-1","4-3",29,11,10,5,3,4,0,0,10,5,10,13,7,15,23,"10-5","Y","Y","Y",7,0,8
"370","E1",2023-09-23,"Leeds","Watford",3,0,"H",0,0,"D",1.75,4.09,4.64,"0-0","3-0",17,10,4,1,1,3,0,0,8,1,13,15,3,9,28,"8-1","Y","Y","N",4,0,8
"371","E1",2023-09-23,"Leicester","Bristol City",1,0,"H",0,0,"D",1.74,4.17,4.68,"0-0","1-0",19,7,6,1,1,2,0,0,9,0,11,10,1,9,21,"9-0","N","N","N",3,0,8
"372","E1",2023-09-23,"Middlesbrough","Southampton",2,1,"H",1,1,"D",2.5,3.62,2.85,"1-1","2-1",14,5,15,5,3,0,0,0,5,7,16,7,3,12,23,"5-7","Y","Y","N",3,0,8
"373","E1",2023-09-23,"Plymouth","Norwich",6,2,"H",4,0,"H",3.44,3.88,2.08,"4-0","6-2",16,10,11,6,1,0,0,0,3,6,9,6,8,9,15,"3-6","Y","Y","Y",1,0,8
"374","E1",2023-09-23,"Rotherham","Preston",1,1,"D",1,1,"D",3.44,3.28,2.31,"1-1","1-1",3,1,14,6,3,2,0,0,2,10,7,6,2,12,13,"2-10","Y","N","N",5,0,8
"375","E1",2023-09-23,"Swansea","Sheffield Weds",3,0,"H",1,0,"H",1.97,3.54,4.17,"1-0","3-0",12,4,10,1,2,2,0,0,2,5,12,16,3,7,28,"2-5","Y","Y","N",4,0,8
"376","E1",2023-09-23,"West Brom","Millwall",0,0,"D",0,0,"D",2.16,3.42,3.67,"0-0","0-0",16,3,7,2,0,2,0,0,6,8,8,12,0,14,20,"6-8","N","N","N",2,0,8
"377","E1",2023-09-24,"Stoke","Hull",1,3,"A",0,2,"A",1.95,3.78,3.97,"0-2","1-3",10,6,13,5,2,3,0,0,11,6,18,9,4,17,27,"11-6","Y","Y","Y",5,0,8
"378","E1",2023-09-24,"Sunderland","Cardiff",0,1,"A",0,0,"D",1.96,3.74,3.98,"0-0","0-1",16,6,7,2,2,2,0,0,4,4,6,14,1,8,20,"4-4","N","N","N",4,0,8
"379","E1",2023-09-25,"Coventry","Huddersfield",1,1,"D",1,0,"H",1.84,3.76,4.53,"1-0","1-1",11,3,10,4,2,3,0,0,10,4,12,14,2,14,26,"10-4","Y","N","N",5,0,8
"380","E1",2023-09-29,"Sheffield Weds","Sunderland",0,3,"A",0,3,"A",3.27,3.49,2.29,"0-3","0-3",8,2,12,6,2,0,0,0,2,5,14,5,3,7,19,"2-5","Y","Y","N",2,0,9
"381","E1",2023-09-30,"Southampton","Leeds",3,1,"H",3,0,"H",2.97,3.7,2.38,"3-0","3-1",10,5,15,5,4,1,0,0,5,6,14,13,4,11,27,"5-6","Y","Y","Y",5,0,9
"382","E1",2023-09-30,"Bristol City","Stoke",2,3,"A",2,1,"H",2.37,3.37,3.23,"2-1","2-3",13,5,6,4,1,1,0,0,11,3,9,13,5,14,22,"11-3","Y","Y","Y",2,0,9
"383","E1",2023-09-30,"Cardiff","Rotherham",2,0,"H",0,0,"D",1.71,3.94,5.2,"0-0","2-0",12,5,7,0,2,0,0,0,6,5,4,11,2,11,15,"6-5","Y","N","N",2,0,9
"384","E1",2023-09-30,"Huddersfield","Ipswich",1,1,"D",0,0,"D",3.88,3.89,1.94,"0-0","1-1",12,6,20,6,3,3,0,0,5,6,10,11,2,11,21,"5-6","Y","N","N",6,0,9
"385","E1",2023-09-30,"Hull","Plymouth",1,1,"D",1,1,"D",1.92,3.92,3.96,"1-1","1-1",21,5,11,5,2,2,0,0,12,4,9,10,2,16,19,"12-4","Y","N","N",4,0,9
"386","E1",2023-09-30,"Millwall","Swansea",0,3,"A",0,1,"A",2.1,3.43,3.85,"0-1","0-3",22,5,7,5,2,2,0,0,6,0,18,10,3,6,28,"6-0","Y","Y","N",4,0,9
"387","E1",2023-09-30,"Norwich","Birmingham",2,0,"H",0,0,"D",1.93,3.68,4.21,"0-0","2-0",16,4,12,2,1,1,0,0,4,4,9,10,2,8,19,"4-4","Y","N","N",2,0,9
"388","E1",2023-09-30,"Preston","West Brom",0,4,"A",0,2,"A",2.5,3.27,3.11,"0-2","0-4",5,1,19,6,3,1,0,0,2,6,12,5,4,8,17,"2-6","Y","Y","Y",4,0,9
"389","E1",2023-09-30,"QPR","Coventry",1,3,"A",0,0,"D",3.25,3.39,2.35,"0-0","1-3",12,3,15,6,4,2,0,0,4,5,11,14,4,9,25,"4-5","Y","Y","Y",6,0,9
"390","E1",2023-09-30,"Watford","Middlesbrough",2,3,"A",1,2,"A",2.46,3.53,2.96,"1-2","2-3",17,4,9,3,2,0,0,0,9,3,10,15,5,12,25,"9-3","Y","Y","Y",2,0,9
"391","E1",2023-10-01,"Blackburn","Leicester",1,4,"A",1,2,"A",3.53,3.82,2.07,"1-2","1-4",15,4,11,4,2,3,0,0,5,6,8,14,5,11,22,"5-6","Y","Y","Y",5,0,9
"392","E1",2023-10-03,"Birmingham","Huddersfield",4,1,"H",2,0,"H",2.3,3.34,3.4,"2-0","4-1",12,6,17,6,3,1,0,0,3,5,14,13,5,8,27,"3-5","Y","Y","Y",4,0,10
"393","E1",2023-10-03,"Ipswich","Hull",3,0,"H",2,0,"H",1.76,3.99,4.74,"2-0","3-0",14,6,13,6,0,0,0,0,6,5,16,11,3,11,27,"6-5","Y","Y","N",0,0,10
"394","E1",2023-10-03,"Middlesbrough","Cardiff",2,0,"H",0,0,"D",1.91,3.84,4.09,"0-0","2-0",11,6,6,3,1,3,0,0,8,2,10,10,2,10,20,"8-2","Y","N","N",4,0,10
"395","E1",2023-10-03,"Plymouth","Millwall",0,2,"A",0,0,"D",2.49,3.58,2.89,"0-0","0-2",22,6,9,3,2,6,0,0,8,1,5,14,2,9,19,"8-1","Y","N","N",8,0,10
"396","E1",2023-10-03,"Stoke","Southampton",0,1,"A",0,1,"A",2.78,3.46,2.64,"0-1","0-1",15,2,9,4,4,1,0,0,8,6,17,2,1,14,19,"8-6","N","N","N",5,0,10
"397","E1",2023-10-03,"West Brom","Sheffield Weds",1,0,"H",1,0,"H",1.61,3.94,6.36,"1-0","1-0",17,3,4,2,0,1,0,0,10,4,2,12,1,14,14,"10-4","N","N","N",1,0,10
"398","E1",2023-10-04,"Coventry","Blackburn",1,0,"H",0,0,"D",2.11,3.73,3.5,"0-0","1-0",14,3,14,4,2,1,0,0,7,8,18,13,1,15,31,"7-8","N","N","N",3,0,10
"399","E1",2023-10-04,"Leeds","QPR",1,0,"H",1,0,"H",1.36,5.53,8.65,"1-0","1-0",16,3,5,2,0,2,0,1,8,0,9,12,1,8,21,"8-0","N","N","N",2,1,10
"400","E1",2023-10-04,"Leicester","Preston",3,0,"H",0,0,"D",1.49,4.52,7.13,"0-0","3-0",9,4,6,1,0,2,0,0,4,4,3,8,3,8,11,"4-4","Y","Y","N",2,0,10
"401","E1",2023-10-04,"Sunderland","Watford",2,0,"H",1,0,"H",1.93,3.71,4.16,"1-0","2-0",9,4,11,4,1,5,0,1,5,2,9,19,2,7,28,"5-2","Y","N","N",6,1,10
"402","E1",2023-10-04,"Swansea","Norwich",2,1,"H",1,1,"D",2.94,3.47,2.51,"1-1","2-1",23,7,14,5,4,2,0,0,8,7,12,12,3,15,24,"8-7","Y","Y","N",6,0,10
"403","E1",2023-10-04,"Rotherham","Bristol City",1,2,"A",0,0,"D",4.01,3.37,2.07,"0-0","1-2",8,1,9,5,1,1,0,0,4,4,3,7,3,8,10,"4-4","Y","Y","N",2,0,10
"404","E1",2023-10-06,"Birmingham","West Brom",3,1,"H",2,1,"H",2.95,3.17,2.68,"2-1","3-1",11,3,10,3,2,1,0,0,6,8,16,6,4,14,22,"6-8","Y","Y","Y",3,0,11
"405","E1",2023-10-07,"Sunderland","Middlesbrough",0,4,"A",0,0,"D",2.4,3.53,3.05,"0-0","0-4",9,3,19,7,3,2,1,0,4,8,14,13,4,12,27,"4-8","Y","Y","Y",5,1,11
"406","E1",2023-10-07,"Cardiff","Watford",1,1,"D",1,0,"H",2.52,3.25,3.09,"1-0","1-1",8,2,8,1,0,2,0,0,2,1,9,10,2,3,19,"2-1","Y","N","N",2,0,11
"407","E1",2023-10-07,"Coventry","Norwich",1,1,"D",0,1,"A",2.57,3.41,2.9,"0-1","1-1",21,3,6,2,1,1,0,0,8,0,11,13,2,8,24,"8-0","Y","N","N",2,0,11
"408","E1",2023-10-07,"Ipswich","Preston",4,2,"H",3,1,"H",1.64,4.14,5.61,"3-1","4-2",16,10,8,2,0,3,0,0,7,0,10,11,6,7,21,"7-0","Y","Y","Y",3,0,11
"409","E1",2023-10-07,"Leeds","Bristol City",2,1,"H",1,1,"D",1.58,4.45,5.77,"1-1","2-1",21,8,9,2,1,2,0,0,8,6,10,8,3,14,18,"8-6","Y","Y","N",3,0,11
"410","E1",2023-10-07,"Leicester","Stoke",2,0,"H",1,0,"H",1.55,4.48,6.15,"1-0","2-0",14,7,3,1,1,1,0,0,4,4,6,5,2,8,11,"4-4","Y","N","N",2,0,11
"411","E1",2023-10-07,"Millwall","Hull",2,2,"D",1,2,"A",2.32,3.48,3.23,"1-2","2-2",13,4,8,3,4,2,0,0,5,1,18,7,4,6,25,"5-1","Y","Y","Y",6,0,11
"412","E1",2023-10-07,"Plymouth","Swansea",1,3,"A",1,0,"H",2.46,3.65,2.89,"1-0","1-3",16,7,14,6,2,0,0,0,12,7,11,5,4,19,16,"12-7","Y","Y","Y",2,0,11
"413","E1",2023-10-07,"QPR","Blackburn",0,4,"A",0,2,"A",3.02,3.65,2.36,"0-2","0-4",21,6,17,7,2,2,0,0,10,7,13,10,4,17,23,"10-7","Y","Y","Y",4,0,11
"414","E1",2023-10-07,"Sheffield Weds","Huddersfield",0,0,"D",0,0,"D",2.66,3.4,2.79,"0-0","0-0",6,1,7,0,1,1,0,0,5,4,16,13,0,9,29,"5-4","N","N","N",2,0,11
"415","E1",2023-10-07,"Southampton","Rotherham",1,1,"D",1,0,"H",1.35,5.51,9.29,"1-0","1-1",22,10,4,2,2,6,0,0,12,4,8,13,2,16,21,"12-4","Y","N","N",8,0,11
"416","E1",2023-10-21,"Preston","Millwall",1,1,"D",1,1,"D",2.52,3.18,3.17,"1-1","1-1",7,2,7,4,4,1,0,0,5,2,13,15,2,7,28,"5-2","Y","N","N",5,0,12
"417","E1",2023-10-21,"Blackburn","Cardiff",1,0,"H",0,0,"D",2.09,3.79,3.51,"0-0","1-0",9,1,11,2,2,1,0,0,4,6,8,8,1,10,16,"4-6","N","N","N",3,0,12
"418","E1",2023-10-21,"Bristol City","Coventry",1,0,"H",1,0,"H",2.47,3.49,2.97,"1-0","1-0",6,3,12,1,2,3,0,0,2,15,15,11,1,17,26,"2-15","N","N","N",5,0,12
"419","E1",2023-10-21,"Huddersfield","QPR",2,1,"H",2,1,"H",1.95,3.64,4.13,"2-1","2-1",6,4,14,2,2,2,0,0,2,9,9,12,3,11,21,"2-9","Y","Y","N",4,0,12
"420","E1",2023-10-21,"Hull","Southampton",1,2,"A",1,1,"D",2.97,3.58,2.43,"1-1","1-2",13,3,18,5,4,3,0,0,7,9,13,14,3,16,27,"7-9","Y","Y","N",7,0,12
"421","E1",2023-10-21,"Middlesbrough","Birmingham",1,0,"H",0,0,"D",1.79,3.89,4.64,"0-0","1-0",17,10,5,3,3,3,0,0,12,0,9,17,1,12,26,"12-0","N","N","N",6,0,12
"422","E1",2023-10-21,"Norwich","Leeds",2,3,"A",2,0,"H",3.21,3.72,2.23,"2-0","2-3",14,4,19,8,2,3,0,0,7,7,11,13,5,14,24,"7-7","Y","Y","Y",5,0,12
"423","E1",2023-10-21,"Stoke","Sunderland",2,1,"H",1,1,"D",2.55,3.56,2.82,"1-1","2-1",11,4,18,7,5,4,0,0,6,2,17,9,3,8,26,"6-2","Y","Y","N",9,0,12
"424","E1",2023-10-21,"Swansea","Leicester",1,3,"A",1,1,"D",4.59,3.97,1.78,"1-1","1-3",11,4,18,7,2,3,0,0,3,3,10,5,4,6,15,"3-3","Y","Y","Y",5,0,12
"425","E1",2023-10-21,"Watford","Sheffield Weds",1,0,"H",0,0,"D",1.72,3.78,5.34,"0-0","1-0",12,3,10,2,2,1,0,0,4,5,15,6,1,9,21,"4-5","N","N","N",3,0,12
"426","E1",2023-10-21,"West Brom","Plymouth",0,0,"D",0,0,"D",1.73,4.04,4.88,"0-0","0-0",14,2,5,2,2,7,0,0,10,5,4,14,0,15,18,"10-5","N","N","N",9,0,12
"427","E1",2023-10-24,"Huddersfield","Cardiff",0,4,"A",0,3,"A",2.41,3.29,3.23,"0-3","0-4",19,6,15,7,1,3,0,0,9,6,7,19,4,15,26,"9-6","Y","Y","Y",4,0,12
"428","E1",2023-10-24,"Millwall","Blackburn",1,2,"A",1,1,"D",2.52,3.54,2.87,"1-1","1-2",16,3,9,6,0,1,0,0,11,3,6,6,3,14,12,"11-3","Y","Y","N",1,0,13
"429","E1",2023-10-24,"Norwich","Middlesbrough",1,2,"A",0,0,"D",2.83,3.68,2.48,"0-0","1-2",13,2,19,8,2,2,0,0,4,7,13,10,3,11,23,"4-7","Y","Y","N",4,0,13
"430","E1",2023-10-24,"Swansea","Watford",0,1,"A",0,0,"D",2.41,3.36,3.17,"0-0","0-1",9,3,12,5,0,3,0,0,6,4,7,14,1,10,21,"6-4","N","N","N",3,0,13
"431","E1",2023-10-24,"Leicester","Sunderland",1,0,"H",1,0,"H",1.53,4.61,6.18,"1-0","1-0",8,5,13,3,4,3,0,0,5,5,13,10,1,10,23,"5-5","N","N","N",7,0,13
"432","E1",2023-10-24,"West Brom","QPR",2,0,"H",0,0,"D",1.63,4.08,5.78,"0-0","2-0",16,4,1,0,1,3,0,1,6,2,8,12,2,8,20,"6-2","Y","N","N",4,1,13
"433","E1",2023-10-25,"Birmingham","Hull",0,2,"A",0,1,"A",2.38,3.36,3.22,"0-1","0-2",14,4,17,8,2,1,0,0,6,5,18,8,2,11,26,"6-5","Y","N","N",3,0,13
"434","E1",2023-10-25,"Bristol City","Ipswich",0,1,"A",0,1,"A",3.55,3.73,2.09,"0-1","0-1",11,4,19,6,0,4,0,0,5,2,11,15,1,7,26,"5-2","N","N","N",4,0,13
"435","E1",2023-10-25,"Plymouth","Sheffield Weds",3,0,"H",2,0,"H",2.06,3.6,3.77,"2-0","3-0",13,6,13,2,2,1,0,0,1,7,10,8,3,8,18,"1-7","Y","Y","N",3,0,13
"436","E1",2023-10-25,"Preston","Southampton",2,2,"D",0,1,"A",3.54,3.59,2.14,"0-1","2-2",12,5,13,5,3,2,0,0,7,2,16,13,4,9,29,"7-2","Y","Y","Y",5,0,13
"437","E1",2023-10-25,"Rotherham","Coventry",2,0,"H",0,0,"D",4.2,3.66,1.93,"0-0","2-0",20,7,23,7,2,1,0,0,6,16,4,6,2,22,10,"6-16","Y","N","N",3,0,13
"438","E1",2023-10-25,"Stoke","Leeds",1,0,"H",0,0,"D",3.96,3.73,1.97,"0-0","1-0",12,4,16,3,1,3,0,0,5,3,16,11,1,8,27,"5-3","N","N","N",4,0,13
"439","E1",2023-10-28,"Leeds","Huddersfield",4,1,"H",4,0,"H",1.36,5.44,8.71,"4-0","4-1",20,5,5,2,0,4,0,0,4,2,7,11,5,6,18,"4-2","Y","Y","Y",4,0,13
"440","E1",2023-10-28,"Southampton","Birmingham",3,1,"H",2,0,"H",1.62,4.27,5.54,"2-0","3-1",11,5,10,2,0,4,0,0,4,4,8,12,4,8,20,"4-4","Y","Y","Y",4,0,14
"441","E1",2023-10-28,"Blackburn","Swansea",0,1,"A",0,1,"A",2.01,3.93,3.62,"0-1","0-1",20,6,16,4,5,3,0,0,6,5,15,7,1,11,22,"6-5","N","N","N",8,0,14
"442","E1",2023-10-28,"Cardiff","Bristol City",2,0,"H",1,0,"H",2.29,3.35,3.41,"1-0","2-0",9,7,8,1,1,2,0,0,4,3,9,9,2,7,18,"4-3","Y","N","N",3,0,14
"443","E1",2023-10-28,"Hull","Preston",1,0,"H",0,0,"D",2.09,3.45,3.83,"0-0","1-0",19,6,11,4,3,3,0,0,7,2,13,13,1,9,26,"7-2","N","N","N",6,0,14
"444","E1",2023-10-28,"Ipswich","Plymouth",3,2,"H",1,1,"D",1.4,5.41,7.45,"1-1","3-2",15,4,10,6,4,2,0,0,11,3,11,7,5,14,18,"11-3","Y","Y","Y",6,0,14
"445","E1",2023-10-28,"Middlesbrough","Stoke",0,2,"A",0,2,"A",1.81,3.9,4.56,"0-2","0-2",9,3,13,6,2,2,0,0,8,4,12,16,2,12,28,"8-4","Y","N","N",4,0,14
"446","E1",2023-10-28,"QPR","Leicester",1,2,"A",1,1,"D",8.06,5.21,1.4,"1-1","1-2",9,3,16,5,1,2,1,0,1,8,13,7,3,9,20,"1-8","Y","Y","N",3,1,14
"447","E1",2023-10-28,"Sunderland","Norwich",3,1,"H",2,1,"H",2.1,3.72,3.52,"2-1","3-1",17,8,9,2,4,4,0,0,7,1,12,17,4,8,29,"7-1","Y","Y","Y",8,0,14
"448","E1",2023-10-28,"Watford","Millwall",2,2,"D",1,1,"D",2.1,3.34,3.95,"1-1","2-2",19,6,11,4,3,3,0,0,7,2,13,13,4,9,26,"7-2","Y","Y","Y",6,0,14
"449","E1",2023-10-29,"Sheffield Weds","Rotherham",2,0,"H",2,0,"H",1.89,3.49,4.65,"2-0","2-0",14,5,6,0,2,3,0,0,4,3,9,16,2,7,25,"4-3","Y","N","N",5,0,14
"450","E1",2023-10-30,"Coventry","West Brom",0,2,"A",0,1,"A",2.33,3.33,3.28,"0-1","0-2",15,3,7,3,2,6,0,0,5,5,9,7,2,10,16,"5-5","Y","N","N",8,0,14
"451","E1",2023-11-03,"Leicester","Leeds",0,1,"A",0,0,"D",2.24,3.67,3.24,"0-0","0-1",10,1,11,6,1,2,0,0,7,6,6,8,1,13,14,"7-6","N","N","N",3,0,14
"452","E1",2023-11-04,"Birmingham","Ipswich",2,2,"D",1,0,"H",4.09,3.86,1.9,"1-0","2-2",13,3,17,7,3,1,0,0,7,8,9,11,4,15,20,"7-8","Y","Y","Y",4,0,15
"453","E1",2023-11-04,"Bristol City","Sheffield Weds",1,0,"H",0,0,"D",2.15,3.36,3.77,"0-0","1-0",17,7,6,2,3,1,0,1,8,7,10,14,1,15,24,"8-7","N","N","N",4,1,15
"454","E1",2023-11-04,"Huddersfield","Watford",0,0,"D",0,0,"D",3.27,3.45,2.31,"0-0","0-0",5,2,9,3,0,2,0,0,1,3,6,20,0,4,26,"1-3","N","N","N",2,0,15
"455","E1",2023-11-04,"Millwall","Southampton",0,1,"A",0,0,"D",3.55,3.68,2.11,"0-0","0-1",7,1,16,8,2,2,0,0,5,12,10,10,1,17,20,"5-12","N","N","N",4,0,15
"456","E1",2023-11-04,"Plymouth","Middlesbrough",3,3,"D",2,1,"H",3.8,3.98,1.94,"2-1","3-3",10,5,20,11,2,3,0,0,8,6,15,15,6,14,30,"8-6","Y","Y","Y",5,0,15
"457","E1",2023-11-04,"Preston","Coventry",3,2,"H",2,1,"H",2.92,3.2,2.69,"2-1","3-2",16,7,18,8,2,2,0,0,6,8,14,15,5,14,29,"6-8","Y","Y","Y",4,0,15
"458","E1",2023-11-04,"Rotherham","QPR",1,1,"D",0,0,"D",2.77,3.26,2.79,"0-0","1-1",8,3,11,4,2,1,0,0,6,6,10,14,2,12,24,"6-6","Y","N","N",3,0,15
"459","E1",2023-11-04,"Stoke","Cardiff",0,0,"D",0,0,"D",2.18,3.42,3.61,"0-0","0-0",7,1,11,3,1,0,0,0,1,7,16,6,0,8,22,"1-7","N","N","N",1,0,15
"460","E1",2023-11-04,"Swansea","Sunderland",0,0,"D",0,0,"D",2.8,3.49,2.61,"0-0","0-0",3,2,25,3,2,3,1,0,2,8,13,12,0,10,25,"2-8","N","N","N",5,1,15
"461","E1",2023-11-04,"West Brom","Hull",3,1,"H",1,1,"D",2.07,3.48,3.86,"1-1","3-1",10,5,9,4,1,1,0,0,1,2,10,12,4,3,22,"1-2","Y","Y","Y",2,0,15
"462","E1",2023-11-05,"Norwich","Blackburn",1,3,"A",0,2,"A",2.17,3.94,3.18,"0-2","1-3",21,8,10,4,3,2,0,1,8,2,11,4,4,10,15,"8-2","Y","Y","Y",5,1,15
"463","E1",2023-11-07,"Rotherham","Ipswich",2,2,"D",1,1,"D",6.51,4.47,1.53,"1-1","2-2",8,3,13,3,1,1,0,0,6,8,12,10,4,14,22,"6-8","Y","Y","Y",2,0,15
"464","E1",2023-11-10,"Blackburn","Preston",1,2,"A",0,1,"A",1.97,3.65,4.02,"0-1","1-2",22,5,9,4,0,1,0,0,7,2,9,13,3,9,22,"7-2","Y","Y","N",1,0,16
"465","E1",2023-11-11,"Sunderland","Birmingham",3,1,"H",1,1,"D",1.76,3.92,4.86,"1-1","3-1",22,6,16,7,2,2,0,0,10,5,5,13,4,15,18,"10-5","Y","Y","Y",4,0,16
"466","E1",2023-11-11,"Cardiff","Norwich",2,3,"A",2,1,"H",2.03,3.8,3.66,"2-1","2-3",13,6,20,8,2,2,0,0,2,9,10,6,5,11,16,"2-9","Y","Y","Y",4,0,16
"467","E1",2023-11-11,"Coventry","Stoke",0,0,"D",0,0,"D",2.32,3.4,3.3,"0-0","0-0",13,2,6,2,1,1,0,0,4,4,14,16,0,8,30,"4-4","N","N","N",2,0,16
"468","E1",2023-11-11,"Hull","Huddersfield",1,0,"H",0,0,"D",1.78,3.71,5.06,"0-0","1-0",20,5,2,1,2,3,0,0,9,1,10,10,1,10,20,"9-1","N","N","N",5,0,16
"469","E1",2023-11-11,"Ipswich","Swansea",3,2,"H",2,1,"H",1.61,4.43,5.46,"2-1","3-2",22,9,7,4,2,1,0,1,6,2,15,9,5,8,24,"6-2","Y","Y","Y",3,1,16
"470","E1",2023-11-11,"Leeds","Plymouth",2,1,"H",2,0,"H",1.27,6.68,10.06,"2-0","2-1",14,6,9,3,1,4,0,0,7,6,10,10,3,13,20,"7-6","Y","Y","N",5,0,16
"471","E1",2023-11-11,"Middlesbrough","Leicester",1,0,"H",0,0,"D",3.02,3.61,2.38,"0-0","1-0",9,6,12,4,4,3,0,0,3,4,18,15,1,7,33,"3-4","N","N","N",7,0,16
"472","E1",2023-11-11,"QPR","Bristol City",0,0,"D",0,0,"D",2.81,3.3,2.72,"0-0","0-0",7,0,7,2,2,2,0,0,5,2,12,16,0,7,28,"5-2","N","N","N",4,0,16
"473","E1",2023-11-11,"Sheffield Weds","Millwall",0,4,"A",0,2,"A",2.76,3.04,2.97,"0-2","0-4",12,2,13,6,2,2,0,0,8,4,13,8,4,12,21,"8-4","Y","Y","Y",4,0,16
"474","E1",2023-11-11,"Southampton","West Brom",2,1,"H",1,0,"H",1.88,3.76,4.31,"1-0","2-1",10,3,14,2,3,0,0,0,3,10,7,10,3,13,17,"3-10","Y","Y","N",3,0,16
"475","E1",2023-11-11,"Watford","Rotherham",5,0,"H",2,0,"H",1.49,4.43,7.55,"2-0","5-0",14,8,9,2,2,1,0,0,7,2,12,11,5,9,23,"7-2","Y","Y","Y",3,0,16
"476","E1",2023-11-24,"Rotherham","Leeds",1,1,"D",1,1,"D",9.25,5.33,1.36,"1-1","1-1",6,3,18,5,0,0,0,0,4,3,11,4,2,7,15,"4-3","Y","N","N",0,0,17
"477","E1",2023-11-25,"Birmingham","Sheffield Weds",2,1,"H",1,1,"D",2.19,3.26,3.79,"1-1","2-1",13,4,16,4,1,0,0,0,6,6,11,11,3,12,22,"6-6","Y","Y","N",1,0,17
"478","E1",2023-11-25,"Bristol City","Middlesbrough",3,2,"H",2,0,"H",3.59,3.49,2.16,"2-0","3-2",10,8,12,4,2,2,0,0,3,8,8,12,5,11,20,"3-8","Y","Y","Y",4,0,17
"479","E1",2023-11-25,"Huddersfield","Southampton",1,1,"D",0,1,"A",4.96,4.07,1.71,"0-1","1-1",10,2,16,4,4,1,0,0,2,7,5,11,2,9,16,"2-7","Y","N","N",5,0,17
"480","E1",2023-11-25,"Leicester","Watford",2,0,"H",0,0,"D",1.61,4.15,5.96,"0-0","2-0",23,8,9,1,2,5,0,1,6,2,5,14,2,8,19,"6-2","Y","N","N",7,1,17
"481","E1",2023-11-25,"Millwall","Coventry",0,3,"A",0,1,"A",2.76,3.27,2.78,"0-1","0-3",20,5,11,9,2,1,0,0,4,3,12,10,3,7,22,"4-3","Y","Y","N",3,0,17
"482","E1",2023-11-25,"Norwich","QPR",1,0,"H",1,0,"H",1.79,3.95,4.56,"1-0","1-0",7,1,9,3,4,4,0,0,4,7,18,12,1,11,30,"4-7","N","N","N",8,0,17
"483","E1",2023-11-25,"Plymouth","Sunderland",2,0,"H",2,0,"H",3.45,3.96,2.06,"2-0","2-0",10,2,24,5,4,1,0,0,4,14,12,5,2,18,17,"4-14","Y","N","N",5,0,17
"484","E1",2023-11-25,"Preston","Cardiff",1,2,"A",0,0,"D",2.47,3.21,3.2,"0-0","1-2",4,2,19,8,3,1,1,0,6,13,9,6,3,19,15,"6-13","Y","Y","N",4,1,17
"485","E1",2023-11-25,"Stoke","Blackburn",0,3,"A",0,1,"A",2.22,3.72,3.24,"0-1","0-3",12,1,7,4,2,1,0,0,7,1,11,9,3,8,20,"7-1","Y","Y","N",3,0,17
"486","E1",2023-11-25,"Swansea","Hull",2,2,"D",2,0,"H",2.63,3.33,2.88,"2-0","2-2",14,4,18,9,0,2,0,0,2,1,12,11,4,3,23,"2-1","Y","Y","Y",2,0,17
"487","E1",2023-11-25,"West Brom","Ipswich",2,0,"H",1,0,"H",2.72,3.55,2.64,"1-0","2-0",10,4,6,0,1,2,0,0,4,5,5,12,2,9,17,"4-5","Y","N","N",3,0,17
"488","E1",2023-11-28,"Cardiff","West Brom",0,1,"A",0,0,"D",3.03,3.2,2.6,"0-0","0-1",11,1,8,1,1,2,0,0,6,3,7,9,1,9,16,"6-3","N","N","N",3,0,18
"489","E1",2023-11-28,"Coventry","Plymouth",1,0,"H",0,0,"D",1.65,4.38,5.07,"0-0","1-0",13,3,13,3,1,3,0,0,7,6,10,11,1,13,21,"7-6","N","N","N",4,0,18
"490","E1",2023-11-28,"Hull","Rotherham",4,1,"H",3,0,"H",1.44,4.66,8,"3-0","4-1",22,12,9,3,1,2,0,0,8,4,5,8,5,12,13,"8-4","Y","Y","Y",3,0,18
"491","E1",2023-11-28,"Middlesbrough","Preston",4,0,"H",3,0,"H",1.69,3.89,5.42,"3-0","4-0",13,8,6,1,0,2,0,0,7,3,15,14,4,10,29,"7-3","Y","Y","Y",2,0,18
"492","E1",2023-11-28,"QPR","Stoke",4,2,"H",1,1,"D",3.29,3.27,2.39,"1-1","4-2",19,9,12,4,2,5,0,1,13,7,13,11,6,20,24,"13-7","Y","Y","Y",7,1,18
"493","E1",2023-11-28,"Watford","Norwich",3,2,"H",2,2,"D",2.19,3.57,3.44,"2-2","3-2",21,9,12,5,1,4,0,0,7,5,14,12,5,12,26,"7-5","Y","Y","Y",5,0,18
"494","E1",2023-11-29,"Blackburn","Birmingham",4,2,"H",0,0,"D",1.8,4.02,4.44,"0-0","4-2",11,6,26,6,4,2,0,0,8,9,12,6,6,17,18,"8-9","Y","Y","Y",6,0,18
"495","E1",2023-11-29,"Leeds","Swansea",3,1,"H",2,1,"H",1.37,5.52,8.43,"2-1","3-1",18,8,10,2,0,1,0,0,6,5,12,11,4,11,23,"6-5","Y","Y","Y",1,0,18
"496","E1",2023-11-29,"Sheffield Weds","Leicester",1,1,"D",0,1,"A",5.84,4.22,1.61,"0-1","1-1",14,7,12,3,2,1,0,0,5,4,10,7,2,9,17,"5-4","Y","N","N",3,0,18
"497","E1",2023-11-29,"Southampton","Bristol City",1,0,"H",0,0,"D",1.59,4.33,5.8,"0-0","1-0",14,5,8,1,3,1,0,0,6,3,11,14,1,9,25,"6-3","N","N","N",4,0,18
"498","E1",2023-11-29,"Sunderland","Huddersfield",1,2,"A",1,1,"D",1.54,4.44,6.29,"1-1","1-2",27,9,9,5,2,1,0,0,10,4,12,11,3,14,23,"10-4","Y","Y","N",3,0,18
"499","E1",2023-11-29,"Ipswich","Millwall",3,1,"H",3,0,"H",1.6,4.28,5.84,"3-0","3-1",19,7,5,3,2,3,0,0,4,2,9,13,4,6,22,"4-2","Y","Y","Y",5,0,18
"500","E1",2023-12-01,"Preston","QPR",0,2,"A",0,0,"D",2.25,3.22,3.67,"0-0","0-2",7,1,8,5,1,1,0,0,6,4,11,11,2,10,22,"6-4","Y","N","N",2,0,19
"501","E1",2023-12-02,"West Brom","Leicester",1,2,"A",0,0,"D",3.02,3.23,2.59,"0-0","1-2",9,3,9,3,2,1,0,0,4,6,10,11,3,10,21,"4-6","Y","Y","N",3,0,19
"502","E1",2023-12-02,"Birmingham","Rotherham",0,0,"D",0,0,"D",1.62,4.3,5.49,"0-0","0-0",12,4,12,4,1,3,0,0,4,6,11,17,0,10,28,"4-6","N","N","N",4,0,19
"503","E1",2023-12-02,"Hull","Watford",1,2,"A",1,1,"D",2.2,3.46,3.5,"1-1","1-2",23,7,10,4,1,2,0,0,8,2,7,12,3,10,19,"8-2","Y","Y","N",3,0,19
"504","E1",2023-12-02,"Ipswich","Coventry",2,1,"H",2,0,"H",1.81,4.08,4.3,"2-0","2-1",13,3,15,1,2,1,0,0,1,6,14,11,3,7,25,"1-6","Y","Y","N",3,0,19
"505","E1",2023-12-02,"Leeds","Middlesbrough",3,2,"H",3,2,"H",1.74,4.15,4.68,"3-2","3-2",20,9,11,5,2,5,0,1,6,3,12,15,5,9,27,"6-3","Y","Y","Y",7,1,19
"506","E1",2023-12-02,"Millwall","Sunderland",1,1,"D",1,0,"H",3.09,3.48,2.4,"1-0","1-1",7,4,10,3,5,3,0,0,4,4,14,12,2,8,26,"4-4","Y","N","N",8,0,19
"507","E1",2023-12-02,"Plymouth","Stoke",2,1,"H",1,1,"D",2.73,3.55,2.63,"1-1","2-1",16,8,9,4,1,2,0,0,7,8,3,15,3,15,18,"7-8","Y","Y","N",3,0,19
"508","E1",2023-12-02,"Sheffield Weds","Blackburn",3,1,"H",1,0,"H",2.93,3.65,2.42,"1-0","3-1",13,8,18,5,2,1,0,0,3,7,12,6,4,10,18,"3-7","Y","Y","Y",3,0,19
"509","E1",2023-12-02,"Southampton","Cardiff",2,0,"H",2,0,"H",1.67,4.11,5.28,"2-0","2-0",18,6,10,3,1,1,0,0,7,3,6,9,2,10,15,"7-3","Y","N","N",2,0,19
"510","E1",2023-12-02,"Swansea","Huddersfield",1,1,"D",0,1,"A",1.95,3.63,4.13,"0-1","1-1",22,5,5,3,1,2,0,0,19,1,11,9,2,20,20,"19-1","Y","N","N",3,0,19
"511","E1",2023-12-03,"Bristol City","Norwich",1,2,"A",1,0,"H",2.33,3.52,3.19,"1-0","1-2",15,6,12,3,1,1,0,0,6,6,5,7,3,12,12,"6-6","Y","Y","N",2,0,19
"512","E1",2023-12-08,"Coventry","Birmingham",2,0,"H",1,0,"H",1.75,3.86,5.01,"1-0","2-0",16,8,13,6,0,5,0,0,6,7,11,19,2,13,30,"6-7","Y","N","N",5,0,20
"513","E1",2023-12-09,"Blackburn","Leeds",0,2,"A",0,1,"A",4.33,4.26,1.77,"0-1","0-2",12,2,8,4,3,2,0,0,13,3,11,7,2,16,18,"13-3","Y","N","N",5,0,20
"514","E1",2023-12-09,"Sunderland","West Brom",2,1,"H",0,0,"D",2.28,3.47,3.33,"0-0","2-1",14,5,11,1,1,6,0,0,4,7,5,13,3,11,18,"4-7","Y","Y","N",7,0,20
"515","E1",2023-12-09,"Cardiff","Millwall",1,0,"H",0,0,"D",2.14,3.31,3.85,"0-0","1-0",7,3,10,3,1,2,0,0,4,2,11,14,1,6,25,"4-2","N","N","N",3,0,20
"516","E1",2023-12-09,"Huddersfield","Bristol City",1,1,"D",1,0,"H",3.24,3.16,2.49,"1-0","1-1",6,2,15,4,1,1,0,0,2,9,8,10,2,11,18,"2-9","Y","N","N",2,0,20
"517","E1",2023-12-09,"Leicester","Plymouth",4,0,"H",1,0,"H",1.28,6.38,9.88,"1-0","4-0",13,7,15,5,0,3,0,0,5,8,6,10,4,13,16,"5-8","Y","Y","Y",3,0,20
"518","E1",2023-12-09,"Middlesbrough","Ipswich",0,2,"A",0,1,"A",2.38,3.78,2.91,"0-1","0-2",7,1,9,3,1,3,0,0,5,3,15,14,2,8,29,"5-3","Y","N","N",4,0,20
"519","E1",2023-12-09,"Norwich","Preston",0,0,"D",0,0,"D",1.93,3.73,4.1,"0-0","0-0",18,4,6,1,0,2,0,0,10,1,8,10,0,11,18,"10-1","N","N","N",2,0,20
"520","E1",2023-12-09,"QPR","Hull",2,0,"H",1,0,"H",3.21,3.35,2.39,"1-0","2-0",13,4,15,6,1,3,0,0,4,4,10,7,2,8,17,"4-4","Y","N","N",4,0,20
"521","E1",2023-12-09,"Rotherham","Swansea",1,2,"A",0,1,"A",3.37,3.65,2.18,"0-1","1-2",7,3,19,9,2,3,1,0,6,11,9,9,3,17,18,"6-11","Y","Y","N",5,1,20
"522","E1",2023-12-09,"Stoke","Sheffield Weds",0,1,"A",0,0,"D",2.04,3.42,4.08,"0-0","0-1",13,4,6,2,3,4,0,0,4,5,7,11,1,9,18,"4-5","N","N","N",7,0,20
"523","E1",2023-12-09,"Watford","Southampton",1,1,"D",0,0,"D",3.22,3.52,2.31,"0-0","1-1",11,4,6,3,3,4,0,0,7,3,10,16,2,10,26,"7-3","Y","N","N",7,0,20
"524","E1",2023-12-12,"Blackburn","Bristol City",2,1,"H",1,0,"H",1.98,3.79,3.84,"1-0","2-1",13,3,11,5,4,1,0,0,3,4,6,7,3,7,13,"3-4","Y","Y","N",5,0,21
"525","E1",2023-12-12,"Huddersfield","Preston",1,3,"A",0,2,"A",2.78,2.99,3,"0-2","1-3",7,3,11,3,0,2,0,0,2,6,12,10,4,8,22,"2-6","Y","Y","Y",2,0,21
"526","E1",2023-12-12,"Rotherham","West Brom",0,2,"A",0,0,"D",5.51,3.76,1.71,"0-0","0-2",4,2,6,2,0,1,0,0,1,2,11,10,2,3,21,"1-2","Y","N","N",1,0,21
"527","E1",2023-12-12,"Stoke","Swansea",1,1,"D",0,0,"D",2.12,3.63,3.56,"0-0","1-1",16,4,8,2,3,2,0,0,6,3,11,14,2,9,25,"6-3","Y","N","N",5,0,21
"528","E1",2023-12-12,"Watford","Ipswich",1,2,"A",1,1,"D",3.03,3.49,2.43,"1-1","1-2",12,3,10,6,2,4,0,0,6,4,12,16,3,10,28,"6-4","Y","Y","N",6,0,21
"529","E1",2023-12-12,"Sunderland","Leeds",1,0,"H",0,0,"D",2.88,3.67,2.45,"0-0","1-0",11,3,12,4,1,3,0,0,6,3,12,8,1,9,20,"6-3","N","N","N",4,0,21
"530","E1",2023-12-13,"Cardiff","Birmingham",0,1,"A",0,1,"A",1.9,3.59,4.45,"0-1","0-1",11,4,11,5,1,2,0,0,4,3,11,18,1,7,29,"4-3","N","N","N",3,0,21
"531","E1",2023-12-13,"Coventry","Southampton",1,1,"D",0,0,"D",2.75,3.53,2.62,"0-0","1-1",11,4,12,3,0,3,0,0,3,9,9,12,2,12,21,"3-9","Y","N","N",3,0,21
"532","E1",2023-12-13,"Leicester","Millwall",3,2,"H",0,1,"A",1.35,5.31,9.9,"0-1","3-2",15,6,11,6,2,4,0,0,9,3,5,16,5,12,21,"9-3","Y","Y","Y",6,0,21
"533","E1",2023-12-13,"Norwich","Sheffield Weds",3,1,"H",1,1,"D",1.97,3.64,4.05,"1-1","3-1",12,5,21,4,1,1,0,0,3,7,6,10,4,10,16,"3-7","Y","Y","Y",2,0,21
"534","E1",2023-12-13,"QPR","Plymouth",0,0,"D",0,0,"D",2.04,3.72,3.7,"0-0","0-0",29,10,12,2,2,3,0,1,6,1,14,8,0,7,22,"6-1","N","N","N",5,1,21
"535","E1",2023-12-13,"Middlesbrough","Hull",1,2,"A",1,0,"H",1.89,3.88,4.1,"1-0","1-2",16,8,8,4,0,1,0,0,6,4,9,5,3,10,14,"6-4","Y","Y","N",1,0,21
"536","E1",2023-12-16,"Ipswich","Norwich",2,2,"D",1,1,"D",1.61,4.31,5.63,"1-1","2-2",18,5,11,3,2,0,0,0,6,3,11,8,4,9,19,"6-3","Y","Y","Y",2,0,22
"537","E1",2023-12-16,"Bristol City","Sunderland",1,0,"H",1,0,"H",3.14,3.48,2.37,"1-0","1-0",6,3,18,9,3,3,0,0,5,11,12,8,1,16,20,"5-11","N","N","N",6,0,22
"538","E1",2023-12-16,"Hull","Cardiff",3,0,"H",1,0,"H",1.91,3.6,4.4,"1-0","3-0",15,7,8,1,1,3,0,0,9,2,14,12,3,11,26,"9-2","Y","Y","N",4,0,22
"539","E1",2023-12-16,"Leeds","Coventry",1,1,"D",0,0,"D",1.55,4.52,6.07,"0-0","1-1",20,6,7,3,3,5,0,0,7,0,8,15,2,7,23,"7-0","Y","N","N",8,0,22
"540","E1",2023-12-16,"Millwall","Huddersfield",1,1,"D",0,0,"D",1.88,3.53,4.63,"0-0","1-1",12,7,10,2,0,2,0,0,0,6,16,8,2,6,24,"0-6","Y","N","N",2,0,22
"541","E1",2023-12-16,"Plymouth","Rotherham",3,2,"H",1,1,"D",1.67,4.16,5.26,"1-1","3-2",25,9,9,4,0,5,0,1,11,5,7,16,5,16,23,"11-5","Y","Y","Y",5,1,22
"542","E1",2023-12-16,"Preston","Watford",1,5,"A",1,1,"D",2.94,3.25,2.64,"1-1","1-5",20,10,15,7,3,1,0,0,10,5,14,9,6,15,23,"10-5","Y","Y","Y",4,0,22
"543","E1",2023-12-16,"Sheffield Weds","QPR",2,1,"H",0,1,"A",2.39,3.24,3.32,"0-1","2-1",8,3,5,2,5,4,0,0,8,3,12,13,3,11,25,"8-3","Y","Y","N",9,0,22
"544","E1",2023-12-16,"Southampton","Blackburn",4,0,"H",1,0,"H",1.7,4.07,5.1,"1-0","4-0",22,11,4,4,3,2,0,1,15,1,9,11,4,16,20,"15-1","Y","Y","Y",5,1,22
"545","E1",2023-12-16,"Swansea","Middlesbrough",1,2,"A",0,1,"A",3.24,3.73,2.22,"0-1","1-2",10,3,9,4,2,3,0,0,4,4,14,14,3,8,28,"4-4","Y","Y","N",5,0,22
"546","E1",2023-12-17,"West Brom","Stoke",1,1,"D",1,1,"D",1.8,3.72,4.88,"1-1","1-1",16,7,9,1,3,1,0,0,11,11,9,14,2,22,23,"11-11","Y","N","N",4,0,22
"547","E1",2023-12-18,"Birmingham","Leicester",2,3,"A",1,2,"A",5.68,4.16,1.61,"1-2","2-3",8,5,14,5,0,1,0,0,3,2,12,17,5,5,29,"3-2","Y","Y","Y",1,0,22
"548","E1",2023-12-22,"Bristol City","Hull",3,2,"H",1,2,"A",2.88,3.2,2.72,"1-2","3-2",21,5,16,4,2,3,0,0,7,6,9,11,5,13,20,"7-6","Y","Y","Y",5,0,23
"549","E1",2023-12-22,"Swansea","Preston",2,1,"H",0,0,"D",2.13,3.48,3.68,"0-0","2-1",10,4,9,4,4,2,0,0,4,3,10,8,3,7,18,"4-3","Y","Y","N",6,0,23
"550","E1",2023-12-23,"Leeds","Ipswich",4,0,"H",3,0,"H",1.81,4.24,4.13,"3-0","4-0",9,4,2,0,1,4,0,0,5,0,10,15,4,5,25,"5-0","Y","Y","Y",5,0,23
"551","E1",2023-12-23,"Blackburn","Watford",1,2,"A",1,0,"H",2.31,3.66,3.11,"1-0","1-2",11,5,18,6,2,3,0,0,7,5,12,8,3,12,20,"7-5","Y","Y","N",5,0,23
"552","E1",2023-12-23,"Leicester","Rotherham",3,0,"H",0,0,"D",1.16,8.62,18.49,"0-0","3-0",24,11,2,0,1,1,0,0,10,0,5,4,3,10,9,"10-0","Y","Y","N",2,0,23
"553","E1",2023-12-23,"Middlesbrough","West Brom",1,0,"H",1,0,"H",2.32,3.41,3.3,"1-0","1-0",13,4,9,2,1,2,0,0,2,10,13,11,1,12,24,"2-10","N","N","N",3,0,23
"554","E1",2023-12-23,"Norwich","Huddersfield",2,0,"H",0,0,"D",1.61,4.22,5.75,"0-0","2-0",21,8,5,1,1,1,0,0,12,2,9,10,2,14,19,"12-2","Y","N","N",2,0,23
"555","E1",2023-12-23,"Plymouth","Birmingham",3,3,"D",1,2,"A",2.22,3.74,3.23,"1-2","3-3",15,8,13,7,2,5,0,1,7,3,7,15,6,10,22,"7-3","Y","Y","Y",7,1,23
"556","E1",2023-12-23,"QPR","Southampton",0,1,"A",0,1,"A",4.9,3.81,1.78,"0-1","0-1",12,2,13,4,1,3,0,1,7,5,8,12,1,12,20,"7-5","N","N","N",4,1,23
"557","E1",2023-12-23,"Sheffield Weds","Cardiff",1,2,"A",1,0,"H",2.18,3.34,3.71,"1-0","1-2",18,5,7,3,3,2,0,0,10,3,10,12,3,13,22,"10-3","Y","Y","N",5,0,23
"558","E1",2023-12-23,"Stoke","Millwall",0,0,"D",0,0,"D",2.15,3.47,3.63,"0-0","0-0",19,3,2,1,1,3,0,0,7,1,11,16,0,8,27,"7-1","N","N","N",4,0,23
"559","E1",2023-12-23,"Sunderland","Coventry",0,3,"A",0,1,"A",2.1,3.65,3.59,"0-1","0-3",21,6,10,5,3,2,0,0,7,7,11,11,3,14,22,"7-7","Y","Y","N",5,0,23
"560","E1",2023-12-26,"Preston","Leeds",2,1,"H",0,0,"D",6.03,4.29,1.58,"0-0","2-1",13,4,11,2,5,1,0,1,5,6,22,12,3,11,34,"5-6","Y","Y","N",6,1,24
"561","E1",2023-12-26,"Millwall","QPR",2,0,"H",1,0,"H",2.2,3.27,3.72,"1-0","2-0",13,3,10,1,3,3,0,0,4,6,12,12,2,10,24,"4-6","Y","N","N",6,0,24
"562","E1",2023-12-26,"Cardiff","Plymouth",2,2,"D",1,1,"D",2.02,3.78,3.73,"1-1","2-2",17,4,13,6,0,1,0,0,7,3,5,9,4,10,14,"7-3","Y","Y","Y",1,0,24
"563","E1",2023-12-26,"Coventry","Sheffield Weds",2,0,"H",1,0,"H",1.76,3.85,4.95,"1-0","2-0",9,2,11,2,1,1,1,1,5,9,7,12,2,14,19,"5-9","Y","N","N",2,2,24
"564","E1",2023-12-26,"Huddersfield","Blackburn",3,0,"H",1,0,"H",3.27,3.77,2.19,"1-0","3-0",12,6,10,1,1,4,0,0,6,4,10,8,3,10,18,"6-4","Y","Y","N",5,0,24
"565","E1",2023-12-26,"Hull","Sunderland",0,1,"A",0,0,"D",2.53,3.47,2.91,"0-0","0-1",10,6,17,3,1,1,0,0,3,7,6,8,1,10,14,"3-7","N","N","N",2,0,24
"566","E1",2023-12-26,"Rotherham","Middlesbrough",1,0,"H",0,0,"D",5.82,4.27,1.6,"0-0","1-0",3,1,19,5,0,0,0,0,0,11,12,8,1,11,20,"0-11","N","N","N",0,0,24
"567","E1",2023-12-26,"Southampton","Swansea",5,0,"H",1,0,"H",1.48,4.83,6.71,"1-0","5-0",11,9,4,1,2,4,0,0,3,1,15,13,5,4,28,"3-1","Y","Y","Y",6,0,24
"568","E1",2023-12-26,"Watford","Bristol City",1,4,"A",0,2,"A",1.97,3.53,4.21,"0-2","1-4",13,5,15,5,1,0,0,0,6,6,10,4,5,12,14,"6-6","Y","Y","Y",1,0,24
"569","E1",2023-12-26,"West Brom","Norwich",1,0,"H",0,0,"D",1.88,3.8,4.24,"0-0","1-0",21,3,7,3,0,0,0,1,12,4,5,8,1,16,13,"12-4","N","N","N",0,1,24
"570","E1",2023-12-26,"Birmingham","Stoke",1,3,"A",0,2,"A",2.73,3.35,2.76,"0-2","1-3",14,5,11,5,2,3,0,0,5,3,10,12,4,8,22,"5-3","Y","Y","Y",5,0,24
"571","E1",2023-12-26,"Ipswich","Leicester",1,1,"D",0,1,"A",3.13,3.67,2.29,"0-1","1-1",19,2,5,2,1,2,0,0,11,2,9,9,2,13,18,"11-2","Y","N","N",3,0,24
"572","E1",2023-12-29,"Southampton","Plymouth",2,1,"H",0,0,"D",1.33,5.98,8.73,"0-0","2-1",26,7,8,1,3,2,0,0,9,3,8,8,3,12,16,"9-3","Y","Y","N",5,0,25
"573","E1",2023-12-29,"Birmingham","Bristol City",0,0,"D",0,0,"D",2.84,3.39,2.63,"0-0","0-0",5,1,8,0,0,0,0,0,1,6,11,6,0,7,17,"1-6","N","N","N",0,0,25
"574","E1",2023-12-29,"Cardiff","Leicester",0,2,"A",0,1,"A",6.02,4.09,1.61,"0-1","0-2",10,2,9,4,1,0,0,0,5,2,11,7,2,7,18,"5-2","Y","N","N",1,0,25
"575","E1",2023-12-29,"Coventry","Swansea",2,2,"D",1,1,"D",1.8,3.96,4.5,"1-1","2-2",21,5,12,4,1,4,0,0,12,4,14,11,4,16,25,"12-4","Y","Y","Y",5,0,25
"576","E1",2023-12-29,"Huddersfield","Middlesbrough",1,2,"A",0,0,"D",4.59,3.92,1.79,"0-0","1-2",16,5,9,5,0,2,0,0,7,2,11,11,3,9,22,"7-2","Y","Y","N",2,0,25
"577","E1",2023-12-29,"Hull","Blackburn",3,2,"H",2,2,"D",1.87,3.98,4.11,"2-2","3-2",21,9,10,4,3,3,0,1,4,4,15,12,5,8,27,"4-4","Y","Y","Y",6,1,25
"578","E1",2023-12-29,"Ipswich","QPR",0,0,"D",0,0,"D",1.47,4.69,7.14,"0-0","0-0",7,5,10,2,3,2,0,0,5,9,13,5,0,14,18,"5-9","N","N","N",5,0,25
"579","E1",2023-12-29,"Millwall","Norwich",1,0,"H",1,0,"H",2.57,3.36,2.94,"1-0","1-0",11,5,11,3,4,5,1,0,5,3,11,12,1,8,23,"5-3","N","N","N",9,1,25
"580","E1",2023-12-29,"Preston","Sheffield Weds",0,1,"A",0,1,"A",2.39,3.12,3.47,"0-1","0-1",9,2,6,3,4,2,0,1,3,0,10,11,1,3,21,"3-0","N","N","N",6,1,25
"581","E1",2023-12-29,"Rotherham","Sunderland",1,1,"D",0,0,"D",6.53,4.32,1.55,"0-0","1-1",13,4,10,3,2,1,0,0,4,8,10,9,2,12,19,"4-8","Y","N","N",3,0,25
"582","E1",2023-12-29,"Watford","Stoke",1,1,"D",1,1,"D",2.19,3.49,3.52,"1-1","1-1",13,6,14,4,4,1,1,0,5,4,7,10,2,9,17,"5-4","Y","N","N",5,1,25
"583","E1",2023-12-29,"West Brom","Leeds",1,0,"H",1,0,"H",3.36,3.39,2.3,"1-0","1-0",13,3,15,1,1,1,0,0,11,8,8,10,1,19,18,"11-8","N","N","N",2,0,25
"584","E1",2024-01-01,"Sunderland","Preston",2,0,"H",2,0,"H",1.6,4.19,6,"2-0","2-0",7,4,12,3,0,1,0,0,2,3,6,12,2,5,18,"2-3","Y","N","N",1,0,26
"585","E1",2024-01-01,"Blackburn","Rotherham",2,2,"D",1,1,"D",1.52,4.85,6.05,"1-1","2-2",18,9,13,4,0,1,0,0,5,5,5,11,4,10,16,"5-5","Y","Y","Y",1,0,26
"586","E1",2024-01-01,"Bristol City","Millwall",0,1,"A",0,0,"D",2.15,3.33,3.8,"0-0","0-1",5,1,11,2,1,2,0,0,6,5,5,10,1,11,15,"6-5","N","N","N",3,0,26
"587","E1",2024-01-01,"Leeds","Birmingham",3,0,"H",2,0,"H",1.25,6.48,12.14,"2-0","3-0",21,11,8,1,0,2,0,0,6,3,10,14,3,9,24,"6-3","Y","Y","N",2,0,26
"588","E1",2024-01-01,"Leicester","Huddersfield",4,1,"H",1,0,"H",1.2,7.26,15.24,"1-0","4-1",19,6,12,4,0,1,0,0,3,4,5,9,5,7,14,"3-4","Y","Y","Y",1,0,26
"589","E1",2024-01-01,"Middlesbrough","Coventry",1,3,"A",1,1,"D",2.04,3.82,3.62,"1-1","1-3",19,7,17,8,2,2,0,0,12,9,10,11,4,21,21,"12-9","Y","Y","Y",4,0,26
"590","E1",2024-01-01,"Norwich","Southampton",1,1,"D",0,0,"D",3.36,3.71,2.17,"0-0","1-1",7,2,21,4,5,0,0,0,1,12,8,8,2,13,16,"1-12","Y","N","N",5,0,26
"591","E1",2024-01-01,"Plymouth","Watford",3,3,"D",3,2,"H",3.04,3.75,2.31,"3-2","3-3",31,11,18,5,2,3,0,0,9,5,11,12,6,14,23,"9-5","Y","Y","Y",5,0,26
"592","E1",2024-01-01,"QPR","Cardiff",1,2,"A",0,1,"A",2.36,3.2,3.44,"0-1","1-2",8,3,10,5,2,5,0,0,1,6,12,20,3,7,32,"1-6","Y","Y","N",7,0,26
"593","E1",2024-01-01,"Stoke","Ipswich",0,0,"D",0,0,"D",2.98,3.48,2.47,"0-0","0-0",8,4,13,2,1,2,1,0,8,5,7,15,0,13,22,"8-5","N","N","N",3,1,26
"594","E1",2024-01-01,"Swansea","West Brom",1,0,"H",0,0,"D",3.35,3.49,2.26,"0-0","1-0",10,4,10,5,2,0,0,0,3,5,10,7,1,8,17,"3-5","N","N","N",2,0,26
"595","E1",2024-01-01,"Sheffield Weds","Hull",3,1,"H",0,0,"D",3.23,3.22,2.46,"0-0","3-1",23,6,5,1,3,4,0,1,10,4,13,13,4,14,26,"10-4","Y","Y","Y",7,1,26
"596","E1",2024-01-12,"Hull","Norwich",1,2,"A",0,1,"A",2.28,3.58,3.23,"0-1","1-2",19,5,9,4,2,4,0,0,9,2,12,14,3,11,26,"9-2","Y","Y","N",6,0,27
"597","E1",2024-01-13,"Coventry","Leicester",3,1,"H",0,1,"A",3.7,3.71,2.05,"0-1","3-1",14,6,8,4,5,3,0,1,7,1,12,14,4,8,26,"7-1","Y","Y","Y",8,1,27
"598","E1",2024-01-13,"Birmingham","Swansea",2,2,"D",1,1,"D",2.33,3.62,3.1,"1-1","2-2",11,6,6,3,5,3,0,0,5,5,21,11,4,10,32,"5-5","Y","Y","Y",8,0,27
"599","E1",2024-01-13,"Cardiff","Leeds",0,3,"A",0,2,"A",5.24,4.11,1.68,"0-2","0-3",9,1,15,7,1,1,0,0,5,4,5,7,3,9,12,"5-4","Y","Y","N",2,0,27
"600","E1",2024-01-13,"Huddersfield","Plymouth",1,1,"D",1,1,"D",2.57,3.72,2.71,"1-1","1-1",13,4,9,3,1,4,0,0,3,5,13,16,2,8,29,"3-5","Y","N","N",5,0,27
"601","E1",2024-01-13,"Millwall","Middlesbrough",1,3,"A",1,1,"D",2.85,3.36,2.64,"1-1","1-3",15,5,14,6,3,1,0,0,5,4,9,10,4,9,19,"5-4","Y","Y","Y",4,0,27
"602","E1",2024-01-13,"Preston","Bristol City",2,0,"H",0,0,"D",2.67,3.19,2.95,"0-0","2-0",12,7,15,6,1,2,0,0,8,6,13,7,2,14,20,"8-6","Y","N","N",3,0,27
"603","E1",2024-01-13,"Rotherham","Stoke",0,1,"A",0,1,"A",4.07,3.66,1.96,"0-1","0-1",3,0,4,3,2,3,0,0,3,6,11,13,1,9,24,"3-6","N","N","N",5,0,27
"604","E1",2024-01-13,"Southampton","Sheffield Weds",4,0,"H",1,0,"H",1.42,4.93,8.13,"1-0","4-0",15,7,6,4,3,3,0,0,14,3,9,12,4,17,21,"14-3","Y","Y","Y",6,0,27
"605","E1",2024-01-13,"West Brom","Blackburn",4,1,"H",3,0,"H",1.75,4.02,4.77,"3-0","4-1",16,8,12,3,2,0,0,0,6,3,8,9,5,9,17,"6-3","Y","Y","Y",2,0,27
"606","E1",2024-01-13,"Ipswich","Sunderland",2,1,"H",1,1,"D",2.15,3.5,3.6,"1-1","2-1",17,5,10,3,5,2,0,0,3,1,17,8,3,4,25,"3-1","Y","Y","N",7,0,27
"607","E1",2024-01-14,"QPR","Watford",1,2,"A",0,0,"D",3.13,3.32,2.46,"0-0","1-2",16,7,9,2,3,3,0,0,8,4,17,13,3,12,30,"8-4","Y","Y","N",6,0,27
"608","E1",2024-01-19,"Sunderland","Hull",0,1,"A",0,0,"D",1.86,3.71,4.47,"0-0","0-1",15,3,2,2,2,7,0,0,12,1,12,17,1,13,29,"12-1","N","N","N",9,0,28
"609","E1",2024-01-20,"Swansea","Southampton",1,3,"A",1,3,"A",5,4.24,1.68,"1-3","1-3",15,6,21,10,2,2,0,0,3,8,10,12,4,11,22,"3-8","Y","Y","Y",4,0,28
"610","E1",2024-01-20,"Blackburn","Huddersfield",1,1,"D",1,1,"D",1.77,4.11,4.49,"1-1","1-1",16,4,8,3,1,2,0,0,7,3,10,4,2,10,14,"7-3","Y","N","N",3,0,28
"611","E1",2024-01-20,"Bristol City","Watford",1,1,"D",1,1,"D",2.45,3.36,3.11,"1-1","1-1",15,6,14,2,1,2,0,0,7,8,8,16,2,15,24,"7-8","Y","N","N",3,0,28
"612","E1",2024-01-20,"Middlesbrough","Rotherham",1,1,"D",0,0,"D",1.31,5.7,10.57,"0-0","1-1",15,3,6,2,1,3,0,0,13,2,8,8,2,15,16,"13-2","Y","N","N",4,0,28
"613","E1",2024-01-20,"Norwich","West Brom",2,0,"H",1,0,"H",2.9,3.47,2.54,"1-0","2-0",13,6,15,3,1,2,0,0,2,6,9,10,2,8,19,"2-6","Y","N","N",3,0,28
"614","E1",2024-01-20,"Plymouth","Cardiff",3,1,"H",1,1,"D",2.28,3.65,3.17,"1-1","3-1",15,5,6,3,4,2,0,0,5,5,9,7,4,10,16,"5-5","Y","Y","Y",6,0,28
"615","E1",2024-01-20,"QPR","Millwall",2,0,"H",1,0,"H",2.61,3.19,3.03,"1-0","2-0",12,5,2,1,0,2,0,0,2,3,10,8,2,5,18,"2-3","Y","N","N",2,0,28
"616","E1",2024-01-20,"Sheffield Weds","Coventry",1,2,"A",0,1,"A",3.19,3.59,2.3,"0-1","1-2",11,5,16,6,4,5,0,0,6,7,14,11,3,13,25,"6-7","Y","Y","N",9,0,28
"617","E1",2024-01-20,"Stoke","Birmingham",1,2,"A",0,1,"A",1.95,3.61,4.2,"0-1","1-2",22,5,9,5,2,0,0,0,13,2,5,7,3,15,12,"13-2","Y","Y","N",2,0,28
"618","E1",2024-01-21,"Leeds","Preston",2,1,"H",1,1,"D",1.31,5.68,10.79,"1-1","2-1",20,6,8,2,4,6,0,0,9,3,12,18,3,12,30,"9-3","Y","Y","N",10,0,28
"619","E1",2024-01-22,"Leicester","Ipswich",1,1,"D",1,0,"H",1.92,3.73,4.08,"1-0","1-1",15,8,11,3,1,3,0,0,8,8,6,11,2,16,17,"8-8","Y","N","N",4,0,28
"620","E1",2024-01-24,"Leeds","Norwich",1,0,"H",1,0,"H",1.48,4.91,6.61,"1-0","1-0",12,4,5,1,1,2,0,0,4,2,13,8,1,6,21,"4-2","N","N","N",3,0,29
"621","E1",2024-01-27,"Millwall","Preston",1,1,"D",1,1,"D",2.27,3.14,3.73,"1-1","1-1",17,8,11,4,3,3,0,0,8,3,19,6,2,11,25,"8-3","Y","N","N",6,0,29
"622","E1",2024-01-27,"Sunderland","Stoke",3,1,"H",1,0,"H",2.04,3.58,3.87,"1-0","3-1",8,5,15,4,1,3,0,0,3,6,10,9,4,9,19,"3-6","Y","Y","Y",4,0,29
"623","E1",2024-01-28,"QPR","Huddersfield",1,1,"D",0,0,"D",2.12,3.28,3.99,"0-0","1-1",7,4,13,3,4,3,0,0,4,10,15,16,2,14,31,"4-10","Y","N","N",7,0,29
"624","E1",2024-01-30,"Coventry","Bristol City",2,2,"D",1,1,"D",1.76,3.71,5.18,"1-1","2-2",11,4,13,5,1,2,0,0,1,5,10,13,4,6,23,"1-5","Y","Y","Y",3,0,29
"625","E1",2024-01-30,"Leicester","Swansea",3,1,"H",1,0,"H",1.34,5.65,9.13,"1-0","3-1",14,7,11,3,1,1,0,0,2,3,12,8,4,5,20,"2-3","Y","Y","Y",2,0,29
"626","E1",2024-01-31,"Sheffield Weds","Watford",0,0,"D",0,0,"D",2.81,3.29,2.72,"0-0","0-0",19,5,10,2,4,3,0,0,5,5,8,13,0,10,21,"5-5","N","N","N",7,0,29
"627","E1",2024-02-02,"Bristol City","Leeds",0,1,"A",0,0,"D",5.11,3.85,1.74,"0-0","0-1",7,1,14,6,1,0,0,0,2,4,10,10,1,6,20,"2-4","N","N","N",1,0,29
"628","E1",2024-02-03,"Blackburn","QPR",1,2,"A",0,0,"D",2,3.72,3.84,"0-0","1-2",16,6,7,4,2,3,0,0,4,10,12,5,3,14,17,"4-10","Y","Y","N",5,0,29
"629","E1",2024-02-03,"Huddersfield","Sheffield Weds",4,0,"H",0,0,"D",2.52,3.27,3.08,"0-0","4-0",12,6,12,3,3,1,0,0,7,8,10,18,4,15,28,"7-8","Y","Y","Y",4,0,29
"630","E1",2024-02-03,"Hull","Millwall",1,0,"H",1,0,"H",2.06,3.48,3.92,"1-0","1-0",9,2,5,1,3,2,0,0,4,4,15,19,1,8,34,"4-4","N","N","N",5,0,29
"631","E1",2024-02-03,"Norwich","Coventry",2,1,"H",0,0,"D",2.48,3.67,2.84,"0-0","2-1",21,5,8,5,2,1,0,1,5,2,11,9,3,7,20,"5-2","Y","Y","N",3,1,29
"632","E1",2024-02-03,"Preston","Ipswich",3,2,"H",3,0,"H",3.87,3.57,2.04,"3-0","3-2",10,3,25,9,0,0,0,0,6,3,13,8,5,9,21,"6-3","Y","Y","Y",0,0,30
"633","E1",2024-02-03,"Rotherham","Southampton",0,2,"A",0,2,"A",8.65,5.67,1.35,"0-2","0-2",8,2,10,7,0,2,0,0,3,10,8,10,2,13,18,"3-10","Y","N","N",2,0,30
"634","E1",2024-02-03,"Stoke","Leicester",0,5,"A",0,2,"A",4.3,3.89,1.85,"0-2","0-5",10,4,16,9,4,3,0,0,3,6,10,12,5,9,22,"3-6","Y","Y","Y",7,0,30
"635","E1",2024-02-03,"Swansea","Plymouth",0,1,"A",0,1,"A",2.02,3.97,3.54,"0-1","0-1",20,4,9,3,2,3,0,0,8,2,12,14,1,10,26,"8-2","N","N","N",5,0,30
"636","E1",2024-02-03,"Watford","Cardiff",0,1,"A",0,1,"A",1.85,3.66,4.62,"0-1","0-1",17,6,10,2,3,3,0,0,10,2,16,6,1,12,22,"10-2","N","N","N",6,0,30
"637","E1",2024-02-03,"West Brom","Birmingham",1,0,"H",0,0,"D",1.75,3.92,4.95,"0-0","1-0",10,2,13,5,2,3,0,0,4,8,12,16,1,12,28,"4-8","N","N","N",5,0,30
"638","E1",2024-02-04,"Middlesbrough","Sunderland",1,1,"D",0,0,"D",2.12,3.58,3.59,"0-0","1-1",15,2,13,5,3,3,0,0,1,6,17,10,2,7,27,"1-6","Y","N","N",6,0,30
"639","E1",2024-02-09,"Sheffield Weds","Birmingham",2,0,"H",1,0,"H",2.31,3.42,3.3,"1-0","2-0",13,3,25,4,3,1,0,0,1,7,14,10,2,8,24,"1-7","Y","N","N",4,0,30
"640","E1",2024-02-10,"Ipswich","West Brom",2,2,"D",0,1,"A",2.11,3.49,3.73,"0-1","2-2",21,7,5,2,2,3,0,0,9,3,12,3,4,12,15,"9-3","Y","Y","Y",5,0,30
"641","E1",2024-02-10,"Blackburn","Stoke",3,1,"H",3,1,"H",2.46,3.66,2.88,"3-1","3-1",9,5,7,3,0,2,0,0,5,8,8,8,4,13,16,"5-8","Y","Y","Y",2,0,30
"642","E1",2024-02-10,"Cardiff","Preston",0,2,"A",0,2,"A",2.34,3.21,3.46,"0-2","0-2",14,5,3,3,2,1,0,0,4,0,5,11,2,4,16,"4-0","Y","N","N",3,0,30
"643","E1",2024-02-10,"Hull","Swansea",0,1,"A",0,1,"A",1.72,4.07,4.92,"0-1","0-1",9,3,13,5,1,3,0,0,2,4,7,10,1,6,17,"2-4","N","N","N",4,0,30
"644","E1",2024-02-10,"Leeds","Rotherham",3,0,"H",1,0,"H",1.16,8.95,16.75,"1-0","3-0",19,6,7,2,0,2,0,0,5,3,13,11,3,8,24,"5-3","Y","Y","N",2,0,31
"645","E1",2024-02-10,"Middlesbrough","Bristol City",1,2,"A",0,2,"A",1.76,3.86,4.97,"0-2","1-2",16,6,12,7,1,0,0,0,7,1,11,11,3,8,22,"7-1","Y","Y","N",1,0,31
"646","E1",2024-02-10,"QPR","Norwich",2,2,"D",1,0,"H",2.82,3.43,2.62,"1-0","2-2",14,4,12,4,2,4,0,0,1,8,25,11,4,9,36,"1-8","Y","Y","Y",6,0,31
"647","E1",2024-02-10,"Southampton","Huddersfield",5,3,"H",0,2,"A",1.3,5.71,11.65,"0-2","5-3",15,7,17,6,2,3,0,0,6,6,11,11,8,12,22,"6-6","Y","Y","Y",5,0,31
"648","E1",2024-02-10,"Sunderland","Plymouth",3,1,"H",0,1,"A",1.56,4.53,5.85,"0-1","3-1",14,5,5,2,1,5,0,0,8,2,17,13,4,10,30,"8-2","Y","Y","Y",6,0,31
"649","E1",2024-02-10,"Watford","Leicester",1,2,"A",0,1,"A",4.56,4.17,1.75,"0-1","1-2",13,3,6,3,2,3,0,0,8,1,11,15,3,9,26,"8-1","Y","Y","N",5,0,31
"650","E1",2024-02-11,"Coventry","Millwall",2,1,"H",0,1,"A",1.81,3.75,4.76,"0-1","2-1",15,5,8,4,0,1,0,0,8,3,9,14,3,11,23,"8-3","Y","Y","N",1,0,31
"651","E1",2024-02-13,"Birmingham","Blackburn",1,0,"H",0,0,"D",2.31,3.75,3.05,"0-0","1-0",18,3,8,3,2,3,0,0,6,4,9,16,1,10,25,"6-4","N","N","N",5,0,31
"652","E1",2024-02-13,"Leicester","Sheffield Weds",2,0,"H",2,0,"H",1.28,6.03,11.62,"2-0","2-0",10,3,13,4,1,2,0,0,4,7,15,12,2,11,27,"4-7","Y","N","N",3,0,31
"653","E1",2024-02-13,"Norwich","Watford",4,2,"H",2,1,"H",2.17,3.54,3.51,"2-1","4-2",14,6,11,3,3,2,0,0,4,4,13,11,6,8,24,"4-4","Y","Y","Y",5,0,31
"654","E1",2024-02-13,"Rotherham","Hull",1,2,"A",1,0,"H",4.91,3.57,1.83,"1-0","1-2",11,6,20,8,2,1,0,0,4,9,13,6,3,13,19,"4-9","Y","Y","N",3,0,31
"655","E1",2024-02-13,"Swansea","Leeds",0,4,"A",0,3,"A",5.71,4.42,1.59,"0-3","0-4",7,1,13,8,3,1,0,0,5,2,11,10,4,7,21,"5-2","Y","Y","Y",4,0,31
"656","E1",2024-02-13,"Bristol City","Southampton",3,1,"H",0,0,"D",4.61,3.79,1.82,"0-0","3-1",14,4,16,4,2,2,0,0,6,5,8,13,4,11,21,"6-5","Y","Y","Y",4,0,32
"657","E1",2024-02-13,"West Brom","Cardiff",2,0,"H",1,0,"H",1.66,3.78,6.14,"1-0","2-0",11,3,11,1,1,2,0,0,4,4,8,11,2,8,19,"4-4","Y","N","N",3,0,32
"658","E1",2024-02-14,"Huddersfield","Sunderland",1,0,"H",1,0,"H",3.8,3.41,2.12,"1-0","1-0",12,6,12,5,2,4,0,0,6,10,14,15,1,16,29,"6-10","N","N","N",6,0,32
"659","E1",2024-02-14,"Plymouth","Coventry",2,2,"D",0,0,"D",3.46,3.98,2.05,"0-0","2-2",13,4,17,7,1,3,0,0,1,9,8,19,4,10,27,"1-9","Y","Y","Y",4,0,32
"660","E1",2024-02-14,"Preston","Middlesbrough",2,1,"H",1,0,"H",3.36,3.46,2.26,"1-0","2-1",7,3,20,4,2,1,0,0,2,7,10,10,3,9,20,"2-7","Y","Y","N",3,0,32
"661","E1",2024-02-14,"Stoke","QPR",1,0,"H",1,0,"H",2.13,3.39,3.8,"1-0","1-0",14,5,10,1,0,1,0,0,5,7,12,11,1,12,23,"5-7","N","N","N",1,0,32
"662","E1",2024-02-14,"Millwall","Ipswich",0,4,"A",0,3,"A",3.67,3.48,2.13,"0-3","0-4",14,4,8,4,3,1,0,0,9,5,12,13,4,14,25,"9-5","Y","Y","Y",4,0,32
"663","E1",2024-02-16,"West Brom","Southampton",0,2,"A",0,1,"A",3.08,3.5,2.4,"0-1","0-2",9,2,13,4,2,1,0,0,6,9,8,5,2,15,13,"6-9","Y","N","N",3,0,32
"664","E1",2024-02-17,"Plymouth","Leeds",0,2,"A",0,1,"A",6.5,5.15,1.46,"0-1","0-2",7,1,9,2,2,1,0,0,4,0,14,13,2,4,27,"4-0","Y","N","N",3,0,32
"665","E1",2024-02-17,"Birmingham","Sunderland",2,1,"H",0,1,"A",2.89,3.36,2.6,"0-1","2-1",16,5,10,4,4,4,0,0,5,5,18,14,3,10,32,"5-5","Y","Y","N",8,0,32
"666","E1",2024-02-17,"Bristol City","QPR",0,1,"A",0,1,"A",1.99,3.37,4.36,"0-1","0-1",11,2,11,7,0,1,0,0,4,2,7,7,1,6,14,"4-2","N","N","N",1,0,32
"667","E1",2024-02-17,"Huddersfield","Hull",1,2,"A",0,1,"A",3.21,3.36,2.39,"0-1","1-2",16,3,9,3,3,1,0,0,11,3,11,8,3,14,19,"11-3","Y","Y","N",4,0,32
"668","E1",2024-02-17,"Leicester","Middlesbrough",1,2,"A",0,2,"A",1.6,4.49,5.52,"0-2","1-2",24,2,5,2,1,4,0,0,12,4,10,8,3,16,18,"12-4","Y","Y","N",5,0,33
"669","E1",2024-02-17,"Millwall","Sheffield Weds",0,2,"A",0,2,"A",2.18,3.24,3.82,"0-2","0-2",9,3,5,2,3,1,0,1,5,5,14,15,2,10,29,"5-5","Y","N","N",4,1,33
"670","E1",2024-02-17,"Norwich","Cardiff",4,1,"H",2,1,"H",1.83,3.83,4.49,"2-1","4-1",23,8,9,3,0,3,0,0,8,0,7,13,5,8,20,"8-0","Y","Y","Y",3,0,33
"671","E1",2024-02-17,"Preston","Blackburn",2,2,"D",2,2,"D",2.44,3.5,3.01,"2-2","2-2",16,8,6,3,0,0,0,0,7,3,10,12,4,10,22,"7-3","Y","Y","Y",0,0,33
"672","E1",2024-02-17,"Rotherham","Watford",0,1,"A",0,0,"D",4.56,3.61,1.88,"0-0","0-1",19,1,8,1,2,1,0,0,7,6,13,11,1,13,24,"7-6","N","N","N",3,0,33
"673","E1",2024-02-17,"Stoke","Coventry",0,1,"A",0,0,"D",2.9,3.51,2.51,"0-0","0-1",13,1,9,3,2,1,0,0,5,4,13,10,1,9,23,"5-4","N","N","N",3,0,33
"674","E1",2024-02-17,"Swansea","Ipswich",1,2,"A",1,2,"A",4.05,3.92,1.9,"1-2","1-2",15,3,15,6,1,1,0,0,9,6,5,13,3,15,18,"9-6","Y","Y","N",2,0,33
"675","E1",2024-02-20,"Cardiff","Blackburn",0,0,"D",0,0,"D",3.02,3.3,2.55,"0-0","0-0",11,5,4,1,2,3,0,0,4,1,10,12,0,5,22,"4-1","N","N","N",5,0,33
"676","E1",2024-02-20,"Ipswich","Rotherham",4,3,"H",3,1,"H",1.23,6.67,13.57,"3-1","4-3",11,7,13,5,1,2,0,0,2,6,16,16,7,8,32,"2-6","Y","Y","Y",3,0,33
"677","E1",2024-02-20,"Plymouth","West Brom",0,3,"A",0,0,"D",3.73,3.58,2.08,"0-0","0-3",4,0,17,7,1,0,0,0,2,7,9,8,3,9,17,"2-7","Y","Y","N",1,0,33
"678","E1",2024-02-20,"Southampton","Hull",1,2,"A",0,2,"A",1.56,4.64,5.75,"0-2","1-2",15,3,17,5,1,2,0,0,4,2,9,13,3,6,22,"4-2","Y","Y","N",3,0,33
"679","E1",2024-02-23,"Coventry","Preston",0,3,"A",0,3,"A",1.78,3.78,4.9,"0-3","0-3",10,4,10,3,1,3,0,0,6,6,9,19,3,12,28,"6-6","Y","Y","N",4,0,33
"680","E1",2024-02-23,"Leeds","Leicester",3,1,"H",0,1,"A",2.16,3.56,3.52,"0-1","3-1",15,4,16,5,5,2,0,0,2,5,15,11,4,7,26,"2-5","Y","Y","Y",7,0,34
"681","E1",2024-02-24,"Hull","West Brom",1,1,"D",1,1,"D",2.5,3.29,3.08,"1-1","1-1",9,3,11,4,0,0,0,0,8,3,10,11,2,11,21,"8-3","Y","N","N",0,0,34
"682","E1",2024-02-24,"Blackburn","Norwich",1,1,"D",0,1,"A",2.57,3.7,2.71,"0-1","1-1",10,5,7,3,2,2,0,0,6,6,14,6,2,12,20,"6-6","Y","N","N",4,0,34
"683","E1",2024-02-24,"Cardiff","Stoke",2,1,"H",2,1,"H",2.86,3.09,2.83,"2-1","2-1",11,5,14,6,4,2,0,0,2,6,13,14,3,8,27,"2-6","Y","Y","N",6,0,34
"684","E1",2024-02-24,"Ipswich","Birmingham",3,1,"H",1,1,"D",1.57,4.56,5.7,"1-1","3-1",26,9,11,4,3,1,0,0,7,5,11,14,4,12,25,"7-5","Y","Y","Y",4,0,34
"685","E1",2024-02-24,"Middlesbrough","Plymouth",0,2,"A",0,2,"A",1.48,4.87,6.71,"0-2","0-2",11,0,22,11,1,1,0,0,6,6,12,10,2,12,22,"6-6","Y","N","N",2,0,34
"686","E1",2024-02-24,"QPR","Rotherham",2,1,"H",0,1,"A",1.69,3.68,6,"0-1","2-1",18,9,14,4,4,1,0,0,9,0,9,17,3,9,26,"9-0","Y","Y","N",5,0,34
"687","E1",2024-02-24,"Sheffield Weds","Bristol City",2,1,"H",2,1,"H",2.63,3.25,2.94,"2-1","2-1",15,7,12,2,1,3,1,0,4,6,8,7,3,10,15,"4-6","Y","Y","N",4,1,34
"688","E1",2024-02-24,"Southampton","Millwall",1,2,"A",1,2,"A",1.36,5.34,8.96,"1-2","1-2",14,7,8,3,4,3,0,0,13,1,9,8,3,14,17,"13-1","Y","Y","N",7,0,34
"689","E1",2024-02-24,"Sunderland","Swansea",1,2,"A",0,2,"A",1.85,3.74,4.5,"0-2","1-2",13,5,13,8,1,4,0,0,4,11,8,15,3,15,23,"4-11","Y","Y","N",5,0,34
"690","E1",2024-02-24,"Watford","Huddersfield",1,2,"A",0,0,"D",2,3.6,3.98,"0-0","1-2",12,4,11,5,2,2,0,0,3,5,16,12,3,8,28,"3-5","Y","Y","N",4,0,34
"691","E1",2024-03-01,"West Brom","Coventry",2,1,"H",2,0,"H",2.14,3.39,3.76,"2-0","2-1",7,2,17,3,2,1,0,0,4,4,10,12,3,8,22,"4-4","Y","Y","N",3,0,34
"692","E1",2024-03-02,"Bristol City","Cardiff",0,1,"A",0,0,"D",1.98,3.3,4.53,"0-0","0-1",17,3,9,4,2,2,0,0,8,3,7,14,1,11,21,"8-3","N","N","N",4,0,35
"693","E1",2024-03-02,"Huddersfield","Leeds",1,1,"D",1,0,"H",5.65,4.25,1.62,"1-0","1-1",12,5,15,2,3,1,1,0,8,8,10,13,2,16,23,"8-8","Y","N","N",4,1,35
"694","E1",2024-03-02,"Birmingham","Southampton",3,4,"A",2,1,"H",4.19,4.01,1.85,"2-1","3-4",13,4,25,10,3,1,1,0,6,16,11,7,7,22,18,"6-16","Y","Y","Y",4,1,35
"695","E1",2024-03-02,"Leicester","QPR",1,2,"A",0,1,"A",1.35,5.48,9.2,"0-1","1-2",18,5,3,2,2,3,0,0,9,0,7,11,3,9,18,"9-0","Y","Y","N",5,0,35
"696","E1",2024-03-02,"Millwall","Watford",1,0,"H",1,0,"H",2.43,3.33,3.17,"1-0","1-0",6,2,12,3,3,1,0,0,4,3,12,14,1,7,26,"4-3","N","N","N",4,0,35
"697","E1",2024-03-02,"Norwich","Sunderland",1,0,"H",0,0,"D",1.95,3.74,4.03,"0-0","1-0",16,4,12,4,2,3,0,0,5,2,13,11,1,7,24,"5-2","N","N","N",5,0,35
"698","E1",2024-03-02,"Plymouth","Ipswich",0,2,"A",0,0,"D",4.51,4.23,1.75,"0-0","0-2",9,2,14,6,1,3,0,0,5,7,11,22,2,12,33,"5-7","Y","N","N",4,0,35
"699","E1",2024-03-02,"Preston","Hull",0,0,"D",0,0,"D",2.96,3.3,2.59,"0-0","0-0",16,4,15,4,1,1,0,0,8,8,12,6,0,16,18,"8-8","N","N","N",2,0,35
"700","E1",2024-03-02,"Rotherham","Sheffield Weds",0,1,"A",0,0,"D",3.58,3.33,2.23,"0-0","0-1",7,1,17,4,1,2,0,0,2,10,16,14,1,12,30,"2-10","N","N","N",3,0,35
"701","E1",2024-03-02,"Stoke","Middlesbrough",2,0,"H",1,0,"H",2.72,3.48,2.69,"1-0","2-0",11,5,10,3,3,1,0,0,6,3,16,5,2,9,21,"6-3","Y","N","N",4,0,35
"702","E1",2024-03-02,"Swansea","Blackburn",2,1,"H",2,0,"H",2.26,3.58,3.27,"2-0","2-1",7,4,10,5,1,2,0,0,6,6,10,12,3,12,22,"6-6","Y","Y","N",3,0,35
"703","E1",2024-03-05,"Blackburn","Millwall",1,1,"D",0,0,"D",2.27,3.3,3.53,"0-0","1-1",11,3,3,1,0,1,0,0,4,2,10,11,2,6,21,"4-2","Y","N","N",1,0,35
"704","E1",2024-03-05,"Coventry","Rotherham",5,0,"H",4,0,"H",1.3,5.86,11.08,"4-0","5-0",16,6,7,1,0,1,0,0,4,5,10,19,5,9,29,"4-5","Y","Y","Y",1,0,36
"705","E1",2024-03-05,"Hull","Birmingham",1,1,"D",1,0,"H",1.72,4,4.96,"1-0","1-1",22,5,8,3,1,3,0,0,10,2,7,8,2,12,15,"10-2","Y","N","N",4,0,36
"706","E1",2024-03-05,"Leeds","Stoke",1,0,"H",1,0,"H",1.33,5.71,9.47,"1-0","1-0",15,7,13,6,1,1,0,1,8,2,7,13,1,10,20,"8-2","N","N","N",2,1,36
"707","E1",2024-03-05,"Sheffield Weds","Plymouth",1,0,"H",0,0,"D",1.96,3.62,4.1,"0-0","1-0",18,3,13,3,1,2,0,0,8,2,12,13,1,10,25,"8-2","N","N","N",3,0,36
"708","E1",2024-03-05,"Sunderland","Leicester",0,1,"A",0,1,"A",4.09,3.78,1.92,"0-1","0-1",17,6,10,6,1,3,0,0,6,5,12,19,1,11,31,"6-5","N","N","N",4,0,36
"709","E1",2024-03-05,"Ipswich","Bristol City",3,2,"H",0,0,"D",1.66,3.88,5.83,"0-0","3-2",14,8,11,4,1,3,0,0,4,5,6,15,5,9,21,"4-5","Y","Y","Y",4,0,36
"710","E1",2024-03-06,"Cardiff","Huddersfield",1,0,"H",1,0,"H",2.49,3.28,3.11,"1-0","1-0",8,4,11,2,4,1,0,0,3,3,10,11,1,6,21,"3-3","N","N","N",5,0,36
"711","E1",2024-03-06,"Middlesbrough","Norwich",3,1,"H",2,1,"H",2.34,3.65,3.07,"2-1","3-1",15,7,6,3,1,1,0,1,2,2,8,9,4,4,17,"2-2","Y","Y","Y",2,1,36
"712","E1",2024-03-06,"Watford","Swansea",1,1,"D",0,1,"A",2.26,3.57,3.27,"0-1","1-1",19,3,11,2,4,2,0,0,9,3,18,10,2,12,28,"9-3","Y","N","N",6,0,36
"713","E1",2024-03-06,"QPR","West Brom",2,2,"D",1,2,"A",3.2,3.17,2.5,"1-2","2-2",20,6,4,2,0,1,0,0,19,4,7,5,4,23,12,"19-4","Y","Y","Y",1,0,36
"714","E1",2024-03-08,"Sheffield Weds","Leeds",0,2,"A",0,1,"A",5.57,4.22,1.63,"0-1","0-2",9,3,13,7,1,1,0,0,8,5,16,9,2,13,25,"8-5","Y","N","N",2,0,36
"715","E1",2024-03-09,"Cardiff","Ipswich",2,1,"H",0,0,"D",4.69,3.74,1.82,"0-0","2-1",15,6,8,4,0,1,0,0,4,2,5,8,3,6,13,"4-2","Y","Y","N",1,0,36
"716","E1",2024-03-09,"Blackburn","Plymouth",1,1,"D",1,0,"H",1.81,3.83,4.66,"1-0","1-1",8,4,20,7,2,1,1,0,1,5,13,10,2,6,23,"1-5","Y","N","N",3,1,37
"717","E1",2024-03-09,"Hull","Leicester",2,2,"D",1,1,"D",3.45,3.63,2.16,"1-1","2-2",8,5,15,2,2,2,0,0,1,3,15,13,4,4,28,"1-3","Y","Y","Y",4,0,37
"718","E1",2024-03-09,"Millwall","Birmingham",1,0,"H",0,0,"D",2.23,3.24,3.68,"0-0","1-0",12,5,16,1,2,1,0,0,4,4,17,10,1,8,27,"4-4","N","N","N",3,0,37
"719","E1",2024-03-09,"Norwich","Rotherham",5,0,"H",4,0,"H",1.29,5.9,11.75,"4-0","5-0",18,8,2,0,1,0,0,0,4,3,9,12,5,7,21,"4-3","Y","Y","Y",1,0,37
"720","E1",2024-03-09,"Preston","Stoke",1,2,"A",0,0,"D",2.48,3.29,3.12,"0-0","1-2",4,2,13,4,2,2,0,0,0,6,10,10,3,6,20,"0-6","Y","Y","N",4,0,37
"721","E1",2024-03-09,"QPR","Middlesbrough",0,2,"A",0,0,"D",2.4,3.51,3.06,"0-0","0-2",10,2,7,4,2,5,0,0,10,3,11,7,2,13,18,"10-3","Y","N","N",7,0,37
"722","E1",2024-03-09,"Southampton","Sunderland",4,2,"H",2,0,"H",1.47,4.72,7.22,"2-0","4-2",21,10,13,5,2,3,0,0,6,2,13,15,6,8,28,"6-2","Y","Y","Y",5,0,37
"723","E1",2024-03-09,"Watford","Coventry",1,2,"A",1,1,"D",2.99,3.54,2.43,"1-1","1-2",19,5,8,3,1,5,0,0,5,4,12,12,3,9,24,"5-4","Y","Y","N",6,0,37
"724","E1",2024-03-10,"Huddersfield","West Brom",1,4,"A",1,0,"H",3.01,3.29,2.55,"1-0","1-4",14,6,12,8,1,1,0,0,5,5,9,11,5,10,20,"5-5","Y","Y","Y",2,0,37
"725","E1",2024-03-10,"Bristol City","Swansea",1,0,"H",0,0,"D",2.36,3.39,3.23,"0-0","1-0",5,2,8,0,2,1,0,0,3,6,14,4,1,9,18,"3-6","N","N","N",3,0,37
"726","E1",2024-03-12,"Birmingham","Middlesbrough",0,1,"A",0,1,"A",3,3.53,2.44,"0-1","0-1",9,0,12,3,0,2,0,0,3,4,9,6,1,7,15,"3-4","N","N","N",2,0,37
"727","E1",2024-03-16,"Swansea","Cardiff",2,0,"H",1,0,"H",2.05,3.42,4.03,"1-0","2-0",20,5,11,2,2,1,0,0,10,5,12,11,2,15,23,"10-5","Y","N","N",3,0,37
"728","E1",2024-03-16,"Birmingham","Watford",0,1,"A",0,1,"A",2.52,3.42,2.96,"0-1","0-1",27,5,14,4,0,3,0,0,7,6,11,12,1,13,23,"7-6","N","N","N",3,0,38
"729","E1",2024-03-16,"Ipswich","Sheffield Weds",6,0,"H",3,0,"H",1.55,4.39,6.28,"3-0","6-0",20,10,9,1,1,2,0,0,10,4,12,8,6,14,20,"10-4","Y","Y","Y",3,0,38
"730","E1",2024-03-16,"Middlesbrough","Blackburn",0,0,"D",0,0,"D",1.85,3.82,4.42,"0-0","0-0",16,3,12,3,3,3,0,0,8,5,10,9,0,13,19,"8-5","N","N","N",6,0,38
"731","E1",2024-03-16,"Plymouth","Preston",0,1,"A",0,1,"A",2.6,3.39,2.88,"0-1","0-1",9,0,9,4,2,2,0,0,6,5,11,22,1,11,33,"6-5","N","N","N",4,0,38
"732","E1",2024-03-16,"Rotherham","Huddersfield",0,0,"D",0,0,"D",4.3,3.55,1.94,"0-0","0-0",7,1,18,5,2,2,0,1,1,6,13,12,0,7,25,"1-6","N","N","N",4,1,38
"733","E1",2024-03-16,"Stoke","Norwich",0,3,"A",0,2,"A",2.65,3.47,2.76,"0-2","0-3",10,1,16,7,1,0,0,0,7,6,12,7,3,13,19,"7-6","Y","Y","N",1,0,38
"734","E1",2024-03-16,"Sunderland","QPR",0,0,"D",0,0,"D",2.54,3.23,3.09,"0-0","0-0",8,0,11,5,1,2,0,0,5,7,10,16,0,12,26,"5-7","N","N","N",3,0,38
"735","E1",2024-03-16,"West Brom","Bristol City",2,0,"H",1,0,"H",1.85,3.55,4.78,"1-0","2-0",12,4,10,5,4,2,0,0,3,7,6,14,2,10,20,"3-7","Y","N","N",6,0,38
"736","E1",2024-03-17,"Leeds","Millwall",2,0,"H",1,0,"H",1.35,5.17,10.05,"1-0","2-0",17,5,12,3,3,4,0,0,13,2,9,21,2,15,30,"13-2","Y","N","N",7,0,38
"737","E3",2023-08-05,"Accrington","Newport County",3,0,"H",1,0,"H",2.49,3.27,3.07,"1-0","3-0",16,8,17,2,2,0,0,0,7,4,11,13,3,11,24,"7-4","Y","Y","N",2,0,1
"738","E3",2023-08-05,"Crawley Town","Bradford",1,0,"H",1,0,"H",4.1,3.5,1.98,"1-0","1-0",21,3,14,7,6,3,0,1,2,4,14,14,1,6,28,"2-4","N","N","N",9,1,1
"739","E3",2023-08-05,"Crewe","Mansfield",2,2,"D",1,2,"A",4.15,3.75,1.87,"1-2","2-2",13,3,21,9,2,4,0,1,10,5,8,16,4,15,24,"10-5","Y","Y","Y",6,1,1
"740","E3",2023-08-05,"Doncaster","Harrogate",0,1,"A",0,0,"D",2.26,3.42,3.35,"0-0","0-1",12,3,7,6,1,4,0,0,6,5,7,20,1,11,27,"6-5","N","N","N",5,0,1
"741","E3",2023-08-05,"Forest Green","Salford",0,2,"A",0,0,"D",3.55,3.53,2.13,"0-0","0-2",19,4,7,3,3,3,0,0,10,4,17,9,2,14,26,"10-4","Y","N","N",6,0,1
"742","E3",2023-08-05,"Grimsby","AFC Wimbledon",0,0,"D",0,0,"D",2.06,3.45,3.87,"0-0","0-0",15,5,10,4,4,3,0,0,8,5,10,12,0,13,22,"8-5","N","N","N",7,0,1
"743","E3",2023-08-05,"Morecambe","Walsall",2,1,"H",1,1,"D",2.7,3.26,2.82,"1-1","2-1",7,5,11,1,6,4,0,0,5,3,12,7,3,8,19,"5-3","Y","Y","N",10,0,1
"744","E3",2023-08-05,"Stockport","Gillingham",0,1,"A",0,0,"D",1.79,3.57,5.1,"0-0","0-1",16,3,6,3,0,5,0,0,6,1,11,11,1,7,22,"6-1","N","N","N",5,0,1
"745","E3",2023-08-05,"Sutton","Notts County",5,1,"H",2,0,"H",4.71,4.13,1.72,"2-0","5-1",12,6,14,3,3,3,0,1,4,5,16,8,6,9,24,"4-5","Y","Y","Y",6,1,1
"746","E3",2023-08-05,"Tranmere","Barrow",1,2,"A",0,1,"A",2.45,3.17,3.23,"0-1","1-2",17,3,7,3,2,2,0,0,7,4,9,8,3,11,17,"7-4","Y","Y","N",4,0,1
"747","E3",2023-08-05,"Wrexham","Milton Keynes Dons",3,5,"A",1,2,"A",1.69,3.98,5.13,"1-2","3-5",23,5,8,6,2,3,0,0,5,4,15,9,8,9,24,"5-4","Y","Y","Y",5,0,1
"748","E3",2023-08-12,"AFC Wimbledon","Wrexham",1,1,"D",0,1,"A",3.61,3.62,2.08,"0-1","1-1",13,3,10,6,3,2,0,0,6,4,12,12,2,10,24,"6-4","Y","N","N",5,0,1
"749","E3",2023-08-12,"Barrow","Sutton",2,1,"H",0,1,"A",2.45,3.13,3.28,"0-1","2-1",17,7,9,3,0,1,0,1,9,1,8,7,3,10,15,"9-1","Y","Y","N",1,1,2
"750","E3",2023-08-12,"Bradford","Colchester",2,1,"H",1,1,"D",1.92,3.57,4.15,"1-1","2-1",19,7,11,2,2,2,0,0,4,11,3,9,3,15,12,"4-11","Y","Y","N",4,0,2
"751","E3",2023-08-12,"Gillingham","Accrington",1,0,"H",1,0,"H",2.08,3.31,3.99,"1-0","1-0",17,4,9,1,3,2,0,0,9,1,14,13,1,10,27,"9-1","N","N","N",5,0,2
"752","E3",2023-08-12,"Harrogate","Forest Green",0,1,"A",0,0,"D",2.4,3.46,3.06,"0-0","0-1",10,3,15,2,1,3,0,0,8,5,7,11,1,13,18,"8-5","N","N","N",4,0,2
"753","E3",2023-08-12,"Mansfield","Morecambe",3,0,"H",1,0,"H",1.56,4.48,5.82,"1-0","3-0",27,6,5,0,2,2,0,0,5,4,9,11,3,9,20,"5-4","Y","Y","N",4,0,2
"754","E3",2023-08-12,"Milton Keynes Dons","Tranmere",1,0,"H",1,0,"H",1.79,3.69,4.83,"1-0","1-0",7,2,16,3,2,1,0,0,3,11,8,12,1,14,20,"3-11","N","N","N",3,0,2
"755","E3",2023-08-12,"Newport County","Doncaster",4,0,"H",3,0,"H",2.25,3.47,3.33,"3-0","4-0",14,6,8,2,4,6,0,0,2,5,10,18,4,7,28,"2-5","Y","Y","Y",10,0,2
"756","E3",2023-08-12,"Notts County","Grimsby",3,2,"H",1,2,"A",1.78,4.16,4.32,"1-2","3-2",12,8,10,3,4,4,0,0,7,6,6,16,5,13,22,"7-6","Y","Y","Y",8,0,2
"757","E3",2023-08-12,"Salford","Crawley Town",1,1,"D",0,1,"A",1.48,4.67,6.68,"0-1","1-1",7,3,16,2,1,4,0,0,2,3,13,10,2,5,23,"2-3","Y","N","N",5,0,2
"758","E3",2023-08-12,"Swindon","Crewe",2,2,"D",1,0,"H",1.86,3.6,4.54,"1-0","2-2",20,6,16,5,4,6,0,0,7,2,13,13,4,9,26,"7-2","Y","Y","Y",10,0,2
"759","E3",2023-08-12,"Walsall","Stockport",2,1,"H",1,0,"H",4.13,3.32,2.04,"1-0","2-1",9,2,18,3,3,5,0,0,4,11,8,9,3,15,17,"4-11","Y","Y","N",8,0,2
"760","E3",2023-08-15,"Accrington","Barrow",1,1,"D",1,0,"H",2.61,3.19,2.97,"1-0","1-1",7,2,13,1,2,1,0,0,1,10,10,5,2,11,15,"1-10","Y","N","N",3,0,2
"761","E3",2023-08-15,"Colchester","AFC Wimbledon",0,2,"A",0,0,"D",2.37,3.21,3.34,"0-0","0-2",9,4,21,7,3,3,0,0,7,9,8,12,2,16,20,"7-9","Y","N","N",6,0,3
"762","E3",2023-08-15,"Crawley Town","Milton Keynes Dons",2,1,"H",1,1,"D",3.06,3.44,2.41,"1-1","2-1",14,5,8,2,1,2,0,0,7,5,8,11,3,12,19,"7-5","Y","Y","N",3,0,3
"763","E3",2023-08-15,"Crewe","Newport County",4,2,"H",1,1,"D",3.21,3.42,2.33,"1-1","4-2",10,6,14,7,0,2,0,0,1,5,4,12,6,6,16,"1-5","Y","Y","Y",2,0,3
"764","E3",2023-08-15,"Doncaster","Mansfield",2,2,"D",1,1,"D",4.3,3.71,1.88,"1-1","2-2",11,5,21,8,1,3,0,0,3,7,8,10,4,10,18,"3-7","Y","Y","Y",4,0,3
"765","E3",2023-08-15,"Forest Green","Swindon",1,2,"A",1,0,"H",2.75,3.4,2.66,"1-0","1-2",13,5,21,8,4,3,1,0,6,5,12,11,3,11,23,"6-5","Y","Y","N",7,1,3
"766","E3",2023-08-15,"Grimsby","Salford",2,0,"H",1,0,"H",2.7,3.3,2.78,"1-0","2-0",10,2,7,1,0,3,0,1,2,7,16,16,2,9,32,"2-7","Y","N","N",3,1,3
"767","E3",2023-08-15,"Morecambe","Notts County",0,0,"D",0,0,"D",4.3,4.03,1.8,"0-0","0-0",13,1,9,1,1,1,0,0,4,5,7,4,0,9,11,"4-5","N","N","N",2,0,3
"768","E3",2023-08-15,"Stockport","Bradford",1,1,"D",0,0,"D",1.85,3.46,4.84,"0-0","1-1",15,5,10,6,2,3,0,0,7,4,8,16,2,11,24,"7-4","Y","N","N",5,0,3
"769","E3",2023-08-15,"Sutton","Gillingham",0,1,"A",0,1,"A",2.68,3.18,2.91,"0-1","0-1",6,2,5,1,2,1,0,0,2,9,6,10,1,11,16,"2-9","N","N","N",3,0,3
"770","E3",2023-08-15,"Tranmere","Harrogate",3,0,"H",2,0,"H",2.14,3.4,3.67,"2-0","3-0",11,5,11,2,2,1,0,0,6,3,10,17,3,9,27,"6-3","Y","Y","N",3,0,3
"771","E3",2023-08-15,"Wrexham","Walsall",4,2,"H",2,1,"H",1.62,4.28,5.36,"2-1","4-2",20,11,12,5,1,3,0,0,6,3,3,9,6,9,12,"6-3","Y","Y","Y",4,0,3
"772","E3",2023-08-19,"Accrington","Harrogate",2,1,"H",1,0,"H",2.13,3.46,3.53,"1-0","2-1",23,7,11,2,4,4,1,0,5,3,14,15,3,8,29,"5-3","Y","Y","N",8,1,3
"773","E3",2023-08-19,"Colchester","Milton Keynes Dons",2,3,"A",2,1,"H",2.86,3.28,2.64,"2-1","2-3",12,4,18,6,5,4,0,0,3,6,16,8,5,9,24,"3-6","Y","Y","Y",9,0,4
"774","E3",2023-08-19,"Crawley Town","Gillingham",0,1,"A",0,1,"A",3.13,3.1,2.52,"0-1","0-1",17,7,7,2,3,3,0,0,9,4,8,10,1,13,18,"9-4","N","N","N",6,0,4
"775","E3",2023-08-19,"Crewe","Walsall",2,2,"D",0,2,"A",2.71,3.41,2.7,"0-2","2-2",11,3,19,7,1,1,0,0,8,5,6,10,4,13,16,"8-5","Y","Y","Y",2,0,4
"776","E3",2023-08-19,"Doncaster","Notts County",1,3,"A",0,1,"A",4.23,3.75,1.88,"0-1","1-3",10,6,8,5,0,3,0,0,4,3,10,8,4,7,18,"4-3","Y","Y","Y",3,0,4
"777","E3",2023-08-19,"Forest Green","Newport County",0,3,"A",0,2,"A",2.55,3.47,2.83,"0-2","0-3",12,1,10,7,2,0,1,0,7,4,6,7,3,11,13,"7-4","Y","Y","N",2,1,4
"778","E3",2023-08-19,"Grimsby","Mansfield",1,1,"D",1,0,"H",3.23,3.46,2.3,"1-0","1-1",8,3,20,4,0,0,0,0,4,6,7,11,2,10,18,"4-6","Y","N","N",0,0,4
"779","E3",2023-08-19,"Morecambe","Bradford",3,0,"H",1,0,"H",3.53,3.45,2.17,"1-0","3-0",11,3,12,5,3,3,0,0,6,3,15,11,3,9,26,"6-3","Y","Y","N",6,0,4
"780","E3",2023-08-19,"Stockport","Barrow",1,0,"H",0,0,"D",1.72,3.87,5.08,"0-0","1-0",11,5,10,3,2,1,0,0,4,3,10,5,1,7,15,"4-3","N","N","N",3,0,4
"781","E3",2023-08-19,"Sutton","AFC Wimbledon",0,3,"A",0,0,"D",2.46,3.27,3.13,"0-0","0-3",10,4,15,5,2,1,0,0,4,5,7,18,3,9,25,"4-5","Y","Y","N",3,0,4
"782","E3",2023-08-19,"Tranmere","Salford",3,4,"A",2,1,"H",2.86,3.36,2.59,"2-1","3-4",13,6,15,6,1,2,0,0,4,5,14,10,7,9,24,"4-5","Y","Y","Y",3,0,4
"783","E3",2023-08-19,"Wrexham","Swindon",5,5,"D",1,4,"A",1.62,4.31,5.37,"1-4","5-5",28,12,8,6,1,3,0,0,9,2,12,17,10,11,29,"9-2","Y","Y","Y",4,0,4
"784","E3",2023-08-26,"AFC Wimbledon","Forest Green",1,1,"D",1,0,"H",1.82,3.7,4.64,"1-0","1-1",22,6,8,3,2,1,0,0,9,2,12,4,2,11,16,"9-2","Y","N","N",3,0,4
"785","E3",2023-08-26,"Barrow","Wrexham",1,1,"D",0,1,"A",3.37,3.54,2.2,"0-1","1-1",5,2,12,4,3,2,0,0,3,10,9,9,2,13,18,"3-10","Y","N","N",5,0,5
"786","E3",2023-08-26,"Bradford","Crewe",1,0,"H",1,0,"H",1.65,4.24,5.13,"1-0","1-0",12,2,10,3,2,0,0,0,4,11,10,8,1,15,18,"4-11","N","N","N",2,0,5
"787","E3",2023-08-26,"Gillingham","Colchester",0,3,"A",0,0,"D",1.83,3.44,5.02,"0-0","0-3",10,4,12,5,2,4,1,0,3,4,14,18,3,7,32,"3-4","Y","Y","N",6,1,5
"788","E3",2023-08-26,"Harrogate","Morecambe",2,0,"H",1,0,"H",2.39,3.51,3.03,"1-0","2-0",16,6,9,1,3,3,0,1,1,4,13,11,2,5,24,"1-4","Y","N","N",6,1,5
"789","E3",2023-08-26,"Mansfield","Stockport",3,2,"H",1,2,"A",2.36,3.36,3.22,"1-2","3-2",28,11,10,3,1,0,0,0,11,1,5,7,5,12,12,"11-1","Y","Y","Y",1,0,5
"790","E3",2023-08-26,"Milton Keynes Dons","Doncaster",2,1,"H",2,0,"H",1.7,3.96,5.11,"2-0","2-1",9,5,17,6,1,1,0,0,2,8,8,17,3,10,25,"2-8","Y","Y","N",2,0,5
"791","E3",2023-08-26,"Newport County","Sutton",3,1,"H",0,0,"D",1.99,3.54,3.99,"0-0","3-1",13,5,15,5,1,3,0,0,1,6,8,10,4,7,18,"1-6","Y","Y","Y",4,0,5
"792","E3",2023-08-26,"Notts County","Tranmere",2,1,"H",1,0,"H",1.6,4.43,5.35,"1-0","2-1",17,6,12,4,3,3,0,0,11,3,6,8,3,14,14,"11-3","Y","Y","N",6,0,5
"793","E3",2023-08-26,"Salford","Accrington",1,2,"A",0,2,"A",1.77,3.84,4.59,"0-2","1-2",16,2,16,6,3,3,0,0,1,6,20,10,3,7,30,"1-6","Y","Y","N",6,0,5
"794","E3",2023-08-26,"Swindon","Crawley Town",6,0,"H",1,0,"H",2.08,3.78,3.46,"1-0","6-0",17,10,14,3,0,1,0,0,5,6,10,10,6,11,20,"5-6","Y","Y","Y",1,0,5
"795","E3",2023-08-26,"Walsall","Grimsby",1,1,"D",0,0,"D",2.46,3.35,3.05,"0-0","1-1",16,6,11,2,2,3,1,0,8,10,13,11,2,18,24,"8-10","Y","N","N",5,1,5
"796","E3",2023-09-02,"Tranmere","Wrexham",0,1,"A",0,0,"D",3.58,3.91,2,"0-0","0-1",11,2,23,5,1,1,0,0,7,17,7,11,1,24,18,"7-17","N","N","N",2,0,5
"797","E3",2023-09-02,"Crewe","Milton Keynes Dons",3,1,"H",0,1,"A",3.03,3.57,2.36,"0-1","3-1",15,7,12,4,4,1,0,0,8,2,12,8,4,10,20,"8-2","Y","Y","Y",5,0,6
"798","E3",2023-09-02,"Doncaster","Swindon",0,0,"D",0,0,"D",2.88,3.46,2.52,"0-0","0-0",6,3,13,2,4,4,1,0,1,11,9,15,0,12,24,"1-11","N","N","N",8,1,6
"799","E3",2023-09-02,"Grimsby","Gillingham",2,0,"H",2,0,"H",2.52,3.3,3.01,"2-0","2-0",12,4,6,3,1,0,0,0,6,4,6,12,2,10,18,"6-4","Y","N","N",1,0,6
"800","E3",2023-09-02,"Harrogate","Barrow",0,1,"A",0,1,"A",2.6,3.3,2.9,"0-1","0-1",12,5,10,2,2,2,0,0,8,6,11,10,1,14,21,"8-6","N","N","N",4,0,6
"801","E3",2023-09-02,"Mansfield","Bradford",0,0,"D",0,0,"D",1.82,3.78,4.51,"0-0","0-0",11,1,9,2,2,4,0,0,8,2,10,12,0,10,22,"8-2","N","N","N",6,0,6
"802","E3",2023-09-02,"Morecambe","Salford",1,0,"H",1,0,"H",2.94,3.54,2.44,"1-0","1-0",11,5,7,2,0,0,0,1,9,3,14,11,1,12,25,"9-3","N","N","N",0,1,6
"803","E3",2023-09-02,"Newport County","AFC Wimbledon",2,2,"D",1,2,"A",2.61,3.34,2.86,"1-2","2-2",11,4,14,4,1,1,0,0,6,3,6,8,4,9,14,"6-3","Y","Y","Y",2,0,6
"804","E3",2023-09-02,"Notts County","Accrington",3,1,"H",1,1,"D",1.59,4.51,5.32,"1-1","3-1",10,5,16,6,4,2,0,0,2,7,11,11,4,9,22,"2-7","Y","Y","Y",6,0,6
"805","E3",2023-09-02,"Stockport","Crawley Town",3,3,"D",2,1,"H",1.56,4.35,6.01,"2-1","3-3",17,5,8,5,1,5,0,0,2,3,7,12,6,5,19,"2-3","Y","Y","Y",6,0,6
"806","E3",2023-09-02,"Sutton","Forest Green",0,1,"A",0,0,"D",2.09,3.45,3.76,"0-0","0-1",12,2,17,6,1,2,0,0,7,3,13,14,1,10,27,"7-3","N","N","N",3,0,6
"807","E3",2023-09-02,"Walsall","Colchester",1,0,"H",0,0,"D",2.14,3.46,3.6,"0-0","1-0",16,7,10,3,4,1,0,0,6,4,17,9,1,10,26,"6-4","N","N","N",5,0,6
"808","E3",2023-09-09,"Bradford","Grimsby",1,1,"D",0,1,"A",2.06,3.45,3.87,"0-1","1-1",9,1,7,3,2,4,0,0,7,2,10,10,2,9,20,"7-2","Y","N","N",6,0,6
"809","E3",2023-09-09,"Accrington","Mansfield",0,3,"A",0,2,"A",3.56,3.57,2.11,"0-2","0-3",13,2,12,5,1,1,0,0,5,4,13,17,3,9,30,"5-4","Y","Y","N",2,0,7
"810","E3",2023-09-09,"AFC Wimbledon","Stockport",1,2,"A",1,0,"H",2.81,3.34,2.65,"1-0","1-2",9,4,12,3,2,2,0,0,3,5,13,7,3,8,20,"3-5","Y","Y","N",4,0,7
"811","E3",2023-09-09,"Colchester","Tranmere",2,0,"H",1,0,"H",2.32,3.5,3.16,"1-0","2-0",27,12,10,4,2,4,0,0,11,5,10,8,2,16,18,"11-5","Y","N","N",6,0,7
"812","E3",2023-09-09,"Crawley Town","Newport County",4,1,"H",1,1,"D",3.07,3.49,2.38,"1-1","4-1",13,8,9,5,2,1,0,0,4,0,8,9,5,4,17,"4-0","Y","Y","Y",3,0,7
"813","E3",2023-09-09,"Forest Green","Crewe",1,4,"A",1,0,"H",2.18,3.52,3.44,"1-0","1-4",9,4,18,5,4,3,0,0,3,7,12,10,5,10,22,"3-7","Y","Y","Y",7,0,7
"814","E3",2023-09-09,"Gillingham","Harrogate",1,0,"H",0,0,"D",1.85,3.57,4.69,"0-0","1-0",15,4,5,2,3,1,0,0,10,2,12,7,1,12,19,"10-2","N","N","N",4,0,7
"815","E3",2023-09-09,"Milton Keynes Dons","Notts County",1,1,"D",0,0,"D",2.89,3.86,2.33,"0-0","1-1",11,3,9,3,1,0,0,0,3,6,12,5,2,9,17,"3-6","Y","N","N",1,0,7
"816","E3",2023-09-09,"Salford","Walsall",1,2,"A",1,0,"H",2.1,3.68,3.49,"1-0","1-2",20,7,10,5,2,1,0,0,12,1,12,12,3,13,24,"12-1","Y","Y","N",3,0,7
"817","E3",2023-09-09,"Swindon","Sutton",5,3,"H",3,2,"H",1.83,3.85,4.34,"3-2","5-3",15,7,13,5,1,2,0,0,5,3,4,6,8,8,10,"5-3","Y","Y","Y",3,0,7
"818","E3",2023-09-09,"Wrexham","Doncaster",2,1,"H",1,0,"H",1.43,5.03,7.21,"1-0","2-1",16,8,8,2,2,3,0,0,6,4,9,13,3,10,22,"6-4","Y","Y","N",5,0,7
"819","E3",2023-09-15,"Salford","Notts County",0,2,"A",0,1,"A",3.05,3.9,2.23,"0-1","0-2",12,2,14,4,3,2,1,1,1,8,11,11,2,9,22,"1-8","Y","N","N",5,2,7
"820","E3",2023-09-16,"Accrington","Sutton",4,1,"H",1,0,"H",2.09,3.63,3.57,"1-0","4-1",15,5,12,1,3,1,0,0,2,3,10,12,5,5,22,"2-3","Y","Y","Y",4,0,7
"821","E3",2023-09-16,"AFC Wimbledon","Crewe",2,2,"D",2,0,"H",1.8,3.96,4.41,"2-0","2-2",21,6,9,4,2,2,0,0,13,7,11,9,4,20,20,"13-7","Y","Y","Y",4,0,8
"822","E3",2023-09-16,"Bradford","Harrogate",1,1,"D",0,0,"D",1.76,3.74,4.95,"0-0","1-1",9,3,8,1,0,2,0,0,3,5,8,10,2,8,18,"3-5","Y","N","N",2,0,8
"823","E3",2023-09-16,"Colchester","Mansfield",1,1,"D",1,0,"H",3.64,3.83,2,"1-0","1-1",12,4,10,5,4,3,0,0,3,4,9,4,2,7,13,"3-4","Y","N","N",7,0,8
"824","E3",2023-09-16,"Crawley Town","Tranmere",3,2,"H",0,1,"A",2.22,3.59,3.28,"0-1","3-2",16,7,7,4,4,5,0,0,9,0,7,9,5,9,16,"9-0","Y","Y","Y",9,0,8
"825","E3",2023-09-16,"Forest Green","Doncaster",1,2,"A",0,1,"A",2.21,3.59,3.3,"0-1","1-2",28,3,15,7,4,2,0,0,10,12,8,10,3,22,18,"10-12","Y","Y","N",6,0,8
"826","E3",2023-09-16,"Gillingham","Morecambe",2,1,"H",2,1,"H",1.79,3.7,4.81,"2-1","2-1",11,5,5,3,2,3,0,1,4,3,8,16,3,7,24,"4-3","Y","Y","N",5,1,8
"827","E3",2023-09-16,"Milton Keynes Dons","Stockport",1,2,"A",1,2,"A",3.03,3.61,2.35,"1-2","1-2",20,3,10,5,4,2,0,0,9,4,11,10,3,13,21,"9-4","Y","Y","N",6,0,8
"828","E3",2023-09-16,"Newport County","Barrow",1,1,"D",1,0,"H",2.09,3.44,3.77,"1-0","1-1",8,2,6,3,2,2,1,0,3,10,13,17,2,13,30,"3-10","Y","N","N",4,1,8
"829","E3",2023-09-16,"Swindon","Walsall",2,0,"H",1,0,"H",1.97,3.81,3.76,"1-0","2-0",12,6,7,2,2,2,0,1,4,2,5,10,2,6,15,"4-2","Y","N","N",4,1,8
"830","E3",2023-09-16,"Wrexham","Grimsby",3,0,"H",2,0,"H",1.66,4.19,5.1,"2-0","3-0",17,9,9,1,2,2,0,0,3,1,7,6,3,4,13,"3-1","Y","Y","N",4,0,8
"831","E3",2023-09-23,"Crewe","Colchester",2,1,"H",2,0,"H",2.48,3.65,2.8,"2-0","2-1",10,3,21,6,1,0,0,0,6,10,15,11,3,16,26,"6-10","Y","Y","N",1,0,8
"832","E3",2023-09-23,"Doncaster","Gillingham",2,1,"H",1,1,"D",3.26,3.17,2.43,"1-1","2-1",13,6,15,5,2,2,0,0,7,6,9,10,3,13,19,"7-6","Y","Y","N",4,0,8
"833","E3",2023-09-23,"Grimsby","Crawley Town",2,3,"A",2,2,"D",2.07,3.62,3.64,"2-2","2-3",18,7,13,3,1,1,0,0,5,5,14,8,5,10,22,"5-5","Y","Y","Y",2,0,9
"834","E3",2023-09-23,"Harrogate","Salford",3,2,"H",2,1,"H",2.95,3.45,2.47,"2-1","3-2",16,7,18,5,2,2,0,0,7,5,6,10,5,12,16,"7-5","Y","Y","Y",4,0,9
"835","E3",2023-09-23,"Mansfield","Barrow",1,0,"H",0,0,"D",1.66,3.95,5.56,"0-0","1-0",14,2,9,2,2,1,0,1,6,2,9,11,1,8,20,"6-2","N","N","N",3,1,9
"836","E3",2023-09-23,"Morecambe","Swindon",2,2,"D",1,1,"D",3.39,3.77,2.11,"1-1","2-2",16,4,13,5,1,2,1,0,9,4,11,6,4,13,17,"9-4","Y","Y","Y",3,1,9
"837","E3",2023-09-23,"Newport County","Bradford",1,4,"A",1,3,"A",2.4,3.32,3.16,"1-3","1-4",7,1,17,7,2,1,0,0,6,7,9,8,5,13,17,"6-7","Y","Y","Y",3,0,9
"838","E3",2023-09-23,"Notts County","Forest Green",4,3,"H",2,0,"H",1.51,4.79,5.96,"2-0","4-3",11,6,14,4,3,5,0,0,7,10,10,11,7,17,21,"7-10","Y","Y","Y",8,0,9
"839","E3",2023-09-23,"Stockport","Wrexham",5,0,"H",3,0,"H",2.52,3.73,2.72,"3-0","5-0",10,5,20,5,1,1,0,0,1,5,10,13,5,6,23,"1-5","Y","Y","Y",2,0,9
"840","E3",2023-09-23,"Sutton","Milton Keynes Dons",1,1,"D",1,0,"H",2.66,3.42,2.74,"1-0","1-1",10,5,12,2,0,1,0,0,7,10,10,13,2,17,23,"7-10","Y","N","N",1,0,9
"841","E3",2023-09-23,"Tranmere","Accrington",2,0,"H",1,0,"H",2.74,3.49,2.62,"1-0","2-0",17,7,9,3,0,3,0,1,8,6,11,16,2,14,27,"8-6","Y","N","N",3,1,9
"842","E3",2023-09-23,"Walsall","AFC Wimbledon",1,3,"A",0,1,"A",2.64,3.43,2.76,"0-1","1-3",5,1,15,6,0,2,1,0,0,5,9,13,4,5,22,"0-5","Y","Y","Y",2,1,9
"843","E3",2023-09-30,"Accrington","Stockport",1,3,"A",0,2,"A",3.68,3.77,2.01,"0-2","1-3",14,4,6,4,1,1,0,0,9,4,16,10,4,13,26,"9-4","Y","Y","Y",2,0,9
"844","E3",2023-09-30,"AFC Wimbledon","Tranmere",4,1,"H",2,1,"H",1.72,3.93,4.97,"2-1","4-1",19,8,8,2,1,2,0,1,4,4,9,10,5,8,19,"4-4","Y","Y","Y",3,1,9
"845","E3",2023-09-30,"Barrow","Doncaster",3,2,"H",1,0,"H",1.94,3.64,4.07,"1-0","3-2",7,4,12,4,4,3,0,0,1,8,12,16,5,9,28,"1-8","Y","Y","Y",7,0,10
"846","E3",2023-09-30,"Bradford","Walsall",1,3,"A",1,2,"A",1.82,3.65,4.53,"1-2","1-3",10,2,7,4,1,4,0,0,10,5,8,9,4,15,17,"10-5","Y","Y","Y",5,0,10
"847","E3",2023-09-30,"Colchester","Notts County",5,4,"H",3,1,"H",3.6,3.87,2.01,"3-1","5-4",15,8,21,7,3,3,1,0,3,8,8,9,9,11,17,"3-8","Y","Y","Y",6,1,10
"848","E3",2023-09-30,"Crawley Town","Sutton",3,0,"H",1,0,"H",2.02,3.72,3.68,"1-0","3-0",18,7,7,2,1,3,0,0,5,4,8,12,3,9,20,"5-4","Y","Y","N",4,0,10
"849","E3",2023-09-30,"Forest Green","Morecambe",1,2,"A",0,1,"A",1.98,3.69,3.88,"0-1","1-2",13,2,14,11,3,2,0,0,7,7,8,6,3,14,14,"7-7","Y","Y","N",5,0,10
"850","E3",2023-09-30,"Gillingham","Mansfield",1,1,"D",1,1,"D",3.15,3.28,2.43,"1-1","1-1",20,4,17,3,4,2,0,0,5,11,11,13,2,16,24,"5-11","Y","N","N",6,0,10
"851","E3",2023-09-30,"Milton Keynes Dons","Harrogate",0,1,"A",0,1,"A",1.85,3.81,4.3,"0-1","0-1",27,4,3,3,3,1,0,0,11,3,12,5,1,14,17,"11-3","N","N","N",4,0,10
"852","E3",2023-09-30,"Salford","Newport County",2,1,"H",2,1,"H",2.28,3.66,3.11,"2-1","2-1",10,2,15,4,1,3,0,0,2,6,11,12,3,8,23,"2-6","Y","Y","N",4,0,10
"853","E3",2023-09-30,"Swindon","Grimsby",2,1,"H",1,0,"H",1.86,3.91,4.12,"1-0","2-1",8,3,13,4,2,2,0,0,9,7,5,10,3,16,15,"9-7","Y","Y","N",4,0,10
"854","E3",2023-09-30,"Wrexham","Crewe",3,3,"D",1,2,"A",1.42,5.24,7.06,"1-2","3-3",12,6,11,7,4,4,1,0,7,6,12,12,6,13,24,"7-6","Y","Y","Y",8,1,10
"855","E3",2023-10-03,"Crewe","Gillingham",2,0,"H",1,0,"H",2.78,3.44,2.61,"1-0","2-0",9,4,13,5,1,0,0,0,6,4,7,9,2,10,16,"6-4","Y","N","N",1,0,10
"856","E3",2023-10-03,"Doncaster","Crawley Town",2,0,"H",1,0,"H",2.68,3.67,2.58,"1-0","2-0",17,8,15,4,3,3,0,0,5,5,15,12,2,10,27,"5-5","Y","N","N",6,0,10
"857","E3",2023-10-03,"Grimsby","Barrow",2,1,"H",1,0,"H",2.17,3.33,3.68,"1-0","2-1",9,6,24,7,1,1,0,0,4,7,13,11,3,11,24,"4-7","Y","Y","N",2,0,11
"858","E3",2023-10-03,"Harrogate","AFC Wimbledon",0,1,"A",0,1,"A",3.6,3.39,2.17,"0-1","0-1",4,2,16,4,2,2,0,0,2,4,10,15,1,6,25,"2-4","N","N","N",4,0,11
"859","E3",2023-10-03,"Mansfield","Wrexham",0,0,"D",0,0,"D",2.28,3.74,3.06,"0-0","0-0",19,5,7,1,2,1,0,0,10,6,10,5,0,16,15,"10-6","N","N","N",3,0,11
"860","E3",2023-10-03,"Morecambe","Accrington",1,1,"D",0,0,"D",2.58,3.47,2.8,"0-0","1-1",15,6,15,3,3,3,0,0,4,9,17,9,2,13,26,"4-9","Y","N","N",6,0,11
"861","E3",2023-10-03,"Newport County","Colchester",2,1,"H",1,1,"D",2.3,3.61,3.12,"1-1","2-1",18,7,14,4,2,2,0,1,8,5,12,11,3,13,23,"8-5","Y","Y","N",4,1,11
"862","E3",2023-10-03,"Notts County","Swindon",3,1,"H",3,0,"H",1.86,4.36,3.71,"3-0","3-1",10,6,19,4,3,2,0,0,3,5,13,14,4,8,27,"3-5","Y","Y","Y",5,0,11
"863","E3",2023-10-03,"Stockport","Forest Green",2,0,"H",2,0,"H",1.43,4.75,7.79,"2-0","2-0",15,6,6,1,1,0,0,1,4,3,8,15,2,7,23,"4-3","Y","N","N",1,1,11
"864","E3",2023-10-03,"Sutton","Salford",0,2,"A",0,0,"D",2.56,3.59,2.75,"0-0","0-2",8,2,11,5,1,3,0,0,4,3,15,10,2,7,25,"4-3","Y","N","N",4,0,11
"865","E3",2023-10-03,"Tranmere","Bradford",2,1,"H",1,0,"H",3.36,3.34,2.29,"1-0","2-1",9,5,10,5,3,3,0,0,5,6,6,15,3,11,21,"5-6","Y","Y","N",6,0,11
"866","E3",2023-10-03,"Walsall","Milton Keynes Dons",0,0,"D",0,0,"D",2.74,3.4,2.67,"0-0","0-0",12,4,18,5,3,3,0,0,5,3,17,8,0,8,25,"5-3","N","N","N",6,0,11
"867","E3",2023-10-07,"Accrington","Forest Green",2,1,"H",1,0,"H",2.11,3.81,3.37,"1-0","2-1",16,4,15,5,1,1,0,0,4,5,13,12,3,9,25,"4-5","Y","Y","N",2,0,11
"868","E3",2023-10-07,"Barrow","Notts County",1,1,"D",0,1,"A",3.64,3.73,2.04,"0-1","1-1",14,6,5,1,1,3,0,0,2,5,7,11,2,7,18,"2-5","Y","N","N",4,0,11
"869","E3",2023-10-07,"Bradford","Swindon",1,0,"H",0,0,"D",2.42,3.73,2.84,"0-0","1-0",19,4,11,2,3,3,0,0,6,3,11,7,1,9,18,"6-3","N","N","N",6,0,12
"870","E3",2023-10-07,"Colchester","Morecambe",1,3,"A",0,1,"A",1.92,3.8,3.99,"0-1","1-3",21,5,15,7,2,4,0,1,5,4,7,12,4,9,19,"5-4","Y","Y","Y",6,1,12
"871","E3",2023-10-07,"Crawley Town","Wrexham",0,1,"A",0,1,"A",3.75,4.06,1.92,"0-1","0-1",25,5,10,5,2,6,0,1,6,8,8,9,1,14,17,"6-8","N","N","N",8,1,12
"872","E3",2023-10-07,"Gillingham","Milton Keynes Dons",2,1,"H",1,0,"H",2.4,3.38,3.12,"1-0","2-1",16,6,27,8,2,3,0,1,6,4,11,10,3,10,21,"6-4","Y","Y","N",5,1,12
"873","E3",2023-10-07,"Mansfield","AFC Wimbledon",0,0,"D",0,0,"D",1.98,3.63,3.92,"0-0","0-0",20,4,8,4,2,2,0,0,6,3,13,13,0,9,26,"6-3","N","N","N",4,0,12
"874","E3",2023-10-07,"Newport County","Harrogate",1,2,"A",0,1,"A",1.96,3.62,4.03,"0-1","1-2",11,4,7,3,2,2,0,0,5,4,16,6,3,9,22,"5-4","Y","Y","N",4,0,12
"875","E3",2023-10-07,"Salford","Crewe",4,2,"H",1,1,"D",2.12,3.75,3.3,"1-1","4-2",14,7,14,3,2,2,0,0,5,1,13,14,6,6,27,"5-1","Y","Y","Y",4,0,12
"876","E3",2023-10-07,"Stockport","Doncaster",1,0,"H",0,0,"D",1.49,4.65,6.59,"0-0","1-0",10,4,6,4,2,1,0,0,6,6,6,11,1,12,17,"6-6","N","N","N",3,0,12
"877","E3",2023-10-07,"Sutton","Walsall",4,0,"H",4,0,"H",2.56,3.42,2.8,"4-0","4-0",12,6,13,5,0,0,0,0,4,5,15,8,4,9,23,"4-5","Y","Y","Y",0,0,12
"878","E3",2023-10-07,"Tranmere","Grimsby",2,2,"D",1,2,"A",2.73,3.42,2.67,"1-2","2-2",8,3,13,5,1,1,0,0,1,5,10,9,4,6,19,"1-5","Y","Y","Y",2,0,12
"879","E3",2023-10-14,"Notts County","Mansfield",1,4,"A",1,1,"D",2.24,3.98,2.98,"1-1","1-4",9,2,21,9,1,1,0,0,5,6,4,10,5,11,14,"5-6","Y","Y","Y",2,0,12
"880","E3",2023-10-14,"AFC Wimbledon","Bradford",0,1,"A",0,0,"D",2.07,3.44,3.85,"0-0","0-1",11,5,7,2,3,2,0,0,10,4,13,13,1,14,26,"10-4","N","N","N",5,0,12
"881","E3",2023-10-14,"Crewe","Tranmere",2,0,"H",1,0,"H",1.97,3.8,3.79,"1-0","2-0",16,4,13,3,3,1,0,2,10,4,7,10,2,14,17,"10-4","Y","N","N",4,2,13
"882","E3",2023-10-14,"Doncaster","Sutton",4,1,"H",1,0,"H",2.1,3.59,3.58,"1-0","4-1",12,5,6,3,2,3,0,0,2,1,15,10,5,3,25,"2-1","Y","Y","Y",5,0,13
"883","E3",2023-10-14,"Forest Green","Colchester",5,0,"H",1,0,"H",2.51,3.59,2.8,"1-0","5-0",14,10,6,1,1,1,0,1,5,3,11,12,5,8,23,"5-3","Y","Y","Y",2,1,13
"884","E3",2023-10-14,"Grimsby","Accrington",0,2,"A",0,0,"D",2.19,3.54,3.4,"0-0","0-2",11,2,12,2,0,2,1,0,9,4,17,14,2,13,31,"9-4","Y","N","N",2,1,13
"885","E3",2023-10-14,"Harrogate","Stockport",1,3,"A",0,1,"A",4.73,3.88,1.76,"0-1","1-3",6,4,16,7,0,1,0,0,5,8,7,12,4,13,19,"5-8","Y","Y","Y",1,0,13
"886","E3",2023-10-14,"Milton Keynes Dons","Barrow",2,2,"D",2,0,"H",2.13,3.49,3.62,"2-0","2-2",15,5,18,9,2,1,0,0,1,8,14,11,4,9,25,"1-8","Y","Y","Y",3,0,13
"887","E3",2023-10-14,"Swindon","Newport County",2,0,"H",1,0,"H",1.74,4.11,4.57,"1-0","2-0",13,6,11,4,1,0,0,0,7,5,12,14,2,12,26,"7-5","Y","N","N",1,0,13
"888","E3",2023-10-14,"Walsall","Gillingham",4,1,"H",2,0,"H",2.85,3.29,2.65,"2-0","4-1",13,7,14,5,3,3,0,0,0,4,14,6,5,4,20,"0-4","Y","Y","Y",6,0,13
"889","E3",2023-10-14,"Wrexham","Salford",3,2,"H",1,2,"A",1.53,4.64,5.9,"1-2","3-2",21,7,10,4,3,4,0,0,11,3,13,8,5,14,21,"11-3","Y","Y","Y",7,0,13
"890","E3",2023-10-20,"Newport County","Walsall",3,3,"D",2,1,"H",2.4,3.48,3.04,"2-1","3-3",8,5,16,6,0,2,0,0,7,6,10,9,6,13,19,"7-6","Y","Y","Y",2,0,13
"891","E3",2023-10-20,"Tranmere","Doncaster",1,2,"A",0,1,"A",2.8,3.47,2.58,"0-1","1-2",12,3,11,5,3,2,0,0,5,3,9,6,3,8,15,"5-3","Y","Y","N",5,0,13
"892","E3",2023-10-21,"Accrington","Milton Keynes Dons",1,0,"H",1,0,"H",2.7,3.57,2.62,"1-0","1-0",13,4,10,1,2,1,0,0,6,4,24,7,1,10,31,"6-4","N","N","N",3,0,13
"893","E3",2023-10-21,"Barrow","AFC Wimbledon",0,0,"D",0,0,"D",2.93,3.34,2.54,"0-0","0-0",13,3,10,4,0,2,0,0,6,4,12,9,0,10,21,"6-4","N","N","N",2,0,14
"894","E3",2023-10-21,"Bradford","Wrexham",1,1,"D",0,0,"D",3.05,3.57,2.35,"0-0","1-1",21,5,8,1,3,2,0,0,11,3,10,8,2,14,18,"11-3","Y","N","N",5,0,14
"895","E3",2023-10-21,"Colchester","Harrogate",1,2,"A",0,0,"D",1.98,3.69,3.88,"0-0","1-2",20,5,8,2,1,0,0,0,10,3,6,3,3,13,9,"10-3","Y","Y","N",1,0,14
"896","E3",2023-10-21,"Crawley Town","Crewe",2,4,"A",2,1,"H",2.08,3.92,3.36,"2-1","2-4",14,5,12,8,4,2,0,0,6,7,9,10,6,13,19,"6-7","Y","Y","Y",6,0,14
"897","E3",2023-10-21,"Gillingham","Notts County",1,2,"A",0,1,"A",2.6,3.68,2.66,"0-1","1-2",11,2,10,7,2,3,0,0,3,5,8,5,3,8,13,"3-5","Y","Y","N",5,0,14
"898","E3",2023-10-21,"Salford","Swindon",2,2,"D",1,1,"D",2.71,3.8,2.49,"1-1","2-2",15,7,15,7,3,1,1,0,2,11,8,6,4,13,14,"2-11","Y","Y","Y",4,1,14
"899","E3",2023-10-21,"Stockport","Grimsby",3,2,"H",2,1,"H",1.54,4.45,6.15,"2-1","3-2",11,6,10,4,2,3,0,0,3,0,14,22,5,3,36,"3-0","Y","Y","Y",5,0,14
"900","E3",2023-10-21,"Sutton","Morecambe",2,3,"A",1,2,"A",2.44,3.58,2.91,"1-2","2-3",7,2,7,5,1,2,0,0,11,4,5,10,5,15,15,"11-4","Y","Y","Y",3,0,14
"901","E3",2023-10-24,"AFC Wimbledon","Accrington",2,4,"A",0,2,"A",1.7,4.03,4.97,"0-2","2-4",14,7,17,9,3,3,0,0,4,2,16,17,6,6,33,"4-2","Y","Y","Y",6,0,14
"902","E3",2023-10-24,"Crewe","Stockport",0,2,"A",0,0,"D",4.17,4.09,1.81,"0-0","0-2",5,0,7,3,2,1,0,0,6,4,9,12,2,10,21,"6-4","Y","N","N",3,0,14
"903","E3",2023-10-24,"Doncaster","Salford",0,3,"A",0,2,"A",2.2,3.6,3.33,"0-2","0-3",20,4,11,4,0,2,0,0,8,3,5,10,3,11,15,"8-3","Y","Y","N",2,0,14
"904","E3",2023-10-24,"Forest Green","Barrow",0,2,"A",0,2,"A",2.61,3.36,2.84,"0-2","0-2",17,7,12,4,2,1,0,0,5,4,12,9,2,9,21,"5-4","Y","N","N",3,0,14
"905","E3",2023-10-24,"Grimsby","Colchester",2,3,"A",1,2,"A",2.12,3.69,3.43,"1-2","2-3",18,6,9,4,1,3,0,0,3,3,11,7,5,6,18,"3-3","Y","Y","Y",4,0,15
"906","E3",2023-10-24,"Harrogate","Mansfield",1,4,"A",0,3,"A",5.6,4.11,1.63,"0-3","1-4",11,3,34,11,1,3,0,0,2,7,9,13,5,9,22,"2-7","Y","Y","Y",4,0,15
"907","E3",2023-10-24,"Milton Keynes Dons","Bradford",4,1,"H",2,1,"H",2.48,3.34,3.03,"2-1","4-1",18,11,7,2,0,4,0,0,4,1,11,11,5,5,22,"4-1","Y","Y","Y",4,0,15
"908","E3",2023-10-24,"Morecambe","Tranmere",1,0,"H",0,0,"D",2.06,3.61,3.68,"0-0","1-0",15,5,13,5,2,2,0,0,10,5,9,9,1,15,18,"10-5","N","N","N",4,0,15
"909","E3",2023-10-24,"Notts County","Newport County",3,0,"H",2,0,"H",1.58,4.65,5.32,"2-0","3-0",18,4,10,3,0,1,0,0,5,2,6,5,3,7,11,"5-2","Y","Y","N",1,0,15
"910","E3",2023-10-24,"Swindon","Gillingham",0,1,"A",0,1,"A",1.85,3.83,4.25,"0-1","0-1",22,7,12,4,0,2,0,0,6,10,6,10,1,16,16,"6-10","N","N","N",2,0,15
"911","E3",2023-10-24,"Walsall","Crawley Town",1,1,"D",0,0,"D",2.18,3.66,3.31,"0-0","1-1",17,7,7,4,0,3,0,0,6,6,11,8,2,12,19,"6-6","Y","N","N",3,0,15
"912","E3",2023-10-24,"Wrexham","Sutton",2,1,"H",1,0,"H",1.39,5.46,7.26,"1-0","2-1",15,5,12,1,3,0,0,0,10,2,10,6,3,12,16,"10-2","Y","Y","N",3,0,15
"913","E3",2023-10-28,"Accrington","Colchester",0,1,"A",0,0,"D",2.07,3.79,3.47,"0-0","0-1",31,6,7,6,1,3,0,0,11,0,9,12,1,11,21,"11-0","N","N","N",4,0,15
"914","E3",2023-10-28,"Barrow","Salford",0,0,"D",0,0,"D",2.04,3.62,3.74,"0-0","0-0",13,2,9,0,2,0,0,0,6,4,11,5,0,10,16,"6-4","N","N","N",2,0,15
"915","E3",2023-10-28,"Doncaster","Grimsby",1,0,"H",0,0,"D",2.3,3.52,3.18,"0-0","1-0",9,2,6,1,3,2,0,0,8,4,7,11,1,12,18,"8-4","N","N","N",5,0,15
"916","E3",2023-10-28,"Forest Green","Crawley Town",2,1,"H",2,1,"H",2.15,3.83,3.26,"2-1","2-1",8,5,13,6,4,0,0,0,4,7,16,4,3,11,20,"4-7","Y","Y","N",4,0,15
"917","E3",2023-10-28,"Gillingham","Newport County",0,2,"A",0,2,"A",1.89,3.59,4.37,"0-2","0-2",15,3,12,5,1,3,0,0,4,4,7,14,2,8,21,"4-4","Y","N","N",4,0,16
"918","E3",2023-10-28,"Harrogate","Crewe",0,1,"A",0,1,"A",2.94,3.63,2.4,"0-1","0-1",12,3,15,4,3,0,0,0,6,6,13,11,1,12,24,"6-6","N","N","N",3,0,16
"919","E3",2023-10-28,"Mansfield","Walsall",2,1,"H",1,0,"H",1.51,4.56,6.44,"1-0","2-1",22,7,7,1,3,2,0,0,6,5,12,11,3,11,23,"6-5","Y","Y","N",5,0,16
"920","E3",2023-10-28,"Milton Keynes Dons","Swindon",3,2,"H",1,0,"H",2.52,3.69,2.74,"1-0","3-2",10,6,7,3,3,4,0,0,3,0,13,11,5,3,24,"3-0","Y","Y","Y",7,0,16
"921","E3",2023-10-28,"Morecambe","AFC Wimbledon",4,1,"H",0,0,"D",3.17,3.41,2.36,"0-0","4-1",11,6,22,5,2,1,0,0,2,8,7,13,5,10,20,"2-8","Y","Y","Y",3,0,16
"922","E3",2023-10-28,"Notts County","Wrexham",0,2,"A",0,0,"D",2.4,3.84,2.81,"0-0","0-2",16,6,15,8,2,3,0,0,10,7,6,15,2,17,21,"10-7","Y","N","N",5,0,16
"923","E3",2023-10-28,"Stockport","Tranmere",2,0,"H",1,0,"H",1.35,5.27,9.22,"1-0","2-0",26,7,9,4,0,1,0,1,13,3,5,7,2,16,12,"13-3","Y","N","N",1,1,16
"924","E3",2023-10-28,"Sutton","Bradford",2,1,"H",1,0,"H",3.18,3.35,2.38,"1-0","2-1",11,2,10,1,2,1,0,0,6,8,13,13,3,14,26,"6-8","Y","Y","N",3,0,16
"925","E3",2023-10-31,"Barrow","Morecambe",1,0,"H",1,0,"H",1.81,3.74,4.61,"1-0","1-0",7,3,3,0,1,1,0,0,4,2,7,15,1,6,22,"4-2","N","N","N",2,0,16
"926","E3",2023-11-07,"Colchester","Swindon",3,1,"H",0,1,"A",2.69,3.84,2.49,"0-1","3-1",12,2,13,3,1,2,0,0,4,4,3,16,4,8,19,"4-4","Y","Y","Y",3,0,16
"927","E3",2023-11-11,"AFC Wimbledon","Doncaster",2,0,"H",1,0,"H",1.85,3.83,4.28,"1-0","2-0",5,2,8,1,3,2,2,0,8,3,17,6,2,11,23,"8-3","Y","N","N",5,2,16
"928","E3",2023-11-11,"Bradford","Barrow",1,2,"A",1,1,"D",2.32,3.07,3.61,"1-1","1-2",9,5,7,4,2,2,0,0,5,4,10,6,3,9,16,"5-4","Y","Y","N",4,0,16
"929","E3",2023-11-11,"Colchester","Sutton",1,1,"D",0,0,"D",2.02,3.93,3.51,"0-0","1-1",11,4,13,3,3,4,0,0,6,3,14,9,2,9,23,"6-3","Y","N","N",7,0,17
"930","E3",2023-11-11,"Crawley Town","Accrington",3,1,"H",1,1,"D",2.42,3.78,2.81,"1-1","3-1",9,4,14,6,2,4,0,1,1,8,14,19,4,9,33,"1-8","Y","Y","Y",6,1,17
"931","E3",2023-11-11,"Crewe","Notts County",1,0,"H",0,0,"D",3.03,3.83,2.26,"0-0","1-0",15,4,12,2,2,5,0,0,3,7,16,15,1,10,31,"3-7","N","N","N",7,0,17
"932","E3",2023-11-11,"Grimsby","Morecambe",3,2,"H",0,1,"A",2.25,3.44,3.35,"0-1","3-2",20,10,16,6,3,1,0,0,9,6,9,9,5,15,18,"9-6","Y","Y","Y",4,0,17
"933","E3",2023-11-11,"Newport County","Milton Keynes Dons",0,0,"D",0,0,"D",3.12,3.64,2.28,"0-0","0-0",16,1,11,5,2,2,0,0,2,4,14,11,0,6,25,"2-4","N","N","N",4,0,17
"934","E3",2023-11-11,"Salford","Mansfield",1,2,"A",1,2,"A",4.34,4.04,1.79,"1-2","1-2",18,7,9,5,1,2,0,0,7,4,10,13,3,11,23,"7-4","Y","Y","N",3,0,17
"935","E3",2023-11-11,"Swindon","Stockport",2,4,"A",1,0,"H",3.34,4.23,2,"1-0","2-4",13,4,16,8,2,2,0,0,8,4,9,10,6,12,19,"8-4","Y","Y","Y",4,0,17
"936","E3",2023-11-11,"Tranmere","Forest Green",3,0,"H",1,0,"H",2.67,3.65,2.6,"1-0","3-0",16,7,15,8,1,2,0,1,12,11,8,11,3,23,19,"12-11","Y","Y","N",3,1,17
"937","E3",2023-11-11,"Walsall","Harrogate",0,1,"A",0,0,"D",1.79,3.9,4.51,"0-0","0-1",25,3,7,2,0,2,0,0,11,6,8,9,1,17,17,"11-6","N","N","N",2,0,17
"938","E3",2023-11-11,"Wrexham","Gillingham",2,0,"H",1,0,"H",1.63,4.28,5.3,"1-0","2-0",15,5,8,2,0,0,0,0,5,5,13,7,2,10,20,"5-5","Y","N","N",0,0,17
"939","E3",2023-11-18,"Notts County","Bradford",4,2,"H",4,0,"H",1.89,3.94,3.97,"4-0","4-2",15,8,24,6,3,0,0,0,6,4,3,12,6,10,15,"6-4","Y","Y","Y",3,0,17
"940","E3",2023-11-18,"Accrington","Wrexham",2,0,"H",0,0,"D",3.21,4.03,2.11,"0-0","2-0",14,6,10,4,1,0,0,0,7,6,20,12,2,13,32,"7-6","Y","N","N",1,0,17
"941","E3",2023-11-18,"Barrow","Crawley Town",1,0,"H",0,0,"D",1.93,3.65,4.08,"0-0","1-0",11,3,10,2,2,3,0,0,4,5,8,13,1,9,21,"4-5","N","N","N",5,0,18
"942","E3",2023-11-18,"Forest Green","Grimsby",2,2,"D",2,0,"H",2.54,3.4,2.89,"2-0","2-2",15,5,16,5,1,2,0,0,6,7,8,5,4,13,13,"6-7","Y","Y","Y",3,0,18
"943","E3",2023-11-18,"Gillingham","Salford",3,1,"H",1,1,"D",2.08,3.59,3.63,"1-1","3-1",10,5,15,4,2,1,0,0,3,2,7,7,4,5,14,"3-2","Y","Y","Y",3,0,18
"944","E3",2023-11-18,"Harrogate","Swindon",1,1,"D",0,1,"A",3.72,3.96,1.94,"0-1","1-1",12,5,15,3,1,2,0,0,5,10,4,13,2,15,17,"5-10","Y","N","N",3,0,18
"945","E3",2023-11-18,"Mansfield","Newport County",2,0,"H",1,0,"H",1.37,5.32,8.19,"1-0","2-0",19,8,14,2,0,4,0,0,5,8,7,18,2,13,25,"5-8","Y","N","N",4,0,18
"946","E3",2023-11-18,"Stockport","Colchester",2,0,"H",1,0,"H",1.37,5.37,8.23,"1-0","2-0",13,4,12,5,3,1,0,0,6,1,18,9,2,7,27,"6-1","Y","N","N",4,0,18
"947","E3",2023-11-18,"Sutton","Tranmere",1,1,"D",0,1,"A",2.19,3.59,3.35,"0-1","1-1",13,2,10,3,2,1,0,0,4,2,9,8,2,6,17,"4-2","Y","N","N",3,0,18
"948","E3",2023-11-25,"AFC Wimbledon","Notts County",4,2,"H",2,0,"H",2.55,3.63,2.73,"2-0","4-2",13,8,10,5,2,1,0,0,2,6,20,8,6,8,28,"2-6","Y","Y","Y",3,0,18
"949","E3",2023-11-25,"Bradford","Accrington",1,0,"H",0,0,"D",2.18,3.58,3.39,"0-0","1-0",12,2,12,3,3,4,0,0,5,3,15,16,1,8,31,"5-3","N","N","N",7,0,18
"950","E3",2023-11-25,"Colchester","Barrow",1,4,"A",1,0,"H",2.99,3.33,2.51,"1-0","1-4",12,8,16,6,2,3,1,0,6,5,8,8,5,11,16,"6-5","Y","Y","Y",5,1,18
"951","E3",2023-11-25,"Crawley Town","Harrogate",2,1,"H",1,1,"D",1.86,3.8,4.24,"1-1","2-1",13,6,15,3,3,3,0,0,5,8,8,14,3,13,22,"5-8","Y","Y","N",6,0,18
"952","E3",2023-11-25,"Crewe","Doncaster",3,2,"H",2,1,"H",2.21,3.73,3.2,"2-1","3-2",19,9,22,6,1,2,0,0,8,8,10,14,5,16,24,"8-8","Y","Y","Y",3,0,18
"953","E3",2023-11-25,"Grimsby","Sutton",1,1,"D",1,1,"D",2,3.65,3.84,"1-1","1-1",13,4,13,2,0,0,0,0,8,4,9,5,2,12,14,"8-4","Y","N","N",0,0,19
"954","E3",2023-11-25,"Newport County","Stockport",2,1,"H",1,0,"H",4.89,3.89,1.74,"1-0","2-1",6,2,13,4,0,1,0,0,2,8,12,13,3,10,25,"2-8","Y","Y","N",1,0,19
"955","E3",2023-11-25,"Salford","Milton Keynes Dons",2,4,"A",2,1,"H",2.78,3.6,2.53,"2-1","2-4",9,4,16,5,2,2,0,0,2,2,15,12,6,4,27,"2-2","Y","Y","Y",4,0,19
"956","E3",2023-11-25,"Swindon","Mansfield",2,1,"H",1,0,"H",3.76,4.01,1.93,"1-0","2-1",20,6,15,6,1,1,0,0,3,2,10,12,3,5,22,"3-2","Y","Y","N",2,0,19
"957","E3",2023-11-25,"Tranmere","Gillingham",3,1,"H",1,0,"H",3.03,3.3,2.5,"1-0","3-1",8,3,11,5,3,2,0,0,0,10,8,7,4,10,15,"0-10","Y","Y","Y",5,0,19
"958","E3",2023-11-25,"Walsall","Forest Green",0,0,"D",0,0,"D",2.2,3.73,3.22,"0-0","0-0",11,2,8,1,2,3,0,0,6,4,10,14,0,10,24,"6-4","N","N","N",5,0,19
"959","E3",2023-11-25,"Wrexham","Morecambe",6,0,"H",3,0,"H",1.41,5.16,7.35,"3-0","6-0",19,8,14,2,1,1,0,0,5,7,11,10,6,12,21,"5-7","Y","Y","Y",2,0,19
"960","E3",2023-11-28,"Accrington","Swindon",3,4,"A",0,2,"A",2.16,3.82,3.23,"0-2","3-4",29,8,12,5,6,2,0,0,11,3,15,9,7,14,24,"11-3","Y","Y","Y",8,0,19
"961","E3",2023-11-28,"Barrow","Walsall",2,0,"H",1,0,"H",1.97,3.5,4.13,"1-0","2-0",11,4,11,4,1,2,0,0,7,3,15,15,2,10,30,"7-3","Y","N","N",3,0,19
"962","E3",2023-11-28,"Doncaster","Colchester",3,1,"H",1,1,"D",2.04,3.61,3.75,"1-1","3-1",15,5,14,7,2,4,0,0,8,4,7,14,4,12,21,"8-4","Y","Y","Y",6,0,19
"963","E3",2023-11-28,"Forest Green","Bradford",0,3,"A",0,2,"A",2.83,3.32,2.64,"0-2","0-3",13,2,13,4,2,1,0,1,8,4,7,7,3,12,14,"8-4","Y","Y","N",3,1,19
"964","E3",2023-11-28,"Gillingham","AFC Wimbledon",1,0,"H",0,0,"D",2.97,3.34,2.52,"0-0","1-0",8,4,9,3,0,1,0,0,3,4,8,9,1,7,17,"3-4","N","N","N",1,0,19
"965","E3",2023-11-28,"Harrogate","Wrexham",2,2,"D",1,2,"A",5.68,4.32,1.59,"1-2","2-2",10,4,22,7,2,2,0,0,4,7,6,11,4,11,17,"4-7","Y","Y","Y",4,0,20
"966","E3",2023-11-28,"Mansfield","Tranmere",2,2,"D",1,1,"D",1.37,5.35,8.31,"1-1","2-2",21,5,15,7,2,2,0,1,5,1,9,16,4,6,25,"5-1","Y","Y","Y",4,1,20
"967","E3",2023-11-28,"Milton Keynes Dons","Grimsby",1,1,"D",0,1,"A",1.71,4.05,4.84,"0-1","1-1",13,3,19,6,1,3,0,0,5,10,10,12,2,15,22,"5-10","Y","N","N",4,0,20
"968","E3",2023-11-28,"Morecambe","Newport County",1,2,"A",1,1,"D",2.22,3.54,3.32,"1-1","1-2",12,3,15,3,1,1,0,0,8,7,11,6,3,15,17,"8-7","Y","Y","N",2,0,20
"969","E3",2023-11-28,"Notts County","Crawley Town",3,1,"H",1,1,"D",1.62,4.62,4.9,"1-1","3-1",14,5,18,6,1,3,0,0,3,6,7,13,4,9,20,"3-6","Y","Y","Y",4,0,20
"970","E3",2023-11-28,"Stockport","Salford",0,0,"D",0,0,"D",1.46,4.86,6.78,"0-0","0-0",19,5,9,2,2,2,0,0,7,3,13,5,0,10,18,"7-3","N","N","N",4,0,20
"971","E3",2023-11-28,"Sutton","Crewe",1,1,"D",1,1,"D",2.71,3.57,2.6,"1-1","1-1",9,3,22,4,2,1,0,0,3,9,14,10,2,12,24,"3-9","Y","N","N",3,0,20
"972","E3",2023-12-09,"Accrington","Doncaster",0,0,"D",0,0,"D",1.99,3.86,3.66,"0-0","0-0",12,3,4,0,2,0,0,0,5,3,8,16,0,8,24,"5-3","N","N","N",2,0,20
"973","E3",2023-12-09,"AFC Wimbledon","Swindon",4,0,"H",1,0,"H",2,3.92,3.58,"1-0","4-0",16,9,10,1,2,1,0,0,7,3,11,10,4,10,21,"7-3","Y","Y","Y",3,0,20
"974","E3",2023-12-09,"Colchester","Crawley Town",1,2,"A",0,1,"A",2.4,3.66,2.91,"0-1","1-2",11,2,12,4,3,2,0,0,4,5,10,9,3,9,19,"4-5","Y","Y","N",5,0,20
"975","E3",2023-12-09,"Grimsby","Crewe",2,1,"H",2,0,"H",2.39,3.53,3.02,"2-0","2-1",17,3,11,2,1,3,0,0,6,5,10,11,3,11,21,"6-5","Y","Y","N",4,0,20
"976","E3",2023-12-09,"Morecambe","Stockport",1,1,"D",0,0,"D",4.89,3.92,1.74,"0-0","1-1",4,3,11,5,1,0,0,0,3,5,6,5,2,8,11,"3-5","Y","N","N",1,0,20
"977","E3",2023-12-09,"Notts County","Walsall",1,2,"A",1,0,"H",1.58,4.63,5.25,"1-0","1-2",6,2,7,4,2,2,0,0,6,4,9,11,3,10,20,"6-4","Y","Y","N",4,0,21
"978","E3",2023-12-09,"Tranmere","Newport County",2,1,"H",0,1,"A",2.44,3.5,2.96,"0-1","2-1",14,3,10,3,3,3,0,0,8,2,12,11,3,10,23,"8-2","Y","Y","N",6,0,21
"979","E3",2023-12-16,"Crawley Town","Mansfield",1,3,"A",1,1,"D",3.89,4.02,1.89,"1-1","1-3",11,2,14,6,4,3,1,0,2,3,12,14,4,5,26,"2-3","Y","Y","Y",7,1,21
"980","E3",2023-12-16,"Crewe","Accrington",3,3,"D",2,1,"H",2.56,3.82,2.62,"2-1","3-3",13,3,19,8,2,1,1,0,6,3,10,10,6,9,20,"6-3","Y","Y","Y",3,1,21
"981","E3",2023-12-16,"Doncaster","Morecambe",0,5,"A",0,2,"A",2.1,3.74,3.44,"0-2","0-5",12,3,15,9,2,3,0,0,6,6,10,10,5,12,20,"6-6","Y","Y","Y",5,0,21
"982","E3",2023-12-16,"Gillingham","Bradford",0,2,"A",0,1,"A",2.45,3.19,3.21,"0-1","0-2",7,1,12,2,3,5,0,0,6,2,11,19,2,8,30,"6-2","Y","N","N",8,0,21
"983","E3",2023-12-16,"Harrogate","Notts County",3,1,"H",2,0,"H",4.04,4.01,1.85,"2-0","3-1",14,5,10,3,2,3,0,0,2,4,8,10,4,6,18,"2-4","Y","Y","Y",5,0,21
"984","E3",2023-12-16,"Milton Keynes Dons","Forest Green",2,0,"H",2,0,"H",1.67,4.29,4.92,"2-0","2-0",14,6,8,0,4,4,0,0,4,4,11,18,2,8,29,"4-4","Y","N","N",8,0,21
"985","E3",2023-12-16,"Newport County","Grimsby",1,1,"D",0,0,"D",2.79,3.2,2.76,"0-0","1-1",19,3,19,5,1,0,0,0,10,2,8,6,2,12,14,"10-2","Y","N","N",1,0,21
"986","E3",2023-12-16,"Salford","AFC Wimbledon",0,0,"D",0,0,"D",3.54,3.54,2.13,"0-0","0-0",8,3,20,2,2,1,0,0,1,11,9,14,0,12,23,"1-11","N","N","N",3,0,21
"987","E3",2023-12-16,"Stockport","Sutton",8,0,"H",4,0,"H",1.38,5.26,8.03,"4-0","8-0",18,11,7,1,0,1,0,0,5,1,12,10,8,6,22,"5-1","Y","Y","Y",1,0,21
"988","E3",2023-12-16,"Swindon","Barrow",0,3,"A",0,1,"A",2.7,3.72,2.54,"0-1","0-3",4,1,8,3,1,1,0,0,7,5,12,14,3,12,26,"7-5","Y","Y","N",2,0,21
"989","E3",2023-12-16,"Walsall","Tranmere",1,0,"H",0,0,"D",1.99,3.57,3.96,"0-0","1-0",13,4,17,6,4,1,0,0,4,1,14,9,1,5,23,"4-1","N","N","N",5,0,22
"990","E3",2023-12-16,"Wrexham","Colchester",2,1,"H",1,0,"H",1.41,5.19,7.44,"1-0","2-1",11,5,18,4,3,2,1,0,4,7,8,7,3,11,15,"4-7","Y","Y","N",5,1,22
"991","E3",2023-12-22,"Forest Green","Gillingham",0,0,"D",0,0,"D",2.82,3.29,2.67,"0-0","0-0",11,4,11,3,2,1,0,0,3,8,11,9,0,11,20,"3-8","N","N","N",3,0,22
"992","E3",2023-12-22,"Colchester","Salford",2,1,"H",1,0,"H",2.09,3.66,3.54,"1-0","2-1",11,5,11,4,5,1,0,0,9,7,11,10,3,16,21,"9-7","Y","Y","N",6,0,22
"993","E3",2023-12-22,"Crawley Town","AFC Wimbledon",1,2,"A",0,2,"A",3.93,3.71,1.96,"0-2","1-2",18,7,12,2,2,3,0,1,6,5,11,11,3,11,22,"6-5","Y","Y","N",5,1,22
"994","E3",2023-12-22,"Crewe","Barrow",1,3,"A",0,1,"A",2.61,3.43,2.79,"0-1","1-3",7,3,11,6,4,4,0,0,5,2,12,10,4,7,22,"5-2","Y","Y","Y",8,0,22
"995","E3",2023-12-22,"Doncaster","Bradford",1,3,"A",1,2,"A",3.12,3.26,2.47,"1-2","1-3",7,2,13,5,1,1,0,0,9,4,9,13,4,13,22,"9-4","Y","Y","Y",2,0,22
"996","E3",2023-12-22,"Stockport","Notts County",2,1,"H",1,0,"H",1.7,4.03,5,"1-0","2-1",9,5,12,3,4,2,0,0,4,3,14,6,3,7,20,"4-3","Y","Y","N",6,0,22
"997","E3",2023-12-23,"Accrington","Walsall",2,1,"H",1,1,"D",2.34,3.73,2.78,"1-1","2-1",13,6,13,1,1,0,0,0,9,7,11,6,3,16,17,"9-7","Y","Y","N",1,0,22
"998","E3",2023-12-23,"Grimsby","Harrogate",1,2,"A",0,1,"A",1.8,3.82,4.59,"0-1","1-2",14,1,14,5,1,1,0,0,9,6,11,7,3,15,18,"9-6","Y","Y","N",2,0,22
"999","E3",2023-12-23,"Morecambe","Milton Keynes Dons",1,3,"A",0,1,"A",3.08,3.55,2.35,"0-1","1-3",9,4,20,7,3,1,0,0,4,5,12,12,4,9,24,"4-5","Y","Y","Y",4,0,22
"1000","E3",2023-12-23,"Sutton","Mansfield",0,2,"A",0,1,"A",4.98,4.25,1.66,"0-1","0-2",7,1,17,5,1,1,0,0,2,5,10,10,2,7,20,"2-5","Y","N","N",2,0,22
"1001","E3",2023-12-23,"Tranmere","Swindon",2,1,"H",0,1,"A",2.27,3.8,3.04,"0-1","2-1",18,9,8,5,2,3,0,0,6,3,11,10,3,9,21,"6-3","Y","Y","N",5,0,23
"1002","E3",2023-12-23,"Wrexham","Newport County",2,0,"H",0,0,"D",1.43,4.98,7.34,"0-0","2-0",16,5,9,2,0,1,0,0,7,5,9,9,2,12,18,"7-5","Y","N","N",1,0,23
"1003","E3",2023-12-26,"Mansfield","Grimsby",2,0,"H",2,0,"H",1.53,4.5,6.14,"2-0","2-0",39,16,13,5,3,1,0,0,15,2,17,10,2,17,27,"15-2","Y","N","N",4,0,23
"1004","E3",2023-12-26,"Gillingham","Crawley Town",0,2,"A",0,1,"A",2.04,3.65,3.7,"0-1","0-2",16,5,8,3,2,5,0,0,8,1,10,15,2,9,25,"8-1","Y","N","N",7,0,23
"1005","E3",2023-12-26,"AFC Wimbledon","Sutton",0,1,"A",0,0,"D",1.56,4.28,6.06,"0-0","0-1",11,5,12,6,3,3,0,0,2,6,13,11,1,8,24,"2-6","N","N","N",6,0,23
"1006","E3",2023-12-26,"Barrow","Stockport",2,2,"D",2,1,"H",3.39,3.34,2.28,"2-1","2-2",13,5,17,5,2,4,0,0,3,6,17,14,4,9,31,"3-6","Y","Y","Y",6,0,23
"1007","E3",2023-12-26,"Bradford","Morecambe",2,2,"D",0,2,"A",1.7,3.88,5.25,"0-2","2-2",17,6,7,2,2,3,0,0,5,5,7,9,4,10,16,"5-5","Y","Y","Y",5,0,23
"1008","E3",2023-12-26,"Harrogate","Accrington",2,1,"H",0,0,"D",3.1,3.43,2.38,"0-0","2-1",13,5,14,6,0,0,0,0,4,11,7,11,3,15,18,"4-11","Y","Y","N",0,0,23
"1009","E3",2023-12-26,"Milton Keynes Dons","Colchester",1,0,"H",0,0,"D",1.65,4.16,5.31,"0-0","1-0",27,4,7,3,3,1,0,0,11,1,12,8,1,12,20,"11-1","N","N","N",4,0,23
"1010","E3",2023-12-26,"Newport County","Forest Green",4,2,"H",0,2,"A",2.11,3.65,3.52,"0-2","4-2",13,8,12,4,3,4,0,1,7,7,10,22,6,14,32,"7-7","Y","Y","Y",7,1,23
"1011","E3",2023-12-26,"Notts County","Doncaster",3,0,"H",2,0,"H",1.65,4.28,5.11,"2-0","3-0",20,10,13,4,0,2,0,0,13,3,6,11,3,16,17,"13-3","Y","Y","N",2,0,23
"1012","E3",2023-12-26,"Salford","Tranmere",1,5,"A",0,2,"A",2.37,3.69,2.94,"0-2","1-5",10,5,19,9,3,1,1,0,4,3,7,11,6,7,18,"4-3","Y","Y","Y",4,1,23
"1013","E3",2023-12-26,"Swindon","Wrexham",0,1,"A",0,1,"A",4.12,4.12,1.82,"0-1","0-1",16,3,15,4,1,0,0,1,8,5,8,10,1,13,18,"8-5","N","N","N",1,1,24
"1014","E3",2023-12-26,"Walsall","Crewe",2,0,"H",1,0,"H",2.17,3.66,3.33,"1-0","2-0",15,5,15,4,1,5,0,0,5,4,9,11,2,9,20,"5-4","Y","N","N",6,0,24
"1015","E3",2023-12-29,"AFC Wimbledon","Colchester",5,3,"H",2,2,"D",1.55,4.36,6.15,"2-2","5-3",31,13,14,4,3,1,0,1,5,2,16,7,8,7,23,"5-2","Y","Y","Y",4,1,24
"1016","E3",2023-12-29,"Barrow","Accrington",1,1,"D",0,0,"D",1.8,3.79,4.61,"0-0","1-1",18,5,11,3,0,6,0,0,8,3,12,12,2,11,24,"8-3","Y","N","N",6,0,24
"1017","E3",2023-12-29,"Bradford","Stockport",0,0,"D",0,0,"D",3.29,3.34,2.32,"0-0","0-0",8,1,10,1,2,2,0,0,6,3,16,7,0,9,23,"6-3","N","N","N",4,0,24
"1018","E3",2023-12-29,"Gillingham","Sutton",1,0,"H",0,0,"D",1.89,3.65,4.31,"0-0","1-0",24,4,4,2,1,3,0,1,12,0,6,10,1,12,16,"12-0","N","N","N",4,1,24
"1019","E3",2023-12-29,"Harrogate","Tranmere",0,2,"A",0,0,"D",2.67,3.36,2.77,"0-0","0-2",12,2,10,4,1,2,0,0,7,6,5,9,2,13,14,"7-6","Y","N","N",3,0,24
"1020","E3",2023-12-29,"Mansfield","Doncaster",1,1,"D",1,0,"H",1.39,5.15,8.1,"1-0","1-1",12,6,12,4,1,1,0,0,7,4,9,13,2,11,22,"7-4","Y","N","N",2,0,24
"1021","E3",2023-12-29,"Milton Keynes Dons","Crawley Town",2,0,"H",1,0,"H",1.61,4.38,5.35,"1-0","2-0",13,8,10,3,3,0,0,1,6,2,7,9,2,8,16,"6-2","Y","N","N",3,1,24
"1022","E3",2023-12-29,"Newport County","Crewe",1,1,"D",0,0,"D",2.25,3.71,3.13,"0-0","1-1",19,3,22,4,0,1,0,0,7,5,10,6,2,12,16,"7-5","Y","N","N",1,0,24
"1023","E3",2023-12-29,"Notts County","Morecambe",5,0,"H",4,0,"H",1.59,4.36,5.61,"4-0","5-0",13,7,6,2,1,2,0,0,4,2,7,8,5,6,15,"4-2","Y","Y","Y",3,0,24
"1024","E3",2023-12-29,"Salford","Grimsby",0,3,"A",0,1,"A",2.62,3.55,2.71,"0-1","0-3",10,2,22,5,0,1,0,0,5,12,10,8,3,17,18,"5-12","Y","Y","N",1,0,24
"1025","E3",2023-12-29,"Swindon","Forest Green",2,1,"H",0,0,"D",2.1,3.81,3.39,"0-0","2-1",15,5,19,7,3,5,0,0,6,4,11,20,3,10,31,"6-4","Y","Y","N",8,0,25
"1026","E3",2023-12-29,"Walsall","Wrexham",3,1,"H",1,1,"D",3.47,3.71,2.1,"1-1","3-1",22,8,16,5,3,1,0,0,2,4,7,9,4,6,16,"2-4","Y","Y","Y",4,0,25
"1027","E3",2024-01-01,"Accrington","Salford",3,0,"H",3,0,"H",1.82,4.09,4.14,"3-0","3-0",17,6,12,5,4,2,0,0,5,3,13,9,3,8,22,"5-3","Y","Y","N",6,0,25
"1028","E3",2024-01-01,"Colchester","Gillingham",0,1,"A",0,0,"D",2.84,3.48,2.54,"0-0","0-1",15,4,15,7,1,3,0,0,0,6,9,7,1,6,16,"0-6","N","N","N",4,0,25
"1029","E3",2024-01-01,"Crawley Town","Swindon",3,1,"H",2,0,"H",2.36,3.72,2.94,"2-0","3-1",11,3,14,8,0,0,0,0,3,9,15,12,4,12,27,"3-9","Y","Y","Y",0,0,25
"1030","E3",2024-01-01,"Crewe","Bradford",1,0,"H",1,0,"H",3.12,3.74,2.24,"1-0","1-0",4,1,16,4,5,2,0,0,1,8,12,18,1,9,30,"1-8","N","N","N",7,0,25
"1031","E3",2024-01-01,"Doncaster","Milton Keynes Dons",3,0,"H",3,0,"H",3.59,3.71,2.06,"3-0","3-0",20,6,12,3,2,4,0,0,6,5,17,13,3,11,30,"6-5","Y","Y","N",6,0,25
"1032","E3",2024-01-01,"Forest Green","AFC Wimbledon",1,1,"D",1,1,"D",3.98,3.71,1.94,"1-1","1-1",16,4,14,4,1,2,0,0,7,9,10,7,2,16,17,"7-9","Y","N","N",3,0,25
"1033","E3",2024-01-01,"Grimsby","Walsall",1,6,"A",1,2,"A",2.36,3.44,3.13,"1-2","1-6",8,3,18,7,0,1,0,0,9,7,12,14,7,16,26,"9-7","Y","Y","Y",1,0,25
"1034","E3",2024-01-01,"Morecambe","Harrogate",2,2,"D",0,1,"A",2.23,3.81,3.09,"0-1","2-2",17,6,11,5,3,2,0,0,7,4,6,8,4,11,14,"7-4","Y","Y","Y",5,0,25
"1035","E3",2024-01-01,"Stockport","Mansfield",0,2,"A",0,0,"D",2.32,3.43,3.22,"0-0","0-2",11,4,8,3,1,3,0,0,3,6,10,8,2,9,18,"3-6","Y","N","N",4,0,25
"1036","E3",2024-01-01,"Sutton","Newport County",1,1,"D",0,0,"D",2.49,3.41,2.96,"0-0","1-1",13,4,11,2,1,0,0,0,3,7,8,5,2,10,13,"3-7","Y","N","N",1,0,25
"1037","E3",2024-01-01,"Tranmere","Notts County",4,2,"H",2,2,"D",3.14,3.94,2.17,"2-2","4-2",14,7,12,7,1,1,0,0,7,7,10,5,6,14,15,"7-7","Y","Y","Y",2,0,26
"1038","E3",2024-01-01,"Wrexham","Barrow",4,1,"H",3,1,"H",1.91,3.7,4.16,"3-1","4-1",16,10,7,3,1,4,0,0,3,0,12,14,5,3,26,"3-0","Y","Y","Y",5,0,26
"1039","E3",2024-01-06,"Harrogate","Doncaster",3,1,"H",1,1,"D",2.6,3.35,2.86,"1-1","3-1",11,4,17,2,0,3,0,0,3,4,8,11,4,7,19,"3-4","Y","Y","Y",3,0,26
"1040","E3",2024-01-06,"Barrow","Tranmere",1,0,"H",0,0,"D",1.93,3.57,4.19,"0-0","1-0",15,2,6,1,1,1,0,0,4,5,10,11,1,9,21,"4-5","N","N","N",2,0,26
"1041","E3",2024-01-06,"Bradford","Crawley Town",2,4,"A",0,1,"A",1.74,3.94,4.82,"0-1","2-4",20,8,13,6,1,2,0,0,10,3,6,11,6,13,17,"10-3","Y","Y","Y",3,0,26
"1042","E3",2024-01-06,"Mansfield","Crewe",0,1,"A",0,1,"A",1.45,4.97,6.73,"0-1","0-1",21,3,12,3,2,2,0,0,12,5,7,8,1,17,15,"12-5","N","N","N",4,0,26
"1043","E3",2024-01-06,"Salford","Forest Green",2,2,"D",1,1,"D",2.41,3.66,2.89,"1-1","2-2",12,5,13,3,2,2,1,1,8,4,9,14,4,12,23,"8-4","Y","Y","Y",4,2,26
"1044","E3",2024-01-06,"Swindon","Colchester",2,2,"D",2,1,"H",2.1,4.14,3.16,"2-1","2-2",9,4,17,6,1,2,0,0,5,2,8,9,4,7,17,"5-2","Y","Y","Y",3,0,26
"1045","E3",2024-01-13,"Accrington","Gillingham",1,2,"A",0,0,"D",2.4,3.39,3.1,"0-0","1-2",14,5,11,3,2,2,0,0,5,7,9,12,3,12,21,"5-7","Y","Y","N",4,0,26
"1046","E3",2024-01-13,"Colchester","Bradford",1,1,"D",0,1,"A",3.73,3.63,2.04,"0-1","1-1",6,3,22,3,0,0,0,0,2,8,5,11,2,10,16,"2-8","Y","N","N",0,0,26
"1047","E3",2024-01-13,"Crawley Town","Salford",0,1,"A",0,0,"D",1.93,3.86,3.9,"0-0","0-1",10,1,35,12,1,3,0,0,2,10,8,15,1,12,23,"2-10","N","N","N",4,0,26
"1048","E3",2024-01-13,"Crewe","Swindon",2,1,"H",1,1,"D",1.93,4,3.73,"1-1","2-1",11,5,11,3,3,3,0,0,3,8,7,9,3,11,16,"3-8","Y","Y","N",6,0,26
"1049","E3",2024-01-13,"Doncaster","Newport County",0,1,"A",0,0,"D",2.2,3.94,3.07,"0-0","0-1",13,5,5,1,1,2,0,0,2,4,12,16,1,6,28,"2-4","N","N","N",3,0,27
"1050","E3",2024-01-13,"Forest Green","Harrogate",0,2,"A",0,0,"D",2.21,3.52,3.37,"0-0","0-2",4,1,17,5,2,2,1,0,3,8,19,6,2,11,25,"3-8","Y","N","N",4,1,27
"1051","E3",2024-01-13,"Grimsby","Notts County",5,5,"D",2,2,"D",2.76,3.84,2.44,"2-2","5-5",22,9,19,9,1,3,0,0,9,2,10,9,10,11,19,"9-2","Y","Y","Y",4,0,27
"1052","E3",2024-01-13,"Morecambe","Mansfield",1,1,"D",0,0,"D",5.81,4.29,1.58,"0-0","1-1",9,3,6,3,3,1,0,0,3,5,9,9,2,8,18,"3-5","Y","N","N",4,0,27
"1053","E3",2024-01-13,"Stockport","Walsall",3,1,"H",1,1,"D",1.57,4.33,5.88,"1-1","3-1",15,6,7,3,1,1,0,0,8,6,10,10,4,14,20,"8-6","Y","Y","Y",2,0,27
"1054","E3",2024-01-13,"Sutton","Barrow",2,2,"D",1,1,"D",3.8,3.44,2.08,"1-1","2-2",9,4,16,5,1,0,0,0,5,5,8,7,4,10,15,"5-5","Y","Y","Y",1,0,27
"1055","E3",2024-01-13,"Tranmere","Milton Keynes Dons",1,2,"A",1,1,"D",2.69,3.78,2.53,"1-1","1-2",5,2,24,6,1,0,0,0,2,6,7,9,3,8,16,"2-6","Y","Y","N",1,0,27
"1056","E3",2024-01-13,"Wrexham","AFC Wimbledon",2,0,"H",0,0,"D",1.89,3.85,4.04,"0-0","2-0",10,5,17,1,1,1,0,0,5,5,11,13,2,10,24,"5-5","Y","N","N",2,0,27
"1057","E3",2024-01-20,"Barrow","Crewe",1,3,"A",1,1,"D",1.83,3.76,4.47,"1-1","1-3",13,5,13,6,1,6,0,0,5,0,7,10,4,5,17,"5-0","Y","Y","Y",7,0,27
"1058","E3",2024-01-20,"Gillingham","Forest Green",1,1,"D",0,0,"D",1.77,3.81,4.8,"0-0","1-1",13,3,11,5,4,2,0,0,6,0,6,11,2,6,17,"6-0","Y","N","N",6,0,27
"1059","E3",2024-01-20,"Milton Keynes Dons","Morecambe",1,2,"A",1,0,"H",1.5,4.82,6.09,"1-0","1-2",22,6,7,3,2,3,0,0,8,6,10,10,3,14,20,"8-6","Y","Y","N",5,0,27
"1060","E3",2024-01-20,"Newport County","Wrexham",1,0,"H",1,0,"H",3.98,3.84,1.91,"1-0","1-0",16,5,4,1,6,3,0,1,5,2,13,12,1,7,25,"5-2","N","N","N",9,1,27
"1061","E3",2024-01-23,"Bradford","Salford",1,1,"D",1,1,"D",1.7,3.99,5.04,"1-1","1-1",7,4,12,4,0,1,0,0,3,3,7,14,2,6,21,"3-3","Y","N","N",1,0,28
"1062","E3",2024-01-23,"Mansfield","Sutton",1,1,"D",1,1,"D",1.33,5.66,9.2,"1-1","1-1",17,2,2,1,2,1,0,0,13,8,8,13,2,21,21,"13-8","Y","N","N",3,0,28
"1063","E3",2024-01-23,"Milton Keynes Dons","AFC Wimbledon",3,1,"H",3,0,"H",2.21,3.53,3.36,"3-0","3-1",18,12,8,2,1,1,0,2,3,3,11,17,4,6,28,"3-3","Y","Y","Y",2,2,28
"1064","E3",2024-01-27,"AFC Wimbledon","Mansfield",2,1,"H",1,0,"H",3.05,3.52,2.37,"1-0","2-1",19,5,5,1,4,4,0,2,6,2,16,10,3,8,26,"6-2","Y","Y","N",8,2,28
"1065","E3",2024-01-27,"Crewe","Salford",2,3,"A",2,1,"H",2.04,3.76,3.6,"2-1","2-3",11,3,18,6,1,4,0,0,2,5,10,16,5,7,26,"2-5","Y","Y","Y",5,0,28
"1066","E3",2024-01-27,"Doncaster","Stockport",1,5,"A",0,3,"A",4.39,3.65,1.88,"0-3","1-5",7,1,14,7,2,1,0,0,2,10,17,11,6,12,28,"2-10","Y","Y","Y",3,0,28
"1067","E3",2024-01-27,"Forest Green","Accrington",0,1,"A",0,1,"A",2.55,3.61,2.75,"0-1","0-1",12,2,9,4,1,5,0,0,6,1,6,17,1,7,23,"6-1","N","N","N",6,0,28
"1068","E3",2024-01-27,"Grimsby","Tranmere",1,2,"A",1,1,"D",2.34,3.52,3.11,"1-1","1-2",12,3,5,2,1,2,0,0,6,2,12,10,3,8,22,"6-2","Y","Y","N",3,0,28
"1069","E3",2024-01-27,"Milton Keynes Dons","Gillingham",2,1,"H",0,0,"D",2,3.54,3.97,"0-0","2-1",11,7,14,6,1,0,0,0,5,4,10,8,3,9,18,"5-4","Y","Y","N",1,0,28
"1070","E3",2024-01-27,"Morecambe","Colchester",0,1,"A",0,1,"A",2.3,3.61,3.11,"0-1","0-1",8,1,16,3,3,2,0,0,3,9,7,11,1,12,18,"3-9","N","N","N",5,0,28
"1071","E3",2024-01-27,"Notts County","Barrow",1,1,"D",1,1,"D",2.16,3.9,3.19,"1-1","1-1",9,1,11,3,1,4,0,0,6,8,9,11,2,14,20,"6-8","Y","N","N",5,0,28
"1072","E3",2024-01-27,"Swindon","Bradford",2,0,"H",2,0,"H",3.35,3.62,2.18,"2-0","2-0",5,2,11,3,2,2,0,0,3,4,10,17,2,7,27,"3-4","Y","N","N",4,0,28
"1073","E3",2024-01-27,"Walsall","Sutton",1,1,"D",1,1,"D",1.83,3.78,4.45,"1-1","1-1",10,5,10,2,5,3,0,0,4,4,10,15,2,8,25,"4-4","Y","N","N",8,0,29
"1074","E3",2024-01-30,"Sutton","Harrogate",1,2,"A",0,0,"D",2.58,3.55,2.75,"0-0","1-2",18,3,10,3,1,3,0,0,10,4,11,5,3,14,16,"10-4","Y","Y","N",4,0,29
"1075","E3",2024-02-03,"Newport County","Swindon",2,1,"H",0,0,"D",2.01,3.81,3.63,"0-0","2-1",11,4,16,3,2,4,0,0,3,7,11,13,3,10,24,"3-7","Y","Y","N",6,0,29
"1076","E3",2024-02-03,"Accrington","Grimsby",0,0,"D",0,0,"D",2.06,3.79,3.52,"0-0","0-0",5,3,16,3,1,1,0,0,6,9,13,6,0,15,19,"6-9","N","N","N",2,0,29
"1077","E3",2024-02-03,"Barrow","Milton Keynes Dons",1,0,"H",0,0,"D",2.44,3.31,3.12,"0-0","1-0",15,6,8,4,3,2,0,0,6,8,10,14,1,14,24,"6-8","N","N","N",5,0,29
"1078","E3",2024-02-03,"Bradford","AFC Wimbledon",0,0,"D",0,0,"D",2.51,3.33,2.99,"0-0","0-0",11,3,6,1,3,4,0,0,4,3,11,17,0,7,28,"4-3","N","N","N",7,0,29
"1079","E3",2024-02-03,"Colchester","Forest Green",3,3,"D",0,2,"A",2.29,3.73,3.05,"0-2","3-3",20,5,11,3,1,1,0,0,5,5,14,10,6,10,24,"5-5","Y","Y","Y",2,0,29
"1080","E3",2024-02-03,"Crawley Town","Morecambe",1,2,"A",1,1,"D",2.11,3.77,3.38,"1-1","1-2",7,3,11,7,2,2,0,0,2,3,8,13,3,5,21,"2-3","Y","Y","N",4,0,29
"1081","E3",2024-02-03,"Gillingham","Walsall",1,1,"D",0,0,"D",2.02,3.42,4.04,"0-0","1-1",14,3,18,3,3,2,0,0,5,4,12,15,2,9,27,"5-4","Y","N","N",5,0,29
"1082","E3",2024-02-03,"Mansfield","Notts County",1,0,"H",1,0,"H",1.86,4.03,3.98,"1-0","1-0",13,7,13,1,4,0,0,0,3,8,16,6,1,11,22,"3-8","N","N","N",4,0,29
"1083","E3",2024-02-03,"Salford","Wrexham",3,1,"H",2,1,"H",3.86,3.92,1.93,"2-1","3-1",18,9,6,1,4,3,0,0,9,3,15,16,4,12,31,"9-3","Y","Y","Y",7,0,29
"1084","E3",2024-02-03,"Stockport","Harrogate",1,1,"D",1,1,"D",1.37,5.19,8.56,"1-1","1-1",20,5,4,2,3,1,0,0,8,1,12,8,2,9,20,"8-1","Y","N","N",4,0,29
"1085","E3",2024-02-03,"Sutton","Doncaster",1,1,"D",0,0,"D",2.48,3.37,3,"0-0","1-1",14,5,9,1,2,3,0,0,1,4,13,21,2,5,34,"1-4","Y","N","N",5,0,30
"1086","E3",2024-02-03,"Tranmere","Crewe",0,0,"D",0,0,"D",2.2,3.84,3.13,"0-0","0-0",9,0,10,1,1,4,0,0,7,6,9,17,0,13,26,"7-6","N","N","N",5,0,30
"1087","E3",2024-02-09,"Notts County","Gillingham",1,3,"A",1,2,"A",2.21,3.68,3.23,"1-2","1-3",11,4,11,4,2,1,0,0,4,4,9,13,4,8,22,"4-4","Y","Y","Y",3,0,30
"1088","E3",2024-02-10,"AFC Wimbledon","Barrow",2,0,"H",2,0,"H",2.22,3.31,3.55,"2-0","2-0",10,3,10,3,3,2,0,1,7,6,23,7,2,13,30,"7-6","Y","N","N",5,1,30
"1089","E3",2024-02-10,"Crewe","Crawley Town",1,0,"H",0,0,"D",2.02,3.92,3.51,"0-0","1-0",10,1,8,2,4,2,0,0,7,5,11,14,1,12,25,"7-5","N","N","N",6,0,30
"1090","E3",2024-02-10,"Doncaster","Tranmere",2,1,"H",1,0,"H",2.44,3.49,2.97,"1-0","2-1",4,3,11,3,1,3,0,0,2,10,13,7,3,12,20,"2-10","Y","Y","N",4,0,30
"1091","E3",2024-02-10,"Forest Green","Mansfield",0,4,"A",0,1,"A",4.53,3.93,1.78,"0-1","0-4",19,5,13,8,2,0,0,0,10,7,5,9,4,17,14,"10-7","Y","Y","Y",2,0,30
"1092","E3",2024-02-10,"Grimsby","Stockport",1,3,"A",0,3,"A",4.12,3.7,1.92,"0-3","1-3",9,2,9,4,4,3,0,0,7,7,10,16,4,14,26,"7-7","Y","Y","Y",7,0,30
"1093","E3",2024-02-10,"Harrogate","Colchester",1,0,"H",0,0,"D",2.19,3.62,3.33,"0-0","1-0",11,6,25,5,1,3,0,0,7,9,4,12,1,16,16,"7-9","N","N","N",4,0,30
"1094","E3",2024-02-10,"Milton Keynes Dons","Accrington",2,1,"H",0,1,"A",1.85,3.94,4.17,"0-1","2-1",13,7,7,1,1,6,0,0,5,3,7,22,3,8,29,"5-3","Y","Y","N",7,0,30
"1095","E3",2024-02-10,"Morecambe","Sutton",1,0,"H",1,0,"H",2.33,3.38,3.24,"1-0","1-0",13,4,14,3,4,4,0,0,6,1,15,18,1,7,33,"6-1","N","N","N",8,0,30
"1096","E3",2024-02-10,"Swindon","Salford",1,1,"D",0,0,"D",2.96,3.73,2.34,"0-0","1-1",25,7,13,4,3,0,0,0,10,7,10,7,2,17,17,"10-7","Y","N","N",3,0,30
"1097","E3",2024-02-10,"Walsall","Newport County",0,3,"A",0,3,"A",2.01,3.66,3.8,"0-3","0-3",15,2,10,5,0,0,1,0,7,0,17,10,3,7,27,"7-0","Y","Y","N",0,1,31
"1098","E3",2024-02-10,"Wrexham","Bradford",0,1,"A",0,0,"D",1.79,3.86,4.59,"0-0","0-1",17,5,10,8,0,3,0,0,11,3,5,19,1,14,24,"11-3","N","N","N",3,0,31
"1099","E3",2024-02-13,"Accrington","AFC Wimbledon",2,0,"H",0,0,"D",2.96,3.37,2.51,"0-0","2-0",14,2,14,4,1,1,0,0,6,6,8,12,2,12,20,"6-6","Y","N","N",2,0,31
"1100","E3",2024-02-13,"Barrow","Forest Green",1,2,"A",1,1,"D",1.61,4.1,5.73,"1-1","1-2",9,1,10,6,1,3,0,0,6,1,14,10,3,7,24,"6-1","Y","Y","N",4,0,31
"1101","E3",2024-02-13,"Bradford","Milton Keynes Dons",4,0,"H",2,0,"H",2.35,3.45,3.16,"2-0","4-0",11,7,16,3,5,1,0,0,1,6,16,8,4,7,24,"1-6","Y","Y","Y",6,0,31
"1102","E3",2024-02-13,"Crawley Town","Walsall",1,1,"D",0,1,"A",2.75,3.57,2.57,"0-1","1-1",15,3,11,4,3,3,0,0,7,8,13,12,2,15,25,"7-8","Y","N","N",6,0,31
"1103","E3",2024-02-13,"Gillingham","Swindon",2,2,"D",0,1,"A",1.8,3.88,4.48,"0-1","2-2",16,3,15,7,1,2,0,0,11,6,6,10,4,17,16,"11-6","Y","Y","Y",3,0,31
"1104","E3",2024-02-13,"Mansfield","Harrogate",9,2,"H",5,0,"H",1.44,4.83,7.27,"5-0","9-2",23,13,7,3,1,0,0,0,6,3,11,5,11,9,16,"6-3","Y","Y","Y",1,0,31
"1105","E3",2024-02-13,"Newport County","Notts County",1,3,"A",0,2,"A",2.65,3.87,2.51,"0-2","1-3",11,3,13,8,0,0,0,0,9,6,5,11,4,15,16,"9-6","Y","Y","Y",0,0,31
"1106","E3",2024-02-13,"Salford","Doncaster",2,2,"D",1,1,"D",1.88,3.77,4.18,"1-1","2-2",12,6,8,2,4,2,0,0,3,3,17,18,4,6,35,"3-3","Y","Y","Y",6,0,31
"1107","E3",2024-02-13,"Stockport","Crewe",1,3,"A",1,2,"A",1.49,4.6,6.66,"1-2","1-3",6,2,8,5,0,1,0,0,4,7,14,17,4,11,31,"4-7","Y","Y","Y",1,0,31
"1108","E3",2024-02-13,"Sutton","Wrexham",1,2,"A",0,1,"A",4.21,3.66,1.91,"0-1","1-2",11,6,12,4,3,0,0,0,10,2,7,9,3,12,16,"10-2","Y","Y","N",3,0,31
"1109","E3",2024-02-13,"Tranmere","Morecambe",2,3,"A",2,1,"H",2.02,3.65,3.77,"2-1","2-3",10,5,18,6,5,2,0,0,0,10,12,13,5,10,25,"0-10","Y","Y","Y",7,0,32
"1110","E3",2024-02-17,"AFC Wimbledon","Morecambe",1,1,"D",0,0,"D",1.61,4.18,5.66,"0-0","1-1",15,3,5,1,1,5,0,0,6,3,15,13,2,9,28,"6-3","Y","N","N",6,0,32
"1111","E3",2024-02-17,"Bradford","Sutton",1,0,"H",0,0,"D",1.68,3.91,5.48,"0-0","1-0",11,7,15,3,1,2,0,0,1,6,11,18,1,7,29,"1-6","N","N","N",3,0,32
"1112","E3",2024-02-17,"Colchester","Accrington",1,1,"D",1,0,"H",2.42,3.59,2.94,"1-0","1-1",17,5,8,1,3,1,0,1,6,4,16,10,2,10,26,"6-4","Y","N","N",4,1,32
"1113","E3",2024-02-17,"Crawley Town","Forest Green",2,0,"H",1,0,"H",2.42,3.62,2.91,"1-0","2-0",18,6,10,4,0,1,0,0,3,3,9,7,2,6,16,"3-3","Y","N","N",1,0,32
"1114","E3",2024-02-17,"Crewe","Harrogate",0,0,"D",0,0,"D",1.79,3.88,4.56,"0-0","0-0",18,2,1,0,0,3,0,0,7,1,11,12,0,8,23,"7-1","N","N","N",3,0,32
"1115","E3",2024-02-17,"Grimsby","Doncaster",1,5,"A",1,2,"A",1.96,3.67,3.98,"1-2","1-5",12,4,9,4,2,3,0,0,5,6,17,20,6,11,37,"5-6","Y","Y","Y",5,0,32
"1116","E3",2024-02-17,"Newport County","Gillingham",1,0,"H",0,0,"D",2.85,3.21,2.7,"0-0","1-0",6,2,18,3,2,2,0,0,4,5,11,11,1,9,22,"4-5","N","N","N",4,0,32
"1117","E3",2024-02-17,"Salford","Barrow",5,3,"H",1,1,"D",2.67,3.36,2.77,"1-1","5-3",29,12,14,8,3,1,0,0,8,6,15,10,8,14,25,"8-6","Y","Y","Y",4,0,32
"1118","E3",2024-02-17,"Swindon","Milton Keynes Dons",1,2,"A",0,2,"A",3.05,3.71,2.3,"0-2","1-2",12,3,9,3,2,1,0,0,5,1,13,9,3,6,22,"5-1","Y","Y","N",3,0,32
"1119","E3",2024-02-17,"Tranmere","Stockport",4,0,"H",1,0,"H",4.69,3.82,1.78,"1-0","4-0",16,9,11,3,1,2,0,0,7,6,8,9,4,13,17,"7-6","Y","Y","Y",3,0,32
"1120","E3",2024-02-17,"Walsall","Mansfield",2,1,"H",0,0,"D",3.52,3.72,2.08,"0-0","2-1",15,5,14,7,2,2,0,0,9,6,9,12,3,15,21,"9-6","Y","Y","N",4,0,32
"1121","E3",2024-02-17,"Wrexham","Notts County",1,0,"H",1,0,"H",2.04,3.84,3.52,"1-0","1-0",16,4,11,3,1,2,0,0,7,8,8,7,1,15,15,"7-8","N","N","N",3,0,33
"1122","E3",2024-02-20,"AFC Wimbledon","Crawley Town",0,1,"A",0,0,"D",1.67,4.16,5.03,"0-0","0-1",14,6,15,4,1,0,0,0,11,5,10,6,1,16,16,"11-5","N","N","N",1,0,33
"1123","E3",2024-02-20,"Gillingham","Stockport",0,0,"D",0,0,"D",3.05,3.36,2.45,"0-0","0-0",4,1,10,1,1,2,0,0,0,7,12,16,0,7,28,"0-7","N","N","N",3,0,33
"1124","E3",2024-02-20,"Milton Keynes Dons","Wrexham",1,1,"D",1,1,"D",2.33,3.6,3.06,"1-1","1-1",11,5,18,5,3,1,1,1,5,6,5,12,2,11,17,"5-6","Y","N","N",4,2,33
"1125","E3",2024-02-20,"Walsall","Morecambe",3,0,"H",2,0,"H",1.99,3.54,4,"2-0","3-0",13,6,16,1,4,2,0,0,6,8,12,12,3,14,24,"6-8","Y","Y","N",6,0,33
"1126","E3",2024-02-24,"Accrington","Crawley Town",0,1,"A",0,0,"D",2.24,3.48,3.33,"0-0","0-1",23,10,9,4,2,2,0,0,6,5,8,11,1,11,19,"6-5","N","N","N",4,0,33
"1127","E3",2024-02-24,"Doncaster","AFC Wimbledon",1,0,"H",1,0,"H",2.82,3.37,2.62,"1-0","1-0",14,3,4,1,0,3,0,0,8,2,5,18,1,10,23,"8-2","N","N","N",3,0,33
"1128","E3",2024-02-24,"Forest Green","Tranmere",1,0,"H",1,0,"H",2.53,3.47,2.86,"1-0","1-0",4,3,20,4,1,2,0,1,1,9,9,10,1,10,19,"1-9","N","N","N",3,1,33
"1129","E3",2024-02-24,"Gillingham","Wrexham",1,0,"H",0,0,"D",2.81,3.32,2.66,"0-0","1-0",14,5,16,3,0,2,0,0,7,11,10,8,1,18,18,"7-11","N","N","N",2,0,33
"1130","E3",2024-02-24,"Harrogate","Walsall",0,2,"A",0,0,"D",3.06,3.35,2.45,"0-0","0-2",12,0,16,6,0,2,0,0,7,4,2,7,2,11,9,"7-4","Y","N","N",2,0,33
"1131","E3",2024-02-24,"Mansfield","Salford",5,1,"H",2,1,"H",1.58,4.38,5.65,"2-1","5-1",29,7,14,3,2,3,0,1,9,8,11,11,6,17,22,"9-8","Y","Y","Y",5,1,33
"1132","E3",2024-02-24,"Milton Keynes Dons","Newport County",3,0,"H",3,0,"H",1.73,3.99,4.82,"3-0","3-0",20,8,4,2,2,3,0,0,9,5,9,11,3,14,20,"9-5","Y","Y","N",5,0,33
"1133","E3",2024-02-24,"Morecambe","Grimsby",1,1,"D",0,1,"A",2.36,3.54,3.05,"0-1","1-1",18,5,14,2,1,1,0,0,10,4,13,12,2,14,25,"10-4","Y","N","N",2,0,34
"1134","E3",2024-02-24,"Notts County","Crewe",1,3,"A",0,2,"A",1.92,3.99,3.8,"0-2","1-3",14,6,9,3,4,4,0,0,9,4,11,7,4,13,18,"9-4","Y","Y","Y",8,0,34
"1135","E3",2024-02-24,"Stockport","Swindon",0,0,"D",0,0,"D",1.46,4.83,6.8,"0-0","0-0",20,8,8,2,0,2,0,0,10,4,10,12,0,14,22,"10-4","N","N","N",2,0,34
"1136","E3",2024-02-24,"Sutton","Colchester",1,1,"D",1,1,"D",2.52,3.43,2.9,"1-1","1-1",16,4,11,4,2,3,0,0,5,5,15,12,2,10,27,"5-5","Y","N","N",5,0,34
"1137","E3",2024-02-27,"Forest Green","Wrexham",1,1,"D",1,0,"H",4.03,3.7,1.93,"1-0","1-1",6,2,19,5,1,0,0,0,3,6,8,7,2,9,15,"3-6","Y","N","N",1,0,34
"1138","E3",2024-02-27,"Harrogate","Newport County",1,4,"A",0,2,"A",2.59,3.43,2.81,"0-2","1-4",7,1,16,6,1,0,0,0,1,8,7,15,5,9,22,"1-8","Y","Y","Y",1,0,34
"1139","E3",2024-02-27,"Notts County","Sutton",3,4,"A",2,2,"D",1.69,4.17,4.85,"2-2","3-4",13,7,17,7,1,5,0,0,4,9,7,13,7,13,20,"4-9","Y","Y","Y",6,0,34
"1140","E3",2024-02-27,"Salford","Colchester",1,1,"D",1,0,"H",1.95,3.96,3.7,"1-0","1-1",11,5,16,7,4,2,0,0,2,4,12,15,2,6,27,"2-4","Y","N","N",6,0,34
"1141","E3",2024-02-27,"Swindon","Tranmere",3,1,"H",2,1,"H",2.46,3.52,2.92,"2-1","3-1",15,7,9,3,2,1,0,0,9,5,12,12,4,14,24,"9-5","Y","Y","Y",3,0,34
"1142","E3",2024-02-27,"Walsall","Accrington",2,1,"H",0,0,"D",1.85,3.74,4.39,"0-0","2-1",26,5,9,2,2,2,0,0,7,5,6,17,3,12,23,"7-5","Y","Y","N",4,0,34
"1143","E3",2024-03-02,"AFC Wimbledon","Milton Keynes Dons",1,0,"H",0,0,"D",2.58,3.42,2.84,"0-0","1-0",10,2,10,3,6,6,0,0,6,5,21,8,1,11,29,"6-5","N","N","N",12,0,34
"1144","E3",2024-03-02,"Crewe","Morecambe",2,3,"A",1,0,"H",1.88,3.76,4.21,"1-0","2-3",26,10,6,4,2,3,0,0,11,0,8,12,5,11,20,"11-0","Y","Y","Y",5,0,34
"1145","E3",2024-03-02,"Grimsby","Forest Green",1,0,"H",1,0,"H",2.09,3.59,3.61,"1-0","1-0",7,1,7,0,1,1,0,0,7,7,9,11,1,14,20,"7-7","N","N","N",2,0,35
"1146","E3",2024-03-02,"Newport County","Mansfield",0,1,"A",0,0,"D",4.6,4.01,1.76,"0-0","0-1",6,0,16,6,2,0,0,0,4,5,8,7,1,9,15,"4-5","N","N","N",2,0,35
"1147","E3",2024-03-02,"Salford","Gillingham",0,2,"A",0,1,"A",2.73,3.4,2.68,"0-1","0-2",15,4,10,4,3,1,0,0,9,6,12,8,2,15,20,"9-6","Y","N","N",4,0,35
"1148","E3",2024-03-02,"Swindon","Harrogate",1,1,"D",0,0,"D",1.83,3.99,4.2,"0-0","1-1",15,3,9,1,1,1,0,0,11,5,7,10,2,16,17,"11-5","Y","N","N",2,0,35
"1149","E3",2024-03-02,"Tranmere","Sutton",1,0,"H",0,0,"D",2.03,3.58,3.84,"0-0","1-0",24,13,11,6,3,3,0,0,9,8,4,13,1,17,17,"9-8","N","N","N",6,0,35
"1150","E3",2024-03-02,"Walsall","Doncaster",3,1,"H",1,0,"H",1.99,3.65,3.9,"1-0","3-1",10,4,6,5,0,5,0,0,8,4,8,13,4,12,21,"8-4","Y","Y","Y",5,0,35
"1151","E3",2024-03-02,"Wrexham","Accrington",4,0,"H",4,0,"H",1.52,4.6,6.23,"4-0","4-0",22,11,12,3,1,1,0,1,6,4,9,20,4,10,29,"6-4","Y","Y","Y",2,1,35
"1152","E3",2024-03-05,"AFC Wimbledon","Grimsby",0,0,"D",0,0,"D",1.88,3.71,4.31,"0-0","0-0",15,6,9,1,1,4,0,0,7,3,8,12,0,10,20,"7-3","N","N","N",5,0,35
"1153","E3",2024-03-05,"Barrow","Gillingham",2,0,"H",1,0,"H",2.22,3.36,3.5,"1-0","2-0",10,4,7,2,3,4,0,0,1,8,11,8,2,9,19,"1-8","Y","N","N",7,0,35
"1154","E3",2024-03-05,"Bradford","Doncaster",1,1,"D",0,1,"A",1.86,3.72,4.37,"0-1","1-1",6,3,13,5,5,4,0,0,1,10,19,10,2,11,29,"1-10","Y","N","N",9,0,35
"1155","E3",2024-03-05,"Mansfield","Milton Keynes Dons",1,2,"A",1,1,"D",1.86,3.76,4.3,"1-1","1-2",23,11,17,5,2,1,0,0,5,3,12,9,3,8,21,"5-3","Y","Y","N",3,0,35
"1156","E3",2024-03-05,"Morecambe","Crawley Town",1,0,"H",0,0,"D",2.25,3.61,3.2,"0-0","1-0",13,5,17,2,4,4,0,0,2,7,14,17,1,9,31,"2-7","N","N","N",8,0,35
"1157","E3",2024-03-09,"Accrington","Bradford",0,3,"A",0,3,"A",3.39,3.58,2.18,"0-3","0-3",16,3,17,5,1,1,0,0,6,7,15,8,3,13,23,"6-7","Y","Y","N",2,0,36
"1158","E3",2024-03-09,"Barrow","Colchester",2,0,"H",1,0,"H",1.88,3.93,4.03,"1-0","2-0",8,4,9,3,1,3,0,0,3,6,10,14,2,9,24,"3-6","Y","N","N",4,0,36
"1159","E3",2024-03-09,"Doncaster","Crewe",2,0,"H",1,0,"H",2.58,3.39,2.85,"1-0","2-0",14,9,9,2,0,4,0,0,5,7,11,12,2,12,23,"5-7","Y","N","N",4,0,36
"1160","E3",2024-03-09,"Forest Green","Walsall",2,0,"H",0,0,"D",3.39,3.39,2.25,"0-0","2-0",5,3,17,4,3,1,0,1,0,7,14,7,2,7,21,"0-7","Y","N","N",4,1,36
"1161","E3",2024-03-09,"Gillingham","Tranmere",1,1,"D",0,1,"A",2.07,3.42,3.88,"0-1","1-1",26,5,10,4,1,3,0,0,6,2,11,6,2,8,17,"6-2","Y","N","N",4,0,36
"1162","E3",2024-03-09,"Harrogate","Crawley Town",1,2,"A",1,0,"H",2.77,3.46,2.62,"1-0","1-2",17,8,18,5,1,1,0,0,5,7,6,10,3,12,16,"5-7","Y","Y","N",2,0,36
"1163","E3",2024-03-09,"Mansfield","Swindon",3,2,"H",1,0,"H",1.54,4.51,6,"1-0","3-2",22,10,20,8,1,1,0,0,6,3,9,8,5,9,17,"6-3","Y","Y","Y",2,0,36
"1164","E3",2024-03-09,"Milton Keynes Dons","Salford",3,1,"H",3,1,"H",1.82,4.05,4.19,"3-1","3-1",9,6,9,6,2,5,0,0,5,2,10,16,4,7,26,"5-2","Y","Y","Y",7,0,36
"1165","E3",2024-03-09,"Morecambe","Wrexham",1,3,"A",1,1,"D",3.71,3.73,2.01,"1-1","1-3",6,2,20,8,2,1,1,0,5,9,13,10,4,14,23,"5-9","Y","Y","Y",3,1,36
"1166","E3",2024-03-09,"Notts County","AFC Wimbledon",0,2,"A",0,0,"D",2.3,3.69,3.05,"0-0","0-2",8,1,8,4,2,5,0,0,7,2,8,17,2,9,25,"7-2","Y","N","N",7,0,36
"1167","E3",2024-03-09,"Stockport","Newport County",1,0,"H",0,0,"D",1.53,4.45,6.31,"0-0","1-0",27,14,3,2,1,4,0,0,11,2,8,15,1,13,23,"11-2","N","N","N",5,0,36
"1168","E3",2024-03-09,"Sutton","Grimsby",1,1,"D",0,1,"A",2.35,3.49,3.12,"0-1","1-1",9,1,20,9,1,3,0,0,4,7,13,15,2,11,28,"4-7","Y","N","N",4,0,36
"1169","E3",2024-03-12,"AFC Wimbledon","Gillingham",2,0,"H",1,0,"H",2.32,3.13,3.53,"1-0","2-0",16,9,8,2,1,2,0,1,7,3,13,10,2,10,23,"7-3","Y","N","N",3,1,37
"1170","E3",2024-03-12,"Bradford","Forest Green",0,2,"A",0,1,"A",1.56,4.1,6.61,"0-1","0-2",17,6,8,3,1,1,0,0,9,2,6,5,2,11,11,"9-2","Y","N","N",2,0,37
"1171","E3",2024-03-12,"Crawley Town","Notts County",2,1,"H",0,1,"A",2.75,3.99,2.39,"0-1","2-1",31,14,12,6,5,2,0,1,9,3,13,4,3,12,17,"9-3","Y","Y","N",7,1,37
"1172","E3",2024-03-12,"Crewe","Sutton",1,0,"H",0,0,"D",1.76,3.94,4.66,"0-0","1-0",7,3,11,2,1,4,0,0,5,4,13,12,1,9,25,"5-4","N","N","N",5,0,37
"1173","E3",2024-03-12,"Grimsby","Milton Keynes Dons",1,0,"H",1,0,"H",3.01,3.64,2.34,"1-0","1-0",7,3,6,1,5,0,0,0,2,6,17,16,1,8,33,"2-6","N","N","N",5,0,37
"1174","E3",2024-03-12,"Newport County","Morecambe",5,3,"H",2,1,"H",2.27,3.45,3.31,"2-1","5-3",19,9,23,7,3,1,0,0,8,5,12,8,8,13,20,"8-5","Y","Y","Y",4,0,37
"1175","E3",2024-03-12,"Swindon","Accrington",1,2,"A",0,0,"D",1.85,4.07,4.03,"0-0","1-2",15,5,14,6,2,2,0,0,6,4,7,14,3,10,21,"6-4","Y","Y","N",4,0,37
"1176","E3",2024-03-12,"Tranmere","Mansfield",2,1,"H",1,1,"D",4.01,3.76,1.93,"1-1","2-1",16,7,13,4,2,4,0,0,6,5,10,15,3,11,25,"6-5","Y","Y","N",6,0,37
"1177","E3",2024-03-12,"Walsall","Barrow",1,1,"D",1,0,"H",2.38,3.17,3.35,"1-0","1-1",12,6,12,3,2,1,0,0,2,5,11,12,2,7,23,"2-5","Y","N","N",3,0,37
"1178","E3",2024-03-12,"Wrexham","Harrogate",0,0,"D",0,0,"D",1.34,5.57,8.73,"0-0","0-0",16,4,3,0,1,2,0,0,10,3,13,9,0,13,22,"10-3","N","N","N",3,0,37
"1179","E3",2024-03-14,"Salford","Stockport",2,2,"D",2,0,"H",4.18,3.87,1.82,"2-0","2-2",6,4,11,5,4,2,0,0,2,7,14,15,4,9,29,"2-7","Y","Y","Y",6,0,37
"1180","E3",2024-03-16,"Accrington","Notts County",2,2,"D",1,2,"A",2.83,3.84,2.38,"1-2","2-2",23,6,14,7,2,1,0,0,6,5,13,11,4,11,24,"6-5","Y","Y","Y",3,0,37
"1181","E3",2024-03-16,"AFC Wimbledon","Newport County",0,2,"A",0,1,"A",1.74,3.87,4.9,"0-1","0-2",15,3,8,4,1,4,0,0,4,3,17,13,2,7,30,"4-3","Y","N","N",5,0,38
"1182","E3",2024-03-16,"Barrow","Harrogate",0,0,"D",0,0,"D",1.58,4.15,6.09,"0-0","0-0",18,1,8,1,1,1,0,0,4,2,9,13,0,6,22,"4-2","N","N","N",2,0,38
"1183","E3",2024-03-16,"Bradford","Mansfield",1,5,"A",0,4,"A",3.22,3.21,2.43,"0-4","1-5",6,1,27,11,2,2,0,0,5,5,10,11,6,10,21,"5-5","Y","Y","Y",4,0,38
"1184","E3",2024-03-16,"Colchester","Walsall",1,1,"D",0,1,"A",2.91,3.58,2.44,"0-1","1-1",14,6,13,4,1,2,0,0,8,6,14,14,2,14,28,"8-6","Y","N","N",3,0,38
"1185","E3",2024-03-16,"Forest Green","Sutton",0,1,"A",0,1,"A",2.29,3.49,3.23,"0-1","0-1",5,2,7,2,1,0,0,0,1,3,10,9,1,4,19,"1-3","N","N","N",1,0,38
"1186","E3",2024-03-16,"Gillingham","Grimsby",1,1,"D",1,1,"D",2.07,3.42,3.88,"1-1","1-1",15,6,8,3,2,3,0,0,4,2,15,19,2,6,34,"4-2","Y","N","N",5,0,38
"1187","E3",2024-03-16,"Milton Keynes Dons","Crewe",3,1,"H",3,1,"H",1.95,3.74,3.9,"3-1","3-1",14,10,15,6,3,2,0,0,4,3,14,12,4,7,26,"4-3","Y","Y","Y",5,0,38
"1188","E3",2024-03-16,"Swindon","Doncaster",1,2,"A",0,2,"A",2.23,3.81,3.1,"0-2","1-2",15,4,7,2,3,3,0,0,7,3,12,13,3,10,25,"7-3","Y","Y","N",6,0,38
"1189","E3",2024-03-16,"Wrexham","Tranmere",0,1,"A",0,1,"A",1.54,4.52,5.92,"0-1","0-1",25,4,7,3,2,2,0,0,9,4,7,10,1,13,17,"9-4","N","N","N",4,0,38
"1190","E3",2024-03-17,"Salford","Morecambe",3,1,"H",1,0,"H",1.87,4,3.99,"1-0","3-1",22,7,5,1,1,1,0,0,8,4,10,8,4,12,18,"8-4","Y","Y","Y",2,0,38
"1191","EC",2023-08-05,"Aldershot","Oxford City",5,2,"H",3,1,"H",1.99,3.68,3.69,"3-1","5-2",0,0,0,0,2,1,0,0,0,0,0,0,7,0,0,"0-0","Y","Y","Y",3,0,1
"1192","EC",2023-08-05,"Altrincham","Dag and Red",1,1,"D",0,0,"D",2.25,3.43,3.23,"0-0","1-1",0,0,0,0,2,2,0,0,0,0,0,0,2,0,0,"0-0","Y","N","N",4,0,1
"1193","EC",2023-08-05,"Barnet","Hartlepool",3,2,"H",1,0,"H",2.09,3.65,3.35,"1-0","3-2",0,0,0,0,1,3,0,0,0,0,0,0,5,0,0,"0-0","Y","Y","Y",4,0,1
"1194","EC",2023-08-05,"Chesterfield","Dorking",4,3,"H",1,1,"D",1.25,6.07,10.66,"1-1","4-3",0,0,0,0,2,3,0,1,0,0,0,0,7,0,0,"0-0","Y","Y","Y",5,1,1
"1195","EC",2023-08-05,"Gateshead","Boreham Wood",2,2,"D",2,0,"H",2.12,3.37,3.63,"2-0","2-2",0,0,0,0,1,3,0,1,0,0,0,0,4,0,0,"0-0","Y","Y","Y",4,1,1
"1196","EC",2023-08-05,"Halifax","Bromley",2,0,"H",0,0,"D",2.79,3.24,2.61,"0-0","2-0",0,0,0,0,3,2,0,0,0,0,0,0,2,0,0,"0-0","Y","N","N",5,0,1
"1197","EC",2023-08-05,"Kidderminster","Woking",0,0,"D",0,0,"D",2.96,3.29,2.49,"0-0","0-0",0,0,0,0,3,2,0,0,0,0,0,0,0,0,0,"0-0","N","N","N",5,0,1
"1198","EC",2023-08-05,"Maidenhead","Fylde",2,2,"D",2,1,"H",2.46,3.33,2.9,"2-1","2-2",0,0,0,0,3,1,0,1,0,0,0,0,4,0,0,"0-0","Y","Y","Y",4,1,1
"1199","EC",2023-08-05,"Solihull","Eastleigh",1,1,"D",0,0,"D",2.6,3.76,2.53,"0-0","1-1",0,0,0,0,1,2,1,0,0,0,0,0,2,0,0,"0-0","Y","N","N",3,1,1
"1200","EC",2023-08-05,"Southend","Oldham",4,0,"H",1,0,"H",3.1,3.37,2.35,"1-0","4-0",0,0,0,0,2,5,0,1,0,0,0,0,4,0,0,"0-0","Y","Y","Y",7,1,1
"1201","EC",2023-08-05,"Wealdstone","York",2,1,"H",0,1,"A",2.68,3.54,2.58,"0-1","2-1",0,0,0,0,3,1,0,1,0,0,0,0,3,0,0,"0-0","Y","Y","N",4,1,1
"1202","EC",2023-08-05,"Rochdale","Ebbsfleet",0,1,"A",0,1,"A",1.69,4.25,4.37,"0-1","0-1",0,0,0,0,2,5,0,0,0,0,0,0,1,0,0,"0-0","N","N","N",7,0,1
"1203","EC",2023-08-12,"Boreham Wood","Halifax",2,0,"H",0,0,"D",2.23,3.13,3.63,"0-0","2-0",0,0,0,0,1,2,0,0,0,0,0,0,2,0,0,"0-0","Y","N","N",3,0,2
"1204","EC",2023-08-12,"Dag and Red","Southend",0,2,"A",0,1,"A",2.68,3.47,2.61,"0-1","0-2",0,0,0,0,3,1,0,0,0,0,0,0,2,0,0,"0-0","Y","N","N",4,0,2
"1205","EC",2023-08-12,"Dorking","Maidenhead",0,2,"A",0,0,"D",2.05,3.69,3.49,"0-0","0-2",0,0,0,0,5,1,0,1,0,0,0,0,2,0,0,"0-0","Y","N","N",6,1,2
"1206","EC",2023-08-12,"Eastleigh","Wealdstone",0,0,"D",0,0,"D",1.7,3.93,4.68,"0-0","0-0",0,0,0,0,5,3,0,0,0,0,0,0,0,0,0,"0-0","N","N","N",8,0,2
"1207","EC",2023-08-12,"Ebbsfleet","Solihull",1,2,"A",0,1,"A",2.17,3.51,3.34,"0-1","1-2",0,0,0,0,3,5,0,0,0,0,0,0,3,0,0,"0-0","Y","Y","N",8,0,2
"1208","EC",2023-08-12,"Fylde","Chesterfield",2,4,"A",0,3,"A",3.94,3.92,1.86,"0-3","2-4",0,0,0,0,3,3,1,0,0,0,0,0,6,0,0,"0-0","Y","Y","Y",6,1,2
"1209","EC",2023-08-12,"Hartlepool","Gateshead",2,1,"H",1,0,"H",2.54,3.6,2.69,"1-0","2-1",0,0,0,0,2,2,1,0,0,0,0,0,3,0,0,"0-0","Y","Y","N",4,1,2
"1210","EC",2023-08-12,"Oldham","Aldershot",5,1,"H",3,0,"H",2.07,3.41,3.7,"3-0","5-1",0,0,0,0,2,1,0,1,0,0,0,0,6,0,0,"0-0","Y","Y","Y",3,1,2
"1211","EC",2023-08-12,"Oxford City","Rochdale",0,1,"A",0,0,"D",3.15,3.64,2.21,"0-0","0-1",0,0,0,0,2,1,0,0,0,0,0,0,1,0,0,"0-0","N","N","N",3,0,2
"1212","EC",2023-08-12,"Woking","Altrincham",2,3,"A",2,2,"D",1.59,4.37,5.24,"2-2","2-3",0,0,0,0,1,4,0,0,0,0,0,0,5,0,0,"0-0","Y","Y","Y",5,0,2
"1213","EC",2023-08-12,"York","Kidderminster",0,1,"A",0,0,"D",1.94,3.57,3.97,"0-0","0-1",0,0,0,0,2,2,0,0,0,0,0,0,1,0,0,"0-0","N","N","N",4,0,2
"1214","EC",2023-08-12,"Bromley","Barnet",0,2,"A",0,1,"A",2.25,3.74,3.01,"0-1","0-2",0,0,0,0,2,0,0,0,0,0,0,0,2,0,0,"0-0","Y","N","N",2,0,2
"1215","EC",2023-08-15,"Bromley","Wealdstone",1,1,"D",0,1,"A",1.71,4.01,4.63,"0-1","1-1",0,0,0,0,5,2,0,0,0,0,0,0,2,0,0,"0-0","Y","N","N",7,0,3
"1216","EC",2023-08-15,"Dag and Red","Gateshead",2,4,"A",0,1,"A",3.64,3.73,1.99,"0-1","2-4",0,0,0,0,4,3,0,0,0,0,0,0,6,0,0,"0-0","Y","Y","Y",7,0,3
"1217","EC",2023-08-15,"Dorking","Southend",2,1,"H",1,1,"D",4.21,3.82,1.83,"1-1","2-1",0,0,0,0,1,1,0,0,0,0,0,0,3,0,0,"0-0","Y","Y","N",2,0,3
"1218","EC",2023-08-15,"Eastleigh","Barnet",3,3,"D",1,3,"A",2.58,3.55,2.67,"1-3","3-3",0,0,0,0,3,3,0,0,0,0,0,0,6,0,0,"0-0","Y","Y","Y",6,0,3
"1219","EC",2023-08-15,"Ebbsfleet","Aldershot",2,0,"H",1,0,"H",1.99,3.66,3.71,"1-0","2-0",0,0,0,0,3,3,0,0,0,0,0,0,2,0,0,"0-0","Y","N","N",6,0,3
"1220","EC",2023-08-15,"Fylde","Kidderminster",2,1,"H",0,0,"D",2.18,3.53,3.31,"0-0","2-1",0,0,0,0,3,2,0,0,0,0,0,0,3,0,0,"0-0","Y","Y","N",5,0,3
"1221","EC",2023-08-15,"Hartlepool","Maidenhead",3,1,"H",0,0,"D",1.85,3.79,4.14,"0-0","3-1",0,0,0,0,4,2,0,0,0,0,0,0,4,0,0,"0-0","Y","Y","Y",6,0,3
"1222","EC",2023-08-15,"Oldham","Halifax",1,2,"A",1,1,"D",1.93,3.27,4.48,"1-1","1-2",0,0,0,0,4,3,0,0,0,0,0,0,3,0,0,"0-0","Y","Y","N",7,0,3
"1223","EC",2023-08-15,"Oxford City","Chesterfield",1,2,"A",0,1,"A",6.35,5.09,1.43,"0-1","1-2",0,0,0,0,2,1,0,0,0,0,0,0,3,0,0,"0-0","Y","Y","N",3,0,3
"1224","EC",2023-08-15,"Woking","Rochdale",3,2,"H",0,1,"A",2.04,3.54,3.67,"0-1","3-2",0,0,0,0,5,4,0,0,0,0,0,0,5,0,0,"0-0","Y","Y","Y",9,0,3
"1225","EC",2023-08-15,"York","Altrincham",2,2,"D",2,1,"H",2.16,3.77,3.16,"2-1","2-2",0,0,0,0,5,3,0,0,0,0,0,0,4,0,0,"0-0","Y","Y","Y",8,0,3
"1226","EC",2023-08-16,"Boreham Wood","Solihull",1,2,"A",0,1,"A",2,3.33,4.06,"0-1","1-2",0,0,0,0,2,1,0,0,0,0,0,0,3,0,0,"0-0","Y","Y","N",3,0,3
"1227","EC",2023-08-19,"Chesterfield","Oldham",1,1,"D",0,0,"D",1.6,4.29,5.27,"0-0","1-1",0,0,0,0,0,3,0,0,0,0,0,0,2,0,0,"0-0","Y","N","N",3,0,4
"1228","EC",2023-08-19,"Aldershot","York",1,1,"D",1,0,"H",2.47,3.5,2.83,"1-0","1-1",0,0,0,0,4,2,0,0,0,0,0,0,2,0,0,"0-0","Y","N","N",6,0,4
"1229","EC",2023-08-19,"Altrincham","Boreham Wood",1,1,"D",1,0,"H",2.44,3.45,2.91,"1-0","1-1",0,0,0,0,3,2,0,0,0,0,0,0,2,0,0,"0-0","Y","N","N",5,0,4
"1230","EC",2023-08-19,"Barnet","Woking",2,0,"H",1,0,"H",2.35,3.48,3.02,"1-0","2-0",0,0,0,0,1,1,0,0,0,0,0,0,2,0,0,"0-0","Y","N","N",2,0,4
"1231","EC",2023-08-19,"Gateshead","Ebbsfleet",4,1,"H",1,1,"D",1.9,3.91,3.78,"1-1","4-1",0,0,0,0,3,3,0,0,0,0,0,0,5,0,0,"0-0","Y","Y","Y",6,0,4
"1232","EC",2023-08-19,"Halifax","Oxford City",1,1,"D",1,0,"H",1.66,3.91,5.22,"1-0","1-1",0,0,0,0,2,1,0,0,0,0,0,0,2,0,0,"0-0","Y","N","N",3,0,4
"1233","EC",2023-08-19,"Kidderminster","Bromley",0,0,"D",0,0,"D",2.3,3.34,3.22,"0-0","0-0",0,0,0,0,1,2,1,1,0,0,0,0,0,0,0,"0-0","N","N","N",3,2,4
"1234","EC",2023-08-19,"Maidenhead","Dag and Red",1,0,"H",0,0,"D",2.45,3.32,2.98,"0-0","1-0",0,0,0,0,1,1,0,0,0,0,0,0,1,0,0,"0-0","N","N","N",2,0,4
"1235","EC",2023-08-19,"Rochdale","Eastleigh",2,0,"H",2,0,"H",2.03,3.69,3.54,"2-0","2-0",0,0,0,0,2,5,0,0,0,0,0,0,2,0,0,"0-0","Y","N","N",7,0,4
"1236","EC",2023-08-19,"Solihull","Dorking",3,0,"H",2,0,"H",1.76,4.16,4.16,"2-0","3-0",0,0,0,0,0,3,0,1,0,0,0,0,3,0,0,"0-0","Y","Y","N",3,1,4
"1237","EC",2023-08-19,"Southend","Hartlepool",2,3,"A",1,1,"D",1.99,3.6,3.75,"1-1","2-3",0,0,0,0,0,0,0,0,0,0,0,0,5,0,0,"0-0","Y","Y","Y",0,0,4
"1238","EC",2023-08-19,"Wealdstone","Fylde",3,2,"H",1,1,"D",2.66,3.73,2.5,"1-1","3-2",0,0,0,0,1,2,0,1,0,0,0,0,5,0,0,"0-0","Y","Y","Y",3,1,4
"1239","EC",2023-08-25,"Rochdale","Bromley",2,2,"D",1,1,"D",1.88,3.64,4.14,"1-1","2-2",0,0,0,0,0,1,1,1,0,0,0,0,4,0,0,"0-0","Y","Y","Y",1,2,5
"1240","EC",2023-08-25,"Solihull","Halifax",1,1,"D",1,0,"H",2.34,3.34,3.15,"1-0","1-1",0,0,0,0,1,1,0,0,0,0,0,0,2,0,0,"0-0","Y","N","N",2,0,5
"1241","EC",2023-08-25,"Southend","Eastleigh",2,0,"H",2,0,"H",1.84,3.79,4.18,"2-0","2-0",0,0,0,0,1,1,0,0,0,0,0,0,2,0,0,"0-0","Y","N","N",2,0,5
"1242","EC",2023-08-26,"Aldershot","Wealdstone",3,1,"H",1,0,"H",2.32,3.82,2.85,"1-0","3-1",0,0,0,0,3,2,0,0,0,0,0,0,4,0,0,"0-0","Y","Y","Y",5,0,5
"1243","EC",2023-08-26,"Altrincham","Chesterfield",2,1,"H",0,1,"A",4.03,4.25,1.78,"0-1","2-1",0,0,0,0,1,4,0,0,0,0,0,0,3,0,0,"0-0","Y","Y","N",5,0,5
"1244","EC",2023-08-26,"Boreham Wood","Oldham",0,0,"D",0,0,"D",2.62,3.37,2.73,"0-0","0-0",0,0,0,0,2,0,0,0,0,0,0,0,0,0,0,"0-0","N","N","N",2,0,5
"1245","EC",2023-08-26,"Dag and Red","Barnet",1,0,"H",0,0,"D",3.83,3.83,1.91,"0-0","1-0",0,0,0,0,4,0,0,0,0,0,0,0,1,0,0,"0-0","N","N","N",4,0,5
"1246","EC",2023-08-26,"Dorking","York",2,2,"D",1,0,"H",3.09,3.64,2.24,"1-0","2-2",0,0,0,0,1,1,0,1,0,0,0,0,4,0,0,"0-0","Y","Y","Y",2,1,5
"1247","EC",2023-08-26,"Ebbsfleet","Kidderminster",3,0,"H",3,0,"H",2.57,3.53,2.69,"3-0","3-0",0,0,0,0,1,0,0,1,0,0,0,0,3,0,0,"0-0","Y","Y","N",1,1,5
"1248","EC",2023-08-26,"Gateshead","Woking",1,3,"A",1,0,"H",2.08,3.61,3.48,"1-0","1-3",0,0,0,0,1,4,0,0,0,0,0,0,4,0,0,"0-0","Y","Y","Y",5,0,5
"1249","EC",2023-08-26,"Maidenhead","Oxford City",0,0,"D",0,0,"D",2.2,3.79,3.06,"0-0","0-0",0,0,0,0,3,2,0,0,0,0,0,0,0,0,0,"0-0","N","N","N",5,0,5
"1250","EC",2023-08-26,"Hartlepool","Fylde",3,1,"H",2,1,"H",2.12,3.67,3.33,"2-1","3-1",0,0,0,0,2,1,0,0,0,0,0,0,4,0,0,"0-0","Y","Y","Y",3,0,5
"1251","EC",2023-08-28,"Barnet","Ebbsfleet",3,2,"H",1,1,"D",2.01,3.81,3.5,"1-1","3-2",0,0,0,0,2,3,0,0,0,0,0,0,5,0,0,"0-0","Y","Y","Y",5,0,6
"1252","EC",2023-08-28,"Bromley","Southend",2,1,"H",1,0,"H",3.75,3.48,2.03,"1-0","2-1",0,0,0,0,3,1,0,0,0,0,0,0,3,0,0,"0-0","Y","Y","N",4,0,6
"1253","EC",2023-08-28,"Chesterfield","Hartlepool",3,2,"H",1,2,"A",1.76,4.22,4.1,"1-2","3-2",0,0,0,0,3,4,0,0,0,0,0,0,5,0,0,"0-0","Y","Y","Y",7,0,6
"1254","EC",2023-08-28,"Eastleigh","Aldershot",3,0,"H",1,0,"H",2.47,3.51,2.82,"1-0","3-0",0,0,0,0,0,1,0,1,0,0,0,0,3,0,0,"0-0","Y","Y","N",1,1,6
"1255","EC",2023-08-28,"Fylde","Altrincham",3,3,"D",0,2,"A",2.45,3.73,2.72,"0-2","3-3",0,0,0,0,4,1,0,0,0,0,0,0,6,0,0,"0-0","Y","Y","Y",5,0,6
"1256","EC",2023-08-28,"Halifax","Gateshead",0,0,"D",0,0,"D",2.79,3.51,2.49,"0-0","0-0",0,0,0,0,4,3,0,1,0,0,0,0,0,0,0,"0-0","N","N","N",7,1,6
"1257","EC",2023-08-28,"Kidderminster","Maidenhead",0,0,"D",0,0,"D",1.98,3.5,3.93,"0-0","0-0",0,0,0,0,2,2,0,0,0,0,0,0,0,0,0,"0-0","N","N","N",4,0,6
"1258","EC",2023-08-28,"Oldham","Solihull",0,2,"A",0,0,"D",1.9,3.98,3.72,"0-0","0-2",0,0,0,0,4,0,1,0,0,0,0,0,2,0,0,"0-0","Y","N","N",4,1,6
"1259","EC",2023-08-28,"Oxford City","Boreham Wood",4,0,"H",0,0,"D",3.48,3.47,2.13,"0-0","4-0",0,0,0,0,2,2,0,0,0,0,0,0,4,0,0,"0-0","Y","Y","Y",4,0,6
"1260","EC",2023-08-28,"Wealdstone","Dag and Red",0,2,"A",0,0,"D",2.25,3.77,2.98,"0-0","0-2",0,0,0,0,1,0,0,0,0,0,0,0,2,0,0,"0-0","Y","N","N",1,0,6
"1261","EC",2023-08-28,"Woking","Dorking",2,0,"H",1,0,"H",1.58,4.38,5.25,"1-0","2-0",0,0,0,0,2,0,0,0,0,0,0,0,2,0,0,"0-0","Y","N","N",2,0,6
"1262","EC",2023-08-28,"York","Rochdale",1,3,"A",1,1,"D",2.67,3.41,2.66,"1-1","1-3",0,0,0,0,5,4,1,0,0,0,0,0,4,0,0,"0-0","Y","Y","Y",9,1,6
"1263","EC",2023-09-02,"Aldershot","Chesterfield",3,4,"A",1,1,"D",4.25,3.97,1.79,"1-1","3-4",0,0,0,0,1,3,1,0,0,0,0,0,7,0,0,"0-0","Y","Y","Y",4,1,7
"1264","EC",2023-09-02,"Altrincham","Bromley",1,2,"A",1,1,"D",1.74,4,4.35,"1-1","1-2",0,0,0,0,2,1,0,0,0,0,0,0,3,0,0,"0-0","Y","Y","N",3,0,7
"1265","EC",2023-09-02,"Boreham Wood","Barnet",0,1,"A",0,0,"D",2.67,3.42,2.65,"0-0","0-1",0,0,0,0,3,2,0,0,0,0,0,0,1,0,0,"0-0","N","N","N",5,0,7
"1266","EC",2023-09-02,"Dag and Red","Fylde",3,1,"H",2,1,"H",2.55,3.49,2.69,"2-1","3-1",0,0,0,0,1,3,0,0,0,0,0,0,4,0,0,"0-0","Y","Y","Y",4,0,7
"1267","EC",2023-09-02,"Dorking","Eastleigh",0,0,"D",0,0,"D",3.03,3.64,2.27,"0-0","0-0",0,0,0,0,1,2,0,0,0,0,0,0,0,0,0,"0-0","N","N","N",3,0,7
"1268","EC",2023-09-02,"Ebbsfleet","York",4,1,"H",2,1,"H",2.06,3.64,3.49,"2-1","4-1",0,0,0,0,1,3,0,0,0,0,0,0,5,0,0,"0-0","Y","Y","Y",4,0,7
"1269","EC",2023-09-02,"Hartlepool","Wealdstone",2,1,"H",1,0,"H",1.7,4.12,4.57,"1-0","2-1",0,0,0,0,1,0,0,0,0,0,0,0,3,0,0,"0-0","Y","Y","N",1,0,7
"1270","EC",2023-09-02,"Maidenhead","Woking",0,0,"D",0,0,"D",3.79,3.37,2.06,"0-0","0-0",0,0,0,0,1,2,0,0,0,0,0,0,0,0,0,"0-0","N","N","N",3,0,7
"1271","EC",2023-09-02,"Rochdale","Halifax",0,1,"A",0,1,"A",1.96,3.53,3.96,"0-1","0-1",0,0,0,0,4,1,0,0,0,0,0,0,1,0,0,"0-0","N","N","N",5,0,7
"1272","EC",2023-09-02,"Solihull","Oxford City",3,3,"D",2,1,"H",1.8,4.06,4.06,"2-1","3-3",0,0,0,0,0,3,0,0,0,0,0,0,6,0,0,"0-0","Y","Y","Y",3,0,7
"1273","EC",2023-09-02,"Southend","Kidderminster",2,1,"H",0,0,"D",1.88,3.41,4.53,"0-0","2-1",0,0,0,0,1,2,0,0,0,0,0,0,3,0,0,"0-0","Y","Y","N",3,0,7
"1274","EC",2023-09-02,"Gateshead","Oldham",2,2,"D",0,1,"A",1.88,3.89,3.86,"0-1","2-2",0,0,0,0,2,4,0,1,0,0,0,0,4,0,0,"0-0","Y","Y","Y",6,1,7
"1275","EC",2023-09-09,"Halifax","Southend",1,1,"D",0,0,"D",2.66,3.25,2.78,"0-0","1-1",0,0,0,0,2,2,1,0,0,0,0,0,2,0,0,"0-0","Y","N","N",4,1,8
"1276","EC",2023-09-09,"Barnet","Altrincham",3,0,"H",1,0,"H",1.92,3.81,3.81,"1-0","3-0",0,0,0,0,2,3,0,0,0,0,0,0,3,0,0,"0-0","Y","Y","N",5,0,8
"1277","EC",2023-09-09,"Bromley","Maidenhead",4,1,"H",3,0,"H",2.2,3.49,3.3,"3-0","4-1",0,0,0,0,1,0,0,0,0,0,0,0,5,0,0,"0-0","Y","Y","Y",1,0,8
"1278","EC",2023-09-09,"Chesterfield","Dag and Red",3,1,"H",0,1,"A",1.47,4.78,6.23,"0-1","3-1",0,0,0,0,0,2,0,1,0,0,0,0,4,0,0,"0-0","Y","Y","Y",2,1,8
"1279","EC",2023-09-09,"Eastleigh","Gateshead",0,6,"A",0,4,"A",2.95,3.45,2.37,"0-4","0-6",0,0,0,0,4,3,0,0,0,0,0,0,6,0,0,"0-0","Y","Y","Y",7,0,8
"1280","EC",2023-09-09,"Fylde","Aldershot",0,2,"A",0,0,"D",1.95,4.06,3.46,"0-0","0-2",0,0,0,0,1,1,0,0,0,0,0,0,2,0,0,"0-0","Y","N","N",2,0,8
"1281","EC",2023-09-09,"Kidderminster","Rochdale",1,1,"D",1,0,"H",2.59,3.14,2.94,"1-0","1-1",0,0,0,0,4,1,0,0,0,0,0,0,2,0,0,"0-0","Y","N","N",5,0,8
"1282","EC",2023-09-09,"Oldham","Dorking",0,0,"D",0,0,"D",1.58,4.35,5.14,"0-0","0-0",0,0,0,0,2,2,0,0,0,0,0,0,0,0,0,"0-0","N","N","N",4,0,8
"1283","EC",2023-09-09,"Oxford City","Hartlepool",5,2,"H",1,2,"A",3.71,3.93,1.92,"1-2","5-2",0,0,0,0,4,0,0,0,0,0,0,0,7,0,0,"0-0","Y","Y","Y",4,0,8
"1284","EC",2023-09-09,"Wealdstone","Ebbsfleet",2,1,"H",0,0,"D",2.79,3.89,2.29,"0-0","2-1",0,0,0,0,4,5,1,1,0,0,0,0,3,0,0,"0-0","Y","Y","N",9,2,8
"1285","EC",2023-09-09,"Woking","Solihull",1,1,"D",0,1,"A",1.68,4.08,4.62,"0-1","1-1",0,0,0,0,4,3,0,0,0,0,0,0,2,0,0,"0-0","Y","N","N",7,0,8
"1286","EC",2023-09-09,"York","Boreham Wood",2,2,"D",1,0,"H",2.58,3.34,2.81,"1-0","2-2",0,0,0,0,1,4,0,0,0,0,0,0,4,0,0,"0-0","Y","Y","Y",5,0,8
"1287","EC",2023-09-16,"Aldershot","Gateshead",1,1,"D",0,0,"D",3.28,3.85,2.05,"0-0","1-1",0,0,0,0,2,0,0,0,0,0,0,0,2,0,0,"0-0","Y","N","N",2,0,9
"1288","EC",2023-09-16,"Bromley","Oldham",3,0,"H",2,0,"H",2.92,3.69,2.32,"2-0","3-0",0,0,0,0,1,1,0,0,0,0,0,0,3,0,0,"0-0","Y","Y","N",2,0,9
"1289","EC",2023-09-16,"Ebbsfleet","Chesterfield",0,1,"A",0,0,"D",3.26,4.09,2.02,"0-0","0-1",0,0,0,0,4,3,0,1,0,0,0,0,1,0,0,"0-0","N","N","N",7,1,9
"1290","EC",2023-09-16,"Fylde","Eastleigh",1,2,"A",0,1,"A",2.09,3.68,3.39,"0-1","1-2",0,0,0,0,1,2,1,0,0,0,0,0,3,0,0,"0-0","Y","Y","N",3,1,9
"1291","EC",2023-09-16,"Halifax","Dorking",0,1,"A",0,1,"A",1.71,4.04,4.47,"0-1","0-1",0,0,0,0,1,4,0,0,0,0,0,0,1,0,0,"0-0","N","N","N",5,0,9
"1292","EC",2023-09-16,"Hartlepool","Woking",0,2,"A",0,0,"D",2.28,3.53,3.11,"0-0","0-2",0,0,0,0,1,1,0,0,0,0,0,0,2,0,0,"0-0","Y","N","N",2,0,9
"1293","EC",2023-09-16,"Maidenhead","Boreham Wood",0,1,"A",0,0,"D",2.95,3.21,2.5,"0-0","0-1",0,0,0,0,0,3,0,0,0,0,0,0,1,0,0,"0-0","N","N","N",3,0,9
"1294","EC",2023-09-16,"Oxford City","Dag and Red",0,0,"D",0,0,"D",2.52,3.5,2.72,"0-0","0-0",0,0,0,0,2,1,0,0,0,0,0,0,0,0,0,"0-0","N","N","N",3,0,9
"1295","EC",2023-09-16,"Rochdale","Barnet",4,2,"H",2,1,"H",2.9,3.49,2.43,"2-1","4-2",0,0,0,0,2,1,0,0,0,0,0,0,6,0,0,"0-0","Y","Y","Y",3,0,9
"1296","EC",2023-09-16,"Wealdstone","Altrincham",0,0,"D",0,0,"D",2.66,3.8,2.47,"0-0","0-0",0,0,0,0,1,1,0,0,0,0,0,0,0,0,0,"0-0","N","N","N",2,0,9
"1297","EC",2023-09-16,"York","Southend",3,0,"H",1,0,"H",3.57,3.69,2.02,"1-0","3-0",0,0,0,0,2,2,0,2,0,0,0,0,3,0,0,"0-0","Y","Y","N",4,2,9
"1298","EC",2023-09-16,"Kidderminster","Solihull",0,1,"A",0,1,"A",2.22,3.45,3.28,"0-1","0-1",0,0,0,0,1,2,0,0,0,0,0,0,1,0,0,"0-0","N","N","N",3,0,9
"1299","EC",2023-09-19,"Altrincham","Hartlepool",2,2,"D",2,1,"H",2.9,3.76,2.3,"2-1","2-2",0,0,0,0,2,5,0,0,0,0,0,0,4,0,0,"0-0","Y","Y","Y",7,0,10
"1300","EC",2023-09-19,"Barnet","Aldershot",2,1,"H",1,0,"H",1.58,4.4,5.25,"1-0","2-1",0,0,0,0,3,3,0,0,0,0,0,0,3,0,0,"0-0","Y","Y","N",6,0,10
"1301","EC",2023-09-19,"Boreham Wood","Rochdale",1,1,"D",0,0,"D",2.65,3.18,2.84,"0-0","1-1",0,0,0,0,1,0,0,0,0,0,0,0,2,0,0,"0-0","Y","N","N",1,0,10
"1302","EC",2023-09-19,"Chesterfield","Halifax",3,2,"H",2,1,"H",1.46,4.46,7.03,"2-1","3-2",0,0,0,0,4,3,1,1,0,0,0,0,5,0,0,"0-0","Y","Y","Y",7,2,10
"1303","EC",2023-09-19,"Dag and Red","Bromley",0,1,"A",0,0,"D",2.66,3.11,2.89,"0-0","0-1",0,0,0,0,2,2,0,0,0,0,0,0,1,0,0,"0-0","N","N","N",4,0,10
"1304","EC",2023-09-19,"Dorking","Wealdstone",3,1,"H",3,0,"H",3.27,3.85,2.08,"3-0","3-1",0,0,0,0,3,2,0,0,0,0,0,0,4,0,0,"0-0","Y","Y","Y",5,0,10
"1305","EC",2023-09-19,"Eastleigh","Oxford City",2,2,"D",1,0,"H",2.16,3.78,3.15,"1-0","2-2",0,0,0,0,1,2,0,0,0,0,0,0,4,0,0,"0-0","Y","Y","Y",3,0,10
"1306","EC",2023-09-19,"Gateshead","Kidderminster",3,0,"H",2,0,"H",1.76,3.96,4.37,"2-0","3-0",0,0,0,0,0,1,0,0,0,0,0,0,3,0,0,"0-0","Y","Y","N",1,0,10
"1307","EC",2023-09-19,"Oldham","York",2,0,"H",1,0,"H",2.01,3.84,3.47,"1-0","2-0",0,0,0,0,3,1,0,0,0,0,0,0,2,0,0,"0-0","Y","N","N",4,0,10
"1308","EC",2023-09-19,"Solihull","Fylde",2,1,"H",2,1,"H",2.4,3.76,2.76,"2-1","2-1",0,0,0,0,2,3,0,0,0,0,0,0,3,0,0,"0-0","Y","Y","N",5,0,10
"1309","EC",2023-09-19,"Southend","Maidenhead",2,0,"H",0,0,"D",2.15,3.32,3.59,"0-0","2-0",0,0,0,0,1,1,0,0,0,0,0,0,2,0,0,"0-0","Y","N","N",2,0,10
"1310","EC",2023-09-19,"Woking","Ebbsfleet",1,1,"D",1,0,"H",1.72,3.89,4.76,"1-0","1-1",0,0,0,0,3,1,0,0,0,0,0,0,2,0,0,"0-0","Y","N","N",4,0,10
"1311","EC",2023-09-23,"Woking","York",1,2,"A",0,1,"A",1.82,3.82,4.24,"0-1","1-2",0,0,0,0,1,1,0,0,0,0,0,0,3,0,0,"0-0","Y","Y","N",2,0,11
"1312","EC",2023-09-23,"Altrincham","Ebbsfleet",6,1,"H",4,1,"H",2.1,3.49,3.55,"4-1","6-1",0,0,0,0,2,1,0,0,0,0,0,0,7,0,0,"0-0","Y","Y","Y",3,0,11
"1313","EC",2023-09-23,"Barnet","Halifax",0,0,"D",0,0,"D",1.79,3.5,4.92,"0-0","0-0",0,0,0,0,3,1,0,0,0,0,0,0,0,0,0,"0-0","N","N","N",4,0,11
"1314","EC",2023-09-23,"Boreham Wood","Aldershot",1,2,"A",0,1,"A",1.9,3.69,3.91,"0-1","1-2",0,0,0,0,2,0,0,0,0,0,0,0,3,0,0,"0-0","Y","Y","N",2,0,11
"1315","EC",2023-09-23,"Chesterfield","Wealdstone",3,2,"H",0,1,"A",1.42,5.39,6.12,"0-1","3-2",0,0,0,0,2,5,0,0,0,0,0,0,5,0,0,"0-0","Y","Y","Y",7,0,11
"1316","EC",2023-09-23,"Dag and Red","Hartlepool",0,1,"A",0,1,"A",3.19,3.57,2.22,"0-1","0-1",0,0,0,0,1,3,0,0,0,0,0,0,1,0,0,"0-0","N","N","N",4,0,11
"1317","EC",2023-09-23,"Dorking","Rochdale",1,2,"A",0,0,"D",3.81,3.82,1.88,"0-0","1-2",0,0,0,0,3,1,1,0,0,0,0,0,3,0,0,"0-0","Y","Y","N",4,1,11
"1318","EC",2023-09-23,"Eastleigh","Kidderminster",2,1,"H",2,1,"H",2.51,3.36,2.87,"2-1","2-1",0,0,0,0,2,1,0,0,0,0,0,0,3,0,0,"0-0","Y","Y","N",3,0,11
"1319","EC",2023-09-23,"Gateshead","Maidenhead",3,0,"H",0,0,"D",1.47,4.64,6.53,"0-0","3-0",0,0,0,0,0,1,0,0,0,0,0,0,3,0,0,"0-0","Y","Y","N",1,0,11
"1320","EC",2023-09-23,"Oldham","Oxford City",4,0,"H",2,0,"H",1.66,4.09,4.94,"2-0","4-0",0,0,0,0,1,2,0,0,0,0,0,0,4,0,0,"0-0","Y","Y","Y",3,0,11
"1321","EC",2023-09-23,"Solihull","Bromley",1,1,"D",0,0,"D",2.13,3.75,3.24,"0-0","1-1",0,0,0,0,1,2,0,0,0,0,0,0,2,0,0,"0-0","Y","N","N",3,0,11
"1322","EC",2023-09-23,"Southend","Fylde",1,2,"A",0,1,"A",1.83,3.81,4.21,"0-1","1-2",0,0,0,0,0,1,0,0,0,0,0,0,3,0,0,"0-0","Y","Y","N",1,0,11
"1323","EC",2023-09-26,"Aldershot","Southend",1,1,"D",1,0,"H",2.96,3.56,2.35,"1-0","1-1",0,0,0,0,2,3,0,0,0,0,0,0,2,0,0,"0-0","Y","N","N",5,0,12
"1324","EC",2023-09-26,"Bromley","Eastleigh",1,0,"H",1,0,"H",2.18,3.49,3.34,"1-0","1-0",0,0,0,0,1,2,0,0,0,0,0,0,1,0,0,"0-0","N","N","N",3,0,12
"1325","EC",2023-09-26,"Ebbsfleet","Dorking",0,1,"A",0,0,"D",1.63,4.38,4.79,"0-0","0-1",0,0,0,0,0,4,0,0,0,0,0,0,1,0,0,"0-0","N","N","N",4,0,12
"1326","EC",2023-09-26,"Fylde","Boreham Wood",2,2,"D",1,1,"D",2.43,3.44,2.93,"1-1","2-2",0,0,0,0,1,2,0,0,0,0,0,0,4,0,0,"0-0","Y","Y","Y",3,0,12
"1327","EC",2023-09-26,"Halifax","Dag and Red",0,0,"D",0,0,"D",2.14,3.25,3.68,"0-0","0-0",0,0,0,0,3,4,0,0,0,0,0,0,0,0,0,"0-0","N","N","N",7,0,12
"1328","EC",2023-09-26,"Hartlepool","Solihull",0,2,"A",0,2,"A",2.01,3.78,3.52,"0-2","0-2",0,0,0,0,3,3,0,0,0,0,0,0,2,0,0,"0-0","Y","N","N",6,0,12
"1329","EC",2023-09-26,"Kidderminster","Oldham",1,2,"A",0,1,"A",2.98,3.31,2.46,"0-1","1-2",0,0,0,0,1,1,0,0,0,0,0,0,3,0,0,"0-0","Y","Y","N",2,0,12
"1330","EC",2023-09-26,"Maidenhead","Altrincham",0,1,"A",0,0,"D",3.11,3.52,2.28,"0-0","0-1",0,0,0,0,2,1,0,0,0,0,0,0,1,0,0,"0-0","N","N","N",3,0,12
"1331","EC",2023-09-26,"Oxford City","Gateshead",0,4,"A",0,1,"A",4.94,4.43,1.61,"0-1","0-4",0,0,0,0,1,3,0,0,0,0,0,0,4,0,0,"0-0","Y","Y","Y",4,0,12
"1332","EC",2023-09-26,"Wealdstone","Woking",1,0,"H",1,0,"H",3.26,3.85,2.09,"1-0","1-0",0,0,0,0,2,0,0,0,0,0,0,0,1,0,0,"0-0","N","N","N",2,0,12
"1333","EC",2023-09-26,"York","Barnet",2,4,"A",1,1,"D",3.1,3.61,2.25,"1-1","2-4",0,0,0,0,0,2,0,0,0,0,0,0,6,0,0,"0-0","Y","Y","Y",2,0,12
"1334","EC",2023-09-26,"Rochdale","Chesterfield",1,2,"A",1,2,"A",3.46,3.73,2.05,"1-2","1-2",0,0,0,0,3,3,0,0,0,0,0,0,3,0,0,"0-0","Y","Y","N",6,0,12
"1335","EC",2023-09-30,"Aldershot","Dag and Red",3,2,"H",1,1,"D",2.33,3.6,2.97,"1-1","3-2",0,0,0,0,1,5,0,1,0,0,0,0,5,0,0,"0-0","Y","Y","Y",6,1,13
"1336","EC",2023-09-30,"Bromley","Gateshead",3,1,"H",0,0,"D",3.72,3.57,2.01,"0-0","3-1",0,0,0,0,4,2,1,0,0,0,0,0,4,0,0,"0-0","Y","Y","Y",6,1,13
"1337","EC",2023-09-30,"Ebbsfleet","Boreham Wood",3,1,"H",2,1,"H",2.56,3.65,2.63,"2-1","3-1",0,0,0,0,2,6,0,1,0,0,0,0,4,0,0,"0-0","Y","Y","Y",8,1,13
"1338","EC",2023-09-30,"Fylde","Woking",0,2,"A",0,1,"A",2.86,3.55,2.42,"0-1","0-2",0,0,0,0,1,3,0,0,0,0,0,0,2,0,0,"0-0","Y","N","N",4,0,13
"1339","EC",2023-09-30,"Halifax","Eastleigh",2,3,"A",0,1,"A",1.99,3.44,3.95,"0-1","2-3",0,0,0,0,1,2,0,0,0,0,0,0,5,0,0,"0-0","Y","Y","Y",3,0,13
"1340","EC",2023-09-30,"Hartlepool","Dorking",0,2,"A",0,0,"D",1.56,4.6,5.22,"0-0","0-2",0,0,0,0,1,1,0,0,0,0,0,0,2,0,0,"0-0","Y","N","N",2,0,13
"1341","EC",2023-09-30,"Kidderminster","Barnet",1,2,"A",0,2,"A",3.2,3.61,2.16,"0-2","1-2",0,0,0,0,2,3,0,0,0,0,0,0,3,0,0,"0-0","Y","Y","N",5,0,13
"1342","EC",2023-09-30,"Maidenhead","Chesterfield",1,1,"D",1,0,"H",6.46,4.21,1.52,"1-0","1-1",0,0,0,0,3,3,0,0,0,0,0,0,2,0,0,"0-0","Y","N","N",6,0,13
"1343","EC",2023-09-30,"Rochdale","Southend",2,2,"D",2,1,"H",2.36,3.39,3,"2-1","2-2",0,0,0,0,0,4,0,0,0,0,0,0,4,0,0,"0-0","Y","Y","Y",4,0,13
"1344","EC",2023-09-30,"Wealdstone","Oldham",1,1,"D",1,1,"D",3.3,3.7,2.08,"1-1","1-1",0,0,0,0,1,1,0,0,0,0,0,0,2,0,0,"0-0","Y","N","N",2,0,13
"1345","EC",2023-09-30,"York","Solihull",2,2,"D",1,0,"H",2.44,3.69,2.7,"1-0","2-2",0,0,0,0,2,1,0,0,0,0,0,0,4,0,0,"0-0","Y","Y","Y",3,0,13
"1346","EC",2023-09-30,"Oxford City","Altrincham",1,2,"A",0,1,"A",3.21,3.86,2.11,"0-1","1-2",0,0,0,0,1,0,0,0,0,0,0,0,3,0,0,"0-0","Y","Y","N",1,0,13
"1347","EC",2023-10-03,"Altrincham","Aldershot",2,1,"H",1,0,"H",1.81,3.96,4.1,"1-0","2-1",0,0,0,0,2,2,0,0,0,0,0,0,3,0,0,"0-0","Y","Y","N",4,0,14
"1348","EC",2023-10-03,"Barnet","Fylde",2,1,"H",0,1,"A",1.51,4.56,6.01,"0-1","2-1",0,0,0,0,1,6,0,1,0,0,0,0,3,0,0,"0-0","Y","Y","N",7,1,14
"1349","EC",2023-10-03,"Chesterfield","Bromley",2,0,"H",0,0,"D",1.41,5.02,7.1,"0-0","2-0",0,0,0,0,2,2,0,0,0,0,0,0,2,0,0,"0-0","Y","N","N",4,0,14
"1350","EC",2023-10-03,"Dag and Red","York",1,2,"A",0,0,"D",2.5,3.13,3.08,"0-0","1-2",0,0,0,0,2,1,0,0,0,0,0,0,3,0,0,"0-0","Y","Y","N",3,0,14
"1351","EC",2023-10-03,"Dorking","Kidderminster",0,1,"A",0,1,"A",2.63,3.52,2.63,"0-1","0-1",0,0,0,0,2,1,0,0,0,0,0,0,1,0,0,"0-0","N","N","N",3,0,14
"1352","EC",2023-10-03,"Eastleigh","Ebbsfleet",5,2,"H",2,1,"H",2.1,3.88,3.21,"2-1","5-2",0,0,0,0,4,3,0,1,0,0,0,0,7,0,0,"0-0","Y","Y","Y",7,1,14
"1353","EC",2023-10-03,"Gateshead","Wealdstone",2,1,"H",0,0,"D",1.44,4.92,6.53,"0-0","2-1",0,0,0,0,1,2,0,0,0,0,0,0,3,0,0,"0-0","Y","Y","N",3,0,14
"1354","EC",2023-10-03,"Oldham","Maidenhead",1,1,"D",1,0,"H",1.62,4.22,5.11,"1-0","1-1",0,0,0,0,2,2,0,0,0,0,0,0,2,0,0,"0-0","Y","N","N",4,0,14
"1355","EC",2023-10-03,"Solihull","Rochdale",2,0,"H",0,0,"D",2.46,3.44,2.89,"0-0","2-0",0,0,0,0,0,3,0,0,0,0,0,0,2,0,0,"0-0","Y","N","N",3,0,14
"1356","EC",2023-10-03,"Southend","Oxford City",2,0,"H",2,0,"H",1.52,4.39,6.12,"2-0","2-0",0,0,0,0,2,1,0,0,0,0,0,0,2,0,0,"0-0","Y","N","N",3,0,14
"1357","EC",2023-10-03,"Woking","Halifax",1,2,"A",1,0,"H",1.88,3.47,4.39,"1-0","1-2",0,0,0,0,4,0,0,0,0,0,0,0,3,0,0,"0-0","Y","Y","N",4,0,14
"1358","EC",2023-10-04,"Boreham Wood","Hartlepool",1,0,"H",0,0,"D",2.56,3.45,2.75,"0-0","1-0",0,0,0,0,2,1,0,0,0,0,0,0,1,0,0,"0-0","N","N","N",3,0,14
"1359","EC",2023-10-07,"Boreham Wood","Chesterfield",0,2,"A",0,1,"A",3.87,3.67,1.93,"0-1","0-2",0,0,0,0,1,0,0,0,0,0,0,0,2,0,0,"0-0","Y","N","N",1,0,15
"1360","EC",2023-10-07,"Ebbsfleet","Halifax",0,2,"A",0,1,"A",2.48,3.54,2.79,"0-1","0-2",0,0,0,0,2,2,0,0,0,0,0,0,2,0,0,"0-0","Y","N","N",4,0,15
"1361","EC",2023-10-07,"Gateshead","Altrincham",0,2,"A",0,0,"D",1.59,4.4,5.18,"0-0","0-2",0,0,0,0,5,2,0,0,0,0,0,0,2,0,0,"0-0","Y","N","N",7,0,15
"1362","EC",2023-10-07,"Hartlepool","Eastleigh",3,1,"H",1,1,"D",2.07,3.92,3.19,"1-1","3-1",0,0,0,0,1,2,0,0,0,0,0,0,4,0,0,"0-0","Y","Y","Y",3,0,15
"1363","EC",2023-10-07,"Kidderminster","Wealdstone",1,0,"H",0,0,"D",2.21,3.61,3.18,"0-0","1-0",0,0,0,0,1,2,0,0,0,0,0,0,1,0,0,"0-0","N","N","N",3,0,15
"1364","EC",2023-10-07,"Maidenhead","Rochdale",2,2,"D",0,1,"A",3.37,3.43,2.19,"0-1","2-2",0,0,0,0,3,3,0,0,0,0,0,0,4,0,0,"0-0","Y","Y","Y",6,0,15
"1365","EC",2023-10-07,"Oldham","Dag and Red",1,1,"D",1,0,"H",1.8,3.69,4.51,"1-0","1-1",0,0,0,0,0,1,0,0,0,0,0,0,2,0,0,"0-0","Y","N","N",1,0,15
"1366","EC",2023-10-07,"Oxford City","Fylde",3,0,"H",1,0,"H",3.01,3.32,2.44,"1-0","3-0",0,0,0,0,2,2,0,0,0,0,0,0,3,0,0,"0-0","Y","Y","N",4,0,15
"1367","EC",2023-10-07,"Solihull","Aldershot",0,1,"A",0,0,"D",1.89,3.9,3.82,"0-0","0-1",0,0,0,0,1,4,0,0,0,0,0,0,1,0,0,"0-0","N","N","N",5,0,15
"1368","EC",2023-10-07,"Woking","Southend",0,2,"A",0,1,"A",2.13,3.59,3.29,"0-1","0-2",0,0,0,0,2,1,0,0,0,0,0,0,2,0,0,"0-0","Y","N","N",3,0,15
"1369","EC",2023-10-07,"York","Bromley",2,2,"D",1,0,"H",2.34,3.43,3.02,"1-0","2-2",0,0,0,0,2,2,0,0,0,0,0,0,4,0,0,"0-0","Y","Y","Y",4,0,15
"1370","EC",2023-10-07,"Dorking","Barnet",2,3,"A",2,0,"H",4.86,3.95,1.69,"2-0","2-3",0,0,0,0,3,1,0,0,0,0,0,0,5,0,0,"0-0","Y","Y","Y",4,0,15
"1371","EC",2023-10-21,"Aldershot","Hartlepool",2,1,"H",0,0,"D",2.82,3.78,2.35,"0-0","2-1",0,0,0,0,3,2,0,0,0,0,0,0,3,0,0,"0-0","Y","Y","N",5,0,16
"1372","EC",2023-10-21,"Barnet","Maidenhead",3,2,"H",1,2,"A",1.41,4.77,7.54,"1-2","3-2",0,0,0,0,2,5,0,1,0,0,0,0,5,0,0,"0-0","Y","Y","Y",7,1,16
"1373","EC",2023-10-21,"Bromley","Oxford City",3,1,"H",1,1,"D",1.71,4.25,4.36,"1-1","3-1",0,0,0,0,2,0,0,0,0,0,0,0,4,0,0,"0-0","Y","Y","Y",2,0,16
"1374","EC",2023-10-21,"Dag and Red","Woking",2,1,"H",1,1,"D",2.92,3.32,2.5,"1-1","2-1",0,0,0,0,3,1,0,1,0,0,0,0,3,0,0,"0-0","Y","Y","N",4,1,16
"1375","EC",2023-10-21,"Eastleigh","York",3,1,"H",1,0,"H",2.07,3.78,3.36,"1-0","3-1",0,0,0,0,1,2,0,0,0,0,0,0,4,0,0,"0-0","Y","Y","Y",3,0,16
"1376","EC",2023-10-21,"Fylde","Ebbsfleet",1,1,"D",0,1,"A",2.1,4.02,3.12,"0-1","1-1",0,0,0,0,1,1,0,1,0,0,0,0,2,0,0,"0-0","Y","N","N",2,1,16
"1377","EC",2023-10-21,"Halifax","Kidderminster",2,1,"H",1,1,"D",2.13,3.26,3.71,"1-1","2-1",0,0,0,0,1,2,0,0,0,0,0,0,3,0,0,"0-0","Y","Y","N",3,0,16
"1378","EC",2023-10-21,"Rochdale","Oldham",3,4,"A",0,1,"A",2.29,3.66,2.99,"0-1","3-4",0,0,0,0,0,2,0,0,0,0,0,0,7,0,0,"0-0","Y","Y","Y",2,0,16
"1379","EC",2023-10-21,"Southend","Solihull",5,0,"H",2,0,"H",1.93,3.49,4.14,"2-0","5-0",0,0,0,0,2,5,0,0,0,0,0,0,5,0,0,"0-0","Y","Y","Y",7,0,16
"1380","EC",2023-10-21,"Wealdstone","Boreham Wood",1,1,"D",1,1,"D",2.6,3.35,2.77,"1-1","1-1",0,0,0,0,1,4,1,0,0,0,0,0,2,0,0,"0-0","Y","N","N",5,1,16
"1381","EC",2023-10-24,"Aldershot","Maidenhead",4,2,"H",2,2,"D",1.91,3.77,3.87,"2-2","4-2",0,0,0,0,2,3,0,0,0,0,0,0,6,0,0,"0-0","Y","Y","Y",5,0,16
"1382","EC",2023-10-24,"Altrincham","Kidderminster",1,1,"D",1,1,"D",2.08,3.55,3.53,"1-1","1-1",0,0,0,0,1,3,0,0,0,0,0,0,2,0,0,"0-0","Y","N","N",4,0,16
"1383","EC",2023-10-24,"Barnet","Solihull",1,1,"D",0,0,"D",1.56,4.33,5.59,"0-0","1-1",0,0,0,0,3,3,0,0,0,0,0,0,2,0,0,"0-0","Y","N","N",6,0,17
"1384","EC",2023-10-24,"Bromley","Dorking",2,1,"H",1,1,"D",1.64,4.29,4.87,"1-1","2-1",0,0,0,0,3,3,0,0,0,0,0,0,3,0,0,"0-0","Y","Y","N",6,0,17
"1385","EC",2023-10-24,"Chesterfield","York",4,0,"H",0,0,"D",1.31,5.71,8.83,"0-0","4-0",0,0,0,0,1,1,0,0,0,0,0,0,4,0,0,"0-0","Y","Y","Y",2,0,17
"1386","EC",2023-10-24,"Dag and Red","Boreham Wood",1,3,"A",1,1,"D",2.44,3.21,3.09,"1-1","1-3",0,0,0,0,0,1,0,0,0,0,0,0,4,0,0,"0-0","Y","Y","Y",1,0,17
"1387","EC",2023-10-24,"Eastleigh","Woking",0,1,"A",0,1,"A",3.08,3.58,2.27,"0-1","0-1",0,0,0,0,0,3,0,0,0,0,0,0,1,0,0,"0-0","N","N","N",3,0,17
"1388","EC",2023-10-24,"Fylde","Oldham",3,0,"H",2,0,"H",2.86,3.72,2.35,"2-0","3-0",0,0,0,0,2,1,0,1,0,0,0,0,3,0,0,"0-0","Y","Y","N",3,1,17
"1389","EC",2023-10-24,"Halifax","Hartlepool",2,1,"H",1,1,"D",2.51,3.34,2.88,"1-1","2-1",0,0,0,0,2,5,0,0,0,0,0,0,3,0,0,"0-0","Y","Y","N",7,0,17
"1390","EC",2023-10-24,"Rochdale","Gateshead",2,2,"D",2,0,"H",3.44,3.78,2.04,"2-0","2-2",0,0,0,0,2,3,0,1,0,0,0,0,4,0,0,"0-0","Y","Y","Y",5,1,17
"1391","EC",2023-10-24,"Southend","Ebbsfleet",3,0,"H",1,0,"H",1.47,4.72,6.27,"1-0","3-0",0,0,0,0,0,3,0,0,0,0,0,0,3,0,0,"0-0","Y","Y","N",3,0,17
"1392","EC",2023-10-24,"Wealdstone","Oxford City",3,1,"H",1,1,"D",1.64,4.23,4.94,"1-1","3-1",0,0,0,0,2,0,0,0,0,0,0,0,4,0,0,"0-0","Y","Y","Y",2,0,17
"1393","EC",2023-10-28,"Boreham Wood","Southend",1,1,"D",0,1,"A",3.57,3.66,2.03,"0-1","1-1",0,0,0,0,4,3,0,0,0,0,0,0,2,0,0,"0-0","Y","N","N",7,0,17
"1394","EC",2023-10-28,"Dorking","Aldershot",2,1,"H",1,0,"H",2.82,3.79,2.35,"1-0","2-1",0,0,0,0,6,2,0,0,0,0,0,0,3,0,0,"0-0","Y","Y","N",8,0,17
"1395","EC",2023-10-28,"Ebbsfleet","Dag and Red",0,1,"A",0,0,"D",2.27,3.74,2.83,"0-0","0-1",0,0,0,0,1,4,0,0,0,0,0,0,1,0,0,"0-0","N","N","N",5,0,18
"1396","EC",2023-10-28,"Gateshead","Fylde",0,4,"A",0,2,"A",1.5,4.79,5.79,"0-2","0-4",0,0,0,0,1,2,0,0,0,0,0,0,4,0,0,"0-0","Y","Y","Y",3,0,18
"1397","EC",2023-10-28,"Hartlepool","Rochdale",2,3,"A",1,3,"A",2.23,4.01,2.88,"1-3","2-3",0,0,0,0,1,0,0,0,0,0,0,0,5,0,0,"0-0","Y","Y","Y",1,0,18
"1398","EC",2023-10-28,"Kidderminster","Chesterfield",1,3,"A",1,1,"D",4.53,3.83,1.77,"1-1","1-3",0,0,0,0,2,2,1,0,0,0,0,0,4,0,0,"0-0","Y","Y","Y",4,1,18
"1399","EC",2023-10-28,"Maidenhead","Eastleigh",3,2,"H",2,0,"H",2.93,3.68,2.32,"2-0","3-2",0,0,0,0,2,6,0,0,0,0,0,0,5,0,0,"0-0","Y","Y","Y",8,0,18
"1400","EC",2023-10-28,"Oldham","Altrincham",2,2,"D",1,2,"A",2.25,3.86,2.93,"1-2","2-2",0,0,0,0,2,1,0,0,0,0,0,0,4,0,0,"0-0","Y","Y","Y",3,0,18
"1401","EC",2023-10-28,"Oxford City","Barnet",0,2,"A",0,2,"A",6.08,4.59,1.5,"0-2","0-2",0,0,0,0,1,1,0,0,0,0,0,0,2,0,0,"0-0","Y","N","N",2,0,18
"1402","EC",2023-10-28,"Solihull","Wealdstone",1,0,"H",0,0,"D",2.12,3.82,3.2,"0-0","1-0",0,0,0,0,1,1,0,1,0,0,0,0,1,0,0,"0-0","N","N","N",2,1,18
"1403","EC",2023-10-28,"Woking","Bromley",0,1,"A",0,0,"D",2.05,3.57,3.59,"0-0","0-1",0,0,0,0,2,0,0,0,0,0,0,0,1,0,0,"0-0","N","N","N",2,0,18
"1404","EC",2023-10-28,"York","Halifax",1,1,"D",0,0,"D",2.98,3.65,2.3,"0-0","1-1",0,0,0,0,2,1,0,0,0,0,0,0,2,0,0,"0-0","Y","N","N",3,0,18
"1405","EC",2023-11-04,"Dorking","Dag and Red",1,3,"A",1,2,"A",2.85,3.57,2.42,"1-2","1-3",0,0,0,0,3,1,0,0,0,0,0,0,4,0,0,"0-0","Y","Y","Y",4,0,18
"1406","EC",2023-11-11,"Aldershot","Kidderminster",1,0,"H",1,0,"H",2.16,3.74,3.17,"1-0","1-0",0,0,0,0,0,1,0,0,0,0,0,0,1,0,0,"0-0","N","N","N",1,0,18
"1407","EC",2023-11-11,"Altrincham","Southend",2,0,"H",0,0,"D",2.69,3.59,2.54,"0-0","2-0",0,0,0,0,0,0,0,0,0,0,0,0,2,0,0,"0-0","Y","N","N",0,0,19
"1408","EC",2023-11-11,"Boreham Wood","Bromley",1,1,"D",0,1,"A",2.6,3.27,2.83,"0-1","1-1",0,0,0,0,0,2,1,0,0,0,0,0,2,0,0,"0-0","Y","N","N",2,1,19
"1409","EC",2023-11-11,"Chesterfield","Barnet",4,2,"H",0,0,"D",1.9,3.9,3.8,"0-0","4-2",0,0,0,0,1,2,0,0,0,0,0,0,6,0,0,"0-0","Y","Y","Y",3,0,19
"1410","EC",2023-11-11,"Fylde","York",0,2,"A",0,2,"A",1.89,3.85,3.88,"0-2","0-2",0,0,0,0,0,1,0,0,0,0,0,0,2,0,0,"0-0","Y","N","N",1,0,19
"1411","EC",2023-11-11,"Gateshead","Dorking",6,0,"H",3,0,"H",1.37,5.18,7.75,"3-0","6-0",0,0,0,0,1,3,0,0,0,0,0,0,6,0,0,"0-0","Y","Y","Y",4,0,19
"1412","EC",2023-11-11,"Hartlepool","Ebbsfleet",2,2,"D",1,1,"D",1.71,4.45,4.15,"1-1","2-2",0,0,0,0,2,2,0,0,0,0,0,0,4,0,0,"0-0","Y","Y","Y",4,0,19
"1413","EC",2023-11-11,"Maidenhead","Halifax",1,0,"H",1,0,"H",2.65,3.41,2.64,"1-0","1-0",0,0,0,0,2,1,1,0,0,0,0,0,1,0,0,"0-0","N","N","N",3,1,19
"1414","EC",2023-11-11,"Oldham","Eastleigh",1,1,"D",0,1,"A",1.56,4.1,4.71,"0-1","1-1",0,0,0,0,4,1,0,0,0,0,0,0,2,0,0,"0-0","Y","N","N",5,0,19
"1415","EC",2023-11-11,"Oxford City","Woking",3,2,"H",2,0,"H",4.26,4.09,1.76,"2-0","3-2",0,0,0,0,4,1,0,0,0,0,0,0,5,0,0,"0-0","Y","Y","Y",5,0,19
"1416","EC",2023-11-11,"Wealdstone","Rochdale",3,2,"H",1,1,"D",2.74,3.54,2.48,"1-1","3-2",0,0,0,0,4,1,0,0,0,0,0,0,5,0,0,"0-0","Y","Y","Y",5,0,19
"1417","EC",2023-11-11,"Dag and Red","Solihull",1,2,"A",1,1,"D",2.41,3.27,3.08,"1-1","1-2",0,0,0,0,2,4,0,0,0,0,0,0,3,0,0,"0-0","Y","Y","N",6,0,19
"1418","EC",2023-11-18,"Barnet","Gateshead",0,2,"A",0,0,"D",2.05,3.99,3.26,"0-0","0-2",0,0,0,0,1,2,0,0,0,0,0,0,2,0,0,"0-0","Y","N","N",3,0,19
"1419","EC",2023-11-18,"Bromley","Fylde",1,0,"H",0,0,"D",1.75,4.07,4.32,"0-0","1-0",0,0,0,0,2,1,0,0,0,0,0,0,1,0,0,"0-0","N","N","N",3,0,20
"1420","EC",2023-11-18,"Dorking","Boreham Wood",2,1,"H",1,0,"H",3.83,3.79,1.92,"1-0","2-1",0,0,0,0,0,0,0,0,0,0,0,0,3,0,0,"0-0","Y","Y","N",0,0,20
"1421","EC",2023-11-18,"Eastleigh","Altrincham",2,1,"H",1,0,"H",3.07,3.8,2.19,"1-0","2-1",0,0,0,0,5,0,0,0,0,0,0,0,3,0,0,"0-0","Y","Y","N",5,0,20
"1422","EC",2023-11-18,"Ebbsfleet","Oxford City",0,4,"A",0,2,"A",1.81,4.12,3.97,"0-2","0-4",0,0,0,0,4,2,1,0,0,0,0,0,4,0,0,"0-0","Y","Y","Y",6,1,20
"1423","EC",2023-11-18,"Halifax","Wealdstone",1,0,"H",0,0,"D",2.08,3.77,3.35,"0-0","1-0",0,0,0,0,2,1,0,0,0,0,0,0,1,0,0,"0-0","N","N","N",3,0,20
"1424","EC",2023-11-18,"Kidderminster","Dag and Red",0,1,"A",0,0,"D",2.7,3,2.94,"0-0","0-1",0,0,0,0,2,2,0,0,0,0,0,0,1,0,0,"0-0","N","N","N",4,0,20
"1425","EC",2023-11-18,"Rochdale","Aldershot",2,1,"H",1,1,"D",1.76,4.17,4.17,"1-1","2-1",0,0,0,0,1,0,0,0,0,0,0,0,3,0,0,"0-0","Y","Y","N",1,0,20
"1426","EC",2023-11-18,"Solihull","Maidenhead",1,2,"A",0,1,"A",1.93,3.73,3.88,"0-1","1-2",0,0,0,0,5,2,0,0,0,0,0,0,3,0,0,"0-0","Y","Y","N",7,0,20
"1427","EC",2023-11-18,"Southend","Chesterfield",2,1,"H",0,1,"A",4.1,4.24,1.76,"0-1","2-1",0,0,0,0,0,1,0,0,0,0,0,0,3,0,0,"0-0","Y","Y","N",1,0,20
"1428","EC",2023-11-18,"Woking","Oldham",0,1,"A",0,0,"D",2.05,3.57,3.6,"0-0","0-1",0,0,0,0,2,1,0,0,0,0,0,0,1,0,0,"0-0","N","N","N",3,0,20
"1429","EC",2023-11-18,"York","Hartlepool",1,3,"A",0,2,"A",2.75,3.68,2.44,"0-2","1-3",0,0,0,0,1,0,0,0,0,0,0,0,4,0,0,"0-0","Y","Y","Y",1,0,20
"1430","EC",2023-11-21,"Bromley","Aldershot",2,3,"A",2,0,"H",1.85,3.75,4.18,"2-0","2-3",0,0,0,0,1,5,1,0,0,0,0,0,5,0,0,"0-0","Y","Y","Y",6,1,20
"1431","EC",2023-11-21,"Eastleigh","Boreham Wood",2,1,"H",1,1,"D",2.66,3.55,2.59,"1-1","2-1",0,0,0,0,1,4,0,0,0,0,0,0,3,0,0,"0-0","Y","Y","N",5,0,21
"1432","EC",2023-11-21,"Ebbsfleet","Maidenhead",1,1,"D",0,0,"D",2.24,3.68,3.05,"0-0","1-1",0,0,0,0,0,3,0,0,0,0,0,0,2,0,0,"0-0","Y","N","N",3,0,21
"1433","EC",2023-11-21,"Halifax","Fylde",2,2,"D",0,1,"A",1.95,3.69,3.81,"0-1","2-2",0,0,0,0,2,3,0,1,0,0,0,0,4,0,0,"0-0","Y","Y","Y",5,1,21
"1434","EC",2023-11-21,"Kidderminster","Hartlepool",1,1,"D",1,1,"D",2.73,3.36,2.64,"1-1","1-1",0,0,0,0,1,2,0,0,0,0,0,0,2,0,0,"0-0","Y","N","N",3,0,21
"1435","EC",2023-11-21,"Rochdale","Altrincham",3,0,"H",1,0,"H",2.28,3.62,3.03,"1-0","3-0",0,0,0,0,2,2,0,0,0,0,0,0,3,0,0,"0-0","Y","Y","N",4,0,21
"1436","EC",2023-11-21,"Solihull","Gateshead",1,2,"A",0,2,"A",3.86,3.85,1.89,"0-2","1-2",0,0,0,0,1,4,0,0,0,0,0,0,3,0,0,"0-0","Y","Y","N",5,0,21
"1437","EC",2023-11-21,"Woking","Chesterfield",0,2,"A",0,1,"A",5.57,4.34,1.56,"0-1","0-2",0,0,0,0,2,1,0,0,0,0,0,0,2,0,0,"0-0","Y","N","N",3,0,21
"1438","EC",2023-11-21,"York","Oxford City",2,0,"H",2,0,"H",1.78,4.03,4.23,"2-0","2-0",0,0,0,0,1,0,0,0,0,0,0,0,2,0,0,"0-0","Y","N","N",1,0,21
"1439","EC",2023-11-22,"Barnet","Oldham",1,4,"A",0,1,"A",1.87,3.86,3.95,"0-1","1-4",0,0,0,0,2,3,0,0,0,0,0,0,5,0,0,"0-0","Y","Y","Y",5,0,21
"1440","EC",2023-11-25,"Fylde","Dorking",3,3,"D",3,1,"H",1.62,4.48,4.77,"3-1","3-3",0,0,0,0,1,1,0,0,0,0,0,0,6,0,0,"0-0","Y","Y","Y",2,0,21
"1441","EC",2023-11-25,"Aldershot","Halifax",1,0,"H",0,0,"D",2.01,3.85,3.46,"0-0","1-0",0,0,0,0,7,2,0,0,0,0,0,0,1,0,0,"0-0","N","N","N",9,0,21
"1442","EC",2023-11-25,"Altrincham","Solihull",6,1,"H",3,0,"H",1.75,4.1,4.28,"3-0","6-1",0,0,0,0,0,1,0,0,0,0,0,0,7,0,0,"0-0","Y","Y","Y",1,0,21
"1443","EC",2023-11-25,"Boreham Wood","Woking",4,2,"H",1,2,"A",2.35,3.31,3.16,"1-2","4-2",0,0,0,0,0,3,0,0,0,0,0,0,6,0,0,"0-0","Y","Y","Y",3,0,22
"1444","EC",2023-11-25,"Chesterfield","Eastleigh",3,2,"H",0,0,"D",1.26,6.25,9.92,"0-0","3-2",0,0,0,0,0,0,0,0,0,0,0,0,5,0,0,"0-0","Y","Y","Y",0,0,22
"1445","EC",2023-11-25,"Dag and Red","Rochdale",1,2,"A",0,1,"A",2.7,3.66,2.49,"0-1","1-2",0,0,0,0,2,0,0,0,0,0,0,0,3,0,0,"0-0","Y","Y","N",2,0,22
"1446","EC",2023-11-25,"Gateshead","Southend",1,1,"D",1,0,"H",1.93,3.8,3.79,"1-0","1-1",0,0,0,0,1,0,0,0,0,0,0,0,2,0,0,"0-0","Y","N","N",1,0,22
"1447","EC",2023-11-25,"Hartlepool","Bromley",1,4,"A",0,2,"A",2.49,3.78,2.65,"0-2","1-4",0,0,0,0,2,3,0,0,0,0,0,0,5,0,0,"0-0","Y","Y","Y",5,0,22
"1448","EC",2023-11-25,"Maidenhead","York",1,1,"D",0,0,"D",2.13,3.49,3.26,"0-0","1-1",0,0,0,0,2,1,0,1,0,0,0,0,2,0,0,"0-0","Y","N","N",3,1,22
"1449","EC",2023-11-25,"Oldham","Ebbsfleet",1,4,"A",0,1,"A",1.68,4.22,4.63,"0-1","1-4",0,0,0,0,0,3,0,0,0,0,0,0,5,0,0,"0-0","Y","Y","Y",3,0,22
"1450","EC",2023-11-25,"Oxford City","Kidderminster",2,2,"D",2,1,"H",2.82,3.44,2.51,"2-1","2-2",0,0,0,0,4,2,0,0,0,0,0,0,4,0,0,"0-0","Y","Y","Y",6,0,22
"1451","EC",2023-11-25,"Wealdstone","Barnet",3,2,"H",1,2,"A",3.74,3.83,1.93,"1-2","3-2",0,0,0,0,2,3,0,0,0,0,0,0,5,0,0,"0-0","Y","Y","Y",5,0,22
"1452","EC",2023-12-02,"Bromley","Rochdale",1,0,"H",0,0,"D",2.44,3.52,2.85,"0-0","1-0",0,0,0,0,0,2,0,0,0,0,0,0,1,0,0,"0-0","N","N","N",2,0,22
"1453","EC",2023-12-02,"Kidderminster","Ebbsfleet",2,0,"H",2,0,"H",2.11,3.52,3.49,"2-0","2-0",0,0,0,0,3,4,0,0,0,0,0,0,2,0,0,"0-0","Y","N","N",7,0,22
"1454","EC",2023-12-02,"Oxford City","Maidenhead",1,4,"A",0,3,"A",3.18,3.58,2.22,"0-3","1-4",0,0,0,0,0,1,0,0,0,0,0,0,5,0,0,"0-0","Y","Y","Y",1,0,22
"1455","EC",2023-12-16,"Gateshead","Halifax",0,2,"A",0,1,"A",1.62,4.14,5.23,"0-1","0-2",0,0,0,0,0,1,0,0,0,0,0,0,2,0,0,"0-0","Y","N","N",1,0,23
"1456","EC",2023-12-16,"Aldershot","Eastleigh",3,5,"A",0,3,"A",1.79,4.33,3.86,"0-3","3-5",0,0,0,0,3,4,0,1,0,0,0,0,8,0,0,"0-0","Y","Y","Y",7,1,23
"1457","EC",2023-12-16,"Altrincham","Fylde",2,1,"H",0,1,"A",1.88,3.95,3.84,"0-1","2-1",0,0,0,0,3,3,0,0,0,0,0,0,3,0,0,"0-0","Y","Y","N",6,0,23
"1458","EC",2023-12-16,"Boreham Wood","Oxford City",2,1,"H",2,1,"H",1.41,4.89,7.31,"2-1","2-1",0,0,0,0,3,1,0,0,0,0,0,0,3,0,0,"0-0","Y","Y","N",4,0,23
"1459","EC",2023-12-16,"Dag and Red","Wealdstone",0,2,"A",0,0,"D",2.3,3.37,3.19,"0-0","0-2",0,0,0,0,3,4,0,0,0,0,0,0,2,0,0,"0-0","Y","N","N",7,0,23
"1460","EC",2023-12-16,"Dorking","Woking",1,2,"A",1,1,"D",3.5,3.77,2.02,"1-1","1-2",0,0,0,0,1,2,0,0,0,0,0,0,3,0,0,"0-0","Y","Y","N",3,0,23
"1461","EC",2023-12-16,"Ebbsfleet","Barnet",1,1,"D",0,0,"D",3.8,4.29,1.81,"0-0","1-1",0,0,0,0,3,1,0,0,0,0,0,0,2,0,0,"0-0","Y","N","N",4,0,23
"1462","EC",2023-12-16,"Hartlepool","Chesterfield",0,1,"A",0,1,"A",5.42,4.31,1.58,"0-1","0-1",0,0,0,0,5,5,0,0,0,0,0,0,1,0,0,"0-0","N","N","N",10,0,23
"1463","EC",2023-12-16,"Maidenhead","Kidderminster",1,0,"H",0,0,"D",2.58,3.17,2.93,"0-0","1-0",0,0,0,0,1,1,0,0,0,0,0,0,1,0,0,"0-0","N","N","N",2,0,23
"1464","EC",2023-12-16,"Rochdale","York",0,0,"D",0,0,"D",1.74,4.05,4.4,"0-0","0-0",0,0,0,0,2,1,0,0,0,0,0,0,0,0,0,"0-0","N","N","N",3,0,23
"1465","EC",2023-12-16,"Solihull","Oldham",2,3,"A",1,0,"H",2.89,3.61,2.38,"1-0","2-3",0,0,0,0,1,4,0,0,0,0,0,0,5,0,0,"0-0","Y","Y","Y",5,0,23
"1466","EC",2023-12-16,"Southend","Bromley",1,2,"A",0,1,"A",2.23,3.67,3.09,"0-1","1-2",0,0,0,0,3,1,0,0,0,0,0,0,3,0,0,"0-0","Y","Y","N",4,0,23
"1467","EC",2023-12-23,"Barnet","Boreham Wood",6,0,"H",3,0,"H",1.93,4,3.59,"3-0","6-0",0,0,0,0,1,2,0,1,0,0,0,0,6,0,0,"0-0","Y","Y","Y",3,1,24
"1468","EC",2023-12-23,"Chesterfield","Aldershot",4,1,"H",1,1,"D",1.29,5.74,9.31,"1-1","4-1",0,0,0,0,0,2,0,0,0,0,0,0,5,0,0,"0-0","Y","Y","Y",2,0,24
"1469","EC",2023-12-23,"Eastleigh","Dorking",2,1,"H",1,0,"H",1.69,4.2,4.57,"1-0","2-1",0,0,0,0,1,0,0,0,0,0,0,0,3,0,0,"0-0","Y","Y","N",1,0,24
"1470","EC",2023-12-23,"Fylde","Dag and Red",1,1,"D",0,1,"A",2.26,3.57,3.1,"0-1","1-1",0,0,0,0,1,2,0,0,0,0,0,0,2,0,0,"0-0","Y","N","N",3,0,24
"1471","EC",2023-12-23,"Halifax","Rochdale",2,2,"D",2,1,"H",2.51,3.19,3,"2-1","2-2",0,0,0,0,2,3,0,0,0,0,0,0,4,0,0,"0-0","Y","Y","Y",5,0,24
"1472","EC",2023-12-23,"Kidderminster","Southend",1,2,"A",1,2,"A",2.75,3.24,2.69,"1-2","1-2",0,0,0,0,0,2,0,0,0,0,0,0,3,0,0,"0-0","Y","Y","N",2,0,24
"1473","EC",2023-12-23,"Oldham","Gateshead",1,2,"A",1,0,"H",3.15,3.68,2.2,"1-0","1-2",0,0,0,0,3,2,0,0,0,0,0,0,3,0,0,"0-0","Y","Y","N",5,0,24
"1474","EC",2023-12-23,"Oxford City","Solihull",1,2,"A",0,0,"D",3.1,3.71,2.21,"0-0","1-2",0,0,0,0,2,0,0,0,0,0,0,0,3,0,0,"0-0","Y","Y","N",2,0,24
"1475","EC",2023-12-23,"Wealdstone","Hartlepool",4,4,"D",3,2,"H",2.32,3.74,2.89,"3-2","4-4",0,0,0,0,0,2,0,0,0,0,0,0,8,0,0,"0-0","Y","Y","Y",2,0,24
"1476","EC",2023-12-23,"Woking","Maidenhead",0,0,"D",0,0,"D",2.02,3.57,3.68,"0-0","0-0",0,0,0,0,2,4,0,0,0,0,0,0,0,0,0,"0-0","N","N","N",6,0,24
"1477","EC",2023-12-23,"York","Ebbsfleet",1,1,"D",1,0,"H",2.27,3.59,3.08,"1-0","1-1",0,0,0,0,1,1,0,0,0,0,0,0,2,0,0,"0-0","Y","N","N",2,0,24
"1478","EC",2023-12-23,"Bromley","Altrincham",2,2,"D",0,1,"A",2.13,3.9,3.14,"0-1","2-2",0,0,0,0,2,2,1,1,0,0,0,0,4,0,0,"0-0","Y","Y","Y",4,2,24
"1479","EC",2023-12-26,"Aldershot","Woking",0,0,"D",0,0,"D",2.23,3.71,3.07,"0-0","0-0",0,0,0,0,3,0,0,0,0,0,0,0,0,0,0,"0-0","N","N","N",3,0,25
"1480","EC",2023-12-26,"Altrincham","Halifax",1,2,"A",0,1,"A",1.94,3.65,3.87,"0-1","1-2",0,0,0,0,2,0,0,0,0,0,0,0,3,0,0,"0-0","Y","Y","N",2,0,25
"1481","EC",2023-12-26,"Boreham Wood","Kidderminster",1,1,"D",0,0,"D",2.16,3.48,3.39,"0-0","1-1",0,0,0,0,3,0,0,0,0,0,0,0,2,0,0,"0-0","Y","N","N",3,0,25
"1482","EC",2023-12-26,"Dag and Red","Eastleigh",4,1,"H",1,0,"H",2.14,3.79,3.19,"1-0","4-1",0,0,0,0,1,4,0,0,0,0,0,0,5,0,0,"0-0","Y","Y","Y",5,0,25
"1483","EC",2023-12-26,"Dorking","Oxford City",0,2,"A",0,0,"D",2.21,3.84,3.05,"0-0","0-2",0,0,0,0,0,1,0,0,0,0,0,0,2,0,0,"0-0","Y","N","N",1,0,25
"1484","EC",2023-12-26,"Ebbsfleet","Bromley",2,3,"A",0,1,"A",3.38,3.72,2.08,"0-1","2-3",0,0,0,0,2,1,0,0,0,0,0,0,5,0,0,"0-0","Y","Y","Y",3,0,25
"1485","EC",2023-12-26,"Gateshead","York",1,1,"D",0,1,"A",1.44,4.77,6.8,"0-1","1-1",0,0,0,0,2,2,0,0,0,0,0,0,2,0,0,"0-0","Y","N","N",4,0,25
"1486","EC",2023-12-26,"Hartlepool","Oldham",1,3,"A",1,2,"A",2.63,3.53,2.66,"1-2","1-3",0,0,0,0,1,4,0,0,0,0,0,0,4,0,0,"0-0","Y","Y","Y",5,0,25
"1487","EC",2023-12-26,"Maidenhead","Wealdstone",0,2,"A",0,2,"A",2.64,3.22,2.82,"0-2","0-2",0,0,0,0,2,1,0,0,0,0,0,0,2,0,0,"0-0","Y","N","N",3,0,25
"1488","EC",2023-12-26,"Rochdale","Fylde",2,0,"H",1,0,"H",1.97,3.82,3.64,"1-0","2-0",0,0,0,0,2,1,0,0,0,0,0,0,2,0,0,"0-0","Y","N","N",3,0,25
"1489","EC",2023-12-26,"Solihull","Chesterfield",2,0,"H",2,0,"H",5.8,4.5,1.53,"2-0","2-0",0,0,0,0,1,2,0,1,0,0,0,0,2,0,0,"0-0","Y","N","N",3,1,25
"1490","EC",2023-12-26,"Southend","Barnet",0,2,"A",0,1,"A",2.42,3.65,2.8,"0-1","0-2",0,0,0,0,2,2,0,0,0,0,0,0,2,0,0,"0-0","Y","N","N",4,0,25
"1491","EC",2023-12-30,"Barnet","Southend",1,0,"H",0,0,"D",2.1,3.86,3.23,"0-0","1-0",0,0,0,0,4,4,0,0,0,0,0,0,1,0,0,"0-0","N","N","N",8,0,26
"1492","EC",2023-12-30,"Bromley","Ebbsfleet",5,1,"H",2,1,"H",1.56,4.4,5.49,"2-1","5-1",0,0,0,0,1,2,0,0,0,0,0,0,6,0,0,"0-0","Y","Y","Y",3,0,26
"1493","EC",2023-12-30,"Kidderminster","Boreham Wood",1,2,"A",1,2,"A",2.53,3.39,2.82,"1-2","1-2",0,0,0,0,1,2,0,0,0,0,0,0,3,0,0,"0-0","Y","Y","N",3,0,26
"1494","EC",2023-12-30,"Oldham","Hartlepool",2,0,"H",1,0,"H",2,3.77,3.56,"1-0","2-0",0,0,0,0,1,1,0,0,0,0,0,0,2,0,0,"0-0","Y","N","N",2,0,26
"1495","EC",2024-01-01,"Chesterfield","Solihull",3,2,"H",0,1,"A",1.32,5.95,8.05,"0-1","3-2",0,0,0,0,0,1,0,0,0,0,0,0,5,0,0,"0-0","Y","Y","Y",1,0,26
"1496","EC",2024-01-01,"Eastleigh","Dag and Red",4,4,"D",2,2,"D",2.83,3.9,2.3,"2-2","4-4",0,0,0,0,3,2,0,0,0,0,0,0,8,0,0,"0-0","Y","Y","Y",5,0,26
"1497","EC",2024-01-01,"Fylde","Rochdale",2,0,"H",0,0,"D",2.33,4.01,2.73,"0-0","2-0",0,0,0,0,0,2,0,0,0,0,0,0,2,0,0,"0-0","Y","N","N",2,0,26
"1498","EC",2024-01-01,"Halifax","Altrincham",0,0,"D",0,0,"D",2.2,3.36,3.4,"0-0","0-0",0,0,0,0,4,2,0,1,0,0,0,0,0,0,0,"0-0","N","N","N",6,1,26
"1499","EC",2024-01-01,"Oxford City","Dorking",1,2,"A",0,0,"D",2.07,3.82,3.33,"0-0","1-2",0,0,0,0,3,4,0,0,0,0,0,0,3,0,0,"0-0","Y","Y","N",7,0,26
"1500","EC",2024-01-01,"Woking","Aldershot",2,3,"A",1,2,"A",2.3,3.79,2.9,"1-2","2-3",0,0,0,0,3,3,0,1,0,0,0,0,5,0,0,"0-0","Y","Y","Y",6,1,26
"1501","EC",2024-01-01,"York","Gateshead",2,0,"H",1,0,"H",4.81,4.48,1.62,"1-0","2-0",0,0,0,0,2,1,0,0,0,0,0,0,2,0,0,"0-0","Y","N","N",3,0,26
"1502","EC",2024-01-06,"Altrincham","Barnet",3,2,"H",2,0,"H",2.97,3.66,2.3,"2-0","3-2",0,0,0,0,2,1,0,0,0,0,0,0,5,0,0,"0-0","Y","Y","Y",3,0,26
"1503","EC",2024-01-06,"Dorking","Oldham",0,1,"A",0,1,"A",4.16,4.31,1.74,"0-1","0-1",0,0,0,0,0,2,0,0,0,0,0,0,1,0,0,"0-0","N","N","N",2,0,27
"1504","EC",2024-01-06,"Ebbsfleet","Wealdstone",2,0,"H",1,0,"H",2.64,3.81,2.48,"1-0","2-0",0,0,0,0,0,2,0,0,0,0,0,0,2,0,0,"0-0","Y","N","N",2,0,27
"1505","EC",2024-01-06,"Hartlepool","Oxford City",2,1,"H",0,0,"D",1.64,4.48,4.68,"0-0","2-1",0,0,0,0,1,1,0,0,0,0,0,0,3,0,0,"0-0","Y","Y","N",2,0,27
"1506","EC",2024-01-06,"Maidenhead","Bromley",0,0,"D",0,0,"D",3.3,3.59,2.16,"0-0","0-0",0,0,0,0,0,2,0,0,0,0,0,0,0,0,0,"0-0","N","N","N",2,0,27
"1507","EC",2024-01-06,"Rochdale","Kidderminster",2,0,"H",0,0,"D",2.14,3.53,3.4,"0-0","2-0",0,0,0,0,2,2,0,0,0,0,0,0,2,0,0,"0-0","Y","N","N",4,0,27
"1508","EC",2024-01-06,"Solihull","Woking",3,0,"H",1,0,"H",2.49,3.39,2.88,"1-0","3-0",0,0,0,0,1,1,0,0,0,0,0,0,3,0,0,"0-0","Y","Y","N",2,0,27
"1509","EC",2024-01-06,"Southend","Halifax",3,0,"H",1,0,"H",2.08,3.29,3.85,"1-0","3-0",0,0,0,0,0,0,0,0,0,0,0,0,3,0,0,"0-0","Y","Y","N",0,0,27
"1510","EC",2024-01-07,"Boreham Wood","York",1,1,"D",0,0,"D",2.06,3.25,3.78,"0-0","1-1",0,0,0,0,2,3,0,0,0,0,0,0,2,0,0,"0-0","Y","N","N",5,0,27
"1511","EC",2024-01-09,"Barnet","Dag and Red",2,1,"H",1,1,"D",1.76,4.24,4.11,"1-1","2-1",0,0,0,0,2,1,0,0,0,0,0,0,3,0,0,"0-0","Y","Y","N",3,0,27
"1512","EC",2024-01-09,"Fylde","Hartlepool",2,1,"H",2,0,"H",1.93,3.92,3.64,"2-0","2-1",0,0,0,0,0,2,0,0,0,0,0,0,3,0,0,"0-0","Y","Y","N",2,0,27
"1513","EC",2024-01-10,"Chesterfield","Gateshead",5,0,"H",4,0,"H",1.52,4.49,5.87,"4-0","5-0",0,0,0,0,1,1,0,0,0,0,0,0,5,0,0,"0-0","Y","Y","Y",2,0,27
"1514","EC",2024-01-13,"Eastleigh","Southend",0,1,"A",0,0,"D",4.11,4.01,1.8,"0-0","0-1",0,0,0,0,2,4,0,0,0,0,0,0,1,0,0,"0-0","N","N","N",6,0,27
"1515","EC",2024-01-16,"Chesterfield","Altrincham",2,1,"H",1,1,"D",1.28,5.79,8.77,"1-1","2-1",0,0,0,0,2,1,0,0,0,0,0,0,3,0,0,"0-0","Y","Y","N",3,0,28
"1516","EC",2024-01-20,"Bromley","Boreham Wood",2,2,"D",1,1,"D",1.84,3.72,4.25,"1-1","2-2",0,0,0,0,3,0,0,0,0,0,0,0,4,0,0,"0-0","Y","Y","Y",3,0,28
"1517","EC",2024-01-20,"Dorking","Gateshead",1,0,"H",1,0,"H",4.1,4.5,1.72,"1-0","1-0",0,0,0,0,3,2,0,1,0,0,0,0,1,0,0,"0-0","N","N","N",5,1,28
"1518","EC",2024-01-20,"Ebbsfleet","Hartlepool",0,1,"A",0,0,"D",2.36,3.83,2.78,"0-0","0-1",0,0,0,0,1,2,0,0,0,0,0,0,1,0,0,"0-0","N","N","N",3,0,28
"1519","EC",2024-01-20,"Kidderminster","Aldershot",4,2,"H",2,2,"D",2.17,3.55,3.31,"2-2","4-2",0,0,0,0,1,2,0,0,0,0,0,0,6,0,0,"0-0","Y","Y","Y",3,0,28
"1520","EC",2024-01-23,"Aldershot","Bromley",1,1,"D",1,0,"H",2.8,3.57,2.46,"1-0","1-1",0,0,0,0,0,3,0,0,0,0,0,0,2,0,0,"0-0","Y","N","N",3,0,28
"1521","EC",2024-01-23,"Chesterfield","Woking",1,0,"H",1,0,"H",1.25,6.21,10.28,"1-0","1-0",0,0,0,0,2,2,0,0,0,0,0,0,1,0,0,"0-0","N","N","N",4,0,28
"1522","EC",2024-01-23,"Dag and Red","Dorking",2,1,"H",0,0,"D",1.74,3.99,4.52,"0-0","2-1",0,0,0,0,1,1,0,0,0,0,0,0,3,0,0,"0-0","Y","Y","N",2,0,28
"1523","EC",2024-01-23,"Fylde","Halifax",2,2,"D",2,0,"H",2.45,3.26,3.03,"2-0","2-2",0,0,0,0,1,2,0,0,0,0,0,0,4,0,0,"0-0","Y","Y","Y",3,0,28
"1524","EC",2024-01-23,"Hartlepool","Kidderminster",0,1,"A",0,0,"D",2.5,3.43,2.83,"0-0","0-1",0,0,0,0,1,2,0,0,0,0,0,0,1,0,0,"0-0","N","N","N",3,0,28
"1525","EC",2024-01-23,"Maidenhead","Ebbsfleet",0,1,"A",0,0,"D",2.18,3.5,3.33,"0-0","0-1",0,0,0,0,2,2,0,0,0,0,0,0,1,0,0,"0-0","N","N","N",4,0,28
"1526","EC",2024-01-23,"Oldham","Barnet",2,0,"H",1,0,"H",2.52,3.49,2.78,"1-0","2-0",0,0,0,0,4,2,0,0,0,0,0,0,2,0,0,"0-0","Y","N","N",6,0,28
"1527","EC",2024-01-23,"Oxford City","York",1,2,"A",0,1,"A",3.02,3.8,2.22,"0-1","1-2",0,0,0,0,1,0,0,0,0,0,0,0,3,0,0,"0-0","Y","Y","N",1,0,29
"1528","EC",2024-01-24,"Boreham Wood","Eastleigh",4,4,"D",0,2,"A",1.88,3.92,3.84,"0-2","4-4",0,0,0,0,3,2,0,0,0,0,0,0,8,0,0,"0-0","Y","Y","Y",5,0,29
"1529","EC",2024-01-27,"Aldershot","Rochdale",3,1,"H",2,1,"H",2.23,3.71,3.06,"2-1","3-1",0,0,0,0,0,2,0,0,0,0,0,0,4,0,0,"0-0","Y","Y","Y",2,0,29
"1530","EC",2024-01-27,"Altrincham","Eastleigh",4,0,"H",2,0,"H",1.64,4.24,4.91,"2-0","4-0",0,0,0,0,0,2,0,0,0,0,0,0,4,0,0,"0-0","Y","Y","Y",2,0,29
"1531","EC",2024-01-27,"Boreham Wood","Dorking",0,3,"A",0,2,"A",1.62,4.26,5.11,"0-2","0-3",0,0,0,0,2,0,0,1,0,0,0,0,3,0,0,"0-0","Y","Y","N",2,1,29
"1532","EC",2024-01-27,"Chesterfield","Southend",3,0,"H",1,0,"H",1.49,4.51,6.34,"1-0","3-0",0,0,0,0,2,1,0,0,0,0,0,0,3,0,0,"0-0","Y","Y","N",3,0,29
"1533","EC",2024-01-27,"Dag and Red","Kidderminster",0,1,"A",0,0,"D",2.28,3.25,3.35,"0-0","0-1",0,0,0,0,0,2,0,0,0,0,0,0,1,0,0,"0-0","N","N","N",2,0,29
"1534","EC",2024-01-27,"Fylde","Bromley",1,0,"H",1,0,"H",2.57,3.47,2.73,"1-0","1-0",0,0,0,0,1,1,0,0,0,0,0,0,1,0,0,"0-0","N","N","N",2,0,29
"1535","EC",2024-01-27,"Gateshead","Barnet",2,1,"H",0,1,"A",2.56,3.93,2.5,"0-1","2-1",0,0,0,0,2,3,0,0,0,0,0,0,3,0,0,"0-0","Y","Y","N",5,0,29
"1536","EC",2024-01-27,"Hartlepool","York",2,1,"H",0,0,"D",2.04,3.59,3.62,"0-0","2-1",0,0,0,0,1,4,0,0,0,0,0,0,3,0,0,"0-0","Y","Y","N",5,0,29
"1537","EC",2024-01-27,"Maidenhead","Solihull",2,1,"H",1,1,"D",2.67,3.28,2.74,"1-1","2-1",0,0,0,0,4,2,0,0,0,0,0,0,3,0,0,"0-0","Y","Y","N",6,0,29
"1538","EC",2024-01-27,"Oldham","Woking",0,1,"A",0,0,"D",1.93,3.67,3.92,"0-0","0-1",0,0,0,0,0,2,0,0,0,0,0,0,1,0,0,"0-0","N","N","N",2,0,29
"1539","EC",2024-01-27,"Oxford City","Ebbsfleet",1,0,"H",1,0,"H",3.25,3.88,2.08,"1-0","1-0",0,0,0,0,2,3,0,0,0,0,0,0,1,0,0,"0-0","N","N","N",5,0,30
"1540","EC",2024-01-27,"Wealdstone","Halifax",2,0,"H",1,0,"H",2.49,3.26,3,"1-0","2-0",0,0,0,0,0,3,0,0,0,0,0,0,2,0,0,"0-0","Y","N","N",3,0,30
"1541","EC",2024-01-30,"Solihull","Dag and Red",1,1,"D",0,0,"D",2.36,3.65,2.89,"0-0","1-1",0,0,0,0,2,2,0,0,0,0,0,0,2,0,0,"0-0","Y","N","N",4,0,30
"1542","EC",2024-01-30,"Wealdstone","Aldershot",3,3,"D",2,2,"D",2.03,3.82,3.44,"2-2","3-3",0,0,0,0,2,2,2,0,0,0,0,0,6,0,0,"0-0","Y","Y","Y",4,2,30
"1543","EC",2024-02-03,"Barnet","Wealdstone",1,1,"D",1,0,"H",1.63,4.35,4.92,"1-0","1-1",0,0,0,0,1,1,0,0,0,0,0,0,2,0,0,"0-0","Y","N","N",2,0,30
"1544","EC",2024-02-03,"Bromley","Hartlepool",1,2,"A",1,1,"D",1.81,3.92,4.21,"1-1","1-2",0,0,0,0,2,0,0,0,0,0,0,0,3,0,0,"0-0","Y","Y","N",2,0,30
"1545","EC",2024-02-03,"Dorking","Fylde",1,3,"A",0,2,"A",3.09,3.87,2.16,"0-2","1-3",0,0,0,0,2,2,0,0,0,0,0,0,4,0,0,"0-0","Y","Y","Y",4,0,30
"1546","EC",2024-02-03,"Eastleigh","Chesterfield",1,3,"A",0,1,"A",8.02,5.25,1.36,"0-1","1-3",0,0,0,0,1,0,1,0,0,0,0,0,4,0,0,"0-0","Y","Y","Y",1,1,30
"1547","EC",2024-02-03,"Halifax","Aldershot",1,2,"A",1,0,"H",2.07,3.51,3.59,"1-0","1-2",0,0,0,0,0,2,0,0,0,0,0,0,3,0,0,"0-0","Y","Y","N",2,0,30
"1548","EC",2024-02-03,"Kidderminster","Oxford City",3,2,"H",0,2,"A",1.56,4.1,5.98,"0-2","3-2",0,0,0,0,3,4,0,0,0,0,0,0,5,0,0,"0-0","Y","Y","Y",7,0,30
"1549","EC",2024-02-03,"Rochdale","Dag and Red",1,2,"A",1,2,"A",2.53,3.52,2.76,"1-2","1-2",0,0,0,0,2,2,0,0,0,0,0,0,3,0,0,"0-0","Y","Y","N",4,0,30
"1550","EC",2024-02-03,"Solihull","Altrincham",0,1,"A",0,1,"A",2.64,3.79,2.49,"0-1","0-1",0,0,0,0,1,1,0,0,0,0,0,0,1,0,0,"0-0","N","N","N",2,0,30
"1551","EC",2024-02-03,"Southend","Gateshead",0,1,"A",0,0,"D",1.77,3.94,4.39,"0-0","0-1",0,0,0,0,1,2,0,0,0,0,0,0,1,0,0,"0-0","N","N","N",3,0,31
"1552","EC",2024-02-03,"Woking","Boreham Wood",0,1,"A",0,1,"A",2.23,3.5,3.23,"0-1","0-1",0,0,0,0,4,3,0,1,0,0,0,0,1,0,0,"0-0","N","N","N",7,1,31
"1553","EC",2024-02-03,"York","Maidenhead",1,1,"D",1,1,"D",2.33,3.27,3.23,"1-1","1-1",0,0,0,0,0,0,0,0,0,0,0,0,2,0,0,"0-0","Y","N","N",0,0,31
"1554","EC",2024-02-03,"Ebbsfleet","Oldham",0,0,"D",0,0,"D",2.93,3.79,2.27,"0-0","0-0",0,0,0,0,2,3,0,0,0,0,0,0,0,0,0,"0-0","N","N","N",5,0,31
"1555","EC",2024-02-06,"Dag and Red","Chesterfield",1,2,"A",0,1,"A",4.81,4.02,1.69,"0-1","1-2",0,0,0,0,3,0,0,0,0,0,0,0,3,0,0,"0-0","Y","Y","N",3,0,31
"1556","EC",2024-02-06,"Gateshead","Eastleigh",1,1,"D",0,0,"D",1.46,4.99,6,"0-0","1-1",0,0,0,0,1,2,0,0,0,0,0,0,2,0,0,"0-0","Y","N","N",3,0,31
"1557","EC",2024-02-06,"Halifax","Solihull",1,3,"A",0,2,"A",2.12,3.38,3.59,"0-2","1-3",0,0,0,0,3,4,0,0,0,0,0,0,4,0,0,"0-0","Y","Y","Y",7,0,31
"1558","EC",2024-02-06,"Wealdstone","Maidenhead",0,1,"A",0,0,"D",2.03,3.59,3.65,"0-0","0-1",0,0,0,0,2,2,1,0,0,0,0,0,1,0,0,"0-0","N","N","N",4,1,31
"1559","EC",2024-02-06,"Woking","Oxford City",2,0,"H",1,0,"H",1.59,4.18,5.53,"1-0","2-0",0,0,0,0,1,4,0,0,0,0,0,0,2,0,0,"0-0","Y","N","N",5,0,31
"1560","EC",2024-02-10,"Altrincham","Rochdale",3,0,"H",1,0,"H",2.06,3.62,3.51,"1-0","3-0",0,0,0,0,3,0,0,0,0,0,0,0,3,0,0,"0-0","Y","Y","N",3,0,31
"1561","EC",2024-02-10,"Boreham Wood","Maidenhead",1,0,"H",1,0,"H",2.08,3.57,3.51,"1-0","1-0",0,0,0,0,3,1,0,0,0,0,0,0,1,0,0,"0-0","N","N","N",4,0,31
"1562","EC",2024-02-10,"Chesterfield","Ebbsfleet",2,2,"D",2,1,"H",1.21,7.45,10.8,"2-1","2-2",0,0,0,0,2,1,0,0,0,0,0,0,4,0,0,"0-0","Y","Y","Y",3,0,31
"1563","EC",2024-02-10,"Dag and Red","Oxford City",7,1,"H",3,0,"H",1.54,4.33,5.83,"3-0","7-1",0,0,0,0,1,1,0,0,0,0,0,0,8,0,0,"0-0","Y","Y","Y",2,0,32
"1564","EC",2024-02-10,"Dorking","Halifax",1,3,"A",1,2,"A",3.24,3.46,2.24,"1-2","1-3",0,0,0,0,3,1,0,0,0,0,0,0,4,0,0,"0-0","Y","Y","Y",4,0,32
"1565","EC",2024-02-10,"Eastleigh","Fylde",1,2,"A",0,1,"A",2.88,3.94,2.25,"0-1","1-2",0,0,0,0,3,3,0,0,0,0,0,0,3,0,0,"0-0","Y","Y","N",6,0,32
"1566","EC",2024-02-10,"Southend","York",0,1,"A",0,0,"D",1.62,3.94,5.61,"0-0","0-1",0,0,0,0,1,3,0,0,0,0,0,0,1,0,0,"0-0","N","N","N",4,0,32
"1567","EC",2024-02-10,"Woking","Hartlepool",1,1,"D",0,1,"A",2.29,3.59,3.03,"0-1","1-1",0,0,0,0,0,1,0,0,0,0,0,0,2,0,0,"0-0","Y","N","N",1,0,32
"1568","EC",2024-02-13,"Aldershot","Fylde",0,5,"A",0,3,"A",2.43,4.05,2.59,"0-3","0-5",0,0,0,0,2,3,1,0,0,0,0,0,5,0,0,"0-0","Y","Y","Y",5,1,32
"1569","EC",2024-02-13,"Halifax","Maidenhead",2,1,"H",1,0,"H",2.11,3.2,3.87,"1-0","2-1",0,0,0,0,3,2,0,0,0,0,0,0,3,0,0,"0-0","Y","Y","N",5,0,32
"1570","EC",2024-02-13,"Oldham","Boreham Wood",2,1,"H",0,1,"A",1.85,3.7,4.25,"0-1","2-1",0,0,0,0,3,3,0,0,0,0,0,0,3,0,0,"0-0","Y","Y","N",6,0,32
"1571","EC",2024-02-13,"York","Dorking",0,1,"A",0,0,"D",1.94,3.75,3.77,"0-0","0-1",0,0,0,0,1,2,0,0,0,0,0,0,1,0,0,"0-0","N","N","N",3,0,32
"1572","EC",2024-02-17,"Bromley","Chesterfield",4,3,"H",0,1,"A",3.74,3.78,1.94,"0-1","4-3",0,0,0,0,1,1,0,0,0,0,0,0,7,0,0,"0-0","Y","Y","Y",2,0,32
"1573","EC",2024-02-17,"Ebbsfleet","Eastleigh",3,0,"H",0,0,"D",1.78,4.19,4.07,"0-0","3-0",0,0,0,0,0,4,0,0,0,0,0,0,3,0,0,"0-0","Y","Y","N",4,0,32
"1574","EC",2024-02-17,"Fylde","Barnet",2,4,"A",2,2,"D",2.44,4.16,2.53,"2-2","2-4",0,0,0,0,3,1,0,0,0,0,0,0,6,0,0,"0-0","Y","Y","Y",4,0,32
"1575","EC",2024-02-17,"Halifax","Woking",2,1,"H",2,0,"H",2.3,3.16,3.41,"2-0","2-1",0,0,0,0,2,2,0,0,0,0,0,0,3,0,0,"0-0","Y","Y","N",4,0,33
"1576","EC",2024-02-17,"Hartlepool","Boreham Wood",3,1,"H",1,1,"D",2.46,3.77,2.68,"1-1","3-1",0,0,0,0,4,1,0,0,0,0,0,0,4,0,0,"0-0","Y","Y","Y",5,0,33
"1577","EC",2024-02-17,"Kidderminster","Dorking",0,0,"D",0,0,"D",1.71,3.9,4.79,"0-0","0-0",0,0,0,0,1,3,0,0,0,0,0,0,0,0,0,"0-0","N","N","N",4,0,33
"1578","EC",2024-02-17,"Maidenhead","Oldham",1,3,"A",0,1,"A",2.86,3.29,2.56,"0-1","1-3",0,0,0,0,2,1,0,0,0,0,0,0,4,0,0,"0-0","Y","Y","Y",3,0,33
"1579","EC",2024-02-17,"Oxford City","Southend",0,0,"D",0,0,"D",6.01,4.56,1.51,"0-0","0-0",0,0,0,0,2,1,0,1,0,0,0,0,0,0,0,"0-0","N","N","N",3,1,33
"1580","EC",2024-02-17,"Rochdale","Solihull",1,2,"A",1,1,"D",2.54,3.55,2.71,"1-1","1-2",0,0,0,0,2,1,0,0,0,0,0,0,3,0,0,"0-0","Y","Y","N",3,0,33
"1581","EC",2024-02-17,"Wealdstone","Gateshead",2,4,"A",1,3,"A",2.19,4.01,2.95,"1-3","2-4",0,0,0,0,1,1,0,0,0,0,0,0,6,0,0,"0-0","Y","Y","Y",2,0,33
"1582","EC",2024-02-17,"York","Dag and Red",1,1,"D",1,1,"D",2.56,3.43,2.76,"1-1","1-1",0,0,0,0,4,1,0,0,0,0,0,0,2,0,0,"0-0","Y","N","N",5,0,33
"1583","EC",2024-02-17,"Aldershot","Altrincham",2,0,"H",2,0,"H",2.67,3.97,2.39,"2-0","2-0",0,0,0,0,2,1,0,0,0,0,0,0,2,0,0,"0-0","Y","N","N",3,0,33
"1584","EC",2024-02-20,"Aldershot","Barnet",1,0,"H",0,0,"D",3.1,4.08,2.09,"0-0","1-0",0,0,0,0,4,3,0,0,0,0,0,0,1,0,0,"0-0","N","N","N",7,0,33
"1585","EC",2024-02-20,"Bromley","Dag and Red",2,2,"D",2,0,"H",2.05,3.75,3.44,"2-0","2-2",0,0,0,0,3,1,0,0,0,0,0,0,4,0,0,"0-0","Y","Y","Y",4,0,33
"1586","EC",2024-02-20,"Ebbsfleet","Woking",1,0,"H",1,0,"H",2.36,3.48,3,"1-0","1-0",0,0,0,0,4,2,0,0,0,0,0,0,1,0,0,"0-0","N","N","N",6,0,33
"1587","EC",2024-02-20,"Fylde","Solihull",2,2,"D",2,1,"H",2.02,3.87,3.44,"2-1","2-2",0,0,0,0,1,3,0,0,0,0,0,0,4,0,0,"0-0","Y","Y","Y",4,0,34
"1588","EC",2024-02-20,"Hartlepool","Altrincham",3,2,"H",0,1,"A",2.37,3.61,2.89,"0-1","3-2",0,0,0,0,3,2,0,0,0,0,0,0,5,0,0,"0-0","Y","Y","Y",5,0,34
"1589","EC",2024-02-20,"Kidderminster","Gateshead",0,2,"A",0,1,"A",2.59,3.46,2.71,"0-1","0-2",0,0,0,0,2,1,0,0,0,0,0,0,2,0,0,"0-0","Y","N","N",3,0,34
"1590","EC",2024-02-20,"Maidenhead","Southend",1,2,"A",1,1,"D",3.55,3.43,2.12,"1-1","1-2",0,0,0,0,3,1,0,0,0,0,0,0,3,0,0,"0-0","Y","Y","N",4,0,34
"1591","EC",2024-02-20,"Oxford City","Eastleigh",2,5,"A",0,4,"A",2.58,3.98,2.47,"0-4","2-5",0,0,0,0,4,1,0,0,0,0,0,0,7,0,0,"0-0","Y","Y","Y",5,0,34
"1592","EC",2024-02-20,"York","Oldham",1,1,"D",0,0,"D",2.79,3.32,2.6,"0-0","1-1",0,0,0,0,1,1,0,0,0,0,0,0,2,0,0,"0-0","Y","N","N",2,0,34
"1593","EC",2024-02-24,"Eastleigh","Bromley",2,0,"H",0,0,"D",3.51,4.04,1.95,"0-0","2-0",0,0,0,0,1,0,0,0,0,0,0,0,2,0,0,"0-0","Y","N","N",1,0,34
"1594","EC",2024-02-24,"Altrincham","Maidenhead",1,3,"A",1,2,"A",1.79,3.79,4.47,"1-2","1-3",0,0,0,0,3,1,0,0,0,0,0,0,4,0,0,"0-0","Y","Y","Y",4,0,34
"1595","EC",2024-02-24,"Barnet","York",2,0,"H",1,0,"H",1.62,4.21,5.13,"1-0","2-0",0,0,0,0,0,0,0,0,0,0,0,0,2,0,0,"0-0","Y","N","N",0,0,34
"1596","EC",2024-02-24,"Boreham Wood","Fylde",4,0,"H",3,0,"H",2.36,3.77,2.81,"3-0","4-0",0,0,0,0,0,2,0,0,0,0,0,0,4,0,0,"0-0","Y","Y","Y",2,0,34
"1597","EC",2024-02-24,"Chesterfield","Rochdale",2,2,"D",0,0,"D",1.23,6.26,12.13,"0-0","2-2",0,0,0,0,3,3,0,0,0,0,0,0,4,0,0,"0-0","Y","Y","Y",6,0,34
"1598","EC",2024-02-24,"Dag and Red","Halifax",0,1,"A",0,0,"D",1.81,3.66,4.51,"0-0","0-1",0,0,0,0,1,1,0,0,0,0,0,0,1,0,0,"0-0","N","N","N",2,0,34
"1599","EC",2024-02-24,"Dorking","Ebbsfleet",1,4,"A",1,2,"A",2.69,3.5,2.58,"1-2","1-4",0,0,0,0,2,2,1,0,0,0,0,0,5,0,0,"0-0","Y","Y","Y",4,1,35
"1600","EC",2024-02-24,"Gateshead","Oxford City",4,0,"H",1,0,"H",1.23,6.77,10.78,"1-0","4-0",0,0,0,0,1,1,0,1,0,0,0,0,4,0,0,"0-0","Y","Y","Y",2,1,35
"1601","EC",2024-02-24,"Oldham","Kidderminster",1,2,"A",0,1,"A",2.08,3.37,3.74,"0-1","1-2",0,0,0,0,2,1,0,0,0,0,0,0,3,0,0,"0-0","Y","Y","N",3,0,35
"1602","EC",2024-02-24,"Solihull","Hartlepool",2,1,"H",1,0,"H",2.37,3.51,2.96,"1-0","2-1",0,0,0,0,0,2,0,0,0,0,0,0,3,0,0,"0-0","Y","Y","N",2,0,35
"1603","EC",2024-02-24,"Southend","Aldershot",4,1,"H",0,1,"A",1.82,3.87,4.17,"0-1","4-1",0,0,0,0,0,2,0,1,0,0,0,0,5,0,0,"0-0","Y","Y","Y",2,1,35
"1604","EC",2024-02-24,"Woking","Wealdstone",1,1,"D",0,0,"D",1.9,3.78,3.91,"0-0","1-1",0,0,0,0,3,3,0,0,0,0,0,0,2,0,0,"0-0","Y","N","N",6,0,35
"1605","EC",2024-02-27,"Barnet","Chesterfield",0,2,"A",0,1,"A",3.42,3.77,2.05,"0-1","0-2",0,0,0,0,0,1,0,0,0,0,0,0,2,0,0,"0-0","Y","N","N",1,0,35
"1606","EC",2024-02-27,"Eastleigh","Oldham",1,2,"A",0,1,"A",3.13,3.6,2.23,"0-1","1-2",0,0,0,0,2,2,1,0,0,0,0,0,3,0,0,"0-0","Y","Y","N",4,1,35
"1607","EC",2024-02-27,"Rochdale","Wealdstone",3,0,"H",3,0,"H",2.17,4.01,2.98,"3-0","3-0",0,0,0,0,1,4,0,0,0,0,0,0,3,0,0,"0-0","Y","Y","N",5,0,35
"1608","EC",2024-02-27,"Solihull","Kidderminster",0,1,"A",0,0,"D",2.43,3.14,3.19,"0-0","0-1",0,0,0,0,1,2,0,1,0,0,0,0,1,0,0,"0-0","N","N","N",3,1,35
"1609","EC",2024-02-27,"Southend","Altrincham",2,1,"H",2,1,"H",1.86,3.72,4.14,"2-1","2-1",0,0,0,0,2,1,0,0,0,0,0,0,3,0,0,"0-0","Y","Y","N",3,0,35
"1610","EC",2024-02-27,"Woking","Gateshead",3,2,"H",1,2,"A",3.57,3.68,2.02,"1-2","3-2",0,0,0,0,3,3,1,0,0,0,0,0,5,0,0,"0-0","Y","Y","Y",6,1,35
"1611","EC",2024-03-02,"Dorking","Chesterfield",4,1,"H",2,1,"H",7.75,5.9,1.33,"2-1","4-1",0,0,0,0,3,1,0,0,0,0,0,0,5,0,0,"0-0","Y","Y","Y",4,0,36
"1612","EC",2024-03-02,"Boreham Wood","Gateshead",1,1,"D",1,0,"H",2.7,3.45,2.62,"1-0","1-1",0,0,0,0,0,1,0,0,0,0,0,0,2,0,0,"0-0","Y","N","N",1,0,36
"1613","EC",2024-03-02,"Bromley","Halifax",2,0,"H",1,0,"H",2.03,3.4,3.88,"1-0","2-0",0,0,0,0,3,2,1,1,0,0,0,0,2,0,0,"0-0","Y","N","N",5,2,36
"1614","EC",2024-03-02,"Dag and Red","Altrincham",3,1,"H",1,1,"D",2.25,3.55,3.14,"1-1","3-1",0,0,0,0,2,1,0,0,0,0,0,0,4,0,0,"0-0","Y","Y","Y",3,0,36
"1615","EC",2024-03-02,"Eastleigh","Solihull",3,3,"D",2,0,"H",2.74,3.59,2.5,"2-0","3-3",0,0,0,0,3,3,0,0,0,0,0,0,6,0,0,"0-0","Y","Y","Y",6,0,36
"1616","EC",2024-03-02,"Ebbsfleet","Rochdale",2,1,"H",1,1,"D",2.09,3.76,3.32,"1-1","2-1",0,0,0,0,0,2,0,0,0,0,0,0,3,0,0,"0-0","Y","Y","N",2,0,36
"1617","EC",2024-03-02,"Fylde","Maidenhead",4,1,"H",1,0,"H",1.85,3.79,4.09,"1-0","4-1",0,0,0,0,1,2,0,0,0,0,0,0,5,0,0,"0-0","Y","Y","Y",3,0,36
"1618","EC",2024-03-02,"Hartlepool","Barnet",1,2,"A",0,2,"A",2.56,3.73,2.59,"0-2","1-2",0,0,0,0,2,2,0,0,0,0,0,0,3,0,0,"0-0","Y","Y","N",4,0,36
"1619","EC",2024-03-02,"Oldham","Southend",1,1,"D",0,0,"D",2.55,3.36,2.82,"0-0","1-1",0,0,0,0,1,1,0,0,0,0,0,0,2,0,0,"0-0","Y","N","N",2,0,36
"1620","EC",2024-03-02,"Oxford City","Aldershot",1,2,"A",1,2,"A",4.29,4.3,1.71,"1-2","1-2",0,0,0,0,1,2,0,0,0,0,0,0,3,0,0,"0-0","Y","Y","N",3,0,36
"1621","EC",2024-03-02,"York","Wealdstone",2,3,"A",1,1,"D",1.94,3.73,3.79,"1-1","2-3",0,0,0,0,1,2,0,0,0,0,0,0,5,0,0,"0-0","Y","Y","Y",3,0,36
"1622","EC",2024-03-05,"Altrincham","Dorking",2,1,"H",2,0,"H",1.54,4.56,5.5,"2-0","2-1",0,0,0,0,3,2,1,0,0,0,0,0,3,0,0,"0-0","Y","Y","N",5,1,36
"1623","EC",2024-03-05,"Barnet","Rochdale",2,0,"H",1,0,"H",1.59,4.45,5.08,"1-0","2-0",0,0,0,0,1,3,0,0,0,0,0,0,2,0,0,"0-0","Y","N","N",4,0,37
"1624","EC",2024-03-05,"Gateshead","Solihull",2,3,"A",1,2,"A",1.82,3.96,4.09,"1-2","2-3",0,0,0,0,1,3,0,0,0,0,0,0,5,0,0,"0-0","Y","Y","Y",4,0,37
"1625","EC",2024-03-05,"Oldham","Bromley",0,0,"D",0,0,"D",2.33,3.26,3.23,"0-0","0-0",0,0,0,0,1,2,0,0,0,0,0,0,0,0,0,"0-0","N","N","N",3,0,37
"1626","EC",2024-03-05,"Southend","Wealdstone",1,1,"D",0,1,"A",1.37,4.96,8.46,"0-1","1-1",0,0,0,0,2,3,0,0,0,0,0,0,2,0,0,"0-0","Y","N","N",5,0,37
"1627","EC",2024-03-05,"Woking","Kidderminster",2,1,"H",0,1,"A",2.55,3.06,3.07,"0-1","2-1",0,0,0,0,4,2,0,0,0,0,0,0,3,0,0,"0-0","Y","Y","N",6,0,37
"1628","EC",2024-03-05,"York","Fylde",1,3,"A",1,1,"D",2.26,3.65,3.04,"1-1","1-3",0,0,0,0,0,1,0,0,0,0,0,0,4,0,0,"0-0","Y","Y","Y",1,0,37
"1629","EC",2024-03-09,"Aldershot","Oldham",2,0,"H",1,0,"H",2.42,3.57,2.85,"1-0","2-0",0,0,0,0,2,4,0,0,0,0,0,0,2,0,0,"0-0","Y","N","N",6,0,37
"1630","EC",2024-03-09,"Altrincham","Woking",0,1,"A",0,0,"D",2.14,3.75,3.23,"0-0","0-1",0,0,0,0,2,2,0,0,0,0,0,0,1,0,0,"0-0","N","N","N",4,0,37
"1631","EC",2024-03-09,"Chesterfield","Fylde",4,1,"H",1,0,"H",1.43,5.38,6.04,"1-0","4-1",0,0,0,0,2,3,0,0,0,0,0,0,5,0,0,"0-0","Y","Y","Y",5,0,37
"1632","EC",2024-03-09,"Halifax","Boreham Wood",2,1,"H",1,0,"H",2.34,3.3,3.19,"1-0","2-1",0,0,0,0,1,2,0,0,0,0,0,0,3,0,0,"0-0","Y","Y","N",3,0,37
"1633","EC",2024-03-09,"Kidderminster","York",0,0,"D",0,0,"D",2.06,3.38,3.8,"0-0","0-0",0,0,0,0,1,4,0,0,0,0,0,0,0,0,0,"0-0","N","N","N",5,0,37
"1634","EC",2024-03-09,"Maidenhead","Dorking",4,2,"H",3,1,"H",1.84,3.87,4.08,"3-1","4-2",0,0,0,0,3,2,0,0,0,0,0,0,6,0,0,"0-0","Y","Y","Y",5,0,37
"1635","EC",2024-03-09,"Rochdale","Oxford City",2,2,"D",1,2,"A",1.39,4.98,7.53,"1-2","2-2",0,0,0,0,1,4,0,0,0,0,0,0,4,0,0,"0-0","Y","Y","Y",5,0,38
"1636","EC",2024-03-09,"Southend","Dag and Red",1,1,"D",0,1,"A",1.82,3.68,4.42,"0-1","1-1",0,0,0,0,3,0,0,0,0,0,0,0,2,0,0,"0-0","Y","N","N",3,0,38
"1637","EC",2024-03-12,"Aldershot","Ebbsfleet",4,1,"H",2,1,"H",2.18,3.69,3.18,"2-1","4-1",0,0,0,0,1,2,1,0,0,0,0,0,5,0,0,"0-0","Y","Y","Y",3,1,38
"1638","EC",2024-03-12,"Altrincham","York",6,1,"H",3,0,"H",2.1,3.79,3.27,"3-0","6-1",0,0,0,0,2,0,0,0,0,0,0,0,7,0,0,"0-0","Y","Y","Y",2,0,38
"1639","EC",2024-03-12,"Chesterfield","Oxford City",2,0,"H",1,0,"H",1.09,12.35,19.57,"1-0","2-0",0,0,0,0,3,4,0,0,0,0,0,0,2,0,0,"0-0","Y","N","N",7,0,38
"1640","EC",2024-03-12,"Gateshead","Dag and Red",1,0,"H",0,0,"D",1.85,3.76,4.14,"0-0","1-0",0,0,0,0,1,3,0,0,0,0,0,0,1,0,0,"0-0","N","N","N",4,0,38
"1641","EC",2024-03-12,"Kidderminster","Fylde",1,1,"D",0,1,"A",2.35,3.43,3.06,"0-1","1-1",0,0,0,0,4,1,0,0,0,0,0,0,2,0,0,"0-0","Y","N","N",5,0,38
"1642","EC",2024-03-12,"Rochdale","Woking",2,1,"H",1,1,"D",2.65,3.31,2.74,"1-1","2-1",0,0,0,0,1,3,1,1,0,0,0,0,3,0,0,"0-0","Y","Y","N",4,2,38
"1643","EC",2024-03-12,"Solihull","Boreham Wood",2,0,"H",0,0,"D",2.32,3.45,3.09,"0-0","2-0",0,0,0,0,2,1,0,0,0,0,0,0,2,0,0,"0-0","Y","N","N",3,0,38
"1644","EC",2024-03-12,"Southend","Dorking",2,0,"H",1,0,"H",1.45,5.11,5.95,"1-0","2-0",0,0,0,0,2,1,0,0,0,0,0,0,2,0,0,"0-0","Y","N","N",3,0,38
"1645","EC",2024-03-16,"Oldham","Chesterfield",2,2,"D",2,1,"H",4.16,3.73,1.85,"2-1","2-2",0,0,0,0,3,4,0,0,0,0,0,0,4,0,0,"0-0","Y","Y","Y",7,0,38
"1646","EC",2024-03-16,"Boreham Wood","Altrincham",0,1,"A",0,0,"D",2.27,3.44,3.19,"0-0","0-1",0,0,0,0,1,1,1,0,0,0,0,0,1,0,0,"0-0","N","N","N",2,1,38
"1647","EC",2024-03-16,"Bromley","Kidderminster",0,0,"D",0,0,"D",1.85,3.61,4.35,"0-0","0-0",0,0,0,0,1,2,0,0,0,0,0,0,0,0,0,"0-0","N","N","N",3,0,39
"1648","EC",2024-03-16,"Dag and Red","Maidenhead",4,1,"H",2,0,"H",1.9,3.63,4.07,"2-0","4-1",0,0,0,0,3,5,0,0,0,0,0,0,5,0,0,"0-0","Y","Y","Y",8,0,39
"1649","EC",2024-03-16,"Dorking","Solihull",1,1,"D",0,0,"D",2.98,3.8,2.24,"0-0","1-1",0,0,0,0,3,2,0,0,0,0,0,0,2,0,0,"0-0","Y","N","N",5,0,39
"1650","EC",2024-03-16,"Eastleigh","Rochdale",1,4,"A",1,2,"A",2.6,3.69,2.57,"1-2","1-4",0,0,0,0,1,0,0,0,0,0,0,0,5,0,0,"0-0","Y","Y","Y",1,0,39
"1651","EC",2024-03-16,"Ebbsfleet","Gateshead",4,2,"H",1,2,"A",2.79,3.67,2.42,"1-2","4-2",0,0,0,0,2,3,0,1,0,0,0,0,6,0,0,"0-0","Y","Y","Y",5,1,39
"1652","EC",2024-03-16,"Fylde","Wealdstone",1,2,"A",0,1,"A",1.78,4.32,3.93,"0-1","1-2",0,0,0,0,3,2,0,0,0,0,0,0,3,0,0,"0-0","Y","Y","N",5,0,39
"1653","EC",2024-03-16,"Hartlepool","Southend",0,0,"D",0,0,"D",3.31,3.58,2.16,"0-0","0-0",0,0,0,0,3,2,0,0,0,0,0,0,0,0,0,"0-0","N","N","N",5,0,39
"1654","EC",2024-03-16,"Woking","Barnet",1,0,"H",0,0,"D",2.96,3.68,2.29,"0-0","1-0",0,0,0,0,5,2,0,0,0,0,0,0,1,0,0,"0-0","N","N","N",7,0,39
"1655","EC",2024-03-16,"York","Aldershot",1,0,"H",0,0,"D",2.27,3.85,2.9,"0-0","1-0",0,0,0,0,2,4,0,0,0,0,0,0,1,0,0,"0-0","N","N","N",6,0,39
"1656","EC",2024-03-17,"Oxford City","Halifax",0,2,"A",0,2,"A",4.81,3.79,1.74,"0-2","0-2",0,0,0,0,0,0,0,0,0,0,0,0,2,0,0,"0-0","Y","N","N",0,0,39
"2754","F1",2023-08-11,"Nice","Lille",1,1,"D",1,0,"H",2.63,3.47,2.83,"1-0","1-1",8,3,12,5,3,2,0,0,3,3,13,9,2,6,22,"3-3","Y","N","N",5,0,1
"2755","F1",2023-08-12,"Marseille","Reims",2,1,"H",1,1,"D",1.73,4.04,4.89,"1-1","2-1",14,4,11,4,1,3,0,0,10,10,7,16,3,20,23,"10-10","Y","Y","N",4,0,1
"2756","F1",2023-08-12,"Paris SG","Lorient",0,0,"D",0,0,"D",1.35,5.73,8.38,"0-0","0-0",20,4,4,0,0,0,0,0,9,2,8,6,0,11,14,"9-2","N","N","N",0,0,1
"2757","F1",2023-08-13,"Brest","Lens",3,2,"H",1,2,"A",4.01,3.62,1.99,"1-2","3-2",15,8,10,2,2,3,0,1,6,8,13,15,5,14,28,"6-8","Y","Y","Y",5,1,1
"2758","F1",2023-08-13,"Clermont","Monaco",2,4,"A",1,2,"A",3.69,3.8,2.02,"1-2","2-4",15,7,14,8,0,4,0,0,6,2,7,16,6,8,23,"6-2","Y","Y","Y",4,0,1
"2759","F1",2023-08-13,"Montpellier","Le Havre",2,2,"D",0,1,"A",2.04,3.47,3.99,"0-1","2-2",15,5,12,4,1,2,0,0,5,2,8,12,4,7,20,"5-2","Y","Y","Y",3,0,1
"2760","F1",2023-08-13,"Nantes","Toulouse",1,2,"A",1,0,"H",2.66,3.36,2.82,"1-0","1-2",9,4,9,5,2,2,0,0,7,5,14,14,3,12,28,"7-5","Y","Y","N",4,0,1
"2761","F1",2023-08-13,"Rennes","Metz",5,1,"H",1,1,"D",1.42,5.07,7.64,"1-1","5-1",29,14,9,3,0,2,0,0,5,4,7,10,6,9,17,"5-4","Y","Y","Y",2,0,1
"2762","F1",2023-08-13,"Strasbourg","Lyon",2,1,"H",0,0,"D",2.61,3.55,2.76,"0-0","2-1",8,2,23,7,2,2,0,0,1,6,8,11,3,7,19,"1-6","Y","Y","N",4,0,1
"2763","F1",2023-08-18,"Metz","Marseille",2,2,"D",0,1,"A",4.96,4.13,1.72,"0-1","2-2",10,5,22,5,3,2,1,0,4,9,15,9,4,13,24,"4-9","Y","Y","Y",5,1,2
"2764","F1",2023-08-19,"Lyon","Montpellier",1,4,"A",0,2,"A",1.72,4.25,4.67,"0-2","1-4",7,3,14,8,4,1,1,0,6,2,20,10,5,8,30,"6-2","Y","Y","Y",5,1,2
"2765","F1",2023-08-19,"Toulouse","Paris SG",1,1,"D",0,0,"D",5.01,4.25,1.68,"0-0","1-1",8,2,16,3,0,3,0,0,5,5,8,11,2,10,19,"5-5","Y","N","N",3,0,2
"2766","F1",2023-08-20,"Lille","Nantes",2,0,"H",0,0,"D",1.43,4.96,7.54,"0-0","2-0",18,8,14,4,0,2,1,0,7,5,8,15,2,12,23,"7-5","Y","N","N",2,1,2
"2767","F1",2023-08-20,"Le Havre","Brest",1,2,"A",0,1,"A",2.82,3.22,2.76,"0-1","1-2",18,7,10,5,0,2,0,0,5,3,18,15,3,8,33,"5-3","Y","Y","N",2,0,2
"2768","F1",2023-08-20,"Lorient","Nice",1,1,"D",0,0,"D",3.49,3.52,2.19,"0-0","1-1",9,2,21,8,1,1,0,0,0,9,8,10,2,9,18,"0-9","Y","N","N",2,0,2
"2769","F1",2023-08-20,"Reims","Clermont",2,0,"H",1,0,"H",1.93,3.72,4.1,"1-0","2-0",8,4,11,4,0,0,0,0,3,10,9,6,2,13,15,"3-10","Y","N","N",0,0,2
"2770","F1",2023-08-20,"Monaco","Strasbourg",3,0,"H",2,0,"H",1.84,4.1,4.13,"2-0","3-0",9,4,4,1,2,1,0,0,4,3,19,16,3,7,35,"4-3","Y","Y","N",3,0,2
"2771","F1",2023-08-20,"Lens","Rennes",1,1,"D",1,0,"H",2.42,3.78,2.86,"1-0","1-1",15,4,10,5,2,1,0,0,11,0,15,10,2,11,25,"11-0","Y","N","N",3,0,2
"2772","F1",2023-08-25,"Nantes","Monaco",3,3,"D",2,1,"H",4.87,3.81,1.79,"2-1","3-3",3,3,27,10,2,2,0,0,1,10,8,7,6,11,15,"1-10","Y","Y","Y",4,0,3
"2773","F1",2023-08-26,"Marseille","Brest",2,0,"H",1,0,"H",1.53,4.48,6.43,"1-0","2-0",15,6,18,7,0,1,0,0,3,10,4,8,2,13,12,"3-10","Y","N","N",1,0,3
"2774","F1",2023-08-26,"Paris SG","Lens",3,1,"H",1,0,"H",1.63,4.27,5.45,"1-0","3-1",17,7,12,4,0,5,0,0,5,5,8,16,4,10,24,"5-5","Y","Y","Y",5,0,3
"2775","F1",2023-08-27,"Rennes","Le Havre",2,2,"D",2,1,"H",1.44,4.76,7.86,"2-1","2-2",22,8,7,3,1,2,0,1,5,2,5,7,4,7,12,"5-2","Y","Y","Y",3,1,3
"2776","F1",2023-08-27,"Clermont","Metz",0,1,"A",0,0,"D",1.93,3.83,3.99,"0-0","0-1",16,4,10,5,1,1,0,0,10,2,8,10,1,12,18,"10-2","N","N","N",2,0,3
"2777","F1",2023-08-27,"Montpellier","Reims",1,3,"A",1,2,"A",2.41,3.54,3.02,"1-2","1-3",19,3,12,6,1,1,0,0,5,3,9,19,4,8,28,"5-3","Y","Y","Y",2,0,3
"2778","F1",2023-08-27,"Strasbourg","Toulouse",2,0,"H",0,0,"D",2.17,3.75,3.32,"0-0","2-0",11,3,7,1,1,3,0,0,3,3,16,17,2,6,33,"3-3","Y","N","N",4,0,3
"2779","F1",2023-08-27,"Lorient","Lille",4,1,"H",2,0,"H",3.83,3.75,1.99,"2-0","4-1",9,6,18,7,2,4,0,0,5,8,22,12,5,13,34,"5-8","Y","Y","Y",6,0,3
"2780","F1",2023-08-27,"Nice","Lyon",0,0,"D",0,0,"D",2.11,3.79,3.44,"0-0","0-0",21,4,6,1,1,4,0,0,7,2,8,14,0,9,22,"7-2","N","N","N",5,0,3
"2781","F1",2023-09-01,"Nantes","Marseille",1,1,"D",1,1,"D",4.97,4.02,1.73,"1-1","1-1",10,2,26,9,0,2,1,0,2,7,7,13,2,9,20,"2-7","Y","N","N",2,1,4
"2782","F1",2023-09-02,"Brest","Rennes",0,0,"D",0,0,"D",3.37,3.68,2.18,"0-0","0-0",13,2,6,3,3,1,0,0,7,5,12,12,0,12,24,"7-5","N","N","N",4,0,4
"2783","F1",2023-09-02,"Monaco","Lens",3,0,"H",2,0,"H",2.11,3.93,3.33,"2-0","3-0",11,6,12,1,4,2,0,0,5,2,21,16,3,7,37,"5-2","Y","Y","N",6,0,4
"2784","F1",2023-09-03,"Toulouse","Clermont",2,2,"D",2,1,"H",2.02,3.69,3.82,"2-1","2-2",9,5,15,3,1,3,0,0,0,8,19,17,4,8,36,"0-8","Y","Y","Y",4,0,4
"2785","F1",2023-09-03,"Le Havre","Lorient",3,0,"H",0,0,"D",2.87,3.12,2.79,"0-0","3-0",17,6,9,2,0,0,0,0,5,4,10,7,3,9,17,"5-4","Y","Y","N",0,0,4
"2786","F1",2023-09-03,"Lille","Montpellier",1,0,"H",1,0,"H",1.83,4.25,4.05,"1-0","1-0",15,6,9,5,2,1,0,0,5,5,15,14,1,10,29,"5-5","N","N","N",3,0,4
"2787","F1",2023-09-03,"Metz","Reims",2,2,"D",1,1,"D",4.09,3.72,1.93,"1-1","2-2",12,4,12,2,0,4,0,0,4,1,10,17,4,5,27,"4-1","Y","Y","Y",4,0,4
"2788","F1",2023-09-03,"Nice","Strasbourg",2,0,"H",1,0,"H",1.98,3.58,4.06,"1-0","2-0",16,6,4,0,2,1,0,0,5,2,7,12,2,7,19,"5-2","Y","N","N",3,0,4
"2789","F1",2023-09-03,"Lyon","Paris SG",1,4,"A",0,4,"A",5.79,5.01,1.52,"0-4","1-4",19,8,22,8,2,2,0,0,5,2,9,5,5,7,14,"5-2","Y","Y","Y",4,0,4
"2790","F1",2023-09-15,"Paris SG","Nice",2,3,"A",1,1,"D",1.56,4.6,5.86,"1-1","2-3",12,3,14,8,2,5,0,0,4,3,8,17,5,7,25,"4-3","Y","Y","Y",7,0,5
"2791","F1",2023-09-16,"Rennes","Lille",2,2,"D",0,1,"A",2.17,3.69,3.37,"0-1","2-2",7,4,10,6,1,4,0,0,5,2,11,16,4,7,27,"5-2","Y","Y","Y",5,0,5
"2792","F1",2023-09-16,"Lens","Metz",0,1,"A",0,1,"A",1.52,4.62,6.36,"0-1","0-1",31,10,2,2,1,2,0,0,9,1,12,12,1,10,24,"9-1","N","N","N",3,0,5
"2793","F1",2023-09-17,"Lorient","Monaco",2,2,"D",1,1,"D",4.12,3.98,1.87,"1-1","2-2",10,3,20,7,0,1,0,0,8,6,13,14,4,14,27,"8-6","Y","Y","Y",1,0,5
"2794","F1",2023-09-17,"Clermont","Nantes",0,1,"A",0,0,"D",2.04,3.6,3.85,"0-0","0-1",16,3,8,5,2,2,0,0,6,3,16,16,1,9,32,"6-3","N","N","N",4,0,5
"2795","F1",2023-09-17,"Reims","Brest",1,2,"A",1,0,"H",1.9,3.6,4.43,"1-0","1-2",13,7,18,7,2,4,0,0,8,8,7,11,3,16,18,"8-8","Y","Y","N",6,0,5
"2796","F1",2023-09-17,"Strasbourg","Montpellier",2,2,"D",0,2,"A",2.39,3.61,3.01,"0-2","2-2",14,7,11,4,4,6,0,0,2,4,17,17,4,6,34,"2-4","Y","Y","Y",10,0,5
"2797","F1",2023-09-17,"Marseille","Toulouse",0,0,"D",0,0,"D",1.5,4.87,6.33,"0-0","0-0",24,6,10,3,2,5,0,0,6,1,9,11,0,7,20,"6-1","N","N","N",7,0,5
"2798","F1",2023-09-17,"Lyon","Le Havre",0,0,"D",0,0,"D",1.7,4.23,4.82,"0-0","0-0",23,7,7,0,3,2,0,0,6,1,13,12,0,7,25,"6-1","N","N","N",5,0,5
"2799","F1",2023-09-22,"Monaco","Nice",0,1,"A",0,0,"D",2.25,3.61,3.27,"0-0","0-1",9,3,13,7,1,1,0,0,5,2,13,15,1,7,28,"5-2","N","N","N",2,0,6
"2800","F1",2023-09-23,"Nantes","Lorient",5,3,"H",1,1,"D",2.46,3.45,3.02,"1-1","5-3",19,9,10,7,1,3,0,0,4,2,8,17,8,6,25,"4-2","Y","Y","Y",4,0,6
"2801","F1",2023-09-23,"Brest","Lyon",1,0,"H",0,0,"D",2.57,3.67,2.73,"0-0","1-0",27,11,6,3,3,1,0,0,10,1,17,16,1,11,33,"10-1","N","N","N",4,0,6
"2802","F1",2023-09-24,"Metz","Strasbourg",0,1,"A",0,0,"D",3.01,3.23,2.59,"0-0","0-1",13,1,4,1,2,0,0,0,1,1,16,15,1,2,31,"1-1","N","N","N",2,0,6
"2803","F1",2023-09-24,"Le Havre","Clermont",2,1,"H",2,1,"H",2.48,3.26,3.15,"2-1","2-1",9,3,11,4,2,3,0,0,1,3,15,17,3,4,32,"1-3","Y","Y","N",5,0,6
"2804","F1",2023-09-24,"Lens","Toulouse",2,1,"H",1,1,"D",1.72,4.05,4.93,"1-1","2-1",27,7,7,2,2,1,0,0,9,4,16,15,3,13,31,"9-4","Y","Y","N",3,0,6
"2805","F1",2023-09-24,"Montpellier","Rennes",0,0,"D",0,0,"D",2.7,3.56,2.65,"0-0","0-0",13,4,18,6,2,1,0,0,3,6,10,15,0,9,25,"3-6","N","N","N",3,0,6
"2806","F1",2023-09-24,"Paris SG","Marseille",4,0,"H",2,0,"H",1.64,4.41,5.15,"2-0","4-0",15,5,6,0,0,3,0,0,8,3,11,14,4,11,25,"8-3","Y","Y","Y",3,0,6
"2807","F1",2023-09-26,"Lille","Reims",1,2,"A",0,2,"A",1.96,3.79,3.95,"0-2","1-2",14,3,4,4,1,2,0,0,4,2,4,19,3,6,23,"4-2","Y","Y","N",3,0,6
"2808","F1",2023-09-29,"Strasbourg","Lens",0,1,"A",0,1,"A",3.69,3.48,2.13,"0-1","0-1",8,2,9,2,2,4,0,0,2,3,16,15,1,5,31,"2-3","N","N","N",6,0,7
"2809","F1",2023-09-30,"Clermont","Paris SG",0,0,"D",0,0,"D",7.03,4.81,1.47,"0-0","0-0",12,3,21,10,2,3,0,0,6,9,11,16,0,15,27,"6-9","N","N","N",5,0,7
"2810","F1",2023-09-30,"Monaco","Marseille",3,2,"H",2,2,"D",2.21,3.88,3.14,"2-2","3-2",10,7,8,4,4,4,0,0,2,6,17,15,5,8,32,"2-6","Y","Y","Y",8,0,7
"2811","F1",2023-10-01,"Reims","Lyon",2,0,"H",1,0,"H",2.1,3.81,3.45,"1-0","2-0",8,3,11,6,2,2,0,0,1,5,19,14,2,6,33,"1-5","Y","N","N",4,0,7
"2812","F1",2023-10-01,"Le Havre","Lille",0,2,"A",0,1,"A",4.08,3.44,2.03,"0-1","0-2",5,0,16,6,0,0,0,0,6,6,18,6,2,12,24,"6-6","Y","N","N",0,0,7
"2813","F1",2023-10-01,"Nice","Brest",0,0,"D",0,0,"D",1.8,3.84,4.69,"0-0","0-0",12,1,7,2,1,3,0,0,6,4,13,9,0,10,22,"6-4","N","N","N",4,0,7
"2814","F1",2023-10-01,"Toulouse","Metz",3,0,"H",2,0,"H",2.13,3.47,3.7,"2-0","3-0",15,10,8,3,3,0,0,0,4,6,10,7,3,10,17,"4-6","Y","Y","N",3,0,7
"2815","F1",2023-10-01,"Lorient","Montpellier",0,3,"A",0,1,"A",2.95,3.59,2.44,"0-1","0-3",14,3,14,8,2,1,0,0,8,3,13,6,3,11,19,"8-3","Y","Y","N",3,0,7
"2816","F1",2023-10-01,"Rennes","Nantes",3,1,"H",1,1,"D",1.53,4.58,6.18,"1-1","3-1",16,5,10,3,3,6,0,1,6,4,11,17,4,10,28,"6-4","Y","Y","Y",9,1,7
"2817","F1",2023-10-06,"Strasbourg","Nantes",1,2,"A",0,0,"D",2.31,3.24,3.57,"0-0","1-2",11,3,16,7,4,0,0,0,3,11,15,12,3,14,27,"3-11","Y","Y","N",4,0,8
"2818","F1",2023-10-07,"Metz","Nice",0,1,"A",0,1,"A",5.12,3.91,1.72,"0-1","0-1",10,3,7,4,0,1,0,0,1,4,9,10,1,5,19,"1-4","N","N","N",1,0,8
"2819","F1",2023-10-07,"Reims","Monaco",1,3,"A",0,1,"A",2.68,3.62,2.64,"0-1","1-3",11,4,11,4,0,3,0,0,10,5,10,14,4,15,24,"10-5","Y","Y","Y",3,0,8
"2820","F1",2023-10-08,"Marseille","Le Havre",3,0,"H",2,0,"H",1.48,4.63,7.2,"2-0","3-0",14,6,7,1,0,3,0,1,4,3,6,16,3,7,22,"4-3","Y","Y","N",3,1,8
"2821","F1",2023-10-08,"Brest","Toulouse",1,1,"D",0,1,"A",1.85,3.74,4.54,"0-1","1-1",13,2,9,3,2,2,0,0,3,5,18,18,2,8,36,"3-5","Y","N","N",4,0,8
"2822","F1",2023-10-08,"Lyon","Lorient",3,3,"D",3,1,"H",1.71,4.06,5.04,"3-1","3-3",9,6,6,5,0,0,0,0,5,2,22,10,6,7,32,"5-2","Y","Y","Y",0,0,8
"2823","F1",2023-10-08,"Lens","Lille",1,1,"D",0,1,"A",2.27,3.48,3.34,"0-1","1-1",14,5,8,3,2,4,0,0,8,5,14,16,2,13,30,"8-5","Y","N","N",6,0,8
"2824","F1",2023-10-08,"Rennes","Paris SG",1,3,"A",0,2,"A",3.61,3.59,2.11,"0-2","1-3",14,4,17,7,1,0,0,0,1,7,12,15,4,8,27,"1-7","Y","Y","Y",1,0,8
"2825","F1",2023-10-20,"Le Havre","Lens",0,0,"D",0,0,"D",4.66,3.6,1.88,"0-0","0-0",14,5,13,7,2,3,0,0,3,3,16,9,0,6,25,"3-3","N","N","N",5,0,8
"2826","F1",2023-10-21,"Paris SG","Strasbourg",3,0,"H",2,0,"H",1.24,6.93,11.72,"2-0","3-0",8,4,7,1,2,0,0,0,1,6,11,10,3,7,21,"1-6","Y","Y","N",2,0,9
"2827","F1",2023-10-21,"Nice","Marseille",1,0,"H",0,0,"D",2.51,3.22,3.14,"0-0","1-0",10,2,9,1,4,3,0,1,4,2,13,6,1,6,19,"4-2","N","N","N",7,1,9
"2828","F1",2023-10-22,"Lorient","Rennes",2,1,"H",2,1,"H",4.02,3.79,1.93,"2-1","2-1",5,4,20,6,0,2,0,0,6,16,5,14,3,22,19,"6-16","Y","Y","N",2,0,9
"2829","F1",2023-10-22,"Lille","Brest",1,0,"H",1,0,"H",1.82,3.64,4.85,"1-0","1-0",6,4,9,1,2,3,0,0,3,5,12,13,1,8,25,"3-5","N","N","N",5,0,9
"2830","F1",2023-10-22,"Nantes","Montpellier",2,0,"H",1,0,"H",3.03,3.62,2.37,"1-0","2-0",14,5,11,6,2,1,0,0,4,3,16,13,2,7,29,"4-3","Y","N","N",3,0,9
"2831","F1",2023-10-22,"Toulouse","Reims",1,1,"D",0,0,"D",2.94,3.47,2.5,"0-0","1-1",11,5,15,4,2,0,0,0,5,7,18,15,2,12,33,"5-7","Y","N","N",2,0,9
"2832","F1",2023-10-22,"Monaco","Metz",2,1,"H",1,1,"D",1.36,5.75,8.16,"1-1","2-1",27,13,8,4,1,3,0,0,10,2,12,11,3,12,23,"10-2","Y","Y","N",4,0,9
"2833","F1",2023-10-22,"Lyon","Clermont",1,2,"A",0,2,"A",1.81,4.08,4.31,"0-2","1-2",25,6,12,5,4,6,0,0,10,3,16,12,3,13,28,"10-3","Y","Y","N",10,0,9
"2834","F1",2023-10-27,"Clermont","Nice",0,1,"A",0,0,"D",4.42,3.42,1.95,"0-0","0-1",8,3,11,5,0,2,0,0,2,2,14,12,1,4,26,"2-2","N","N","N",2,0,9
"2835","F1",2023-10-28,"Reims","Lorient",1,0,"H",0,0,"D",1.67,4.24,5.13,"0-0","1-0",12,5,9,1,1,3,0,0,4,4,16,7,1,8,23,"4-4","N","N","N",4,0,10
"2836","F1",2023-10-28,"Lens","Nantes",4,0,"H",1,0,"H",1.6,4.36,5.65,"1-0","4-0",11,7,11,1,1,2,0,0,4,1,12,17,4,5,29,"4-1","Y","Y","Y",3,0,10
"2837","F1",2023-10-29,"Brest","Paris SG",2,3,"A",1,2,"A",6.06,4.63,1.54,"1-2","2-3",20,5,17,10,3,4,0,0,9,5,14,10,5,14,24,"9-5","Y","Y","Y",7,0,10
"2838","F1",2023-10-29,"Lille","Monaco",2,0,"H",2,0,"H",2.34,3.82,2.95,"2-0","2-0",7,5,16,6,1,2,0,0,2,8,17,13,2,10,30,"2-8","Y","N","N",3,0,10
"2839","F1",2023-10-29,"Metz","Le Havre",0,0,"D",0,0,"D",2.61,3.26,2.96,"0-0","0-0",9,3,12,1,2,2,0,0,5,6,13,15,0,11,28,"5-6","N","N","N",4,0,10
"2840","F1",2023-10-29,"Montpellier","Toulouse",3,0,"H",1,0,"H",1.8,3.95,4.53,"1-0","3-0",19,6,16,5,2,3,0,0,3,4,13,15,3,7,28,"3-4","Y","Y","N",5,0,10
"2841","F1",2023-10-29,"Rennes","Strasbourg",1,1,"D",1,0,"H",1.6,4.19,5.92,"1-0","1-1",20,3,11,3,2,2,0,0,7,5,14,16,2,12,30,"7-5","Y","N","N",4,0,10
"2842","F1",2023-11-03,"Paris SG","Montpellier",3,0,"H",1,0,"H",1.26,6.76,10.17,"1-0","3-0",21,10,7,2,1,0,0,0,9,2,10,13,3,11,23,"9-2","Y","Y","N",1,0,10
"2843","F1",2023-11-04,"Lorient","Lens",0,0,"D",0,0,"D",4.73,3.95,1.75,"0-0","0-0",7,2,14,7,3,3,0,0,1,5,10,14,0,6,24,"1-5","N","N","N",6,0,10
"2844","F1",2023-11-04,"Marseille","Lille",0,0,"D",0,0,"D",2.21,3.59,3.31,"0-0","0-0",8,3,10,1,2,3,0,0,2,8,10,12,0,10,22,"2-8","N","N","N",5,0,11
"2845","F1",2023-11-05,"Lyon","Metz",1,1,"D",0,0,"D",1.67,4.04,5.24,"0-0","1-1",15,4,10,5,1,1,0,0,4,9,16,14,2,13,30,"4-9","Y","N","N",2,0,11
"2846","F1",2023-11-05,"Nantes","Reims",0,1,"A",0,0,"D",2.99,3.2,2.59,"0-0","0-1",17,4,7,4,1,2,0,0,10,6,5,11,1,16,16,"10-6","N","N","N",3,0,11
"2847","F1",2023-11-05,"Strasbourg","Clermont",0,0,"D",0,0,"D",2.42,3.23,3.22,"0-0","0-0",18,5,10,2,2,0,1,0,4,6,11,5,0,10,16,"4-6","N","N","N",2,1,11
"2848","F1",2023-11-05,"Toulouse","Le Havre",1,2,"A",0,0,"D",2.16,3.35,3.67,"0-0","1-2",17,5,15,7,2,2,0,0,4,6,9,12,3,10,21,"4-6","Y","Y","N",4,0,11
"2849","F1",2023-11-05,"Monaco","Brest",2,0,"H",1,0,"H",1.76,4.14,4.44,"1-0","2-0",12,6,15,1,2,4,0,1,6,4,15,11,2,10,26,"6-4","Y","N","N",6,1,11
"2850","F1",2023-11-05,"Nice","Rennes",2,0,"H",1,0,"H",2.13,3.36,3.74,"1-0","2-0",16,4,11,4,0,2,1,1,2,1,7,12,2,3,19,"2-1","Y","N","N",2,2,11
"2851","F1",2023-11-10,"Montpellier","Nice",0,0,"D",0,0,"D",3.61,3.39,2.17,"0-0","0-0",9,1,15,4,0,4,0,0,3,7,11,15,0,10,26,"3-7","N","N","N",4,0,11
"2852","F1",2023-11-11,"Reims","Paris SG",0,3,"A",0,1,"A",5.46,4.35,1.6,"0-1","0-3",19,6,14,6,1,0,0,0,8,4,14,6,3,12,20,"8-4","Y","Y","N",1,0,11
"2853","F1",2023-11-11,"Le Havre","Monaco",0,0,"D",0,0,"D",4.5,3.95,1.78,"0-0","0-0",9,5,10,4,2,3,0,0,2,4,10,18,0,6,28,"2-4","N","N","N",5,0,12
"2854","F1",2023-11-12,"Clermont","Lorient",1,0,"H",0,0,"D",2.18,3.35,3.63,"0-0","1-0",17,6,10,3,3,2,0,0,5,4,15,10,1,9,25,"5-4","N","N","N",5,0,12
"2855","F1",2023-11-12,"Lille","Toulouse",1,1,"D",1,0,"H",1.59,4.33,5.62,"1-0","1-1",13,6,2,1,3,4,0,0,11,1,12,16,2,12,28,"11-1","Y","N","N",7,0,12
"2856","F1",2023-11-12,"Metz","Nantes",3,1,"H",2,1,"H",3.04,3.24,2.53,"2-1","3-1",9,4,16,3,0,0,0,0,2,5,7,9,4,7,16,"2-5","Y","Y","Y",0,0,12
"2857","F1",2023-11-12,"Rennes","Lyon",0,1,"A",0,0,"D",1.75,4.12,4.48,"0-0","0-1",8,2,12,5,3,1,1,0,6,9,5,18,1,15,23,"6-9","N","N","N",4,1,12
"2858","F1",2023-11-12,"Lens","Marseille",1,0,"H",0,0,"D",2.27,3.54,3.22,"0-0","1-0",14,3,8,2,2,2,0,0,4,5,19,15,1,9,34,"4-5","N","N","N",4,0,12
"2859","F1",2023-11-24,"Paris SG","Monaco",5,2,"H",2,1,"H",1.5,5.1,5.7,"2-1","5-2",16,11,14,7,0,1,0,0,2,10,9,19,7,12,28,"2-10","Y","Y","Y",1,0,12
"2860","F1",2023-11-25,"Clermont","Lens",0,3,"A",0,1,"A",3.89,3.52,2.03,"0-1","0-3",13,4,16,10,2,3,1,1,2,4,16,17,3,6,33,"2-4","Y","Y","N",5,2,12
"2861","F1",2023-11-25,"Strasbourg","Marseille",1,1,"D",1,1,"D",3.94,3.58,1.99,"1-1","1-1",15,7,16,3,1,2,0,0,7,11,14,16,2,18,30,"7-11","Y","N","N",3,0,12
"2862","F1",2023-11-26,"Nice","Toulouse",1,0,"H",0,0,"D",1.52,4.18,7.02,"0-0","1-0",8,3,19,3,0,4,0,0,4,2,9,19,1,6,28,"4-2","N","N","N",4,0,13
"2863","F1",2023-11-26,"Lorient","Metz",2,3,"A",2,1,"H",2,3.45,4.07,"2-1","2-3",11,5,14,5,2,1,0,0,5,6,10,17,5,11,27,"5-6","Y","Y","Y",3,0,13
"2864","F1",2023-11-26,"Montpellier","Brest",1,3,"A",0,1,"A",2.31,3.39,3.27,"0-1","1-3",17,5,17,5,2,2,0,0,9,1,11,18,4,10,29,"9-1","Y","Y","Y",4,0,13
"2865","F1",2023-11-26,"Nantes","Le Havre",0,0,"D",0,0,"D",2.07,3.47,3.8,"0-0","0-0",19,3,6,0,1,2,0,1,10,5,10,17,0,15,27,"10-5","N","N","N",3,1,13
"2866","F1",2023-11-26,"Rennes","Reims",3,1,"H",1,1,"D",2,3.63,3.85,"1-1","3-1",10,5,15,5,2,2,0,0,1,8,10,18,4,9,28,"1-8","Y","Y","Y",4,0,13
"2867","F1",2023-11-26,"Lyon","Lille",0,2,"A",0,2,"A",3.1,3.28,2.47,"0-2","0-2",11,5,15,8,2,2,0,0,3,5,17,5,2,8,22,"3-5","Y","N","N",4,0,13
"2868","F1",2023-11-29,"Montpellier","Clermont",1,1,"D",0,1,"A",1.95,3.66,4,"0-1","1-1",32,10,5,1,3,4,0,0,8,0,23,14,2,8,37,"8-0","Y","N","N",7,0,13
"2869","F1",2023-12-01,"Reims","Strasbourg",2,1,"H",2,0,"H",1.76,3.87,4.93,"2-0","2-1",13,4,10,3,1,1,0,0,4,5,7,7,3,9,14,"4-5","Y","Y","N",2,0,13
"2870","F1",2023-12-02,"Lens","Lyon",3,2,"H",1,1,"D",1.7,4.14,4.81,"1-1","3-2",10,7,12,7,2,0,1,0,3,6,11,14,5,9,25,"3-6","Y","Y","Y",2,1,13
"2871","F1",2023-12-02,"Nantes","Nice",1,0,"H",1,0,"H",4.03,3.38,2.04,"1-0","1-0",13,4,13,6,3,0,0,0,5,6,15,18,1,11,33,"5-6","N","N","N",3,0,14
"2872","F1",2023-12-03,"Le Havre","Paris SG",0,2,"A",0,1,"A",9.54,5.88,1.31,"0-1","0-2",22,7,9,5,2,1,0,1,9,2,11,9,2,11,20,"9-2","Y","N","N",3,1,14
"2873","F1",2023-12-03,"Brest","Clermont",3,0,"H",2,0,"H",1.8,3.79,4.62,"2-0","3-0",12,7,10,1,1,2,0,0,4,2,11,17,3,6,28,"4-2","Y","Y","N",3,0,14
"2874","F1",2023-12-03,"Monaco","Montpellier",2,0,"H",1,0,"H",1.66,4.47,4.74,"1-0","2-0",27,9,9,4,2,3,0,1,8,2,15,13,2,10,28,"8-2","Y","N","N",5,1,14
"2875","F1",2023-12-03,"Toulouse","Lorient",1,1,"D",0,0,"D",2.03,3.53,3.86,"0-0","1-1",11,6,11,5,2,4,0,0,3,4,16,10,2,7,26,"3-4","Y","N","N",6,0,14
"2876","F1",2023-12-03,"Lille","Metz",2,0,"H",2,0,"H",1.45,4.82,7.11,"2-0","2-0",16,6,7,4,0,0,0,0,6,1,8,11,2,7,19,"6-1","Y","N","N",0,0,14
"2877","F1",2023-12-03,"Marseille","Rennes",2,0,"H",1,0,"H",1.92,3.84,3.95,"1-0","2-0",5,2,10,0,1,3,1,1,1,6,9,15,2,7,24,"1-6","Y","N","N",4,2,14
"2878","F1",2023-12-06,"Marseille","Lyon",3,0,"H",2,0,"H",1.71,3.94,5.06,"2-0","3-0",12,5,6,1,1,2,0,0,10,3,14,11,3,13,25,"10-3","Y","Y","N",3,0,14
"2879","F1",2023-12-07,"Brest","Strasbourg",1,1,"D",1,0,"H",1.83,3.68,4.61,"1-0","1-1",13,3,9,5,1,0,0,0,6,0,11,18,2,6,29,"6-0","Y","N","N",1,0,14
"2880","F1",2023-12-08,"Montpellier","Lens",0,0,"D",0,0,"D",3.49,3.51,2.19,"0-0","0-0",18,4,13,5,2,3,0,0,4,3,16,11,0,7,27,"4-3","N","N","N",5,0,15
"2881","F1",2023-12-09,"Rennes","Monaco",1,2,"A",0,0,"D",2.59,3.72,2.65,"0-0","1-2",15,5,12,5,3,6,0,1,5,5,9,22,3,10,31,"5-5","Y","Y","N",9,1,15
"2882","F1",2023-12-09,"Paris SG","Nantes",2,1,"H",1,0,"H",1.22,7.2,11.37,"1-0","2-1",16,6,10,4,1,3,0,0,5,3,9,12,3,8,21,"5-3","Y","Y","N",4,0,15
"2883","F1",2023-12-10,"Nice","Reims",2,1,"H",0,0,"D",1.89,3.53,4.46,"0-0","2-1",15,5,9,2,2,3,0,0,9,0,13,6,3,9,19,"9-0","Y","Y","N",5,0,15
"2884","F1",2023-12-10,"Clermont","Lille",0,0,"D",0,0,"D",5.08,3.74,1.75,"0-0","0-0",16,5,12,3,2,2,0,0,3,6,18,9,0,9,27,"3-6","N","N","N",4,0,15
"2885","F1",2023-12-10,"Metz","Brest",0,1,"A",0,0,"D",3.56,3.3,2.23,"0-0","0-1",6,3,4,3,3,2,0,0,3,2,14,16,1,5,30,"3-2","N","N","N",5,0,15
"2886","F1",2023-12-10,"Strasbourg","Le Havre",2,1,"H",1,0,"H",2.16,3.32,3.7,"1-0","2-1",12,3,15,3,3,1,0,0,4,3,14,15,3,7,29,"4-3","Y","Y","N",4,0,15
"2887","F1",2023-12-10,"Lyon","Toulouse",3,0,"H",2,0,"H",2,3.7,3.81,"2-0","3-0",15,7,16,6,2,3,0,0,2,1,15,15,3,3,30,"2-1","Y","Y","N",5,0,15
"2888","F1",2023-12-10,"Lorient","Marseille",2,4,"A",1,4,"A",4.58,3.78,1.81,"1-4","2-4",15,9,18,8,5,3,0,1,4,6,17,17,6,10,34,"4-6","Y","Y","Y",8,1,15
"2889","F1",2023-12-15,"Monaco","Lyon",0,1,"A",0,0,"D",1.76,4.22,4.47,"0-0","0-1",19,4,5,2,1,2,0,0,6,1,13,12,1,7,25,"6-1","N","N","N",3,0,16
"2890","F1",2023-12-16,"Le Havre","Nice",3,1,"H",2,0,"H",4.46,3.28,1.98,"2-0","3-1",9,5,13,6,3,2,1,1,2,9,13,9,4,11,22,"2-9","Y","Y","Y",5,2,16
"2891","F1",2023-12-16,"Lens","Reims",2,0,"H",1,0,"H",1.88,3.75,4.2,"1-0","2-0",7,2,14,3,0,1,0,0,4,7,9,10,2,11,19,"4-7","Y","N","N",1,0,16
"2892","F1",2023-12-17,"Nantes","Brest",0,2,"A",0,0,"D",2.67,3.29,2.81,"0-0","0-2",12,4,14,8,1,3,0,0,4,3,15,8,2,7,23,"4-3","Y","N","N",4,0,16
"2893","F1",2023-12-17,"Lorient","Strasbourg",1,2,"A",0,1,"A",2.6,3.25,2.94,"0-1","1-2",7,1,12,9,3,2,0,0,6,1,14,12,3,7,26,"6-1","Y","Y","N",5,0,16
"2894","F1",2023-12-17,"Metz","Montpellier",0,1,"A",0,1,"A",3.29,3.32,2.34,"0-1","0-1",19,4,6,3,2,2,0,0,12,5,15,14,1,17,29,"12-5","N","N","N",4,0,16
"2895","F1",2023-12-17,"Toulouse","Rennes",0,0,"D",0,0,"D",3.26,3.57,2.24,"0-0","0-0",15,6,11,4,3,2,0,0,4,4,17,14,0,8,31,"4-4","N","N","N",5,0,16
"2896","F1",2023-12-17,"Marseille","Clermont",2,1,"H",2,0,"H",1.43,4.79,7.84,"2-0","2-1",15,6,5,2,0,3,0,0,4,1,12,14,3,5,26,"4-1","Y","Y","N",3,0,16
"2897","F1",2023-12-17,"Lille","Paris SG",1,1,"D",0,0,"D",4.11,4.05,1.83,"0-0","1-1",15,3,10,2,1,1,0,0,8,8,9,19,2,16,28,"8-8","Y","N","N",2,0,16
"2898","F1",2023-12-20,"Brest","Lorient",4,0,"H",4,0,"H",1.61,4.06,5.91,"4-0","4-0",12,7,7,3,1,2,0,0,1,0,8,17,4,1,25,"1-0","Y","Y","Y",3,0,17
"2899","F1",2023-12-20,"Clermont","Rennes",1,3,"A",1,0,"H",3.44,3.4,2.23,"1-0","1-3",14,6,25,11,0,3,1,0,4,5,8,11,4,9,19,"4-5","Y","Y","Y",3,1,17
"2900","F1",2023-12-20,"Lyon","Nantes",1,0,"H",0,0,"D",1.7,4.2,4.71,"0-0","1-0",8,7,7,0,1,2,1,0,7,7,8,14,1,14,22,"7-7","N","N","N",3,1,17
"2901","F1",2023-12-20,"Montpellier","Marseille",1,1,"D",1,0,"H",3.62,3.59,2.09,"1-0","1-1",12,6,17,4,2,1,0,0,5,10,21,13,2,15,34,"5-10","Y","N","N",3,0,17
"2902","F1",2023-12-20,"Nice","Lens",2,0,"H",0,0,"D",2.34,3.19,3.41,"0-0","2-0",14,5,10,3,2,2,0,0,5,6,14,11,2,11,25,"5-6","Y","N","N",4,0,17
"2903","F1",2023-12-20,"Paris SG","Metz",3,1,"H",0,0,"D",1.15,9.06,16.98,"0-0","3-1",13,5,3,1,0,1,0,0,5,5,6,9,4,10,15,"5-5","Y","Y","Y",1,0,17
"2904","F1",2023-12-20,"Reims","Le Havre",1,0,"H",1,0,"H",1.69,3.92,5.28,"1-0","1-0",22,7,4,1,1,1,0,1,6,2,7,6,1,8,13,"6-2","N","N","N",2,1,17
"2905","F1",2023-12-20,"Strasbourg","Lille",2,1,"H",1,1,"D",4.01,3.57,1.98,"1-1","2-1",9,2,9,2,1,2,0,0,6,5,19,10,3,11,29,"6-5","Y","Y","N",3,0,17
"2906","F1",2023-12-20,"Toulouse","Monaco",1,2,"A",1,2,"A",4.31,3.94,1.82,"1-2","1-2",20,5,12,4,2,3,0,1,4,5,17,10,3,9,27,"4-5","Y","Y","N",5,1,17
"2907","F1",2024-01-12,"Marseille","Strasbourg",1,1,"D",1,0,"H",1.62,4.01,6.08,"1-0","1-1",8,2,18,4,3,2,0,0,6,4,11,10,2,10,21,"6-4","Y","N","N",5,0,18
"2908","F1",2024-01-13,"Monaco","Reims",1,3,"A",0,1,"A",1.76,4.08,4.46,"0-1","1-3",9,5,12,5,3,2,0,0,6,6,11,9,4,12,20,"6-6","Y","Y","Y",5,0,18
"2909","F1",2024-01-13,"Rennes","Nice",2,0,"H",1,0,"H",2.43,3.27,3.17,"1-0","2-0",15,5,9,2,1,0,0,0,6,6,13,11,2,12,24,"6-6","Y","N","N",1,0,18
"2910","F1",2024-01-14,"Lille","Lorient",3,0,"H",1,0,"H",1.38,5.04,8.5,"1-0","3-0",24,10,1,0,1,4,0,0,7,1,10,22,3,8,32,"7-1","Y","Y","N",5,0,18
"2911","F1",2024-01-14,"Brest","Montpellier",2,0,"H",0,0,"D",1.88,3.65,4.34,"0-0","2-0",26,9,9,4,1,2,0,0,3,3,6,7,2,6,13,"3-3","Y","N","N",3,0,18
"2912","F1",2024-01-14,"Metz","Toulouse",0,1,"A",0,1,"A",3.16,3.02,2.59,"0-1","0-1",14,2,4,2,3,2,1,0,5,2,20,18,1,7,38,"5-2","N","N","N",5,1,18
"2913","F1",2024-01-14,"Nantes","Clermont",1,2,"A",0,1,"A",2,3.44,4.11,"0-1","1-2",20,9,15,6,1,1,1,0,11,5,10,5,3,16,15,"11-5","Y","Y","N",2,1,18
"2914","F1",2024-01-14,"Le Havre","Lyon",3,1,"H",1,0,"H",3.26,3.29,2.36,"1-0","3-1",14,7,9,2,1,0,0,2,3,7,15,4,4,10,19,"3-7","Y","Y","Y",1,2,18
"2915","F1",2024-01-14,"Lens","Paris SG",0,2,"A",0,1,"A",3.81,4.06,1.9,"0-1","0-2",17,5,15,7,0,1,1,0,5,6,10,8,2,11,18,"5-6","Y","N","N",1,1,18
"2916","F1",2024-01-26,"Lyon","Rennes",2,3,"A",0,3,"A",2.56,3.35,2.91,"0-3","2-3",12,6,11,5,2,2,0,0,3,2,15,12,5,5,27,"3-2","Y","Y","Y",4,0,19
"2917","F1",2024-01-27,"Nice","Metz",1,0,"H",0,0,"D",1.41,4.57,8.94,"0-0","1-0",15,9,2,1,1,1,0,0,5,2,10,13,1,7,23,"5-2","N","N","N",2,0,19
"2918","F1",2024-01-27,"Marseille","Monaco",2,2,"D",1,2,"A",2.45,3.68,2.83,"1-2","2-2",22,9,6,5,1,3,0,2,10,1,11,12,4,11,23,"10-1","Y","Y","Y",4,2,19
"2919","F1",2024-01-28,"Montpellier","Lille",0,0,"D",0,0,"D",3.93,3.59,1.99,"0-0","0-0",12,7,12,0,4,3,0,1,5,2,13,16,0,7,29,"5-2","N","N","N",7,1,19
"2920","F1",2024-01-28,"Clermont","Strasbourg",1,1,"D",0,1,"A",2.83,3.27,2.67,"0-1","1-1",14,6,6,2,1,3,0,0,5,2,12,16,2,7,28,"5-2","Y","N","N",4,0,19
"2921","F1",2024-01-28,"Lorient","Le Havre",3,3,"D",1,1,"D",3,3.12,2.63,"1-1","3-3",13,6,14,5,4,4,0,0,1,4,15,21,6,5,36,"1-4","Y","Y","Y",8,0,19
"2922","F1",2024-01-28,"Reims","Nantes",0,0,"D",0,0,"D",1.83,3.76,4.5,"0-0","0-0",10,1,7,5,3,2,0,0,6,2,8,16,0,8,24,"6-2","N","N","N",5,0,19
"2923","F1",2024-01-28,"Toulouse","Lens",0,2,"A",0,1,"A",3.54,3.63,2.1,"0-1","0-2",13,4,13,5,3,3,0,0,10,7,11,14,2,17,25,"10-7","Y","N","N",6,0,19
"2924","F1",2024-01-28,"Paris SG","Brest",2,2,"D",2,0,"H",1.4,5.45,6.98,"2-0","2-2",10,4,9,6,5,3,1,0,7,0,12,10,4,7,22,"7-0","Y","Y","Y",8,1,19
"2925","F1",2024-02-02,"Strasbourg","Paris SG",1,2,"A",0,1,"A",6.58,4.66,1.5,"0-1","1-2",20,8,9,5,3,1,0,0,3,4,12,13,3,7,25,"3-4","Y","Y","N",4,0,20
"2926","F1",2024-02-03,"Rennes","Montpellier",2,1,"H",1,0,"H",1.63,4.09,5.56,"1-0","2-1",9,3,17,9,4,3,0,0,5,3,17,12,3,8,29,"5-3","Y","Y","N",7,0,20
"2927","F1",2024-02-03,"Nantes","Lens",0,1,"A",0,0,"D",3.47,3.36,2.23,"0-0","0-1",7,2,12,4,2,2,0,0,2,3,16,11,1,5,27,"2-3","N","N","N",4,0,20
"2928","F1",2024-02-04,"Monaco","Le Havre",1,1,"D",0,0,"D",1.49,4.56,6.8,"0-0","1-1",17,5,3,0,3,2,0,0,9,4,16,11,2,13,27,"9-4","Y","N","N",5,0,20
"2929","F1",2024-02-04,"Lille","Clermont",4,0,"H",4,0,"H",1.42,4.81,7.95,"4-0","4-0",23,13,4,3,0,1,0,0,12,1,8,10,4,13,18,"12-1","Y","Y","Y",1,0,20
"2930","F1",2024-02-04,"Metz","Lorient",1,2,"A",1,1,"D",2.28,3.11,3.66,"1-1","1-2",10,3,12,4,3,1,0,0,4,3,12,13,3,7,25,"4-3","Y","Y","N",4,0,20
"2931","F1",2024-02-04,"Reims","Toulouse",2,3,"A",0,3,"A",1.8,3.73,4.69,"0-3","2-3",17,5,9,4,2,3,0,0,10,6,13,16,5,16,29,"10-6","Y","Y","Y",5,0,20
"2932","F1",2024-02-04,"Brest","Nice",0,0,"D",0,0,"D",2.51,3.15,3.15,"0-0","0-0",17,2,13,1,3,1,0,0,3,5,12,12,0,8,24,"3-5","N","N","N",4,0,20
"2933","F1",2024-02-04,"Lyon","Marseille",1,0,"H",1,0,"H",2.91,3.38,2.54,"1-0","1-0",12,7,8,1,2,1,0,0,3,2,14,10,1,5,24,"3-2","N","N","N",3,0,20
"2934","F1",2024-02-09,"Marseille","Metz",1,1,"D",0,0,"D",1.43,4.64,8.45,"0-0","1-1",18,6,7,3,2,0,1,0,6,3,12,16,2,9,28,"6-3","Y","N","N",2,1,21
"2935","F1",2024-02-10,"Lens","Strasbourg",3,1,"H",2,1,"H",1.67,3.82,5.68,"2-1","3-1",10,6,19,5,2,1,0,0,4,5,14,14,4,9,28,"4-5","Y","Y","Y",3,0,21
"2936","F1",2024-02-10,"Paris SG","Lille",3,1,"H",2,1,"H",1.63,4.28,5.3,"2-1","3-1",16,8,10,3,2,3,0,0,6,8,12,10,4,14,22,"6-8","Y","Y","Y",5,0,21
"2937","F1",2024-02-11,"Le Havre","Rennes",0,1,"A",0,0,"D",3.66,3.38,2.15,"0-0","0-1",13,5,11,2,2,1,0,0,5,1,14,7,1,6,21,"5-1","N","N","N",3,0,21
"2938","F1",2024-02-11,"Clermont","Brest",1,1,"D",0,0,"D",3.81,3.39,2.1,"0-0","1-1",7,2,15,9,2,4,1,1,2,4,12,13,2,6,25,"2-4","Y","N","N",6,2,21
"2939","F1",2024-02-11,"Lorient","Reims",2,0,"H",0,0,"D",3.73,3.57,2.06,"0-0","2-0",17,5,23,6,1,1,0,0,1,7,9,14,2,8,23,"1-7","Y","N","N",2,0,21
"2940","F1",2024-02-11,"Toulouse","Nantes",1,2,"A",0,1,"A",2.2,3.44,3.47,"0-1","1-2",16,3,5,2,2,1,0,0,12,0,10,13,3,12,23,"12-0","Y","Y","N",3,0,21
"2941","F1",2024-02-11,"Montpellier","Lyon",1,2,"A",1,0,"H",3.1,3.41,2.4,"1-0","1-2",15,8,19,5,1,2,0,0,1,5,11,11,3,6,22,"1-5","Y","Y","N",3,0,21
"2942","F1",2024-02-11,"Nice","Monaco",2,3,"A",1,1,"D",2.38,3.39,3.14,"1-1","2-3",15,5,9,5,5,4,1,0,8,2,17,14,5,10,31,"8-2","Y","Y","Y",9,1,21
"2943","F1",2024-02-16,"Lyon","Nice",1,0,"H",1,0,"H",2.71,3.16,2.93,"1-0","1-0",9,1,20,6,0,1,0,0,4,9,8,12,1,13,20,"4-9","N","N","N",1,0,22
"2944","F1",2024-02-17,"Lille","Le Havre",3,0,"H",2,0,"H",1.52,4.18,7.01,"2-0","3-0",17,8,6,2,2,3,0,0,1,3,11,17,3,4,28,"1-3","Y","Y","N",5,0,22
"2945","F1",2024-02-17,"Nantes","Paris SG",0,2,"A",0,0,"D",6.4,4.77,1.49,"0-0","0-2",12,7,12,2,1,0,0,0,3,8,10,12,2,11,22,"3-8","Y","N","N",1,0,22
"2946","F1",2024-02-18,"Strasbourg","Lorient",1,3,"A",0,2,"A",1.72,3.85,5.13,"0-2","1-3",18,4,13,6,3,1,1,0,9,4,13,12,4,13,25,"9-4","Y","Y","Y",4,1,22
"2947","F1",2024-02-18,"Monaco","Toulouse",1,2,"A",0,1,"A",1.52,4.67,6.01,"0-1","1-2",22,5,14,7,1,3,0,0,4,6,18,12,3,10,30,"4-6","Y","Y","N",4,0,22
"2948","F1",2024-02-18,"Montpellier","Metz",3,0,"H",1,0,"H",1.78,3.67,4.98,"1-0","3-0",21,7,14,4,3,3,0,0,7,4,17,13,3,11,30,"7-4","Y","Y","N",6,0,22
"2949","F1",2024-02-18,"Rennes","Clermont",3,1,"H",1,0,"H",1.52,4.41,6.44,"1-0","3-1",16,8,14,5,1,0,0,1,4,4,9,10,4,8,19,"4-4","Y","Y","Y",1,1,22
"2950","F1",2024-02-18,"Reims","Lens",1,1,"D",1,1,"D",2.75,3.3,2.73,"1-1","1-1",11,2,9,1,2,2,0,0,3,2,15,9,2,5,24,"3-2","Y","N","N",4,0,22
"2951","F1",2024-02-18,"Brest","Marseille",1,0,"H",0,0,"D",2.58,3.23,2.97,"0-0","1-0",15,5,9,2,3,1,1,0,6,4,14,9,1,10,23,"6-4","N","N","N",4,1,22
"2952","F1",2024-02-23,"Metz","Lyon",1,2,"A",1,1,"D",4.31,3.44,1.98,"1-1","1-2",15,4,11,5,1,2,0,0,4,3,13,12,3,7,25,"4-3","Y","Y","N",3,0,23
"2953","F1",2024-02-24,"Lorient","Nantes",0,1,"A",0,0,"D",2.61,3.19,2.97,"0-0","0-1",6,1,7,6,0,2,0,0,3,8,11,11,1,11,22,"3-8","N","N","N",2,0,23
"2954","F1",2024-02-24,"Strasbourg","Brest",0,3,"A",0,2,"A",3.01,3.21,2.57,"0-2","0-3",6,2,15,8,3,0,0,0,0,4,21,10,3,4,31,"0-4","Y","Y","N",3,0,23
"2955","F1",2024-02-25,"Lens","Monaco",2,3,"A",1,2,"A",2.48,3.55,2.87,"1-2","2-3",20,10,15,9,6,3,0,0,9,3,10,13,5,12,23,"9-3","Y","Y","Y",9,0,23
"2956","F1",2024-02-25,"Le Havre","Reims",1,2,"A",0,0,"D",3.02,3.3,2.51,"0-0","1-2",18,4,16,5,3,3,0,1,5,5,11,13,3,10,24,"5-5","Y","Y","N",6,1,23
"2957","F1",2024-02-25,"Nice","Clermont",0,0,"D",0,0,"D",1.47,4.31,7.88,"0-0","0-0",23,4,13,5,2,1,0,0,8,1,8,12,0,9,20,"8-1","N","N","N",3,0,23
"2958","F1",2024-02-25,"Toulouse","Lille",3,1,"H",0,1,"A",4.07,3.62,1.95,"0-1","3-1",14,4,12,2,2,0,0,0,6,8,20,10,4,14,30,"6-8","Y","Y","Y",2,0,23
"2959","F1",2024-02-25,"Paris SG","Rennes",1,1,"D",0,1,"A",1.47,4.65,6.94,"0-1","1-1",15,3,3,1,5,3,0,0,4,0,13,16,2,4,29,"4-0","Y","N","N",8,0,23
"2960","F1",2024-02-25,"Marseille","Montpellier",4,1,"H",2,1,"H",1.73,3.96,4.85,"2-1","4-1",16,6,9,4,2,4,0,0,7,4,8,12,5,11,20,"7-4","Y","Y","Y",6,0,23
"2961","F1",2024-03-01,"Monaco","Paris SG",0,0,"D",0,0,"D",3.51,3.93,2.05,"0-0","0-0",14,6,14,7,0,0,0,0,5,6,10,13,0,11,23,"5-6","N","N","N",0,0,24
"2962","F1",2024-03-02,"Reims","Lille",0,1,"A",0,0,"D",2.78,3.33,2.69,"0-0","0-1",8,3,8,3,3,2,0,0,4,4,12,14,1,8,26,"4-4","N","N","N",5,0,24
"2963","F1",2024-03-02,"Clermont","Marseille",1,5,"A",0,1,"A",4.2,3.65,1.91,"0-1","1-5",7,2,17,11,2,1,0,0,7,4,9,13,6,11,22,"7-4","Y","Y","Y",3,0,24
"2964","F1",2024-03-03,"Toulouse","Nice",2,1,"H",0,1,"A",3.41,3.19,2.34,"0-1","2-1",17,6,9,6,2,2,0,0,7,6,16,10,3,13,26,"7-6","Y","Y","N",4,0,24
"2965","F1",2024-03-03,"Brest","Le Havre",1,0,"H",1,0,"H",1.61,3.91,6.28,"1-0","1-0",8,4,11,2,4,1,0,0,0,2,21,15,1,2,36,"0-2","N","N","N",5,0,24
"2966","F1",2024-03-03,"Montpellier","Strasbourg",2,2,"D",0,0,"D",2.04,3.53,3.82,"0-0","2-2",21,7,12,4,1,3,0,0,8,4,12,17,4,12,29,"8-4","Y","Y","Y",4,0,24
"2967","F1",2024-03-03,"Nantes","Metz",0,2,"A",0,0,"D",1.78,3.58,5.15,"0-0","0-2",9,2,13,4,3,2,0,0,10,3,7,11,2,13,18,"10-3","Y","N","N",5,0,24
"2968","F1",2024-03-03,"Rennes","Lorient",1,2,"A",0,0,"D",1.45,4.59,7.78,"0-0","1-2",22,6,12,6,1,2,0,0,6,3,12,9,3,9,21,"6-3","Y","Y","N",3,0,24
"2969","F1",2024-03-03,"Lyon","Lens",0,3,"A",0,1,"A",2.63,3.33,2.85,"0-1","0-3",13,4,18,8,0,2,1,0,2,4,5,15,3,6,20,"2-4","Y","Y","N",2,1,24
"2970","F1",2024-03-08,"Nice","Montpellier",1,2,"A",1,2,"A",1.8,3.92,4.57,"1-2","1-2",19,5,7,2,1,2,0,0,8,5,13,11,3,13,24,"8-5","Y","Y","N",3,0,25
"2971","F1",2024-03-09,"Lorient","Lyon",0,2,"A",0,0,"D",3.33,3.44,2.26,"0-0","0-2",9,0,13,6,0,0,0,0,4,7,10,7,2,11,17,"4-7","Y","N","N",0,0,25
"2972","F1",2024-03-09,"Lens","Brest",1,0,"H",1,0,"H",2.05,3.4,3.94,"1-0","1-0",6,2,9,3,1,2,0,0,2,4,13,10,1,6,23,"2-4","N","N","N",3,0,25
"2973","F1",2024-03-10,"Paris SG","Reims",2,2,"D",2,2,"D",1.4,5.45,7.21,"2-2","2-2",19,6,8,3,2,2,0,0,7,2,10,12,4,9,22,"7-2","Y","Y","Y",4,0,25
"2974","F1",2024-03-10,"Le Havre","Toulouse",1,0,"H",0,0,"D",2.8,3.21,2.74,"0-0","1-0",12,4,5,0,1,1,0,0,3,3,12,17,1,6,29,"3-3","N","N","N",2,0,25
"2975","F1",2024-03-10,"Metz","Clermont",1,0,"H",1,0,"H",2.28,3.32,3.4,"1-0","1-0",11,2,13,6,1,3,0,0,5,7,10,10,1,12,20,"5-7","N","N","N",4,0,25
"2976","F1",2024-03-10,"Strasbourg","Monaco",0,1,"A",0,0,"D",3.5,3.84,2.05,"0-0","0-1",8,1,17,6,1,3,0,0,5,8,9,15,1,13,24,"5-8","N","N","N",4,0,25
"2977","F1",2024-03-10,"Lille","Rennes",2,2,"D",0,2,"A",2.05,3.5,3.84,"0-2","2-2",15,8,11,3,5,2,0,0,6,3,17,20,4,9,37,"6-3","Y","Y","Y",7,0,25
"2978","F1",2024-03-10,"Marseille","Nantes",2,0,"H",1,0,"H",1.49,4.47,7.01,"1-0","2-0",12,4,10,3,2,3,0,0,2,8,11,16,2,10,27,"2-8","Y","N","N",5,0,25
"2979","F1",2024-03-15,"Toulouse","Lyon",2,3,"A",0,1,"A",2.89,3.26,2.63,"0-1","2-3",13,5,18,6,2,2,0,0,5,3,18,12,5,8,30,"5-3","Y","Y","Y",4,0,26
"2980","F1",2024-03-16,"Nantes","Strasbourg",1,3,"A",1,1,"D",2.27,3.35,3.41,"1-1","1-3",11,2,11,6,2,3,0,0,4,5,16,15,4,9,31,"4-5","Y","Y","Y",5,0,26
"2981","F1",2024-03-16,"Lens","Nice",1,3,"A",0,1,"A",2.01,3.42,4.07,"0-1","1-3",20,4,7,3,4,3,0,0,11,3,9,12,4,14,21,"11-3","Y","Y","Y",7,0,26
"2982","F1",2024-03-17,"Brest","Lille",1,1,"D",0,0,"D",2.6,3.16,3.02,"0-0","1-1",16,4,13,8,3,0,0,0,3,3,9,12,2,6,21,"3-3","Y","N","N",3,0,26
"2983","F1",2024-03-17,"Clermont","Le Havre",2,1,"H",2,1,"H",2.73,3.1,2.91,"2-1","2-1",9,4,14,5,3,5,1,1,3,5,13,17,3,8,30,"3-5","Y","Y","N",8,2,26
"2984","F1",2024-03-17,"Monaco","Lorient",2,2,"D",1,1,"D",1.33,5.72,8.83,"1-1","2-2",23,8,11,6,3,1,1,1,10,8,21,8,4,18,29,"10-8","Y","Y","Y",4,2,26
"2985","F1",2024-03-17,"Reims","Metz",2,1,"H",1,1,"D",1.58,4.11,6.19,"1-1","2-1",17,7,12,4,4,4,0,0,7,7,17,10,3,14,27,"7-7","Y","Y","N",8,0,26
"2986","F1",2024-03-17,"Rennes","Marseille",2,0,"H",1,0,"H",2.51,3.49,2.87,"1-0","2-0",7,4,8,1,1,3,0,0,4,5,9,12,2,9,21,"4-5","Y","N","N",4,0,26
"2987","F1",2024-03-17,"Montpellier","Paris SG",2,6,"A",2,2,"D",5.62,4.81,1.53,"2-2","2-6",12,7,16,9,0,3,0,0,7,4,9,13,8,11,22,"7-4","Y","Y","Y",3,0,26
"2988","F2",2023-08-05,"St Etienne","Grenoble",0,1,"A",0,0,"D",1.65,3.78,6.05,"0-0","0-1",17,4,13,5,2,1,0,0,6,1,14,12,1,7,26,"6-1","N","N","N",3,0,1
"2989","F2",2023-08-05,"Ajaccio","Rodez",1,1,"D",1,1,"D",1.96,3.22,4.69,"1-1","1-1",19,6,8,3,1,3,0,0,7,4,9,12,2,11,21,"7-4","Y","N","N",4,0,1
"2990","F2",2023-08-05,"Amiens","Quevilly Rouen",1,0,"H",0,0,"D",2.59,3.46,2.79,"0-0","1-0",5,2,6,2,1,1,0,0,9,2,12,17,1,11,29,"9-2","N","N","N",2,0,1
"2991","F2",2023-08-05,"Annecy","Guingamp",1,4,"A",1,0,"H",3.6,3.41,2.16,"1-0","1-4",11,4,15,8,2,0,0,0,3,2,13,12,5,5,25,"3-2","Y","Y","Y",2,0,1
"2992","F2",2023-08-05,"Concarneau","Bastia",0,0,"D",0,0,"D",3.11,3.22,2.49,"0-0","0-0",13,3,8,1,0,3,0,0,5,6,7,17,0,11,24,"5-6","N","N","N",3,0,1
"2993","F2",2023-08-05,"Dunkerque","Troyes",2,2,"D",1,2,"A",2.82,3.14,2.78,"1-2","2-2",16,5,14,7,2,1,0,0,4,4,16,6,4,8,22,"4-4","Y","Y","Y",3,0,1
"2994","F2",2023-08-05,"Laval","Angers",1,0,"H",0,0,"D",2.67,3.29,2.82,"0-0","1-0",13,5,6,2,1,3,0,0,3,4,7,11,1,7,18,"3-4","N","N","N",4,0,1
"2995","F2",2023-08-05,"Paris FC","Caen",0,2,"A",0,1,"A",2.91,3.2,2.66,"0-1","0-2",2,0,12,5,2,2,1,0,2,6,12,13,2,8,25,"2-6","Y","N","N",4,1,1
"2996","F2",2023-08-05,"Valenciennes","Auxerre",1,4,"A",1,1,"D",3.97,3.4,2.05,"1-1","1-4",12,5,19,6,1,1,0,0,6,7,10,15,5,13,25,"6-7","Y","Y","Y",2,0,1
"2997","F2",2023-08-07,"Pau FC","Bordeaux",3,0,"H",2,0,"H",3.83,3.51,2,"2-0","3-0",7,4,15,6,2,0,0,0,2,8,21,8,3,10,29,"2-8","Y","Y","N",2,0,1
"2998","F2",2023-08-12,"Rodez","St Etienne",2,1,"H",1,0,"H",3.78,3.7,1.97,"1-0","2-1",21,7,15,8,0,2,0,0,10,2,7,11,3,12,18,"10-2","Y","Y","N",2,0,2
"2999","F2",2023-08-12,"Angers","Annecy",0,0,"D",0,0,"D",1.72,3.76,5.29,"0-0","0-0",12,1,5,2,2,2,0,0,8,3,17,13,0,11,30,"8-3","N","N","N",4,0,2
"3000","F2",2023-08-12,"Auxerre","Amiens",0,1,"A",0,0,"D",1.7,3.77,5.44,"0-0","0-1",15,0,7,1,0,1,0,0,6,5,8,11,1,11,19,"6-5","N","N","N",1,0,2
"3001","F2",2023-08-12,"Bastia","Valenciennes",3,0,"H",1,0,"H",1.81,3.56,4.95,"1-0","3-0",15,7,3,1,0,2,0,0,5,5,12,13,3,10,25,"5-5","Y","Y","N",2,0,2
"3002","F2",2023-08-12,"Caen","Pau FC",2,0,"H",2,0,"H",1.7,3.74,5.54,"2-0","2-0",23,5,7,2,0,2,0,1,8,3,10,16,2,11,26,"8-3","Y","N","N",2,1,2
"3003","F2",2023-08-12,"Grenoble","Paris FC",2,0,"H",0,0,"D",2.45,3.21,3.19,"0-0","2-0",11,7,3,3,1,2,0,1,5,6,9,10,2,11,19,"5-6","Y","N","N",3,1,2
"3004","F2",2023-08-12,"Guingamp","Dunkerque",0,1,"A",0,0,"D",1.93,3.56,4.21,"0-0","0-1",16,3,9,5,4,3,0,0,7,1,13,18,1,8,31,"7-1","N","N","N",7,0,2
"3005","F2",2023-08-12,"Quevilly Rouen","Ajaccio",0,1,"A",0,1,"A",2.57,3.08,3.14,"0-1","0-1",4,2,3,3,2,1,0,0,3,0,19,13,1,3,32,"3-0","N","N","N",3,0,2
"3006","F2",2023-08-12,"Troyes","Laval",3,1,"H",2,0,"H",2.09,3.55,3.64,"2-0","3-1",9,6,19,3,1,1,0,0,5,7,5,20,4,12,25,"5-7","Y","Y","Y",2,0,2
"3007","F2",2023-08-14,"Bordeaux","Concarneau",1,0,"H",0,0,"D",1.67,4.09,4.86,"0-0","1-0",16,5,10,4,2,1,0,0,8,5,16,10,1,13,26,"8-5","N","N","N",3,0,2
"3008","F2",2023-08-19,"Angers","Auxerre",2,2,"D",1,1,"D",2.8,3.39,2.63,"1-1","2-2",12,5,13,5,3,0,0,1,3,3,22,8,4,6,30,"3-3","Y","Y","Y",3,1,3
"3009","F2",2023-08-19,"Amiens","Bastia",2,1,"H",1,1,"D",2.6,3.16,3.02,"1-1","2-1",17,6,11,4,3,2,0,1,12,2,9,17,3,14,26,"12-2","Y","Y","N",5,1,3
"3010","F2",2023-08-19,"Annecy","Dunkerque",3,0,"H",0,0,"D",2.82,3.23,2.71,"0-0","3-0",11,4,4,2,3,1,0,0,4,3,11,9,3,7,20,"4-3","Y","Y","N",4,0,3
"3011","F2",2023-08-19,"Concarneau","Caen",0,2,"A",0,0,"D",3.4,3.45,2.23,"0-0","0-2",14,4,11,3,1,1,0,0,2,2,15,8,2,4,23,"2-2","Y","N","N",2,0,3
"3012","F2",2023-08-19,"Grenoble","Troyes",0,0,"D",0,0,"D",2.48,3.31,3.06,"0-0","0-0",18,7,6,1,1,1,0,1,14,5,13,13,0,19,26,"14-5","N","N","N",2,1,3
"3013","F2",2023-08-19,"Laval","Rodez",1,0,"H",0,0,"D",2.07,3.4,3.87,"0-0","1-0",9,4,7,1,2,0,0,0,2,3,11,13,1,5,24,"2-3","N","N","N",2,0,3
"3014","F2",2023-08-19,"Pau FC","Paris FC",2,0,"H",1,0,"H",2.52,3.27,3.02,"1-0","2-0",9,3,14,5,2,1,0,0,1,2,13,10,2,3,23,"1-2","Y","N","N",3,0,3
"3015","F2",2023-08-19,"St Etienne","Quevilly Rouen",2,1,"H",2,0,"H",1.75,3.93,4.8,"2-0","2-1",5,2,10,1,0,3,0,0,3,5,8,18,3,8,26,"3-5","Y","Y","N",3,0,3
"3016","F2",2023-08-19,"Valenciennes","Guingamp",0,0,"D",0,0,"D",3.43,3.33,2.26,"0-0","0-0",9,3,6,3,3,2,0,0,3,7,12,15,0,10,27,"3-7","N","N","N",5,0,3
"3017","F2",2023-08-21,"Ajaccio","Bordeaux",0,0,"D",0,0,"D",2.8,3.11,2.74,"0-0","0-0",9,2,15,4,4,3,1,0,1,4,11,8,0,5,19,"1-4","N","N","N",7,1,3
"3018","F2",2023-08-26,"Bordeaux","Amiens",2,0,"H",0,0,"D",1.81,3.79,4.55,"0-0","2-0",17,7,12,2,5,1,0,0,6,5,12,7,2,11,19,"6-5","Y","N","N",6,0,4
"3019","F2",2023-08-26,"Auxerre","Grenoble",0,0,"D",0,0,"D",1.86,3.66,4.43,"0-0","0-0",15,2,7,4,2,2,0,0,4,3,11,16,0,7,27,"4-3","N","N","N",4,0,4
"3020","F2",2023-08-26,"Bastia","Troyes",3,2,"H",0,2,"A",2,3.61,3.87,"0-2","3-2",24,6,9,6,2,1,1,1,6,2,18,15,5,8,33,"6-2","Y","Y","Y",3,2,4
"3021","F2",2023-08-26,"Caen","Ajaccio",3,0,"H",2,0,"H",1.85,3.35,5.02,"2-0","3-0",10,4,5,2,1,2,0,0,7,4,5,10,3,11,15,"7-4","Y","Y","N",3,0,4
"3022","F2",2023-08-26,"Dunkerque","Angers",0,1,"A",0,0,"D",2.83,3.35,2.62,"0-0","0-1",14,9,7,3,3,2,0,0,3,4,10,13,1,7,23,"3-4","N","N","N",5,0,4
"3023","F2",2023-08-26,"Guingamp","Pau FC",4,0,"H",2,0,"H",1.93,3.46,4.42,"2-0","4-0",23,9,13,6,3,2,0,0,6,2,17,14,4,8,31,"6-2","Y","Y","Y",5,0,4
"3024","F2",2023-08-26,"Paris FC","Concarneau",3,0,"H",1,0,"H",2.46,3.31,3.08,"1-0","3-0",13,6,13,4,1,0,0,0,3,8,14,14,3,11,28,"3-8","Y","Y","N",1,0,4
"3025","F2",2023-08-26,"Quevilly Rouen","Laval",0,0,"D",0,0,"D",2.31,3.27,3.39,"0-0","0-0",7,2,11,2,1,1,0,0,4,6,15,16,0,10,31,"4-6","N","N","N",2,0,4
"3026","F2",2023-08-26,"Rodez","Valenciennes",0,1,"A",0,1,"A",1.99,3.2,4.57,"0-1","0-1",19,7,10,4,2,3,0,0,7,1,8,18,1,8,26,"7-1","N","N","N",5,0,4
"3027","F2",2023-08-28,"Annecy","St Etienne",1,1,"D",1,0,"H",3.58,3.55,2.06,"1-0","1-1",17,5,10,4,2,2,0,0,3,3,15,13,2,6,28,"3-3","Y","N","N",4,0,4
"3028","F2",2023-09-02,"Bordeaux","Auxerre",2,4,"A",1,2,"A",2.07,3.66,3.6,"1-2","2-4",20,9,15,6,2,2,0,0,3,11,8,17,6,14,25,"3-11","Y","Y","Y",4,0,5
"3029","F2",2023-09-02,"Ajaccio","Dunkerque",2,2,"D",0,1,"A",1.91,3.41,4.58,"0-1","2-2",10,3,10,4,3,1,1,0,2,5,14,20,4,7,34,"2-5","Y","Y","Y",4,1,5
"3030","F2",2023-09-02,"Amiens","Guingamp",4,1,"H",1,1,"D",2.4,3.28,3.22,"1-1","4-1",11,7,12,4,1,4,0,0,2,4,16,15,5,6,31,"2-4","Y","Y","Y",5,0,5
"3031","F2",2023-09-02,"Angers","Paris FC",2,0,"H",1,0,"H",2.04,3.4,3.88,"1-0","2-0",11,4,9,3,1,2,0,0,5,4,12,14,2,9,26,"5-4","Y","N","N",3,0,5
"3032","F2",2023-09-02,"Concarneau","Annecy",1,1,"D",0,1,"A",2.26,3.36,3.33,"0-1","1-1",10,2,17,7,5,4,0,1,4,1,10,21,2,5,31,"4-1","Y","N","N",9,1,5
"3033","F2",2023-09-02,"Grenoble","Bastia",0,0,"D",0,0,"D",2.33,3.25,3.38,"0-0","0-0",22,3,11,1,0,1,0,0,8,3,6,14,0,11,20,"8-3","N","N","N",1,0,5
"3034","F2",2023-09-02,"Laval","Caen",2,1,"H",0,0,"D",3.63,3.17,2.26,"0-0","2-1",9,3,5,2,2,3,0,0,3,2,13,9,3,5,22,"3-2","Y","Y","N",5,0,5
"3035","F2",2023-09-02,"Pau FC","Rodez",2,2,"D",2,0,"H",2.84,3.34,2.62,"2-0","2-2",10,3,17,8,4,3,0,0,4,5,17,15,4,9,32,"4-5","Y","Y","Y",7,0,5
"3036","F2",2023-09-02,"St Etienne","Valenciennes",0,0,"D",0,0,"D",1.6,4.22,5.76,"0-0","0-0",11,1,9,3,7,3,0,0,4,4,11,13,0,8,24,"4-4","N","N","N",10,0,5
"3037","F2",2023-09-02,"Troyes","Quevilly Rouen",2,2,"D",0,2,"A",2.33,3.25,3.37,"0-2","2-2",10,4,10,3,2,1,0,0,5,7,14,9,4,12,23,"5-7","Y","Y","Y",3,0,5
"3038","F2",2023-09-16,"Caen","St Etienne",1,2,"A",0,1,"A",1.93,3.78,3.98,"0-1","1-2",14,6,8,3,3,1,0,0,3,1,12,10,3,4,22,"3-1","Y","Y","N",4,0,6
"3039","F2",2023-09-16,"Annecy","Troyes",0,0,"D",0,0,"D",2.45,3.46,2.98,"0-0","0-0",15,0,7,3,1,0,0,0,10,4,9,11,0,14,20,"10-4","N","N","N",1,0,6
"3040","F2",2023-09-16,"Auxerre","Pau FC",2,2,"D",1,1,"D",1.5,4.47,6.8,"1-1","2-2",24,6,6,4,2,3,0,0,13,4,10,3,4,17,13,"13-4","Y","Y","Y",5,0,6
"3041","F2",2023-09-16,"Bastia","Laval",0,3,"A",0,1,"A",2.19,3.35,3.6,"0-1","0-3",8,3,9,4,2,2,0,0,5,6,14,12,3,11,26,"5-6","Y","Y","N",4,0,6
"3042","F2",2023-09-16,"Dunkerque","Grenoble",0,0,"D",0,0,"D",2.81,3.23,2.72,"0-0","0-0",5,4,18,5,2,2,1,0,3,6,13,9,0,9,22,"3-6","N","N","N",4,1,6
"3043","F2",2023-09-16,"Paris FC","Amiens",3,0,"H",2,0,"H",2.78,3.31,2.7,"2-0","3-0",12,3,13,3,2,2,0,0,3,8,11,17,3,11,28,"3-8","Y","Y","N",4,0,6
"3044","F2",2023-09-16,"Quevilly Rouen","Concarneau",2,3,"A",0,3,"A",1.94,3.46,4.18,"0-3","2-3",23,8,9,6,1,1,0,0,7,1,18,12,5,8,30,"7-1","Y","Y","Y",2,0,6
"3045","F2",2023-09-16,"Rodez","Angers",4,1,"H",0,1,"A",2.96,3.19,2.62,"0-1","4-1",13,5,9,3,2,2,0,0,3,4,12,13,5,7,25,"3-4","Y","Y","Y",4,0,6
"3046","F2",2023-09-16,"Valenciennes","Bordeaux",1,2,"A",0,1,"A",4.26,3.66,1.89,"0-1","1-2",11,3,13,5,3,2,0,0,3,5,7,17,3,8,24,"3-5","Y","Y","N",5,0,6
"3047","F2",2023-09-18,"Guingamp","Ajaccio",3,0,"H",2,0,"H",2.27,3.19,3.45,"2-0","3-0",12,5,15,4,0,1,0,0,3,6,15,9,3,9,24,"3-6","Y","Y","N",1,0,6
"3048","F2",2023-09-23,"Troyes","Auxerre",1,2,"A",0,1,"A",3.45,3.74,2.1,"0-1","1-2",10,4,19,5,2,2,0,0,3,14,20,12,3,17,32,"3-14","Y","Y","N",4,0,7
"3049","F2",2023-09-23,"Ajaccio","Paris FC",2,1,"H",0,0,"D",1.97,3.41,4.26,"0-0","2-1",11,4,6,1,2,2,0,0,4,4,14,11,3,8,25,"4-4","Y","Y","N",4,0,7
"3050","F2",2023-09-23,"Amiens","Valenciennes",0,0,"D",0,0,"D",1.7,3.79,5.38,"0-0","0-0",12,4,8,3,3,3,0,0,4,5,21,19,0,9,40,"4-5","N","N","N",6,0,7
"3051","F2",2023-09-23,"Angers","Bastia",2,0,"H",1,0,"H",1.98,3.48,3.99,"1-0","2-0",10,7,9,3,1,3,0,1,9,3,13,10,2,12,23,"9-3","Y","N","N",4,1,7
"3052","F2",2023-09-23,"Concarneau","St Etienne",0,1,"A",0,0,"D",3.2,3.47,2.31,"0-0","0-1",9,3,16,4,1,1,0,0,5,9,13,11,1,14,24,"5-9","N","N","N",2,0,7
"3053","F2",2023-09-23,"Dunkerque","Rodez",1,2,"A",0,1,"A",2.56,3,3.17,"0-1","1-2",15,3,14,5,1,2,0,0,6,2,10,12,3,8,22,"6-2","Y","Y","N",3,0,7
"3054","F2",2023-09-23,"Grenoble","Quevilly Rouen",2,1,"H",1,1,"D",2.49,3.28,3.07,"1-1","2-1",10,4,11,5,1,2,0,0,4,1,9,11,3,5,20,"4-1","Y","Y","N",3,0,7
"3055","F2",2023-09-23,"Laval","Guingamp",2,1,"H",0,0,"D",2.62,3.09,3.06,"0-0","2-1",15,6,13,6,1,2,0,0,6,3,19,13,3,9,32,"6-3","Y","Y","N",3,0,7
"3056","F2",2023-09-23,"Pau FC","Annecy",0,3,"A",0,2,"A",2.9,3.21,2.65,"0-2","0-3",12,4,9,5,5,1,0,0,7,4,17,16,3,11,33,"7-4","Y","Y","N",6,0,7
"3057","F2",2023-09-26,"Amiens","Ajaccio",0,0,"D",0,0,"D",2.11,3.24,4,"0-0","0-0",7,0,6,2,2,5,0,0,3,3,16,27,0,6,43,"3-3","N","N","N",7,0,7
"3058","F2",2023-09-26,"Auxerre","Annecy",4,0,"H",2,0,"H",1.57,4.17,6.13,"2-0","4-0",11,5,5,1,0,1,0,0,3,5,7,15,4,8,22,"3-5","Y","Y","Y",1,0,8
"3059","F2",2023-09-26,"Bastia","Pau FC",1,4,"A",0,1,"A",1.72,3.87,5.08,"0-1","1-4",10,2,17,10,2,3,1,0,10,3,7,12,5,13,19,"10-3","Y","Y","Y",5,1,8
"3060","F2",2023-09-26,"Caen","Grenoble",1,2,"A",1,0,"H",1.94,3.47,4.33,"1-0","1-2",10,1,10,4,0,3,0,0,3,3,10,17,3,6,27,"3-3","Y","Y","N",3,0,8
"3061","F2",2023-09-26,"Guingamp","Bordeaux",0,0,"D",0,0,"D",2.91,3.19,2.66,"0-0","0-0",11,2,14,3,1,1,0,0,2,4,12,16,0,6,28,"2-4","N","N","N",2,0,8
"3062","F2",2023-09-26,"Paris FC","Laval",0,1,"A",0,0,"D",2.89,3.02,2.82,"0-0","0-1",15,4,11,2,1,1,0,0,9,3,13,11,1,12,24,"9-3","N","N","N",2,0,8
"3063","F2",2023-09-26,"Quevilly Rouen","Angers",0,1,"A",0,1,"A",2.84,3.13,2.77,"0-1","0-1",12,1,6,3,3,4,1,0,2,5,15,17,1,7,32,"2-5","N","N","N",7,1,8
"3064","F2",2023-09-26,"Rodez","Troyes",2,1,"H",0,0,"D",1.96,3.78,3.83,"0-0","2-1",19,5,7,3,1,2,0,0,8,3,11,11,3,11,22,"8-3","Y","Y","N",3,0,8
"3065","F2",2023-09-26,"Valenciennes","Concarneau",0,1,"A",0,1,"A",2.44,3.15,3.26,"0-1","0-1",19,2,9,3,3,4,0,0,4,8,22,20,1,12,42,"4-8","N","N","N",7,0,8
"3066","F2",2023-09-30,"Troyes","St Etienne",0,1,"A",0,0,"D",3.51,3.68,2.09,"0-0","0-1",20,4,11,5,1,1,0,0,11,4,9,6,1,15,15,"11-4","N","N","N",2,0,8
"3067","F2",2023-09-30,"Angers","Concarneau",2,0,"H",0,0,"D",1.74,3.62,5.41,"0-0","2-0",14,7,11,6,1,2,0,0,12,5,12,9,2,17,21,"12-5","Y","N","N",3,0,8
"3068","F2",2023-09-30,"Annecy","Paris FC",2,2,"D",1,0,"H",2.38,3.16,3.36,"1-0","2-2",9,5,11,2,4,2,0,0,7,6,15,7,4,13,22,"7-6","Y","Y","Y",6,0,9
"3069","F2",2023-09-30,"Auxerre","Rodez",3,1,"H",1,0,"H",1.57,4.36,5.76,"1-0","3-1",15,4,7,1,1,3,0,0,5,7,12,9,4,12,21,"5-7","Y","Y","Y",4,0,9
"3070","F2",2023-09-30,"Caen","Guingamp",0,1,"A",0,0,"D",2.03,3.4,4.04,"0-0","0-1",7,1,14,7,1,2,0,0,6,5,17,21,1,11,38,"6-5","N","N","N",3,0,9
"3071","F2",2023-09-30,"Dunkerque","Quevilly Rouen",0,1,"A",0,0,"D",2.48,3.23,3.12,"0-0","0-1",11,3,16,6,0,0,0,0,9,12,8,14,1,21,22,"9-12","N","N","N",0,0,9
"3072","F2",2023-09-30,"Grenoble","Bordeaux",2,0,"H",1,0,"H",2.73,3.17,2.84,"1-0","2-0",10,8,15,4,2,2,0,0,2,8,16,10,2,10,26,"2-8","Y","N","N",4,0,9
"3073","F2",2023-09-30,"Laval","Valenciennes",1,0,"H",0,0,"D",1.78,3.56,5.18,"0-0","1-0",17,8,7,2,1,1,0,0,4,4,19,14,1,8,33,"4-4","N","N","N",2,0,9
"3074","F2",2023-09-30,"Pau FC","Amiens",1,0,"H",1,0,"H",2.96,3.37,2.51,"1-0","1-0",15,6,14,7,2,0,0,0,4,3,14,15,1,7,29,"4-3","N","N","N",2,0,9
"3075","F2",2023-10-02,"Ajaccio","Bastia",2,0,"H",0,0,"D",2.33,3.08,3.44,"0-0","2-0",11,3,7,2,0,1,0,1,4,3,8,11,2,7,19,"4-3","Y","N","N",1,1,9
"3076","F2",2023-10-03,"Bordeaux","Caen",1,1,"D",1,1,"D",2.14,3.5,3.56,"1-1","1-1",19,8,7,2,3,1,0,0,4,4,17,16,2,8,33,"4-4","Y","N","N",4,0,9
"3077","F2",2023-10-04,"St Etienne","Dunkerque",2,0,"H",0,0,"D",1.68,4.12,5.02,"0-0","2-0",20,4,15,4,1,3,0,0,9,6,10,17,2,15,27,"9-6","Y","N","N",4,0,9
"3078","F2",2023-10-07,"Bordeaux","Laval",0,1,"A",0,1,"A",1.88,3.57,4.48,"0-1","0-1",18,5,7,3,1,3,0,0,7,4,12,22,1,11,34,"7-4","N","N","N",4,0,10
"3079","F2",2023-10-07,"Amiens","Angers",1,4,"A",1,2,"A",2.46,3.19,3.19,"1-2","1-4",17,7,15,6,4,4,1,1,11,3,22,13,5,14,35,"11-3","Y","Y","Y",8,2,10
"3080","F2",2023-10-07,"Bastia","Annecy",2,1,"H",0,0,"D",2.02,3.46,3.98,"0-0","2-1",6,2,9,2,3,3,0,0,4,4,7,13,3,8,20,"4-4","Y","Y","N",6,0,10
"3081","F2",2023-10-07,"Concarneau","Dunkerque",4,3,"H",1,2,"A",2.4,3.33,3.16,"1-2","4-3",13,6,12,3,2,4,0,0,3,2,9,20,7,5,29,"3-2","Y","Y","Y",6,0,10
"3082","F2",2023-10-07,"Guingamp","Grenoble",2,2,"D",2,1,"H",2.29,3.35,3.36,"2-1","2-2",13,8,6,2,0,1,0,0,6,3,17,16,4,9,33,"6-3","Y","Y","Y",1,0,10
"3083","F2",2023-10-07,"Paris FC","Auxerre",0,2,"A",0,1,"A",3.82,3.66,2,"0-1","0-2",18,3,7,4,2,0,0,0,10,2,12,14,2,12,26,"10-2","Y","N","N",2,0,10
"3084","F2",2023-10-07,"Quevilly Rouen","Pau FC",2,2,"D",1,1,"D",1.89,3.7,4.25,"1-1","2-2",19,4,4,2,1,3,0,1,3,0,17,14,4,3,31,"3-0","Y","Y","Y",4,1,10
"3085","F2",2023-10-07,"Rodez","Caen",5,3,"H",2,3,"A",3.02,3.2,2.52,"2-3","5-3",19,8,11,4,3,3,0,0,6,7,17,12,8,13,29,"6-7","Y","Y","Y",6,0,10
"3086","F2",2023-10-07,"St Etienne","Ajaccio",0,0,"D",0,0,"D",2.04,3.34,4.1,"0-0","0-0",8,1,5,2,2,2,0,0,4,3,15,16,0,7,31,"4-3","N","N","N",4,0,10
"3087","F2",2023-10-07,"Valenciennes","Troyes",1,1,"D",0,1,"A",2.65,3.08,3.02,"0-1","1-1",21,7,4,2,3,3,0,0,7,2,10,18,2,9,28,"7-2","Y","N","N",6,0,10
"3088","F2",2023-10-21,"Caen","Auxerre",1,1,"D",0,1,"A",3.21,3.66,2.23,"0-1","1-1",9,1,15,6,1,1,0,0,3,8,8,14,2,11,22,"3-8","Y","N","N",2,0,11
"3089","F2",2023-10-21,"Ajaccio","Pau FC",2,0,"H",0,0,"D",1.79,3.6,5.04,"0-0","2-0",11,3,4,1,0,2,0,0,1,4,10,13,2,5,23,"1-4","Y","N","N",2,0,11
"3090","F2",2023-10-21,"Angers","Bordeaux",2,0,"H",1,0,"H",2.56,3.32,2.93,"1-0","2-0",9,4,16,5,0,0,0,0,2,6,6,9,2,8,15,"2-6","Y","N","N",0,0,11
"3091","F2",2023-10-21,"Annecy","Amiens",1,1,"D",1,1,"D",2.85,3.16,2.74,"1-1","1-1",8,3,10,5,2,2,0,0,1,2,19,22,2,3,41,"1-2","Y","N","N",4,0,11
"3092","F2",2023-10-21,"Dunkerque","Paris FC",1,3,"A",0,1,"A",2.58,3.3,2.92,"0-1","1-3",13,4,15,5,2,0,0,0,7,3,18,8,4,10,26,"7-3","Y","Y","Y",2,0,11
"3093","F2",2023-10-21,"Grenoble","Valenciennes",3,3,"D",2,1,"H",1.98,3.3,4.38,"2-1","3-3",13,7,10,7,2,3,0,0,2,2,10,15,6,4,25,"2-2","Y","Y","Y",5,0,11
"3094","F2",2023-10-21,"Guingamp","Quevilly Rouen",2,2,"D",1,1,"D",1.94,3.53,4.23,"1-1","2-2",8,4,13,5,1,1,0,0,3,7,11,12,4,10,23,"3-7","Y","Y","Y",2,0,11
"3095","F2",2023-10-21,"Rodez","Bastia",1,1,"D",0,1,"A",2,3.44,4.08,"0-1","1-1",26,8,6,1,1,2,0,0,10,6,10,21,2,16,31,"10-6","Y","N","N",3,0,11
"3096","F2",2023-10-21,"Troyes","Concarneau",0,0,"D",0,0,"D",2.11,3.52,3.64,"0-0","0-0",8,3,21,5,2,2,1,0,1,6,6,18,0,7,24,"1-6","N","N","N",4,1,11
"3097","F2",2023-10-23,"Laval","St Etienne",0,1,"A",0,1,"A",2.62,3.17,2.88,"0-1","0-1",13,1,6,2,1,1,0,0,4,6,12,6,1,10,18,"4-6","N","N","N",2,0,11
"3098","F2",2023-10-28,"Bordeaux","Rodez",2,2,"D",2,1,"H",1.72,3.92,4.99,"2-1","2-2",11,6,9,3,4,2,1,1,3,4,12,12,4,7,24,"3-4","Y","Y","Y",6,2,12
"3099","F2",2023-10-28,"Amiens","Laval",0,0,"D",0,0,"D",2.53,3.08,3.2,"0-0","0-0",8,4,10,5,2,1,0,0,2,5,13,12,0,7,25,"2-5","N","N","N",3,0,12
"3100","F2",2023-10-28,"Auxerre","Dunkerque",0,1,"A",0,0,"D",1.42,4.93,7.65,"0-0","0-1",24,6,8,2,1,3,0,0,12,6,10,10,1,18,20,"12-6","N","N","N",4,0,12
"3101","F2",2023-10-28,"Bastia","Guingamp",0,0,"D",0,0,"D",2.9,3.35,2.57,"0-0","0-0",6,1,10,2,1,4,0,1,8,3,11,17,0,11,28,"8-3","N","N","N",5,1,12
"3102","F2",2023-10-28,"Concarneau","Ajaccio",2,1,"H",0,0,"D",3.02,3.06,2.62,"0-0","2-1",4,2,16,5,0,1,0,0,5,7,9,16,3,12,25,"5-7","Y","Y","N",1,0,12
"3103","F2",2023-10-28,"Paris FC","Troyes",2,2,"D",0,0,"D",1.98,3.65,3.92,"0-0","2-2",15,3,8,3,1,0,0,0,6,3,7,9,4,9,16,"6-3","Y","Y","Y",1,0,12
"3104","F2",2023-10-28,"Pau FC","Grenoble",3,2,"H",1,1,"D",3.33,3.42,2.23,"1-1","3-2",15,7,7,4,2,2,0,0,5,4,18,11,5,9,29,"5-4","Y","Y","Y",4,0,12
"3105","F2",2023-10-28,"Quevilly Rouen","Annecy",1,2,"A",1,1,"D",2.06,3.48,3.82,"1-1","1-2",19,6,8,3,2,2,0,0,6,8,9,11,3,14,20,"6-8","Y","Y","N",4,0,12
"3106","F2",2023-10-28,"Valenciennes","Caen",2,2,"D",2,0,"H",2.96,3.32,2.54,"2-0","2-2",9,4,14,4,0,2,0,0,5,7,14,8,4,12,22,"5-7","Y","Y","Y",2,0,12
"3107","F2",2023-10-30,"St Etienne","Angers",2,0,"H",0,0,"D",2.56,3.24,2.9,"0-0","2-0",20,10,14,3,2,1,0,0,5,11,15,8,2,16,23,"5-11","Y","N","N",3,0,12
"3108","F2",2023-11-04,"St Etienne","Paris FC",0,1,"A",0,0,"D",1.98,3.59,3.88,"0-0","0-1",11,1,15,5,0,3,0,0,9,8,8,14,1,17,22,"9-8","N","N","N",3,0,13
"3109","F2",2023-11-04,"Angers","Valenciennes",2,0,"H",2,0,"H",1.63,3.92,5.69,"2-0","2-0",9,6,5,2,5,3,0,0,8,1,15,11,2,9,26,"8-1","Y","N","N",8,0,13
"3110","F2",2023-11-04,"Annecy","Laval",1,3,"A",1,1,"D",3.07,3.08,2.61,"1-1","1-3",5,1,9,3,0,2,1,1,4,8,9,13,4,12,22,"4-8","Y","Y","Y",2,2,13
"3111","F2",2023-11-04,"Bastia","Bordeaux",3,1,"H",2,0,"H",3.61,3.47,2.14,"2-0","3-1",16,7,10,2,3,1,0,0,1,5,21,13,4,6,34,"1-5","Y","Y","Y",4,0,13
"3112","F2",2023-11-04,"Dunkerque","Amiens",0,1,"A",0,1,"A",2.99,3.11,2.65,"0-1","0-1",18,5,5,2,0,4,0,0,7,5,7,11,1,12,18,"7-5","N","N","N",4,0,13
"3113","F2",2023-11-04,"Grenoble","Ajaccio",0,3,"A",0,2,"A",2.19,3.06,3.99,"0-2","0-3",12,5,6,3,1,3,0,0,5,0,10,11,3,5,21,"5-0","Y","Y","N",4,0,13
"3114","F2",2023-11-04,"Quevilly Rouen","Rodez",3,1,"H",2,1,"H",2.28,3.46,3.28,"2-1","3-1",12,4,5,3,2,0,0,0,6,4,17,11,4,10,28,"6-4","Y","Y","Y",2,0,13
"3115","F2",2023-11-04,"Troyes","Caen",2,1,"H",1,0,"H",2.82,3.46,2.57,"1-0","2-1",8,4,22,5,4,1,0,0,0,11,15,12,3,11,27,"0-11","Y","Y","N",5,0,13
"3116","F2",2023-11-06,"Guingamp","Auxerre",2,1,"H",0,0,"D",3.33,3.39,2.22,"0-0","2-1",8,1,14,4,6,3,1,1,4,4,14,15,3,8,29,"4-4","Y","Y","N",9,2,13
"3117","F2",2023-11-11,"Bordeaux","Annecy",3,1,"H",2,1,"H",1.59,4.17,5.9,"2-1","3-1",11,7,9,3,1,2,0,0,3,5,9,21,4,8,30,"3-5","Y","Y","Y",3,0,13
"3118","F2",2023-11-11,"Ajaccio","Troyes",1,0,"H",1,0,"H",1.89,3.43,4.65,"1-0","1-0",7,3,3,1,2,1,0,0,1,2,13,17,1,3,30,"1-2","N","N","N",3,0,14
"3119","F2",2023-11-11,"Amiens","Grenoble",1,2,"A",1,1,"D",2.55,3.07,3.18,"1-1","1-2",10,4,6,4,1,2,0,0,1,4,9,12,3,5,21,"1-4","Y","Y","N",3,0,14
"3120","F2",2023-11-11,"Auxerre","St Etienne",5,2,"H",3,1,"H",1.82,3.83,4.46,"3-1","5-2",14,7,14,8,1,2,0,0,1,2,14,11,7,3,25,"1-2","Y","Y","Y",3,0,14
"3121","F2",2023-11-11,"Caen","Quevilly Rouen",3,3,"D",2,2,"D",2.3,3.45,3.24,"2-2","3-3",16,5,9,6,1,2,0,1,4,3,13,17,6,7,30,"4-3","Y","Y","Y",3,1,14
"3122","F2",2023-11-11,"Laval","Concarneau",0,3,"A",0,1,"A",1.77,3.6,5.18,"0-1","0-3",10,5,10,6,4,1,1,0,7,3,26,9,3,10,35,"7-3","Y","Y","N",5,1,14
"3123","F2",2023-11-11,"Paris FC","Bastia",1,0,"H",1,0,"H",2.01,3.57,3.88,"1-0","1-0",11,3,11,4,1,1,0,1,5,5,12,23,1,10,35,"5-5","N","N","N",2,1,14
"3124","F2",2023-11-11,"Pau FC","Angers",4,4,"D",2,1,"H",3.57,3.38,2.19,"2-1","4-4",12,6,7,5,3,0,0,0,6,7,16,8,8,13,24,"6-7","Y","Y","Y",3,0,14
"3125","F2",2023-11-11,"Rodez","Guingamp",0,0,"D",0,0,"D",2.5,3.29,3.04,"0-0","0-0",6,0,13,2,0,1,0,0,6,7,11,13,0,13,24,"6-7","N","N","N",1,0,14
"3126","F2",2023-11-11,"Valenciennes","Dunkerque",0,1,"A",0,0,"D",2.37,3.33,3.21,"0-0","0-1",13,4,11,3,4,3,0,0,4,7,14,22,1,11,36,"4-7","N","N","N",7,0,14
"3127","F2",2023-11-25,"St Etienne","Pau FC",1,2,"A",1,0,"H",1.66,4.03,4.87,"1-0","1-2",14,3,11,4,3,3,0,0,9,5,19,14,3,14,33,"9-5","Y","Y","N",6,0,14
"3128","F2",2023-11-25,"Amiens","Concarneau",1,1,"D",1,1,"D",2.02,3.39,4.07,"1-1","1-1",19,6,6,1,2,0,0,0,6,2,15,7,2,8,22,"6-2","Y","N","N",2,0,15
"3129","F2",2023-11-25,"Annecy","Ajaccio",2,0,"H",1,0,"H",2.96,2.87,2.8,"1-0","2-0",19,6,6,2,4,2,0,0,6,3,21,13,2,9,34,"6-3","Y","N","N",6,0,15
"3130","F2",2023-11-25,"Bastia","Auxerre",0,0,"D",0,0,"D",4.32,3.97,1.75,"0-0","0-0",6,1,20,7,1,2,0,0,1,7,15,5,0,8,20,"1-7","N","N","N",3,0,15
"3131","F2",2023-11-25,"Dunkerque","Laval",0,2,"A",0,2,"A",3.34,3.24,2.29,"0-2","0-2",11,3,5,3,1,4,0,0,6,2,10,15,2,8,25,"6-2","Y","N","N",5,0,15
"3132","F2",2023-11-25,"Grenoble","Rodez",2,1,"H",1,1,"D",1.92,3.62,4.02,"1-1","2-1",9,6,11,4,1,3,0,0,6,5,7,11,3,11,18,"6-5","Y","Y","N",4,0,15
"3133","F2",2023-11-25,"Paris FC","Bordeaux",1,2,"A",1,1,"D",3.21,3.49,2.24,"1-1","1-2",12,2,11,5,0,0,0,0,9,3,16,7,3,12,23,"9-3","Y","Y","N",0,0,15
"3134","F2",2023-11-25,"Quevilly Rouen","Valenciennes",0,0,"D",0,0,"D",1.68,3.91,5.03,"0-0","0-0",17,4,6,2,2,3,0,1,6,1,18,11,0,7,29,"6-1","N","N","N",5,1,15
"3135","F2",2023-11-25,"Troyes","Guingamp",0,1,"A",0,1,"A",3.53,3.41,2.13,"0-1","0-1",7,2,14,4,1,1,0,0,5,8,8,11,1,13,19,"5-8","N","N","N",2,0,15
"3136","F2",2023-11-27,"Angers","Caen",3,0,"H",1,0,"H",2.16,3.33,3.41,"1-0","3-0",11,6,10,2,1,5,0,1,2,6,13,14,3,8,27,"2-6","Y","Y","N",6,1,15
"3137","F2",2023-11-28,"Concarneau","Pau FC",1,2,"A",0,1,"A",2.23,3.37,3.47,"0-1","1-2",17,6,10,2,4,2,1,1,5,2,12,10,3,7,22,"5-2","Y","Y","N",6,2,15
"3138","F2",2023-12-02,"Bordeaux","Troyes",0,1,"A",0,1,"A",1.45,4.58,6.5,"0-1","0-1",24,4,12,3,3,5,1,0,10,5,16,20,1,15,36,"10-5","N","N","N",8,1,16
"3139","F2",2023-12-02,"Ajaccio","Angers",1,1,"D",1,1,"D",2.65,2.95,3.16,"1-1","1-1",13,5,5,2,3,1,0,0,3,3,11,14,2,6,25,"3-3","Y","N","N",4,0,16
"3140","F2",2023-12-02,"Amiens","St Etienne",1,0,"H",1,0,"H",2.82,3.16,2.61,"1-0","1-0",7,3,15,5,3,1,0,0,2,1,16,10,1,3,26,"2-1","N","N","N",4,0,16
"3141","F2",2023-12-02,"Auxerre","Quevilly Rouen",3,2,"H",1,2,"A",1.64,4.18,5.36,"1-2","3-2",17,3,15,6,1,1,0,0,3,3,10,15,5,6,25,"3-3","Y","Y","Y",2,0,16
"3142","F2",2023-12-02,"Caen","Bastia",1,0,"H",0,0,"D",1.88,3.65,4.32,"0-0","1-0",9,3,10,5,1,3,0,0,5,4,12,21,1,9,33,"5-4","N","N","N",4,0,16
"3143","F2",2023-12-02,"Guingamp","Paris FC",0,1,"A",0,0,"D",2.19,3.31,3.63,"0-0","0-1",7,3,4,1,2,3,0,0,4,2,19,14,1,6,33,"4-2","N","N","N",5,0,16
"3144","F2",2023-12-02,"Laval","Grenoble",1,1,"D",0,0,"D",2.35,3.18,3.42,"0-0","1-1",9,5,7,2,4,1,0,0,2,5,14,9,2,7,23,"2-5","Y","N","N",5,0,16
"3145","F2",2023-12-02,"Pau FC","Dunkerque",1,1,"D",1,0,"H",2.3,3.45,3.25,"1-0","1-1",10,5,8,4,2,2,0,0,3,3,14,13,2,6,27,"3-3","Y","N","N",4,0,16
"3146","F2",2023-12-02,"Rodez","Concarneau",2,0,"H",1,0,"H",1.85,3.68,4.51,"1-0","2-0",16,5,8,2,2,4,0,0,9,4,20,7,2,13,27,"9-4","Y","N","N",6,0,16
"3147","F2",2023-12-02,"Valenciennes","Annecy",0,0,"D",0,0,"D",2.54,3.1,3.16,"0-0","0-0",14,6,18,2,1,2,0,1,4,5,14,15,0,9,29,"4-5","N","N","N",3,1,16
"3148","F2",2023-12-05,"Ajaccio","Laval",2,0,"H",0,0,"D",2.53,2.85,3.49,"0-0","2-0",8,4,6,1,1,2,0,0,2,3,14,19,2,5,33,"2-3","Y","N","N",3,0,17
"3149","F2",2023-12-05,"Angers","Grenoble",1,0,"H",1,0,"H",2.06,3.41,3.93,"1-0","1-0",7,1,15,5,0,0,0,0,3,10,5,11,1,13,16,"3-10","N","N","N",0,0,17
"3150","F2",2023-12-05,"Concarneau","Auxerre",1,2,"A",0,2,"A",4.97,4.14,1.68,"0-2","1-2",13,4,16,7,1,2,0,0,6,5,7,11,3,11,18,"6-5","Y","Y","N",3,0,17
"3151","F2",2023-12-05,"Dunkerque","Bastia",0,5,"A",0,2,"A",2.39,3.11,3.42,"0-2","0-5",8,2,14,8,3,1,0,0,3,6,11,10,5,9,21,"3-6","Y","Y","Y",4,0,17
"3152","F2",2023-12-05,"Paris FC","Rodez",2,0,"H",2,0,"H",2.1,3.47,3.71,"2-0","2-0",9,2,12,5,2,1,0,0,2,8,10,16,2,10,26,"2-8","Y","N","N",3,0,17
"3153","F2",2023-12-05,"Pau FC","Valenciennes",3,1,"H",1,0,"H",1.93,3.5,4.31,"1-0","3-1",14,6,14,7,0,0,0,0,5,3,10,22,4,8,32,"5-3","Y","Y","Y",0,0,17
"3154","F2",2023-12-05,"Quevilly Rouen","Bordeaux",3,2,"H",2,0,"H",2.61,3.28,2.89,"2-0","3-2",24,9,26,6,1,1,0,1,4,6,22,12,5,10,34,"4-6","Y","Y","Y",2,1,17
"3155","F2",2023-12-05,"St Etienne","Guingamp",1,3,"A",1,1,"D",2.39,3.15,3.37,"1-1","1-3",10,3,14,6,2,0,0,0,6,10,21,10,4,16,31,"6-10","Y","Y","Y",2,0,17
"3156","F2",2023-12-05,"Troyes","Amiens",2,0,"H",2,0,"H",2.89,3.18,2.68,"2-0","2-0",9,3,18,3,2,3,0,0,5,9,8,16,2,14,24,"5-9","Y","N","N",5,0,17
"3157","F2",2023-12-06,"Annecy","Caen",1,2,"A",1,0,"H",2.81,3.39,2.62,"1-0","1-2",15,5,13,9,2,1,0,0,5,7,14,15,3,12,29,"5-7","Y","Y","N",3,0,17
"3158","F2",2023-12-16,"Auxerre","Ajaccio",2,0,"H",2,0,"H",1.68,3.77,5.62,"2-0","2-0",12,3,1,0,0,3,0,1,6,2,10,13,2,8,23,"6-2","Y","N","N",3,1,18
"3159","F2",2023-12-16,"Bordeaux","St Etienne",0,0,"D",0,0,"D",2.14,3.52,3.54,"0-0","0-0",20,4,10,1,0,3,0,0,9,6,15,20,0,15,35,"9-6","N","N","N",3,0,18
"3160","F2",2023-12-16,"Bastia","Quevilly Rouen",0,0,"D",0,0,"D",3.02,3.12,2.62,"0-0","0-0",4,1,13,3,0,3,0,0,2,6,12,16,0,8,28,"2-6","N","N","N",3,0,18
"3161","F2",2023-12-16,"Caen","Dunkerque",1,0,"H",1,0,"H",1.87,3.75,4.28,"1-0","1-0",13,6,13,4,2,2,0,0,6,7,12,18,1,13,30,"6-7","N","N","N",4,0,18
"3162","F2",2023-12-16,"Grenoble","Annecy",1,0,"H",0,0,"D",1.91,3.55,4.33,"0-0","1-0",16,5,6,3,1,0,0,0,8,4,8,8,1,12,16,"8-4","N","N","N",1,0,18
"3163","F2",2023-12-16,"Guingamp","Concarneau",0,1,"A",0,0,"D",1.62,3.97,5.95,"0-0","0-1",18,2,4,1,3,2,0,0,4,3,16,16,1,7,32,"4-3","N","N","N",5,0,18
"3164","F2",2023-12-16,"Laval","Pau FC",1,1,"D",0,0,"D",1.81,3.64,4.79,"0-0","1-1",15,5,11,5,2,1,0,0,11,4,17,15,2,15,32,"11-4","Y","N","N",3,0,18
"3165","F2",2023-12-16,"Rodez","Amiens",2,2,"D",0,1,"A",2.34,3.15,3.47,"0-1","2-2",19,5,8,4,3,1,0,0,10,3,13,11,4,13,24,"10-3","Y","Y","Y",4,0,18
"3166","F2",2023-12-16,"Troyes","Angers",1,4,"A",1,3,"A",4.19,3.58,1.93,"1-3","1-4",8,2,13,5,1,1,0,0,7,3,7,15,5,10,22,"7-3","Y","Y","Y",2,0,18
"3167","F2",2023-12-16,"Valenciennes","Paris FC",0,1,"A",0,1,"A",3.29,3.25,2.37,"0-1","0-1",7,1,7,3,0,0,0,0,6,5,16,13,1,11,29,"6-5","N","N","N",0,0,18
"3168","F2",2023-12-19,"Ajaccio","Valenciennes",2,1,"H",2,1,"H",2,2.99,5.01,"2-1","2-1",6,3,4,2,1,1,0,0,3,1,18,18,3,4,36,"3-1","Y","Y","N",2,0,19
"3169","F2",2023-12-19,"Amiens","Caen",0,0,"D",0,0,"D",2.45,3.22,3.18,"0-0","0-0",14,3,10,3,2,1,0,0,3,2,17,18,0,5,35,"3-2","N","N","N",3,0,19
"3170","F2",2023-12-19,"Angers","Guingamp",1,0,"H",1,0,"H",2.34,3.15,3.47,"1-0","1-0",7,2,21,5,1,3,0,0,2,6,14,19,1,8,33,"2-6","N","N","N",4,0,19
"3171","F2",2023-12-19,"Annecy","Rodez",1,2,"A",0,1,"A",2.86,3.12,2.75,"0-1","1-2",16,7,16,6,2,4,0,0,5,2,11,14,3,7,25,"5-2","Y","Y","N",6,0,19
"3172","F2",2023-12-19,"Concarneau","Grenoble",0,3,"A",0,1,"A",3.44,3.14,2.35,"0-1","0-3",19,6,11,6,0,0,0,0,6,1,11,11,3,7,22,"6-1","Y","Y","N",0,0,19
"3173","F2",2023-12-19,"Dunkerque","Bordeaux",0,2,"A",0,1,"A",3.53,3.53,2.14,"0-1","0-2",14,3,9,2,3,2,0,0,3,3,14,14,2,6,28,"3-3","Y","N","N",5,0,19
"3174","F2",2023-12-19,"Laval","Auxerre",1,3,"A",1,1,"D",3.57,3.34,2.2,"1-1","1-3",5,3,13,5,1,2,0,0,3,6,11,16,4,9,27,"3-6","Y","Y","Y",3,0,19
"3175","F2",2023-12-19,"Paris FC","Quevilly Rouen",2,2,"D",1,1,"D",2.3,3.31,3.38,"1-1","2-2",10,4,13,5,4,2,0,0,3,2,16,25,4,5,41,"3-2","Y","Y","Y",6,0,19
"3176","F2",2023-12-19,"Pau FC","Troyes",1,1,"D",0,0,"D",2.05,3.64,3.68,"0-0","1-1",19,5,11,6,3,3,0,0,6,2,14,12,2,8,26,"6-2","Y","N","N",6,0,19
"3177","F2",2023-12-19,"St Etienne","Bastia",3,2,"H",2,0,"H",1.86,3.52,4.68,"2-0","3-2",12,5,11,5,2,2,0,0,2,6,13,19,5,8,32,"2-6","Y","Y","Y",4,0,19
"3178","F2",2024-01-13,"St Etienne","Laval",0,0,"D",0,0,"D",2.19,3.31,3.65,"0-0","0-0",14,4,9,3,0,0,0,0,4,6,14,13,0,10,27,"4-6","N","N","N",0,0,20
"3179","F2",2024-01-13,"Bastia","Angers",2,0,"H",1,0,"H",3.5,3.1,2.36,"1-0","2-0",14,5,1,0,1,0,0,0,8,4,9,9,2,12,18,"8-4","Y","N","N",1,0,20
"3180","F2",2024-01-13,"Caen","Concarneau",1,0,"H",0,0,"D",1.93,3.54,4.31,"0-0","1-0",9,2,6,2,1,2,0,0,4,3,22,19,1,7,41,"4-3","N","N","N",3,0,20
"3181","F2",2024-01-13,"Grenoble","Dunkerque",2,2,"D",1,0,"H",1.7,3.83,5.3,"1-0","2-2",10,4,10,7,0,0,0,0,6,3,11,9,4,9,20,"6-3","Y","Y","Y",0,0,20
"3182","F2",2024-01-13,"Paris FC","Annecy",2,1,"H",0,0,"D",1.88,3.56,4.53,"0-0","2-1",17,5,7,3,1,3,0,1,6,4,12,18,3,10,30,"6-4","Y","Y","N",4,1,20
"3183","F2",2024-01-13,"Quevilly Rouen","Guingamp",0,1,"A",0,0,"D",2.74,3.03,2.96,"0-0","0-1",10,2,10,5,2,1,0,0,6,1,21,12,1,7,33,"6-1","N","N","N",3,0,20
"3184","F2",2024-01-13,"Rodez","Pau FC",2,1,"H",0,0,"D",1.84,3.7,4.52,"0-0","2-1",11,4,12,5,3,2,1,0,3,8,11,14,3,11,25,"3-8","Y","Y","N",5,1,20
"3185","F2",2024-01-13,"Troyes","Ajaccio",3,1,"H",1,1,"D",2.79,3.02,2.92,"1-1","3-1",12,4,9,3,1,1,0,0,3,1,14,11,4,4,25,"3-1","Y","Y","Y",2,0,20
"3186","F2",2024-01-13,"Valenciennes","Amiens",0,1,"A",0,1,"A",3.15,2.95,2.65,"0-1","0-1",11,2,13,4,4,1,0,0,8,5,21,20,1,13,41,"8-5","N","N","N",5,0,20
"3187","F2",2024-01-15,"Auxerre","Bordeaux",3,1,"H",1,1,"D",1.72,3.97,4.6,"1-1","3-1",18,10,12,5,0,3,0,0,7,5,8,12,4,12,20,"7-5","Y","Y","Y",3,0,20
"3188","F2",2024-01-23,"Amiens","Annecy",1,0,"H",0,0,"D",2.04,3.29,4.16,"0-0","1-0",14,2,6,2,0,2,0,0,5,3,15,25,1,8,40,"5-3","N","N","N",2,0,21
"3189","F2",2024-01-23,"Angers","Quevilly Rouen",3,2,"H",2,1,"H",2.12,3.36,3.77,"2-1","3-2",12,3,9,5,1,1,0,0,4,5,5,17,5,9,22,"4-5","Y","Y","Y",2,0,21
"3190","F2",2024-01-23,"Bastia","Caen",1,2,"A",1,0,"H",2.49,2.99,3.36,"1-0","1-2",9,3,11,5,2,4,1,0,2,4,19,12,3,6,31,"2-4","Y","Y","N",6,1,21
"3191","F2",2024-01-23,"Bordeaux","Valenciennes",3,1,"H",0,0,"D",1.5,4.42,6.92,"0-0","3-1",18,10,13,4,2,1,0,0,6,2,14,23,4,8,37,"6-2","Y","Y","Y",3,0,21
"3192","F2",2024-01-23,"Concarneau","Troyes",1,0,"H",0,0,"D",2.44,3.27,3.15,"0-0","1-0",7,2,9,3,1,1,0,0,3,2,14,17,1,5,31,"3-2","N","N","N",2,0,21
"3193","F2",2024-01-23,"Dunkerque","Ajaccio",2,0,"H",1,0,"H",2.93,2.95,2.84,"1-0","2-0",7,4,8,1,2,3,0,0,5,3,11,18,2,8,29,"5-3","Y","N","N",5,0,21
"3194","F2",2024-01-23,"Grenoble","Auxerre",1,1,"D",1,1,"D",3.4,3.48,2.21,"1-1","1-1",18,6,14,3,2,1,0,0,4,4,13,8,2,8,21,"4-4","Y","N","N",3,0,21
"3195","F2",2024-01-23,"Guingamp","Rodez",3,3,"D",3,3,"D",2.01,3.45,4.06,"3-3","3-3",16,5,9,5,1,1,0,0,5,4,12,16,6,9,28,"5-4","Y","Y","Y",2,0,21
"3196","F2",2024-01-23,"Laval","Paris FC",1,1,"D",1,0,"H",2.46,3.11,3.29,"1-0","1-1",11,3,13,3,3,2,1,0,3,4,12,14,2,7,26,"3-4","Y","N","N",5,1,21
"3197","F2",2024-01-23,"Pau FC","St Etienne",0,1,"A",0,1,"A",2.79,3.52,2.56,"0-1","0-1",8,0,19,9,3,0,0,0,3,8,8,16,1,11,24,"3-8","N","N","N",3,0,21
"3198","F2",2024-01-27,"St Etienne","Amiens",0,1,"A",0,1,"A",2.08,3.5,3.75,"0-1","0-1",18,2,3,3,1,3,0,0,10,4,12,18,1,14,30,"10-4","N","N","N",4,0,22
"3199","F2",2024-01-27,"Ajaccio","Concarneau",1,0,"H",1,0,"H",2.04,3.08,4.61,"1-0","1-0",9,3,7,1,1,1,0,0,1,1,17,10,1,2,27,"1-1","N","N","N",2,0,22
"3200","F2",2024-01-27,"Annecy","Pau FC",0,0,"D",0,0,"D",2.12,3.56,3.55,"0-0","0-0",7,1,11,2,2,2,0,0,2,0,12,16,0,2,28,"2-0","N","N","N",4,0,22
"3201","F2",2024-01-27,"Auxerre","Guingamp",1,1,"D",1,1,"D",1.94,3.55,4.17,"1-1","1-1",8,3,7,2,1,2,0,0,2,3,8,14,2,5,22,"2-3","Y","N","N",3,0,22
"3202","F2",2024-01-27,"Caen","Troyes",0,0,"D",0,0,"D",2.02,3.58,3.85,"0-0","0-0",19,6,6,0,2,1,0,0,10,4,16,17,0,14,33,"10-4","N","N","N",3,0,22
"3203","F2",2024-01-27,"Paris FC","Dunkerque",1,2,"A",0,1,"A",1.79,3.7,4.87,"0-1","1-2",19,4,12,2,2,2,1,0,9,4,12,15,3,13,27,"9-4","Y","Y","N",4,1,22
"3204","F2",2024-01-27,"Quevilly Rouen","Grenoble",1,1,"D",0,0,"D",2.59,3.19,3.01,"0-0","1-1",17,6,7,3,1,1,0,0,6,5,10,13,2,11,23,"6-5","Y","N","N",2,0,22
"3205","F2",2024-01-27,"Rodez","Laval",1,2,"A",0,0,"D",2.21,3.25,3.67,"0-0","1-2",17,3,11,7,2,4,0,0,5,5,13,19,3,10,32,"5-5","Y","Y","N",6,0,22
"3206","F2",2024-01-27,"Valenciennes","Bastia",3,1,"H",1,1,"D",2.8,3.08,2.84,"1-1","3-1",11,6,10,4,2,3,0,0,6,2,14,17,4,8,31,"6-2","Y","Y","Y",5,0,22
"3207","F2",2024-01-29,"Bordeaux","Angers",1,0,"H",0,0,"D",2.07,3.47,3.65,"0-0","1-0",11,2,22,8,3,3,1,0,4,7,14,10,1,11,24,"4-7","N","N","N",6,1,22
"3208","F2",2024-02-03,"Dunkerque","St Etienne",1,0,"H",0,0,"D",3.48,3.41,2.21,"0-0","1-0",7,4,12,2,1,2,0,0,1,4,14,15,1,5,29,"1-4","N","N","N",3,0,23
"3209","F2",2024-02-03,"Amiens","Paris FC",1,1,"D",0,0,"D",2.73,3.07,2.96,"0-0","1-1",12,2,22,7,2,0,0,0,0,13,9,9,2,13,18,"0-13","Y","N","N",2,0,23
"3210","F2",2024-02-03,"Angers","Rodez",2,1,"H",1,1,"D",2.03,3.48,3.95,"1-1","2-1",16,3,10,4,2,3,0,0,6,8,8,11,3,14,19,"6-8","Y","Y","N",5,0,23
"3211","F2",2024-02-03,"Concarneau","Valenciennes",1,0,"H",0,0,"D",2.36,3.12,3.45,"0-0","1-0",9,5,6,1,0,0,0,0,7,0,9,20,1,7,29,"7-0","N","N","N",0,0,23
"3212","F2",2024-02-03,"Grenoble","Caen",5,1,"H",2,0,"H",2.02,3.46,4,"2-0","5-1",9,7,11,8,1,1,0,1,2,3,18,13,6,5,31,"2-3","Y","Y","Y",2,1,23
"3213","F2",2024-02-03,"Guingamp","Annecy",1,4,"A",1,2,"A",1.61,3.84,6.47,"1-2","1-4",16,6,8,4,1,4,2,0,3,2,10,19,5,5,29,"3-2","Y","Y","Y",5,2,23
"3214","F2",2024-02-03,"Laval","Quevilly Rouen",2,4,"A",0,2,"A",2.29,3.18,3.55,"0-2","2-4",7,3,13,10,3,2,1,0,3,5,13,12,6,8,25,"3-5","Y","Y","Y",5,1,23
"3215","F2",2024-02-03,"Pau FC","Auxerre",2,2,"D",1,1,"D",4.52,4.05,1.76,"1-1","2-2",12,5,14,6,1,2,0,0,3,4,10,12,4,7,22,"3-4","Y","Y","Y",3,0,23
"3216","F2",2024-02-03,"Troyes","Bordeaux",2,1,"H",0,0,"D",3.77,3.64,2.02,"0-0","2-1",12,3,17,6,3,1,0,0,3,5,15,9,3,8,24,"3-5","Y","Y","N",4,0,23
"3217","F2",2024-02-05,"Bastia","Ajaccio",1,0,"H",0,0,"D",2.36,2.93,3.57,"0-0","1-0",4,1,7,0,2,2,0,0,3,3,19,22,1,6,41,"3-3","N","N","N",4,0,23
"3218","F2",2024-02-10,"Auxerre","Angers",1,0,"H",0,0,"D",1.79,3.85,4.57,"0-0","1-0",8,2,7,2,2,2,1,0,9,3,6,11,1,12,17,"9-3","N","N","N",4,1,24
"3219","F2",2024-02-10,"Ajaccio","Guingamp",3,0,"H",1,0,"H",3.08,2.8,2.86,"1-0","3-0",5,3,5,0,3,1,0,1,2,4,21,14,3,6,35,"2-4","Y","Y","N",4,1,24
"3220","F2",2024-02-10,"Annecy","Concarneau",0,3,"A",0,0,"D",2.23,3.23,3.62,"0-0","0-3",7,1,13,6,4,0,1,0,4,3,23,7,3,7,30,"4-3","Y","Y","N",4,1,24
"3221","F2",2024-02-10,"Bordeaux","Grenoble",1,0,"H",1,0,"H",2.29,3.47,3.25,"1-0","1-0",14,6,17,6,2,3,0,0,9,8,13,13,1,17,26,"9-8","N","N","N",5,0,24
"3222","F2",2024-02-10,"Caen","Amiens",2,0,"H",0,0,"D",2.12,3.24,3.92,"0-0","2-0",13,2,8,0,2,2,0,0,2,4,12,17,2,6,29,"2-4","Y","N","N",4,0,24
"3223","F2",2024-02-10,"Paris FC","Pau FC",1,1,"D",0,0,"D",1.83,3.7,4.55,"0-0","1-1",13,6,13,5,2,1,0,0,7,5,9,7,2,12,16,"7-5","Y","N","N",3,0,24
"3224","F2",2024-02-10,"Quevilly Rouen","Bastia",0,1,"A",0,1,"A",2.04,3.32,4.11,"0-1","0-1",5,3,13,3,4,3,1,0,7,4,12,8,1,11,20,"7-4","N","N","N",7,1,24
"3225","F2",2024-02-10,"Rodez","Dunkerque",0,0,"D",0,0,"D",1.74,3.85,4.96,"0-0","0-0",8,1,9,2,2,1,1,0,5,3,12,8,0,8,20,"5-3","N","N","N",3,1,24
"3226","F2",2024-02-10,"Valenciennes","Laval",1,1,"D",0,0,"D",3.39,3.02,2.46,"0-0","1-1",6,3,7,2,2,3,0,0,4,2,15,26,2,6,41,"4-2","Y","N","N",5,0,24
"3227","F2",2024-02-12,"St Etienne","Troyes",5,0,"H",2,0,"H",1.7,3.93,4.88,"2-0","5-0",18,11,9,1,5,1,0,0,4,3,21,9,5,7,30,"4-3","Y","Y","Y",6,0,24
"3228","F2",2024-02-17,"Angers","St Etienne",0,3,"A",0,2,"A",2.34,3.32,3.29,"0-2","0-3",6,0,13,5,3,1,0,0,5,7,15,16,3,12,31,"5-7","Y","Y","N",4,0,25
"3229","F2",2024-02-17,"Annecy","Auxerre",0,2,"A",0,1,"A",5.27,3.47,1.79,"0-1","0-2",11,3,6,2,2,2,0,1,8,2,9,13,2,10,22,"8-2","Y","N","N",4,1,25
"3230","F2",2024-02-17,"Bastia","Rodez",0,2,"A",0,1,"A",2.53,3.09,3.18,"0-1","0-2",16,4,11,6,2,0,0,0,11,4,13,7,2,15,20,"11-4","Y","N","N",2,0,25
"3231","F2",2024-02-17,"Concarneau","Paris FC",2,2,"D",1,0,"H",3.17,3.21,2.47,"1-0","2-2",9,4,9,5,2,1,0,0,6,4,11,8,4,10,19,"6-4","Y","Y","Y",3,0,25
"3232","F2",2024-02-17,"Dunkerque","Valenciennes",2,1,"H",1,1,"D",2.26,3.13,3.7,"1-1","2-1",12,5,6,2,1,2,0,0,5,6,14,12,3,11,26,"5-6","Y","Y","N",3,0,25
"3233","F2",2024-02-17,"Guingamp","Caen",1,0,"H",1,0,"H",1.91,3.59,4.29,"1-0","1-0",7,1,7,3,2,3,0,0,3,9,21,15,1,12,36,"3-9","N","N","N",5,0,25
"3234","F2",2024-02-17,"Laval","Ajaccio",1,1,"D",1,0,"H",2.52,2.77,3.63,"1-0","1-1",6,3,13,2,2,1,0,0,5,2,17,11,2,7,28,"5-2","Y","N","N",3,0,25
"3235","F2",2024-02-17,"Pau FC","Quevilly Rouen",0,2,"A",0,2,"A",2.56,3.32,2.93,"0-2","0-2",15,6,9,3,1,2,0,0,9,3,8,14,2,12,22,"9-3","Y","N","N",3,0,25
"3236","F2",2024-02-17,"Troyes","Grenoble",3,1,"H",1,0,"H",3.3,3.39,2.3,"1-0","3-1",11,5,9,2,1,2,0,0,4,4,19,17,4,8,36,"4-4","Y","Y","Y",3,0,25
"3237","F2",2024-02-19,"Amiens","Bordeaux",1,1,"D",1,0,"H",2.91,3.2,2.58,"1-0","1-1",14,7,9,6,1,2,0,0,7,6,14,16,2,13,30,"7-6","Y","N","N",3,0,25
"3238","F2",2024-02-24,"St Etienne","Annecy",2,1,"H",2,0,"H",1.63,3.86,6.17,"2-0","2-1",7,4,15,5,3,0,0,0,1,7,15,16,3,8,31,"1-7","Y","Y","N",3,0,26
"3239","F2",2024-02-24,"Ajaccio","Amiens",0,0,"D",0,0,"D",2.46,2.81,3.69,"0-0","0-0",10,1,7,1,2,3,0,0,2,3,17,12,0,5,29,"2-3","N","N","N",5,0,26
"3240","F2",2024-02-24,"Auxerre","Bastia",1,1,"D",1,0,"H",1.54,4.31,6.43,"1-0","1-1",15,4,10,5,0,2,0,0,10,1,7,12,2,11,19,"10-1","Y","N","N",2,0,26
"3241","F2",2024-02-24,"Bordeaux","Guingamp",1,0,"H",1,0,"H",2.38,3.15,3.4,"1-0","1-0",10,5,13,2,1,5,0,0,4,4,13,15,1,8,28,"4-4","N","N","N",6,0,26
"3242","F2",2024-02-24,"Concarneau","Laval",1,3,"A",0,1,"A",2.97,3.02,2.74,"0-1","1-3",10,2,15,8,1,3,0,0,4,5,17,17,4,9,34,"4-5","Y","Y","Y",4,0,26
"3243","F2",2024-02-24,"Grenoble","Pau FC",0,1,"A",0,1,"A",1.88,3.57,4.45,"0-1","0-1",14,3,10,4,1,2,0,0,3,1,10,15,1,4,25,"3-1","N","N","N",3,0,26
"3244","F2",2024-02-24,"Quevilly Rouen","Paris FC",0,0,"D",0,0,"D",2.62,3.14,3.02,"0-0","0-0",12,3,6,2,0,1,0,0,3,3,11,10,0,6,21,"3-3","N","N","N",1,0,26
"3245","F2",2024-02-24,"Troyes","Dunkerque",1,2,"A",1,1,"D",2.14,3.45,3.62,"1-1","1-2",11,3,4,2,1,1,0,0,3,4,16,12,3,7,28,"3-4","Y","Y","N",2,0,26
"3246","F2",2024-02-24,"Valenciennes","Rodez",0,2,"A",0,1,"A",3.06,3.35,2.46,"0-1","0-2",8,4,14,7,1,0,0,0,4,3,8,8,2,7,16,"4-3","Y","N","N",1,0,26
"3247","F2",2024-02-26,"Caen","Angers",2,0,"H",1,0,"H",2.42,3.15,3.2,"1-0","2-0",12,5,14,2,1,1,0,0,3,8,5,8,2,11,13,"3-8","Y","N","N",2,0,26
"3248","F2",2024-03-02,"Paris FC","St Etienne",0,0,"D",0,0,"D",2.62,3.26,2.9,"0-0","0-0",7,3,11,3,1,2,0,0,6,6,11,17,0,12,28,"6-6","N","N","N",3,0,27
"3249","F2",2024-03-02,"Annecy","Quevilly Rouen",0,0,"D",0,0,"D",2.96,3.08,2.71,"0-0","0-0",7,4,7,3,1,1,0,0,10,0,12,10,0,10,22,"10-0","N","N","N",2,0,27
"3250","F2",2024-03-02,"Auxerre","Valenciennes",0,0,"D",0,0,"D",1.33,5.13,10.93,"0-0","0-0",17,3,5,2,2,4,0,0,12,3,9,17,0,15,26,"12-3","N","N","N",6,0,27
"3251","F2",2024-03-02,"Bastia","Grenoble",1,0,"H",1,0,"H",2.56,3.1,3.13,"1-0","1-0",14,4,7,2,4,1,0,0,4,5,17,8,1,9,25,"4-5","N","N","N",5,0,27
"3252","F2",2024-03-02,"Dunkerque","Concarneau",2,2,"D",1,1,"D",2.38,3.07,3.49,"1-1","2-2",8,4,14,7,2,3,0,0,2,5,14,6,4,7,20,"2-5","Y","Y","Y",5,0,27
"3253","F2",2024-03-02,"Guingamp","Troyes",0,0,"D",0,0,"D",1.75,3.67,5.17,"0-0","0-0",15,4,5,1,2,2,0,0,7,5,10,19,0,12,29,"7-5","N","N","N",4,0,27
"3254","F2",2024-03-02,"Laval","Amiens",1,1,"D",1,0,"H",2.07,3.08,4.41,"1-0","1-1",15,4,8,4,0,1,0,0,7,6,15,15,2,13,30,"7-6","Y","N","N",1,0,27
"3255","F2",2024-03-02,"Pau FC","Caen",2,3,"A",0,1,"A",2.97,3.22,2.59,"0-1","2-3",19,8,7,3,1,1,0,0,8,1,12,12,5,9,24,"8-1","Y","Y","Y",2,0,27
"3256","F2",2024-03-02,"Rodez","Bordeaux",2,2,"D",2,1,"H",2.67,3.44,2.72,"2-1","2-2",13,3,8,3,0,1,0,0,7,6,9,8,4,13,17,"7-6","Y","Y","Y",1,0,27
"3257","F2",2024-03-04,"Angers","Ajaccio",3,1,"H",1,1,"D",2.26,2.87,3.93,"1-1","3-1",12,6,13,8,1,2,0,0,4,3,11,9,4,7,20,"4-3","Y","Y","Y",3,0,27
"3258","F2",2024-03-09,"St Etienne","Auxerre",1,0,"H",0,0,"D",2.93,3.39,2.52,"0-0","1-0",14,6,11,3,2,3,0,0,6,9,18,8,1,15,26,"6-9","N","N","N",5,0,28
"3259","F2",2024-03-09,"Ajaccio","Annecy",1,3,"A",1,1,"D",2.09,2.96,4.58,"1-1","1-3",11,7,21,6,2,2,0,0,3,5,11,12,4,8,23,"3-5","Y","Y","Y",4,0,28
"3260","F2",2024-03-09,"Amiens","Rodez",1,1,"D",1,1,"D",2.61,3.17,3,"1-1","1-1",16,3,9,2,3,2,0,1,7,4,15,12,2,11,27,"7-4","Y","N","N",5,1,28
"3261","F2",2024-03-09,"Bordeaux","Quevilly Rouen",0,0,"D",0,0,"D",1.97,3.5,4.14,"0-0","0-0",14,4,6,1,1,1,0,0,7,3,14,15,0,10,29,"7-3","N","N","N",2,0,28
"3262","F2",2024-03-09,"Caen","Paris FC",0,1,"A",0,0,"D",2.47,3.06,3.32,"0-0","0-1",9,1,16,2,0,2,0,0,2,5,9,17,1,7,26,"2-5","N","N","N",2,0,28
"3263","F2",2024-03-09,"Concarneau","Guingamp",2,3,"A",0,1,"A",3.62,3.19,2.25,"0-1","2-3",8,6,17,7,0,3,0,0,3,6,9,11,5,9,20,"3-6","Y","Y","Y",3,0,28
"3264","F2",2024-03-09,"Dunkerque","Pau FC",1,0,"H",0,0,"D",2.41,3.27,3.2,"0-0","1-0",12,6,5,2,1,2,0,0,7,2,12,19,1,9,31,"7-2","N","N","N",3,0,28
"3265","F2",2024-03-09,"Troyes","Bastia",2,0,"H",1,0,"H",2.74,3.16,2.86,"1-0","2-0",10,5,12,3,3,1,0,1,2,3,17,12,2,5,29,"2-3","Y","N","N",4,1,28
"3266","F2",2024-03-09,"Valenciennes","Angers",0,0,"D",0,0,"D",3.91,3.32,2.09,"0-0","0-0",5,2,13,5,2,1,0,0,1,6,15,8,0,7,23,"1-6","N","N","N",3,0,28
"3267","F2",2024-03-11,"Grenoble","Laval",0,2,"A",0,1,"A",2.39,3,3.41,"0-1","0-2",4,1,15,6,3,3,0,0,4,7,14,18,2,11,32,"4-7","Y","N","N",6,0,28
"3268","F2",2024-03-16,"Auxerre","Caen",2,1,"H",0,1,"A",1.71,3.88,5.16,"0-1","2-1",23,6,10,3,1,1,0,0,15,5,10,18,3,20,28,"15-5","Y","Y","N",2,0,29
"3269","F2",2024-03-16,"Angers","Amiens",1,3,"A",1,0,"H",1.97,3.35,4.39,"1-0","1-3",11,3,14,6,0,2,0,0,3,5,13,15,4,8,28,"3-5","Y","Y","Y",2,0,29
"3270","F2",2024-03-16,"Annecy","Bordeaux",3,1,"H",2,1,"H",3.16,3.41,2.36,"2-1","3-1",11,5,11,3,2,2,0,0,11,4,26,7,4,15,33,"11-4","Y","Y","Y",4,0,29
"3271","F2",2024-03-16,"Bastia","St Etienne",0,4,"A",0,2,"A",2.95,3.18,2.63,"0-2","0-4",10,3,14,9,2,1,0,0,4,5,19,12,4,9,31,"4-5","Y","Y","Y",3,0,29
"3272","F2",2024-03-16,"Guingamp","Valenciennes",3,0,"H",2,0,"H",1.54,3.96,7.38,"2-0","3-0",14,8,5,0,1,1,0,0,4,3,9,14,3,7,23,"4-3","Y","Y","N",2,0,29
"3273","F2",2024-03-16,"Laval","Dunkerque",1,2,"A",0,2,"A",2.1,3.31,3.93,"0-2","1-2",13,6,11,4,1,4,0,0,7,4,9,15,3,11,24,"7-4","Y","Y","N",5,0,29
"3274","F2",2024-03-16,"Paris FC","Ajaccio",2,0,"H",0,0,"D",2.15,2.98,4.28,"0-0","2-0",10,4,12,5,2,1,0,0,5,3,13,15,2,8,28,"5-3","Y","N","N",3,0,29
"3275","F2",2024-03-16,"Pau FC","Concarneau",2,0,"H",0,0,"D",2.24,3.28,3.54,"0-0","2-0",15,4,10,0,1,3,0,0,9,2,17,18,2,11,35,"9-2","Y","N","N",4,0,29
"3276","F2",2024-03-16,"Quevilly Rouen","Troyes",1,1,"D",0,1,"A",2.04,3.32,4.14,"0-1","1-1",9,3,5,1,5,1,0,0,1,1,21,18,2,2,39,"1-1","Y","N","N",6,0,29
"3277","F2",2024-03-16,"Rodez","Grenoble",3,1,"H",1,1,"D",2.3,3.31,3.38,"1-1","3-1",13,5,9,4,2,3,0,0,5,6,15,16,4,11,31,"5-6","Y","Y","Y",5,0,29
"4873","G1",2023-08-18,"Volos NFC","Lamia",2,2,"D",0,0,"D",2.5,3.01,3.2,"0-0","2-2",8,4,13,8,3,2,0,0,7,0,13,16,4,7,29,"7-0","Y","Y","Y",5,0,1
"4874","G1",2023-08-20,"Giannina","Kifisia",3,0,"H",1,0,"H",2.26,2.88,3.93,"1-0","3-0",10,7,4,0,3,4,1,0,7,2,16,19,3,9,35,"7-2","Y","Y","N",7,1,1
"4875","G1",2023-08-20,"OFI Crete","Aris",3,2,"H",2,1,"H",2.45,3.17,3.02,"2-1","3-2",13,4,16,7,5,3,0,0,3,4,25,13,5,7,38,"3-4","Y","Y","Y",8,0,1
"4876","G1",2023-08-20,"PAOK","Asteras Tripolis",3,0,"H",1,0,"H",1.27,5.32,11.14,"1-0","3-0",13,6,9,2,2,1,0,0,3,1,5,12,3,4,17,"3-1","Y","Y","N",3,0,1
"4877","G1",2023-08-20,"Olympiakos","Panserraikos",2,0,"H",0,0,"D",1.17,7.06,14.52,"0-0","2-0",29,3,5,2,3,0,0,1,8,3,19,7,2,11,26,"8-3","Y","N","N",3,1,1
"4878","G1",2023-08-25,"Panetolikos","Giannina",0,0,"D",0,0,"D",2.54,2.92,3.26,"0-0","0-0",17,7,8,2,1,4,0,0,2,3,16,19,0,5,35,"2-3","N","N","N",5,0,1
"4879","G1",2023-08-26,"Asteras Tripolis","OFI Crete",3,0,"H",2,0,"H",2.28,3.29,3.3,"2-0","3-0",12,4,16,6,1,3,0,0,3,4,16,16,3,7,32,"3-4","Y","Y","N",4,0,1
"4880","G1",2023-08-26,"Panathinaikos","Volos NFC",3,0,"H",2,0,"H",1.29,5.92,9.42,"2-0","3-0",14,8,5,3,1,3,0,0,6,1,16,19,3,7,35,"6-1","Y","Y","N",4,0,2
"4881","G1",2023-08-26,"AEK","Panserraikos",1,1,"D",0,1,"A",1.14,7.98,20.36,"0-1","1-1",29,10,7,4,1,6,0,0,12,1,6,20,2,13,26,"12-1","Y","N","N",7,0,2
"4882","G1",2023-08-27,"Lamia","Aris",1,0,"H",1,0,"H",3.4,3.3,2.18,"1-0","1-0",7,4,7,3,4,4,1,0,2,2,22,16,1,4,38,"2-2","N","N","N",8,1,2
"4883","G1",2023-08-27,"PAOK","Kifisia",2,1,"H",1,0,"H",1.17,6.66,16.16,"1-0","2-1",19,8,6,3,1,5,0,0,8,5,12,14,3,13,26,"8-5","Y","Y","N",6,0,2
"4884","G1",2023-08-27,"Olympiakos","Atromitos",4,0,"H",2,0,"H",1.28,5.51,10.05,"2-0","4-0",24,9,3,1,1,5,0,1,5,2,9,9,4,7,18,"5-2","Y","Y","Y",6,1,2
"4885","G1",2023-09-01,"Kifisia","Atromitos",2,1,"H",1,0,"H",2.64,3.18,2.86,"1-0","2-1",14,7,13,9,3,1,0,1,5,8,14,12,3,13,26,"5-8","Y","Y","N",4,1,2
"4886","G1",2023-09-02,"Panserraikos","Panetolikos",1,1,"D",1,0,"H",2.31,3.22,3.25,"1-0","1-1",14,3,8,4,3,1,0,0,4,6,14,15,2,10,29,"4-6","Y","N","N",4,0,2
"4887","G1",2023-09-03,"Aris","Asteras Tripolis",3,2,"H",1,1,"D",1.52,3.88,6.81,"1-1","3-2",10,6,4,4,1,3,0,0,3,5,14,13,5,8,27,"3-5","Y","Y","Y",4,0,3
"4888","G1",2023-09-03,"OFI Crete","PAOK",1,0,"H",0,0,"D",5.24,3.85,1.64,"0-0","1-0",7,2,12,4,4,5,0,0,1,5,20,17,1,6,37,"1-5","N","N","N",9,0,3
"4889","G1",2023-09-03,"Olympiakos","Lamia",4,0,"H",2,0,"H",1.25,5.66,11.44,"2-0","4-0",17,8,8,3,2,3,0,0,5,2,14,14,4,7,28,"5-2","Y","Y","Y",5,0,3
"4890","G1",2023-09-03,"Volos NFC","AEK",2,3,"A",1,2,"A",11.46,6.13,1.22,"1-2","2-3",7,5,11,7,4,1,0,1,3,8,18,17,5,11,35,"3-8","Y","Y","Y",5,1,3
"4891","G1",2023-09-03,"Giannina","Panathinaikos",0,1,"A",0,0,"D",6.17,3.66,1.6,"0-0","0-1",11,4,11,2,6,2,0,0,2,8,11,19,1,10,30,"2-8","N","N","N",8,0,3
"4892","G1",2023-09-16,"Lamia","OFI Crete",2,2,"D",0,1,"A",2.72,3.17,2.73,"0-1","2-2",7,2,12,4,1,3,0,0,6,7,7,16,4,13,23,"6-7","Y","Y","Y",4,0,3
"4893","G1",2023-09-16,"Panetolikos","Panathinaikos",0,5,"A",0,2,"A",7.6,4.07,1.49,"0-2","0-5",11,4,18,10,2,1,0,0,3,6,10,13,5,9,23,"3-6","Y","Y","Y",3,0,3
"4894","G1",2023-09-17,"Asteras Tripolis","Giannina",2,2,"D",2,2,"D",2.13,3.07,3.82,"2-2","2-2",10,4,7,6,2,3,0,0,8,1,15,9,4,9,24,"8-1","Y","Y","Y",5,0,4
"4895","G1",2023-09-17,"Kifisia","Panserraikos",4,4,"D",0,3,"A",2.04,3.41,3.66,"0-3","4-4",19,6,9,4,3,5,0,1,3,3,16,22,8,6,38,"3-3","Y","Y","Y",8,1,4
"4896","G1",2023-09-17,"PAOK","Aris",0,0,"D",0,0,"D",1.55,4.01,5.99,"0-0","0-0",10,3,8,4,4,3,0,0,7,1,17,13,0,8,30,"7-1","N","N","N",7,0,4
"4897","G1",2023-09-17,"AEK","Olympiakos",1,1,"D",1,1,"D",2.19,3.35,3.32,"1-1","1-1",9,4,7,3,2,4,0,0,5,5,15,21,2,10,36,"5-5","Y","N","N",6,0,4
"4898","G1",2023-09-18,"Atromitos","Volos NFC",1,1,"D",1,0,"H",1.79,3.83,4.16,"1-0","1-1",8,1,10,1,3,2,0,0,4,1,13,19,2,5,32,"4-1","Y","N","N",5,0,4
"4899","G1",2023-09-23,"OFI Crete","Atromitos",1,1,"D",1,0,"H",2.08,3.41,3.59,"1-0","1-1",16,5,9,4,3,4,0,0,8,4,13,18,2,12,31,"8-4","Y","N","N",7,0,4
"4900","G1",2023-09-23,"Panserraikos","Lamia",2,0,"H",0,0,"D",2.3,3.22,3.33,"0-0","2-0",14,7,4,1,1,2,0,0,3,1,14,19,2,4,33,"3-1","Y","N","N",3,0,4
"4901","G1",2023-09-24,"Olympiakos","Kifisia",4,0,"H",2,0,"H",1.15,7.58,16.14,"2-0","4-0",13,7,8,2,1,2,0,0,7,1,18,11,4,8,29,"7-1","Y","Y","Y",3,0,5
"4902","G1",2023-09-24,"Aris","Panetolikos",3,0,"H",1,0,"H",1.5,4.06,6.79,"1-0","3-0",14,6,5,3,0,2,0,0,6,5,10,8,3,11,18,"6-5","Y","Y","N",2,0,5
"4903","G1",2023-09-24,"Volos NFC","Asteras Tripolis",1,2,"A",0,2,"A",2.63,3.14,2.81,"0-2","1-2",13,7,16,6,4,3,0,0,1,5,18,18,3,6,36,"1-5","Y","Y","N",7,0,5
"4904","G1",2023-09-24,"Giannina","PAOK",1,3,"A",1,2,"A",5.4,3.87,1.62,"1-2","1-3",10,3,10,5,4,2,0,0,8,6,10,9,4,14,19,"8-6","Y","Y","Y",6,0,5
"4905","G1",2023-09-25,"Panathinaikos","AEK",1,2,"A",1,1,"D",2.37,3.09,3.23,"1-1","1-2",10,5,15,4,3,4,0,0,6,6,13,21,3,12,34,"6-6","Y","Y","N",7,0,5
"4906","G1",2023-09-27,"Panetolikos","OFI Crete",1,1,"D",1,1,"D",2.88,3.37,2.38,"1-1","1-1",18,6,21,10,2,2,0,0,3,7,7,13,2,10,20,"3-7","Y","N","N",4,0,5
"4907","G1",2023-09-27,"Kifisia","Lamia",1,1,"D",0,0,"D",2.3,3.33,3.24,"0-0","1-1",17,4,8,4,4,3,1,0,6,8,14,12,2,14,26,"6-8","Y","N","N",7,1,5
"4908","G1",2023-09-27,"Olympiakos","Aris",4,1,"H",1,0,"H",1.36,4.85,9.26,"1-0","4-1",20,5,7,1,2,0,0,0,8,1,17,7,5,9,24,"8-1","Y","Y","Y",2,0,6
"4909","G1",2023-09-27,"PAOK","Volos NFC",3,0,"H",2,0,"H",1.18,7.46,14.45,"2-0","3-0",17,10,5,2,0,1,0,0,5,3,14,13,3,8,27,"5-3","Y","Y","N",1,0,6
"4910","G1",2023-09-28,"Panserraikos","Giannina",3,2,"H",2,1,"H",2.28,3.07,3.45,"2-1","3-2",12,6,6,3,5,3,0,1,4,4,10,11,5,8,21,"4-4","Y","Y","Y",8,1,6
"4911","G1",2023-09-28,"Asteras Tripolis","Panathinaikos",1,4,"A",1,2,"A",5.4,3.6,1.67,"1-2","1-4",9,4,9,7,3,1,0,0,2,4,7,9,5,6,16,"2-4","Y","Y","Y",4,0,6
"4912","G1",2023-09-28,"AEK","Atromitos",2,1,"H",1,0,"H",1.17,7.15,14.76,"1-0","2-1",18,8,5,2,2,4,1,0,6,1,9,10,3,7,19,"6-1","Y","Y","N",6,1,6
"4913","G1",2023-10-01,"Lamia","Panetolikos",1,0,"H",1,0,"H",1.88,3.33,4.41,"1-0","1-0",7,3,13,1,2,4,0,0,2,5,16,18,1,7,34,"2-5","N","N","N",6,0,6
"4914","G1",2023-10-01,"Aris","Kifisia",1,1,"D",1,0,"H",1.41,4.43,7.69,"1-0","1-1",12,6,10,4,2,7,0,0,5,3,13,20,2,8,33,"5-3","Y","N","N",9,0,6
"4915","G1",2023-10-01,"Panathinaikos","PAOK",2,2,"D",1,1,"D",1.9,3.33,4.33,"1-1","2-2",22,13,5,2,2,4,0,0,7,2,10,13,4,9,23,"7-2","Y","Y","Y",6,0,7
"4916","G1",2023-10-01,"Giannina","Olympiakos",0,3,"A",0,2,"A",7.93,4.46,1.4,"0-2","0-3",5,0,25,9,3,2,0,0,2,6,10,14,3,8,24,"2-6","Y","Y","N",5,0,7
"4917","G1",2023-10-02,"Atromitos","Asteras Tripolis",0,0,"D",0,0,"D",2.16,3.17,3.69,"0-0","0-0",8,1,8,4,1,5,1,0,4,5,8,22,0,9,30,"4-5","N","N","N",6,1,7
"4918","G1",2023-10-02,"OFI Crete","AEK",2,0,"H",1,0,"H",6.48,4.38,1.47,"1-0","2-0",7,5,14,4,4,3,0,0,2,4,10,17,2,6,27,"2-4","Y","N","N",7,0,7
"4919","G1",2023-10-08,"AEK","Panetolikos",3,0,"H",2,0,"H",1.06,13.71,32.27,"2-0","3-0",23,9,7,4,0,2,0,0,9,5,10,15,3,14,25,"9-5","Y","Y","N",2,0,7
"4920","G1",2023-10-08,"Panathinaikos","Atromitos",5,0,"H",3,0,"H",1.22,5.9,13.39,"3-0","5-0",14,10,5,1,0,1,1,1,2,1,15,8,5,3,23,"2-1","Y","Y","Y",1,2,7
"4921","G1",2023-10-20,"Lamia","Giannina",2,1,"H",2,1,"H",2.18,2.96,4.04,"2-1","2-1",15,7,12,2,3,3,0,0,4,3,17,13,3,7,30,"4-3","Y","Y","N",6,0,7
"4922","G1",2023-10-21,"Panetolikos","Volos NFC",2,0,"H",1,0,"H",2.1,3.23,3.83,"1-0","2-0",13,6,11,1,2,3,0,0,3,6,18,8,2,9,26,"3-6","Y","N","N",5,0,8
"4923","G1",2023-10-21,"Aris","Panserraikos",1,0,"H",0,0,"D",1.46,4.33,7.33,"0-0","1-0",20,6,5,2,3,6,0,0,8,2,15,18,1,10,33,"8-2","N","N","N",9,0,8
"4924","G1",2023-10-22,"Asteras Tripolis","AEK",0,3,"A",0,1,"A",7.11,4.48,1.44,"0-1","0-3",4,1,15,5,6,5,1,0,2,3,8,9,3,5,17,"2-3","Y","Y","N",11,1,8
"4925","G1",2023-10-22,"Kifisia","OFI Crete",0,0,"D",0,0,"D",2.9,3.36,2.45,"0-0","0-0",8,2,9,3,2,6,1,0,5,4,8,16,0,9,24,"5-4","N","N","N",8,1,8
"4926","G1",2023-10-22,"PAOK","Atromitos",2,0,"H",1,0,"H",1.28,5.46,10.2,"1-0","2-0",15,5,6,3,3,3,0,0,8,1,16,13,2,9,29,"8-1","Y","N","N",6,0,8
"4927","G1",2023-10-28,"Volos NFC","Kifisia",2,1,"H",1,0,"H",2.27,3.46,3.18,"1-0","2-1",17,6,9,2,4,6,0,2,4,8,12,17,3,12,29,"4-8","Y","Y","N",10,2,8
"4928","G1",2023-10-28,"Atromitos","Panetolikos",3,2,"H",0,1,"A",1.81,3.59,4.59,"0-1","3-2",10,5,6,3,2,2,0,1,1,2,19,16,5,3,35,"1-2","Y","Y","Y",4,1,8
"4929","G1",2023-10-29,"Asteras Tripolis","Lamia",0,1,"A",0,0,"D",1.88,3.33,4.41,"0-0","0-1",11,5,10,4,2,3,0,0,5,2,14,10,1,7,24,"5-2","N","N","N",5,0,9
"4930","G1",2023-10-29,"Panathinaikos","Panserraikos",5,0,"H",3,0,"H",1.21,6.39,12.19,"3-0","5-0",13,6,7,1,2,4,0,1,7,1,22,11,5,8,33,"7-1","Y","Y","Y",6,1,9
"4931","G1",2023-10-29,"Aris","Giannina",2,0,"H",0,0,"D",1.4,4.43,7.97,"0-0","2-0",17,7,2,0,4,2,0,1,6,1,11,9,2,7,20,"6-1","Y","N","N",6,1,9
"4932","G1",2023-10-30,"AEK","PAOK",2,0,"H",1,0,"H",1.72,3.74,4.75,"1-0","2-0",15,3,4,2,4,5,0,0,5,2,14,9,2,7,23,"5-2","Y","N","N",9,0,9
"4933","G1",2023-10-30,"OFI Crete","Olympiakos",0,2,"A",0,1,"A",5.97,4.26,1.51,"0-1","0-2",4,0,13,3,1,3,0,0,2,3,7,18,2,5,25,"2-3","Y","N","N",4,0,9
"4934","G1",2023-11-04,"Lamia","Panathinaikos",1,2,"A",0,1,"A",7.97,4.51,1.42,"0-1","1-2",13,4,9,6,3,6,0,1,3,3,17,16,3,6,33,"3-3","Y","Y","N",9,1,9
"4935","G1",2023-11-04,"Kifisia","AEK",1,1,"D",0,0,"D",14.16,8.09,1.16,"0-0","1-1",7,2,18,6,2,2,0,0,5,8,10,13,2,13,23,"5-8","Y","N","N",4,0,9
"4936","G1",2023-11-05,"Panetolikos","Asteras Tripolis",0,1,"A",0,1,"A",3.04,3.06,2.51,"0-1","0-1",15,4,4,3,6,5,0,1,8,3,23,13,1,11,36,"8-3","N","N","N",11,1,10
"4937","G1",2023-11-05,"Giannina","Volos NFC",1,1,"D",0,0,"D",1.93,3.38,4.09,"0-0","1-1",12,3,11,2,5,2,0,0,4,7,23,13,2,11,36,"4-7","Y","N","N",7,0,10
"4938","G1",2023-11-05,"Olympiakos","PAOK",2,4,"A",0,1,"A",1.48,3.9,5.84,"0-1","2-4",11,6,10,5,3,2,0,0,7,2,14,11,6,9,25,"7-2","Y","Y","Y",5,0,10
"4939","G1",2023-11-05,"Aris","Atromitos",1,3,"A",1,1,"D",1.54,4.08,5.96,"1-1","1-3",16,5,8,6,3,4,0,0,9,2,14,18,4,11,32,"9-2","Y","Y","Y",7,0,10
"4940","G1",2023-11-06,"Panserraikos","OFI Crete",2,1,"H",1,1,"D",2.66,3.14,2.78,"1-1","2-1",9,4,15,3,3,4,0,0,4,4,18,13,3,8,31,"4-4","Y","Y","N",7,0,10
"4941","G1",2023-11-11,"OFI Crete","Giannina",1,1,"D",1,0,"H",1.69,3.76,5.02,"1-0","1-1",13,5,18,7,2,2,0,0,2,4,17,14,2,6,31,"2-4","Y","N","N",4,0,10
"4942","G1",2023-11-11,"Atromitos","Panserraikos",1,1,"D",0,1,"A",1.94,3.36,4.27,"0-1","1-1",12,3,7,2,4,4,0,0,5,1,21,20,2,6,41,"5-1","Y","N","N",8,0,10
"4943","G1",2023-11-11,"Volos NFC","Aris",0,2,"A",0,0,"D",4.44,3.8,1.79,"0-0","0-2",14,5,7,3,4,2,0,0,5,7,10,18,2,12,28,"5-7","Y","N","N",6,0,11
"4944","G1",2023-11-12,"PAOK","Panetolikos",2,1,"H",2,1,"H",1.17,7.07,13.77,"2-1","2-1",9,2,8,2,2,3,0,0,4,1,7,14,3,5,21,"4-1","Y","Y","N",5,0,11
"4945","G1",2023-11-12,"AEK","Lamia",3,0,"H",2,0,"H",1.2,6.85,11.31,"2-0","3-0",12,5,5,1,3,3,0,0,4,4,15,15,3,8,30,"4-4","Y","Y","N",6,0,11
"4946","G1",2023-11-12,"Asteras Tripolis","Olympiakos",0,2,"A",0,0,"D",7.05,4.47,1.43,"0-0","0-2",5,2,13,4,3,0,0,0,2,5,7,16,2,7,23,"2-5","Y","N","N",3,0,11
"4947","G1",2023-11-12,"Kifisia","Panathinaikos",0,1,"A",0,0,"D",10.43,5.94,1.24,"0-0","0-1",4,2,14,6,1,3,0,0,0,9,13,14,1,9,27,"0-9","N","N","N",4,0,11
"4948","G1",2023-11-24,"OFI Crete","Volos NFC",1,1,"D",0,1,"A",1.75,3.77,4.77,"0-1","1-1",16,6,10,3,3,5,0,1,6,2,10,17,2,8,27,"6-2","Y","N","N",8,1,11
"4949","G1",2023-11-25,"Olympiakos","Panetolikos",3,1,"H",2,1,"H",1.13,9.49,17.72,"2-1","3-1",9,4,8,4,3,1,0,0,3,2,20,15,4,5,35,"3-2","Y","Y","Y",4,0,11
"4950","G1",2023-11-25,"PAOK","Panserraikos",5,0,"H",2,0,"H",1.24,6.37,11,"2-0","5-0",16,11,7,2,0,0,0,0,8,3,3,7,5,11,10,"8-3","Y","Y","Y",0,0,12
"4951","G1",2023-11-26,"Kifisia","Asteras Tripolis",1,3,"A",0,2,"A",2.45,3.16,3.03,"0-2","1-3",17,6,5,4,2,2,0,0,7,2,17,15,4,9,32,"7-2","Y","Y","Y",4,0,12
"4952","G1",2023-11-26,"Giannina","AEK",0,1,"A",0,1,"A",8.9,5.28,1.31,"0-1","0-1",8,4,20,7,3,1,0,0,3,6,12,13,1,9,25,"3-6","N","N","N",4,0,12
"4953","G1",2023-11-26,"Lamia","Atromitos",3,3,"D",2,2,"D",2.41,3.25,3.02,"2-2","3-3",12,7,11,6,4,3,0,0,3,8,11,18,6,11,29,"3-8","Y","Y","Y",7,0,12
"4954","G1",2023-11-26,"Aris","Panathinaikos",2,0,"H",1,0,"H",3.41,3.42,2.13,"1-0","2-0",8,4,14,8,3,1,0,0,1,9,19,11,2,10,30,"1-9","Y","N","N",4,0,12
"4955","G1",2023-11-29,"Volos NFC","Panserraikos",1,0,"H",0,0,"D",2.43,3.27,3.06,"0-0","1-0",11,5,11,4,2,4,0,0,3,5,21,16,1,8,37,"3-5","N","N","N",6,0,12
"4956","G1",2023-12-02,"Panetolikos","Kifisia",3,0,"H",1,0,"H",2.2,3.26,3.53,"1-0","3-0",14,7,8,4,2,5,0,0,5,6,17,17,3,11,34,"5-6","Y","Y","N",7,0,12
"4957","G1",2023-12-02,"Asteras Tripolis","Panserraikos",1,0,"H",0,0,"D",2,3.36,4.05,"0-0","1-0",9,2,16,4,4,4,0,0,5,3,17,12,1,8,29,"5-3","N","N","N",8,0,13
"4958","G1",2023-12-03,"Volos NFC","Olympiakos",2,2,"D",1,1,"D",12.69,6.38,1.2,"1-1","2-2",10,4,11,3,7,3,1,1,2,6,16,8,4,8,24,"2-6","Y","Y","Y",10,2,13
"4959","G1",2023-12-03,"Atromitos","Giannina",1,1,"D",0,0,"D",2.2,3.28,3.38,"0-0","1-1",12,4,9,3,4,2,0,0,2,2,16,7,2,4,23,"2-2","Y","N","N",6,0,13
"4960","G1",2023-12-03,"Panathinaikos","OFI Crete",4,0,"H",1,0,"H",1.22,6,11.75,"1-0","4-0",16,9,5,3,1,6,0,0,2,3,18,21,4,5,39,"2-3","Y","Y","Y",7,0,13
"4961","G1",2023-12-04,"PAOK","Lamia",3,0,"H",2,0,"H",1.2,6.39,12.52,"2-0","3-0",17,8,11,6,0,1,0,0,5,5,7,9,3,10,16,"5-5","Y","Y","N",1,0,13
"4962","G1",2023-12-04,"AEK","Aris",1,0,"H",0,0,"D",1.39,4.8,7.45,"0-0","1-0",17,4,7,1,1,1,0,0,9,2,15,9,1,11,24,"9-2","N","N","N",2,0,13
"4963","G1",2023-12-16,"Kifisia","Giannina",4,2,"H",3,2,"H",2.39,3.05,3.36,"3-2","4-2",12,10,9,5,3,5,0,1,3,7,13,19,6,10,32,"3-7","Y","Y","Y",8,1,13
"4964","G1",2023-12-17,"Aris","OFI Crete",1,0,"H",1,0,"H",1.64,3.94,5.45,"1-0","1-0",17,7,6,1,1,1,0,0,6,5,12,18,1,11,30,"6-5","N","N","N",2,0,14
"4965","G1",2023-12-17,"Asteras Tripolis","PAOK",1,4,"A",0,1,"A",6.02,3.86,1.57,"0-1","1-4",10,3,13,8,2,1,0,0,7,4,16,17,5,11,33,"7-4","Y","Y","Y",3,0,14
"4966","G1",2023-12-17,"Lamia","Volos NFC",1,2,"A",0,0,"D",1.89,3.44,4.17,"0-0","1-2",10,4,8,4,3,4,0,0,6,2,12,24,3,8,36,"6-2","Y","Y","N",7,0,14
"4967","G1",2023-12-17,"Atromitos","Panathinaikos",3,2,"H",1,1,"D",6.79,4.21,1.47,"1-1","3-2",9,4,12,4,3,2,0,0,1,7,14,16,5,8,30,"1-7","Y","Y","Y",5,0,14
"4968","G1",2023-12-18,"Panetolikos","AEK",2,2,"D",1,2,"A",9.34,5.39,1.3,"1-2","2-2",6,3,19,7,4,1,0,0,2,9,17,10,4,11,27,"2-9","Y","Y","Y",5,0,14
"4969","G1",2023-12-18,"Panserraikos","Olympiakos",0,1,"A",0,0,"D",8.79,4.98,1.34,"0-0","0-1",5,2,13,3,1,4,0,0,3,5,7,16,1,8,23,"3-5","N","N","N",5,0,14
"4970","G1",2023-12-20,"Aris","Lamia",2,2,"D",0,0,"D",1.52,4.23,6.44,"0-0","2-2",22,11,8,3,1,4,0,0,10,3,17,14,4,13,31,"10-3","Y","Y","Y",5,0,14
"4971","G1",2023-12-20,"Volos NFC","Panathinaikos",0,3,"A",0,0,"D",8.4,5.02,1.36,"0-0","0-3",3,0,14,6,1,2,0,0,3,4,14,16,3,7,30,"3-4","Y","Y","N",3,0,15
"4972","G1",2023-12-21,"Giannina","Panetolikos",0,0,"D",0,0,"D",2.06,3.27,3.81,"0-0","0-0",11,3,4,1,1,4,0,1,7,6,16,17,0,13,33,"7-6","N","N","N",5,1,15
"4973","G1",2023-12-21,"Panserraikos","AEK",2,2,"D",1,2,"A",10.99,5.6,1.26,"1-2","2-2",10,7,14,6,5,4,1,0,5,3,18,14,4,8,32,"5-3","Y","Y","Y",9,1,15
"4974","G1",2023-12-21,"OFI Crete","Asteras Tripolis",0,2,"A",0,1,"A",2.02,3.29,3.87,"0-1","0-2",19,5,14,6,3,1,0,0,9,4,15,7,2,13,22,"9-4","Y","N","N",4,0,15
"4975","G1",2023-12-21,"Kifisia","PAOK",0,6,"A",0,3,"A",7.7,4.82,1.38,"0-3","0-6",7,2,14,10,1,0,0,0,1,4,15,15,6,5,30,"1-4","Y","Y","Y",1,0,15
"4976","G1",2023-12-21,"Atromitos","Olympiakos",0,0,"D",0,0,"D",7.93,4.69,1.38,"0-0","0-0",3,1,18,4,3,1,0,0,0,9,13,11,0,9,24,"0-9","N","N","N",4,0,15
"4977","G1",2024-01-03,"Asteras Tripolis","Aris",3,2,"H",1,2,"A",3.13,3.22,2.42,"1-2","3-2",10,3,8,3,1,2,0,0,5,1,18,14,5,6,32,"5-1","Y","Y","Y",3,0,15
"4978","G1",2024-01-03,"Lamia","Olympiakos",1,0,"H",1,0,"H",8.2,4.98,1.37,"1-0","1-0",14,7,13,5,4,1,0,0,7,5,14,12,1,12,26,"7-5","N","N","N",5,0,16
"4979","G1",2024-01-03,"AEK","Volos NFC",3,0,"H",1,0,"H",1.12,9.25,19.94,"1-0","3-0",10,4,4,2,2,5,0,0,9,3,11,21,3,12,32,"9-3","Y","Y","N",7,0,16
"4980","G1",2024-01-03,"Panathinaikos","Giannina",2,0,"H",1,0,"H",1.17,7.38,16.57,"1-0","2-0",13,7,7,3,1,1,0,0,8,3,15,12,2,11,27,"8-3","Y","N","N",2,0,16
"4981","G1",2024-01-03,"PAOK","OFI Crete",4,0,"H",2,0,"H",1.22,6.6,11.67,"2-0","4-0",15,10,14,7,1,3,0,0,6,2,11,14,4,8,25,"6-2","Y","Y","Y",4,0,16
"4982","G1",2024-01-04,"Panetolikos","Panserraikos",3,2,"H",1,1,"D",2.26,3.16,3.38,"1-1","3-2",18,6,9,3,2,2,0,0,4,3,20,15,5,7,35,"4-3","Y","Y","Y",4,0,16
"4983","G1",2024-01-04,"Atromitos","Kifisia",3,0,"H",1,0,"H",1.82,3.67,4.24,"1-0","3-0",12,7,11,2,2,4,0,0,1,10,14,11,3,11,25,"1-10","Y","Y","N",6,0,16
"4984","G1",2024-01-07,"Panserraikos","Kifisia",1,1,"D",0,1,"A",2.05,3.38,3.66,"0-1","1-1",8,1,13,5,2,4,0,0,3,3,9,19,2,6,28,"3-3","Y","N","N",6,0,16
"4985","G1",2024-01-07,"Volos NFC","Atromitos",1,2,"A",0,1,"A",2.54,3.23,2.85,"0-1","1-2",7,4,14,6,4,3,0,0,2,8,16,18,3,10,34,"2-8","Y","Y","N",7,0,17
"4986","G1",2024-01-07,"Panathinaikos","Panetolikos",2,1,"H",0,0,"D",1.17,7.2,14.39,"0-0","2-1",12,5,8,5,2,2,0,0,4,3,18,11,3,7,29,"4-3","Y","Y","N",4,0,17
"4987","G1",2024-01-07,"Giannina","Asteras Tripolis",2,1,"H",2,1,"H",2.46,3.06,3.1,"2-1","2-1",14,5,9,3,2,0,0,0,7,3,12,17,3,10,29,"7-3","Y","Y","N",2,0,17
"4988","G1",2024-01-07,"Aris","PAOK",2,1,"H",0,0,"D",4.03,3.36,1.95,"0-0","2-1",13,4,9,2,2,4,0,0,4,5,21,11,3,9,32,"4-5","Y","Y","N",6,0,17
"4989","G1",2024-01-07,"Olympiakos","AEK",1,2,"A",1,2,"A",2.68,3.2,2.71,"1-2","1-2",7,3,10,3,3,3,0,0,5,9,9,16,3,14,25,"5-9","Y","Y","N",6,0,17
"4990","G1",2024-01-08,"OFI Crete","Lamia",1,1,"D",1,1,"D",1.86,3.4,4.39,"1-1","1-1",18,7,4,3,4,3,0,0,7,1,22,20,2,8,42,"7-1","Y","N","N",7,0,17
"4991","G1",2024-01-13,"Atromitos","OFI Crete",1,1,"D",0,0,"D",2.26,3.36,3.29,"0-0","1-1",10,2,12,4,2,4,0,0,5,7,8,20,2,12,28,"5-7","Y","N","N",6,0,17
"4992","G1",2024-01-13,"Lamia","Panserraikos",0,2,"A",0,1,"A",2.08,3.19,4,"0-1","0-2",9,3,7,4,2,2,0,0,2,1,14,20,2,3,34,"2-1","Y","N","N",4,0,18
"4993","G1",2024-01-14,"Panetolikos","Aris",0,4,"A",0,1,"A",2.71,3.09,2.86,"0-1","0-4",13,4,15,7,3,1,0,0,4,6,15,18,4,10,33,"4-6","Y","Y","Y",4,0,18
"4994","G1",2024-01-14,"Kifisia","Olympiakos",2,3,"A",1,2,"A",8.7,5.18,1.32,"1-2","2-3",6,4,13,9,6,2,1,1,2,4,13,10,5,6,23,"2-4","Y","Y","Y",8,2,18
"4995","G1",2024-01-14,"Asteras Tripolis","Volos NFC",1,0,"H",0,0,"D",2.04,3.14,4.04,"0-0","1-0",10,2,11,2,2,1,0,0,6,4,18,16,1,10,34,"6-4","N","N","N",3,0,18
"4996","G1",2024-01-14,"AEK","Panathinaikos",2,2,"D",1,1,"D",1.88,3.37,4.36,"1-1","2-2",15,5,8,2,3,2,0,0,7,2,17,11,4,9,28,"7-2","Y","Y","Y",5,0,18
"4997","G1",2024-01-14,"PAOK","Giannina",4,0,"H",1,0,"H",1.17,6.89,14.82,"1-0","4-0",19,9,4,0,0,0,0,0,9,2,11,10,4,11,21,"9-2","Y","Y","Y",0,0,18
"4998","G1",2024-01-20,"Lamia","Kifisia",4,1,"H",2,1,"H",1.93,2.86,4.62,"2-1","4-1",11,6,9,3,1,1,0,0,6,8,12,21,5,14,33,"6-8","Y","Y","Y",2,0,18
"4999","G1",2024-01-20,"Giannina","Panserraikos",0,2,"A",0,2,"A",2.28,2.98,3.7,"0-2","0-2",10,3,11,6,4,3,0,0,9,5,11,13,2,14,24,"9-5","Y","N","N",7,0,19
"5000","G1",2024-01-20,"OFI Crete","Panetolikos",1,0,"H",1,0,"H",1.95,3.22,4.47,"1-0","1-0",4,1,7,2,2,4,0,0,1,1,19,14,1,2,33,"1-1","N","N","N",6,0,19
"5001","G1",2024-01-21,"Volos NFC","PAOK",1,5,"A",0,2,"A",6.79,4.51,1.47,"0-2","1-5",11,3,14,7,2,1,0,0,1,5,22,11,6,6,33,"1-5","Y","Y","Y",3,0,19
"5002","G1",2024-01-21,"Atromitos","AEK",0,5,"A",0,3,"A",7.42,4.75,1.39,"0-3","0-5",9,3,16,9,0,2,0,0,7,7,21,20,5,14,41,"7-7","Y","Y","Y",2,0,19
"5003","G1",2024-01-21,"Panathinaikos","Asteras Tripolis",2,0,"H",0,0,"D",1.33,5.22,8.43,"0-0","2-0",17,7,9,2,1,6,0,1,9,3,11,9,2,12,20,"9-3","Y","N","N",7,1,19
"5004","G1",2024-01-21,"Aris","Olympiakos",1,2,"A",0,2,"A",4.31,3.5,1.85,"0-2","1-2",3,1,11,3,2,2,0,0,1,1,12,22,3,2,34,"1-1","Y","Y","N",4,0,19
"5005","G1",2024-01-27,"Panetolikos","Lamia",1,2,"A",0,1,"A",2.12,3.14,3.91,"0-1","1-2",14,2,13,5,2,5,0,0,4,5,15,14,3,9,29,"4-5","Y","Y","N",7,0,19
"5006","G1",2024-01-27,"Panserraikos","Volos NFC",2,2,"D",0,1,"A",2.24,3.18,3.52,"0-1","2-2",13,8,5,4,4,6,0,0,2,2,14,28,4,4,42,"2-2","Y","Y","Y",10,0,20
"5007","G1",2024-01-27,"Kifisia","Aris",0,1,"A",0,1,"A",6.09,4.04,1.56,"0-1","0-1",14,5,6,4,5,6,0,0,8,3,13,11,1,11,24,"8-3","N","N","N",11,0,20
"5008","G1",2024-01-28,"AEK","OFI Crete",3,0,"H",1,0,"H",1.29,5.91,8.11,"1-0","3-0",17,8,9,4,2,1,0,0,13,4,21,7,3,17,28,"13-4","Y","Y","N",3,0,20
"5009","G1",2024-01-28,"Asteras Tripolis","Atromitos",3,1,"H",1,0,"H",2.08,3.3,3.67,"1-0","3-1",9,6,10,2,1,0,0,0,5,3,15,8,4,8,23,"5-3","Y","Y","Y",1,0,20
"5010","G1",2024-01-28,"Olympiakos","Giannina",3,1,"H",0,0,"D",1.21,6.51,11.78,"0-0","3-1",16,8,7,2,1,4,0,0,8,3,15,6,4,11,21,"8-3","Y","Y","Y",5,0,20
"5011","G1",2024-01-28,"PAOK","Panathinaikos",2,1,"H",1,0,"H",2.35,3.34,3.02,"1-0","2-1",9,4,10,5,4,2,0,0,3,6,9,15,3,9,24,"3-6","Y","Y","N",6,0,20
"5012","G1",2024-02-03,"Volos NFC","Panetolikos",1,1,"D",1,1,"D",2.32,3.21,3.31,"1-1","1-1",9,6,8,3,2,4,0,0,5,5,23,20,2,10,43,"5-5","Y","N","N",6,0,20
"5013","G1",2024-02-03,"Panserraikos","Aris",1,1,"D",0,0,"D",3.52,3.29,2.19,"0-0","1-1",11,7,9,5,5,2,0,0,4,0,19,14,2,4,33,"4-0","Y","N","N",7,0,21
"5014","G1",2024-02-04,"OFI Crete","Kifisia",1,2,"A",0,1,"A",1.76,3.84,4.35,"0-1","1-2",9,3,11,4,3,4,0,0,3,6,21,11,3,9,32,"3-6","Y","Y","N",7,0,21
"5015","G1",2024-02-04,"AEK","Asteras Tripolis",4,2,"H",3,1,"H",1.23,6.13,10.76,"3-1","4-2",18,7,7,2,0,3,0,0,6,5,10,17,6,11,27,"6-5","Y","Y","Y",3,0,21
"5016","G1",2024-02-04,"Giannina","Lamia",1,4,"A",1,2,"A",2.44,2.79,3.49,"1-2","1-4",15,5,12,8,5,3,0,0,11,4,12,13,5,15,25,"11-4","Y","Y","Y",8,0,21
"5017","G1",2024-02-04,"Atromitos","PAOK",0,2,"A",0,0,"D",6.91,4.53,1.43,"0-0","0-2",0,0,15,4,3,3,0,0,2,8,15,10,2,10,25,"2-8","Y","N","N",6,0,21
"5018","G1",2024-02-04,"Panathinaikos","Olympiakos",2,0,"H",1,0,"H",2.54,2.85,3.23,"1-0","2-0",11,7,11,4,1,3,0,0,3,7,10,13,2,10,23,"3-7","Y","N","N",4,0,21
"5019","G1",2024-02-10,"Olympiakos","OFI Crete",4,0,"H",3,0,"H",1.26,6.08,9.93,"3-0","4-0",19,8,6,0,1,2,0,0,5,2,15,14,4,7,29,"5-2","Y","Y","Y",3,0,21
"5020","G1",2024-02-10,"Giannina","Aris",0,0,"D",0,0,"D",4.58,3.57,1.82,"0-0","0-0",10,3,6,2,4,2,0,0,2,4,19,20,0,6,39,"2-4","N","N","N",6,0,22
"5021","G1",2024-02-10,"Panetolikos","Atromitos",1,0,"H",1,0,"H",2.41,3.21,3.15,"1-0","1-0",8,5,14,4,4,3,1,0,5,10,13,16,1,15,29,"5-10","N","N","N",7,1,22
"5022","G1",2024-02-11,"Kifisia","Volos NFC",0,0,"D",0,0,"D",2.21,3.28,3.36,"0-0","0-0",13,5,5,3,2,5,0,1,11,5,22,21,0,16,43,"11-5","N","N","N",7,1,22
"5023","G1",2024-02-11,"Panserraikos","Panathinaikos",0,3,"A",0,2,"A",7.56,4.38,1.42,"0-2","0-3",9,3,11,7,4,2,0,0,3,3,15,22,3,6,37,"3-3","Y","Y","N",6,0,22
"5024","G1",2024-02-11,"Lamia","Asteras Tripolis",2,1,"H",0,1,"A",2.53,2.95,3.12,"0-1","2-1",11,6,13,6,2,4,0,1,4,3,14,23,3,7,37,"4-3","Y","Y","N",6,1,22
"5025","G1",2024-02-11,"PAOK","AEK",1,1,"D",0,0,"D",2.28,3.4,3.1,"0-0","1-1",10,6,9,5,2,3,0,0,5,4,17,17,2,9,34,"5-4","Y","N","N",5,0,22
"5026","G1",2024-02-17,"Atromitos","Aris",0,2,"A",0,1,"A",3.19,3.27,2.35,"0-1","0-2",10,2,9,4,4,4,0,0,0,3,11,17,2,3,28,"0-3","Y","N","N",8,0,22
"5027","G1",2024-02-17,"Panathinaikos","Lamia",2,2,"D",1,1,"D",1.35,5.36,8.12,"1-1","2-2",27,7,4,2,1,3,0,1,12,2,20,9,4,14,29,"12-2","Y","Y","Y",4,1,23
"5028","G1",2024-02-18,"Volos NFC","Giannina",1,2,"A",0,1,"A",2.05,3.07,4.1,"0-1","1-2",10,4,13,6,5,3,0,0,4,7,19,18,3,11,37,"4-7","Y","Y","N",8,0,23
"5029","G1",2024-02-18,"AEK","Kifisia",3,0,"H",2,0,"H",1.13,8.81,16.43,"2-0","3-0",24,10,2,0,2,3,0,1,10,0,16,8,3,10,24,"10-0","Y","Y","N",5,1,23
"5030","G1",2024-02-18,"PAOK","Olympiakos",1,4,"A",1,1,"D",2.18,3.11,3.63,"1-1","1-4",13,4,10,6,2,6,0,0,3,4,10,16,5,7,26,"3-4","Y","Y","Y",8,0,23
"5031","G1",2024-02-19,"OFI Crete","Panserraikos",4,0,"H",3,0,"H",1.99,3.31,3.94,"3-0","4-0",11,5,12,3,4,2,0,0,3,4,18,13,4,7,31,"3-4","Y","Y","Y",6,0,23
"5032","G1",2024-02-19,"Asteras Tripolis","Panetolikos",2,2,"D",1,1,"D",1.93,3.43,4.04,"1-1","2-2",20,6,11,8,1,4,0,0,6,3,14,16,4,9,30,"6-3","Y","Y","Y",5,0,23
"5033","G1",2024-02-24,"Lamia","AEK",1,3,"A",0,2,"A",7.29,4.55,1.44,"0-2","1-3",4,4,14,7,2,1,0,0,3,4,11,16,4,7,27,"3-4","Y","Y","Y",3,0,23
"5034","G1",2024-02-24,"Panserraikos","Atromitos",0,0,"D",0,0,"D",2.44,3.04,3.27,"0-0","0-0",12,2,2,1,3,4,0,0,3,4,17,24,0,7,41,"3-4","N","N","N",7,0,24
"5035","G1",2024-02-25,"Giannina","OFI Crete",2,2,"D",2,0,"H",2.37,3.23,3.09,"2-0","2-2",7,4,10,4,4,3,0,0,6,2,16,12,4,8,28,"6-2","Y","Y","Y",7,0,24
"5036","G1",2024-02-25,"Panetolikos","PAOK",1,3,"A",1,0,"H",7.76,4.91,1.37,"1-0","1-3",6,4,18,5,2,0,0,0,2,5,12,14,4,7,26,"2-5","Y","Y","Y",2,0,24
"5037","G1",2024-02-25,"Olympiakos","Asteras Tripolis",2,1,"H",0,1,"A",1.3,5.48,8.93,"0-1","2-1",25,11,7,2,0,2,0,0,11,1,8,13,3,12,21,"11-1","Y","Y","N",2,0,24
"5038","G1",2024-02-25,"Aris","Volos NFC",2,0,"H",1,0,"H",1.54,3.93,6.29,"1-0","2-0",18,8,2,2,2,6,0,0,6,1,7,19,2,7,26,"6-1","Y","N","N",8,0,24
"5039","G1",2024-02-25,"Panathinaikos","Kifisia",1,1,"D",1,0,"H",1.16,7.35,14.79,"1-0","1-1",17,4,14,7,2,3,1,0,7,11,13,16,2,18,29,"7-11","Y","N","N",5,1,24
"5040","G1",2024-02-28,"Asteras Tripolis","Kifisia",3,3,"D",3,2,"H",1.74,3.82,4.75,"3-2","3-3",18,10,12,8,2,2,0,0,8,5,14,15,6,13,29,"8-5","Y","Y","Y",4,0,24
"5041","G1",2024-02-28,"Volos NFC","OFI Crete",3,1,"H",1,1,"D",2.58,3.12,2.97,"1-1","3-1",5,3,8,2,3,5,0,0,2,7,24,24,4,9,48,"2-7","Y","Y","Y",8,0,25
"5042","G1",2024-02-28,"Atromitos","Lamia",3,1,"H",1,1,"D",2.27,3.29,3.32,"1-1","3-1",9,5,5,4,4,3,1,0,3,3,13,10,4,6,23,"3-3","Y","Y","Y",7,1,25
"5043","G1",2024-02-28,"Panetolikos","Olympiakos",1,2,"A",1,0,"H",7.09,5.14,1.4,"1-0","1-2",3,2,12,4,1,3,0,0,1,9,8,19,3,10,27,"1-9","Y","Y","N",4,0,25
"5044","G1",2024-02-28,"AEK","Giannina",4,2,"H",1,2,"A",1.12,9.32,18.85,"1-2","4-2",18,6,6,2,0,5,0,0,10,2,3,18,6,12,21,"10-2","Y","Y","Y",5,0,25
"5045","G1",2024-02-28,"Panserraikos","PAOK",0,2,"A",0,1,"A",15.32,6.43,1.2,"0-1","0-2",9,3,14,5,3,1,2,0,1,6,12,12,2,7,24,"1-6","Y","N","N",4,2,25
"5046","G1",2024-02-28,"Panathinaikos","Aris",2,0,"H",1,0,"H",1.56,3.95,6.4,"1-0","2-0",9,4,8,2,2,1,0,0,3,5,18,13,2,8,31,"3-5","Y","N","N",3,0,25
"5047","G1",2024-03-03,"Aris","AEK",3,3,"D",1,1,"D",7.62,4.43,1.41,"1-1","3-3",4,4,13,9,3,3,0,0,0,8,12,19,6,8,31,"0-8","Y","Y","Y",6,0,25
"5048","G1",2024-03-03,"Giannina","Atromitos",1,1,"D",1,0,"H",2.24,3.25,3.32,"1-0","1-1",12,4,8,4,1,1,0,1,8,2,19,16,2,10,35,"8-2","Y","N","N",2,1,26
"5049","G1",2024-03-03,"Kifisia","Panetolikos",2,2,"D",1,0,"H",2.41,3.22,3.03,"1-0","2-2",14,8,11,4,3,6,0,0,5,4,20,18,4,9,38,"5-4","Y","Y","Y",9,0,26
"5050","G1",2024-03-03,"Lamia","PAOK",0,2,"A",0,0,"D",7.87,4.92,1.36,"0-0","0-2",4,2,17,8,2,2,0,0,1,8,13,12,2,9,25,"1-8","Y","N","N",4,0,26
"5051","G1",2024-03-03,"OFI Crete","Panathinaikos",2,2,"D",1,1,"D",6.94,4.22,1.47,"1-1","2-2",8,4,13,6,6,3,0,0,1,4,15,17,4,5,32,"1-4","Y","Y","Y",9,0,26
"5052","G1",2024-03-03,"Olympiakos","Volos NFC",3,0,"H",2,0,"H",1.11,9.09,22.33,"2-0","3-0",28,15,4,0,3,2,0,1,9,0,21,7,3,9,28,"9-0","Y","Y","N",5,1,26
"5053","G1",2024-03-03,"Panserraikos","Asteras Tripolis",2,1,"H",1,1,"D",2.2,3.3,3.36,"1-1","2-1",7,6,4,1,5,4,0,1,5,5,19,9,3,10,28,"5-5","Y","Y","N",9,1,26
"5054","G1",2024-03-10,"Lamia","AEK",0,4,"A",0,1,"A",11.09,5.92,1.24,"0-1","0-4",2,0,20,7,4,1,0,0,1,12,14,13,4,13,27,"1-12","Y","Y","Y",5,0,26
"5055","G1",2024-03-10,"Olympiakos","Panathinaikos",1,3,"A",1,2,"A",2.04,3.14,3.7,"1-2","1-3",13,4,11,5,5,3,0,0,8,5,11,10,4,13,21,"8-5","Y","Y","Y",8,0,27
"5056","G1",2024-03-10,"PAOK","Aris",0,1,"A",0,1,"A",1.52,4.21,5.92,"0-1","0-1",14,4,6,3,2,3,0,0,7,1,13,12,1,8,25,"7-1","N","N","N",5,0,27
"5057","G1",2024-03-16,"Asteras Tripolis","Volos NFC",0,2,"A",0,0,"D",2.04,3.34,3.9,"0-0","0-2",9,3,10,4,2,3,0,0,4,5,14,15,2,9,29,"4-5","Y","N","N",5,0,27
"5058","G1",2024-03-16,"Kifisia","OFI Crete",0,0,"D",0,0,"D",2.78,3.21,2.69,"0-0","0-0",13,4,11,3,2,3,0,0,5,8,8,16,0,13,24,"5-8","N","N","N",5,0,27
"5059","G1",2024-03-16,"Atromitos","Giannina",3,2,"H",1,0,"H",1.99,3.38,4.03,"1-0","3-2",8,6,14,5,1,2,0,0,2,6,11,13,5,8,24,"2-6","Y","Y","Y",3,0,27
"5060","G1",2024-03-16,"Panetolikos","Panserraikos",3,0,"H",2,0,"H",2.18,3.29,3.54,"2-0","3-0",15,10,7,1,3,3,0,0,3,4,15,22,3,7,37,"3-4","Y","Y","N",6,0,27
"3278","I1",2023-08-19,"Empoli","Verona",0,1,"A",0,0,"D",2.3,3.3,3.44,"0-0","0-1",10,4,10,4,2,2,0,0,2,4,17,18,1,6,35,"2-4","N","N","N",4,0,1
"3279","I1",2023-08-19,"Frosinone","Napoli",1,3,"A",1,2,"A",8.85,5.25,1.37,"1-2","1-3",4,1,19,8,3,3,0,0,4,6,14,17,4,10,31,"4-6","Y","Y","Y",6,0,1
"3280","I1",2023-08-19,"Genoa","Fiorentina",1,4,"A",0,3,"A",3.54,3.36,2.23,"0-3","1-4",4,2,9,5,2,3,0,0,3,4,14,13,5,7,27,"3-4","Y","Y","Y",5,0,1
"3281","I1",2023-08-19,"Inter","Monza",2,0,"H",1,0,"H",1.39,5.1,8.76,"1-0","2-0",22,3,12,2,1,1,0,0,8,3,8,13,2,11,21,"8-3","Y","N","N",2,0,1
"3282","I1",2023-08-20,"Roma","Salernitana",2,2,"D",1,1,"D",1.53,4.18,7.16,"1-1","2-2",13,3,3,2,0,4,0,0,9,1,12,9,4,10,21,"9-1","Y","Y","Y",4,0,1
"3283","I1",2023-08-20,"Sassuolo","Atalanta",0,2,"A",0,0,"D",3.39,3.63,2.18,"0-0","0-2",11,3,16,6,0,0,0,0,7,7,9,13,2,14,22,"7-7","Y","N","N",0,0,1
"3284","I1",2023-08-20,"Lecce","Lazio",2,1,"H",0,1,"A",3.87,3.31,2.14,"0-1","2-1",23,7,10,4,3,2,0,0,5,2,12,16,3,7,28,"5-2","Y","Y","N",5,0,1
"3285","I1",2023-08-20,"Udinese","Juventus",0,3,"A",0,3,"A",4.64,3.66,1.85,"0-3","0-3",18,5,9,4,1,3,0,0,7,3,12,10,3,10,22,"7-3","Y","Y","N",4,0,1
"3286","I1",2023-08-21,"Torino","Cagliari",0,0,"D",0,0,"D",1.67,3.86,5.78,"0-0","0-0",11,2,8,2,1,1,0,0,8,3,8,12,0,11,20,"8-3","N","N","N",2,0,1
"3287","I1",2023-08-21,"Bologna","Milan",0,2,"A",0,2,"A",4.02,3.52,2.01,"0-2","0-2",17,5,10,6,2,2,0,0,3,6,10,4,2,9,14,"3-6","Y","N","N",4,0,1
"3288","I1",2023-08-26,"Frosinone","Atalanta",2,1,"H",2,0,"H",5.04,4.16,1.69,"2-0","2-1",13,5,18,6,1,2,0,0,3,7,10,10,3,10,20,"3-7","Y","Y","N",3,0,2
"3289","I1",2023-08-26,"Monza","Empoli",2,0,"H",1,0,"H",1.95,3.59,4.18,"1-0","2-0",20,5,18,6,1,2,0,0,6,5,14,7,2,11,21,"6-5","Y","N","N",3,0,2
"3290","I1",2023-08-26,"Milan","Torino",4,1,"H",3,1,"H",1.69,3.8,5.71,"3-1","4-1",17,7,8,1,2,3,0,0,2,1,13,16,5,3,29,"2-1","Y","Y","Y",5,0,2
"3291","I1",2023-08-26,"Verona","Roma",2,1,"H",2,0,"H",4.83,3.49,1.87,"2-0","2-1",5,3,23,7,1,3,1,0,1,12,17,12,3,13,29,"1-12","Y","Y","N",4,1,2
"3292","I1",2023-08-27,"Fiorentina","Lecce",2,2,"D",2,0,"H",1.64,4,5.86,"2-0","2-2",9,4,6,2,1,3,0,0,3,3,13,12,4,6,25,"3-3","Y","Y","Y",4,0,2
"3293","I1",2023-08-27,"Juventus","Bologna",1,1,"D",0,1,"A",1.51,4.42,7.08,"0-1","1-1",14,3,9,4,2,1,0,0,5,1,14,13,2,6,27,"5-1","Y","N","N",3,0,2
"3294","I1",2023-08-27,"Lazio","Genoa",0,1,"A",0,1,"A",1.61,4.23,5.75,"0-1","0-1",16,2,5,3,4,2,0,0,15,1,9,16,1,16,25,"15-1","N","N","N",6,0,2
"3295","I1",2023-08-27,"Napoli","Sassuolo",2,0,"H",1,0,"H",1.34,5.87,8.45,"1-0","2-0",25,5,6,1,0,1,0,1,12,4,9,10,2,16,19,"12-4","Y","N","N",1,1,2
"3296","I1",2023-08-28,"Salernitana","Udinese",1,1,"D",0,0,"D",2.8,3.34,2.69,"0-0","1-1",9,4,14,6,4,4,0,0,7,5,12,19,2,12,31,"7-5","Y","N","N",8,0,2
"3297","I1",2023-08-28,"Cagliari","Inter",0,2,"A",0,2,"A",6.7,5.01,1.47,"0-2","0-2",12,2,17,3,1,1,0,0,4,7,9,10,2,11,19,"4-7","Y","N","N",2,0,2
"3298","I1",2023-09-01,"Sassuolo","Verona",3,1,"H",1,0,"H",2.04,3.66,3.84,"1-0","3-1",16,7,11,3,1,3,0,0,10,1,8,13,4,11,21,"10-1","Y","Y","Y",4,0,3
"3299","I1",2023-09-01,"Roma","Milan",1,2,"A",0,1,"A",2.88,3.2,2.76,"0-1","1-2",13,2,9,4,2,4,0,1,3,5,14,15,3,8,29,"3-5","Y","Y","N",6,1,3
"3300","I1",2023-09-02,"Bologna","Cagliari",2,1,"H",0,1,"A",1.75,3.63,5.47,"0-1","2-1",16,7,7,1,1,2,0,0,5,2,9,13,3,7,22,"5-2","Y","Y","N",3,0,3
"3301","I1",2023-09-02,"Udinese","Frosinone",0,0,"D",0,0,"D",1.82,3.72,4.74,"0-0","0-0",12,6,12,2,2,2,0,0,3,5,14,9,0,8,23,"3-5","N","N","N",4,0,3
"3302","I1",2023-09-02,"Atalanta","Monza",3,0,"H",2,0,"H",1.64,4.27,5.32,"2-0","3-0",18,8,8,2,0,3,0,0,7,3,11,9,3,10,20,"7-3","Y","Y","N",3,0,3
"3303","I1",2023-09-02,"Napoli","Lazio",1,2,"A",1,1,"D",1.62,4.19,5.73,"1-1","1-2",22,4,6,2,1,2,0,0,7,2,8,9,3,9,17,"7-2","Y","Y","N",3,0,3
"3304","I1",2023-09-03,"Inter","Fiorentina",4,0,"H",1,0,"H",1.66,4.16,5.29,"1-0","4-0",21,11,6,2,1,1,0,0,1,1,13,12,4,2,25,"1-1","Y","Y","Y",2,0,3
"3305","I1",2023-09-03,"Torino","Genoa",1,0,"H",0,0,"D",2.09,3.31,4.03,"0-0","1-0",10,3,7,2,2,5,0,0,4,0,13,7,1,4,20,"4-0","N","N","N",7,0,3
"3306","I1",2023-09-03,"Empoli","Juventus",0,2,"A",0,1,"A",5.43,3.98,1.68,"0-1","0-2",7,0,18,5,3,3,0,0,3,7,14,13,2,10,27,"3-7","Y","N","N",6,0,3
"3307","I1",2023-09-03,"Lecce","Salernitana",2,0,"H",1,0,"H",2.06,3.4,4,"1-0","2-0",20,6,11,4,3,3,0,0,6,5,17,15,2,11,32,"6-5","Y","N","N",6,0,3
"3308","I1",2023-09-16,"Juventus","Lazio",3,1,"H",2,0,"H",1.94,3.47,4.41,"2-0","3-1",17,7,16,5,5,1,0,0,7,9,13,13,4,16,26,"7-9","Y","Y","Y",6,0,4
"3309","I1",2023-09-16,"Inter","Milan",5,1,"H",2,0,"H",2.15,3.57,3.53,"2-0","5-1",14,7,9,2,2,2,0,0,5,0,16,13,6,5,29,"5-0","Y","Y","Y",4,0,4
"3310","I1",2023-09-16,"Genoa","Napoli",2,2,"D",1,0,"H",5.41,4.1,1.66,"1-0","2-2",8,3,12,4,3,2,0,0,3,1,14,8,4,4,22,"3-1","Y","Y","Y",5,0,4
"3311","I1",2023-09-17,"Cagliari","Udinese",0,0,"D",0,0,"D",2.9,3.27,2.65,"0-0","0-0",10,1,11,1,2,1,1,0,4,6,12,11,0,10,23,"4-6","N","N","N",3,1,4
"3312","I1",2023-09-17,"Frosinone","Sassuolo",4,2,"H",1,2,"A",2.83,3.52,2.57,"1-2","4-2",16,6,18,7,4,2,0,0,5,6,10,9,6,11,19,"5-6","Y","Y","Y",6,0,4
"3313","I1",2023-09-17,"Monza","Lecce",1,1,"D",1,1,"D",2.13,3.5,3.66,"1-1","1-1",25,6,4,3,6,1,1,1,10,1,17,11,2,11,28,"10-1","Y","N","N",7,2,4
"3314","I1",2023-09-17,"Fiorentina","Atalanta",3,2,"H",2,1,"H",2.54,3.55,2.84,"2-1","3-2",15,8,11,4,1,2,0,0,3,4,8,14,5,7,22,"3-4","Y","Y","Y",3,0,4
"3315","I1",2023-09-17,"Roma","Empoli",7,0,"H",3,0,"H",1.43,4.66,8.61,"3-0","7-0",14,9,8,2,2,2,0,0,2,6,15,5,7,8,20,"2-6","Y","Y","Y",4,0,4
"3316","I1",2023-09-18,"Salernitana","Torino",0,3,"A",0,2,"A",3.73,3.27,2.2,"0-2","0-3",14,4,11,3,2,2,0,0,1,2,12,16,3,3,28,"1-2","Y","Y","N",4,0,4
"3317","I1",2023-09-18,"Verona","Bologna",0,0,"D",0,0,"D",3.15,3.39,2.41,"0-0","0-0",9,1,11,4,4,2,0,0,3,4,18,10,0,7,28,"3-4","N","N","N",6,0,4
"3318","I1",2023-09-22,"Salernitana","Frosinone",1,1,"D",0,1,"A",2.59,3.3,3.01,"0-1","1-1",19,6,9,3,2,2,0,0,8,6,12,12,2,14,24,"8-6","Y","N","N",4,0,5
"3319","I1",2023-09-22,"Lecce","Genoa",1,0,"H",0,0,"D",2.49,3.22,3.23,"0-0","1-0",18,3,8,1,1,3,0,1,4,3,12,10,1,7,22,"4-3","N","N","N",4,1,5
"3320","I1",2023-09-23,"Milan","Verona",1,0,"H",1,0,"H",1.39,4.95,9.16,"1-0","1-0",9,4,10,2,4,2,0,0,2,3,13,9,1,5,22,"2-3","N","N","N",6,0,5
"3321","I1",2023-09-23,"Sassuolo","Juventus",4,2,"H",2,1,"H",4.35,4.03,1.81,"2-1","4-2",18,7,15,2,4,2,0,0,6,3,13,8,6,9,21,"6-3","Y","Y","Y",6,0,5
"3322","I1",2023-09-23,"Lazio","Monza",1,1,"D",1,1,"D",1.8,3.94,4.52,"1-1","1-1",8,1,16,4,2,2,0,0,1,3,13,7,2,4,20,"1-3","Y","N","N",4,0,5
"3323","I1",2023-09-24,"Empoli","Inter",0,1,"A",0,0,"D",9.73,5.6,1.33,"0-0","0-1",7,1,23,6,2,2,0,0,3,6,15,11,1,9,26,"3-6","N","N","N",4,0,5
"3324","I1",2023-09-24,"Atalanta","Cagliari",2,0,"H",1,0,"H",1.41,5.11,7.79,"1-0","2-0",10,6,11,1,1,2,0,0,7,7,6,11,2,14,17,"7-7","Y","N","N",3,0,5
"3325","I1",2023-09-24,"Udinese","Fiorentina",0,2,"A",0,1,"A",3.17,3.45,2.37,"0-1","0-2",20,8,6,2,0,1,0,0,10,3,13,11,2,13,24,"10-3","Y","N","N",1,0,5
"3326","I1",2023-09-24,"Bologna","Napoli",0,0,"D",0,0,"D",3.72,3.66,2.06,"0-0","0-0",5,2,12,4,4,5,0,0,5,5,16,12,0,10,28,"5-5","N","N","N",9,0,5
"3327","I1",2023-09-24,"Torino","Roma",1,1,"D",0,0,"D",3.09,3.1,2.62,"0-0","1-1",13,4,11,3,0,2,0,0,7,1,4,5,2,8,9,"7-1","Y","N","N",2,0,5
"3328","I1",2023-09-26,"Juventus","Lecce",1,0,"H",0,0,"D",1.52,4.31,7.27,"0-0","1-0",14,5,2,0,2,5,0,1,5,1,14,15,1,6,29,"5-1","N","N","N",7,1,6
"3329","I1",2023-09-27,"Cagliari","Milan",1,3,"A",1,2,"A",5.46,3.96,1.68,"1-2","1-3",16,6,17,6,3,1,0,0,3,5,13,6,4,8,19,"3-5","Y","Y","Y",4,0,6
"3330","I1",2023-09-27,"Empoli","Salernitana",1,0,"H",1,0,"H",2.41,3.22,3.31,"1-0","1-0",13,6,14,2,2,1,0,0,10,2,18,13,1,12,31,"10-2","N","N","N",3,0,6
"3331","I1",2023-09-27,"Verona","Atalanta",0,1,"A",0,1,"A",4.63,3.78,1.82,"0-1","0-1",11,2,8,2,2,3,0,0,4,1,10,25,1,5,35,"4-1","N","N","N",5,0,6
"3332","I1",2023-09-27,"Inter","Sassuolo",1,2,"A",1,0,"H",1.32,5.99,9.3,"1-0","1-2",13,3,13,6,0,1,0,0,8,6,10,8,3,14,18,"8-6","Y","Y","N",1,0,6
"3333","I1",2023-09-27,"Lazio","Torino",2,0,"H",0,0,"D",2.17,3.37,3.7,"0-0","2-0",6,3,7,2,1,4,0,0,4,2,12,13,2,6,25,"4-2","Y","N","N",5,0,6
"3334","I1",2023-09-27,"Napoli","Udinese",4,1,"H",2,0,"H",1.39,5.16,8.46,"2-0","4-1",23,10,13,3,1,1,0,0,8,4,11,10,5,12,21,"8-4","Y","Y","Y",2,0,6
"3335","I1",2023-09-28,"Frosinone","Fiorentina",1,1,"D",0,1,"A",3.78,3.67,2.03,"0-1","1-1",11,3,19,6,3,3,0,0,8,10,6,11,2,18,17,"8-10","Y","N","N",6,0,6
"3336","I1",2023-09-28,"Monza","Bologna",0,0,"D",0,0,"D",2.49,3.35,3.06,"0-0","0-0",12,3,7,5,5,3,0,1,7,5,9,13,0,12,22,"7-5","N","N","N",8,1,6
"3337","I1",2023-09-28,"Genoa","Roma",4,1,"H",2,1,"H",3.85,3.31,2.14,"2-1","4-1",8,4,13,3,4,3,0,0,1,7,7,12,5,8,19,"1-7","Y","Y","Y",7,0,6
"3338","I1",2023-09-30,"Lecce","Napoli",0,4,"A",0,1,"A",4.84,3.9,1.76,"0-1","0-4",9,4,15,6,3,2,0,0,3,7,11,11,4,10,22,"3-7","Y","Y","Y",5,0,7
"3339","I1",2023-09-30,"Milan","Lazio",2,0,"H",0,0,"D",1.78,3.72,5.04,"0-0","2-0",14,7,13,4,3,2,0,0,7,1,15,5,2,8,20,"7-1","Y","N","N",5,0,7
"3340","I1",2023-09-30,"Salernitana","Inter",0,4,"A",0,0,"D",8.16,4.81,1.43,"0-0","0-4",12,3,16,6,2,1,0,0,3,3,12,10,4,6,22,"3-3","Y","Y","Y",3,0,7
"3341","I1",2023-10-01,"Bologna","Empoli",3,0,"H",1,0,"H",1.66,3.97,5.17,"1-0","3-0",21,9,12,4,2,4,0,0,2,6,11,16,3,8,27,"2-6","Y","Y","N",6,0,7
"3342","I1",2023-10-01,"Udinese","Genoa",2,2,"D",1,2,"A",2.38,3.07,3.35,"1-2","2-2",11,2,8,4,2,2,1,0,5,0,12,12,4,5,24,"5-0","Y","Y","Y",4,1,7
"3343","I1",2023-10-01,"Atalanta","Juventus",0,0,"D",0,0,"D",2.53,3.48,2.77,"0-0","0-0",15,2,5,3,1,2,0,0,5,2,13,7,0,7,20,"5-2","N","N","N",3,0,7
"3344","I1",2023-10-01,"Roma","Frosinone",2,0,"H",1,0,"H",1.45,4.36,7.55,"1-0","2-0",11,5,8,0,1,2,0,0,7,3,12,11,2,10,23,"7-3","Y","N","N",3,0,7
"3345","I1",2023-10-02,"Sassuolo","Monza",0,1,"A",0,0,"D",2.16,3.87,3.04,"0-0","0-1",19,7,13,4,0,0,0,0,7,4,8,10,1,11,18,"7-4","N","N","N",0,0,7
"3346","I1",2023-10-02,"Torino","Verona",0,0,"D",0,0,"D",1.83,3.37,4.73,"0-0","0-0",8,2,5,2,1,1,0,0,10,1,6,11,0,11,17,"10-1","N","N","N",2,0,7
"3347","I1",2023-10-02,"Fiorentina","Cagliari",3,0,"H",2,0,"H",1.48,4.17,6.98,"2-0","3-0",14,2,6,4,1,1,0,0,4,2,10,10,3,6,20,"4-2","Y","Y","N",2,0,7
"3348","I1",2023-10-06,"Empoli","Udinese",0,0,"D",0,0,"D",3.24,3.31,2.43,"0-0","0-0",18,3,11,1,1,2,0,0,5,7,11,15,0,12,26,"5-7","N","N","N",3,0,8
"3349","I1",2023-10-06,"Lecce","Sassuolo",1,1,"D",0,1,"A",2.6,3.56,2.8,"0-1","1-1",13,4,14,1,2,3,0,0,5,3,9,15,2,8,24,"5-3","Y","N","N",5,0,8
"3350","I1",2023-10-07,"Inter","Bologna",2,2,"D",2,1,"H",1.4,5.17,8.08,"2-1","2-2",14,5,8,3,2,3,0,0,7,7,11,9,4,14,20,"7-7","Y","Y","Y",5,0,8
"3351","I1",2023-10-07,"Juventus","Torino",2,0,"H",0,0,"D",1.94,3.39,4.58,"0-0","2-0",17,6,10,1,1,1,0,0,7,3,10,8,2,10,18,"7-3","Y","N","N",2,0,8
"3352","I1",2023-10-07,"Genoa","Milan",0,1,"A",0,0,"D",4.24,3.57,1.95,"0-0","0-1",7,1,12,3,3,5,1,1,3,2,10,13,1,5,23,"3-2","N","N","N",8,2,8
"3353","I1",2023-10-08,"Monza","Salernitana",3,0,"H",2,0,"H",1.68,3.97,5.48,"2-0","3-0",16,7,8,5,1,2,0,0,7,7,8,16,3,14,24,"7-7","Y","Y","N",3,0,8
"3354","I1",2023-10-08,"Frosinone","Verona",2,1,"H",1,0,"H",2.45,3.22,3.23,"1-0","2-1",11,2,16,4,1,4,0,0,2,4,9,12,3,6,21,"2-4","Y","Y","N",5,0,8
"3355","I1",2023-10-08,"Lazio","Atalanta",3,2,"H",2,1,"H",2.93,3.26,2.63,"2-1","3-2",12,4,12,4,1,1,0,0,4,6,7,10,5,10,17,"4-6","Y","Y","Y",2,0,8
"3356","I1",2023-10-08,"Cagliari","Roma",1,4,"A",0,2,"A",4.96,3.46,1.85,"0-2","1-4",16,2,11,5,2,3,0,0,4,3,15,13,5,7,28,"4-3","Y","Y","Y",5,0,8
"3357","I1",2023-10-08,"Napoli","Fiorentina",1,3,"A",1,1,"D",1.62,4.26,5.6,"1-1","1-3",16,4,12,3,2,4,0,0,6,4,4,14,4,10,18,"6-4","Y","Y","Y",6,0,8
"3358","I1",2023-10-21,"Verona","Napoli",1,3,"A",0,2,"A",5.71,3.96,1.66,"0-2","1-3",15,9,22,10,3,2,0,0,5,8,12,9,4,13,21,"5-8","Y","Y","Y",5,0,9
"3359","I1",2023-10-21,"Torino","Inter",0,3,"A",0,0,"D",5.39,3.72,1.74,"0-0","0-3",7,3,14,4,1,2,0,0,2,4,13,8,3,6,21,"2-4","Y","Y","N",3,0,9
"3360","I1",2023-10-21,"Sassuolo","Lazio",0,2,"A",0,2,"A",2.71,3.72,2.57,"0-2","0-2",9,2,18,6,1,5,0,0,5,7,6,10,2,12,16,"5-7","Y","N","N",6,0,9
"3361","I1",2023-10-22,"Roma","Monza",1,0,"H",0,0,"D",1.74,3.87,5.08,"0-0","1-0",21,4,11,4,2,4,0,1,8,5,11,11,1,13,22,"8-5","N","N","N",6,1,9
"3362","I1",2023-10-22,"Bologna","Frosinone",2,1,"H",2,0,"H",1.76,3.86,4.95,"2-0","2-1",12,6,12,5,2,2,0,1,4,5,10,14,3,9,24,"4-5","Y","Y","N",4,1,9
"3363","I1",2023-10-22,"Salernitana","Cagliari",2,2,"D",0,0,"D",2.35,3.18,3.46,"0-0","2-2",13,2,13,6,3,4,0,0,8,5,11,12,4,13,23,"8-5","Y","Y","Y",7,0,9
"3364","I1",2023-10-22,"Atalanta","Genoa",2,0,"H",0,0,"D",1.56,4.19,6.61,"0-0","2-0",13,8,15,4,4,2,0,0,8,4,17,9,2,12,26,"8-4","Y","N","N",6,0,9
"3365","I1",2023-10-22,"Milan","Juventus",0,1,"A",0,0,"D",2.32,3.29,3.42,"0-0","0-1",7,1,14,4,1,4,1,0,6,3,12,16,1,9,28,"6-3","N","N","N",5,1,9
"3366","I1",2023-10-23,"Udinese","Lecce",1,1,"D",0,0,"D",2.21,3.19,3.81,"0-0","1-1",12,6,12,1,3,5,0,0,2,7,11,15,2,9,26,"2-7","Y","N","N",8,0,9
"3367","I1",2023-10-23,"Fiorentina","Empoli",0,2,"A",0,1,"A",1.43,4.89,7.67,"0-1","0-2",19,7,7,3,1,3,0,0,13,3,13,17,2,16,30,"13-3","Y","N","N",4,0,9
"3368","I1",2023-10-27,"Genoa","Salernitana",1,0,"H",1,0,"H",1.76,3.72,5.17,"1-0","1-0",8,4,7,2,3,4,0,0,7,0,11,19,1,7,30,"7-0","N","N","N",7,0,10
"3369","I1",2023-10-28,"Sassuolo","Bologna",1,1,"D",1,1,"D",2.76,3.41,2.69,"1-1","1-1",17,6,9,5,1,4,0,0,6,2,11,10,2,8,21,"6-2","Y","N","N",5,0,10
"3370","I1",2023-10-28,"Lecce","Torino",0,1,"A",0,1,"A",2.8,3.03,2.94,"0-1","0-1",11,6,10,2,3,5,0,0,3,0,17,19,1,3,36,"3-0","N","N","N",8,0,10
"3371","I1",2023-10-28,"Juventus","Verona",1,0,"H",0,0,"D",1.36,5.17,9.54,"0-0","1-0",30,6,7,1,3,2,0,0,5,1,13,8,1,6,21,"5-1","N","N","N",5,0,10
"3372","I1",2023-10-29,"Cagliari","Frosinone",4,3,"H",0,2,"A",2.37,3.42,3.2,"0-2","4-3",24,6,10,6,1,4,0,0,5,7,8,7,7,12,15,"5-7","Y","Y","Y",5,0,10
"3373","I1",2023-10-29,"Monza","Udinese",1,1,"D",1,0,"H",2.14,3.54,3.58,"1-0","1-1",10,4,10,3,2,1,0,0,10,3,15,11,2,13,26,"10-3","Y","N","N",3,0,10
"3374","I1",2023-10-29,"Inter","Roma",1,0,"H",0,0,"D",1.65,4,5.78,"0-0","1-0",19,3,3,1,3,4,0,0,8,0,14,9,1,8,23,"8-0","N","N","N",7,0,10
"3375","I1",2023-10-29,"Napoli","Milan",2,2,"D",0,2,"A",2.3,3.37,3.38,"0-2","2-2",17,4,20,6,4,3,1,0,6,4,14,10,4,10,24,"6-4","Y","Y","Y",7,1,10
"3376","I1",2023-10-30,"Empoli","Atalanta",0,3,"A",0,2,"A",5.03,4.08,1.7,"0-2","0-3",9,2,18,6,4,0,0,0,3,6,10,13,3,9,23,"3-6","Y","Y","N",4,0,10
"3377","I1",2023-10-30,"Lazio","Fiorentina",1,0,"H",0,0,"D",2.31,3.48,3.24,"0-0","1-0",11,4,9,5,3,3,0,0,0,4,12,17,1,4,29,"0-4","N","N","N",6,0,10
"3378","I1",2023-11-03,"Bologna","Lazio",1,0,"H",0,0,"D",2.76,3.17,2.86,"0-0","1-0",6,2,11,1,2,5,0,0,2,6,12,8,1,8,20,"2-6","N","N","N",7,0,11
"3379","I1",2023-11-04,"Salernitana","Napoli",0,2,"A",0,1,"A",7.02,4.99,1.44,"0-1","0-2",10,3,21,8,1,1,0,0,8,9,15,10,2,17,25,"8-9","Y","N","N",2,0,11
"3380","I1",2023-11-04,"Atalanta","Inter",1,2,"A",0,1,"A",3.46,3.47,2.19,"0-1","1-2",14,4,10,4,4,1,1,0,6,1,13,9,3,7,22,"6-1","Y","Y","N",5,1,11
"3381","I1",2023-11-04,"Milan","Udinese",0,1,"A",0,0,"D",1.46,4.66,7.3,"0-0","0-1",14,5,12,2,1,2,0,0,11,5,13,14,1,16,27,"11-5","N","N","N",3,0,11
"3382","I1",2023-11-05,"Verona","Monza",1,3,"A",0,1,"A",3.22,3.29,2.39,"0-1","1-3",16,5,12,6,1,2,0,0,2,6,6,12,4,8,18,"2-6","Y","Y","Y",3,0,11
"3383","I1",2023-11-05,"Cagliari","Genoa",2,1,"H",0,0,"D",2.8,3.18,2.77,"0-0","2-1",12,4,8,2,4,2,0,0,1,1,14,11,3,2,25,"1-1","Y","Y","N",6,0,11
"3384","I1",2023-11-05,"Roma","Lecce",2,1,"H",0,0,"D",1.57,3.99,6.63,"0-0","2-1",15,5,15,4,3,5,0,0,5,2,18,11,3,7,29,"5-2","Y","Y","N",8,0,11
"3385","I1",2023-11-05,"Fiorentina","Juventus",0,1,"A",0,1,"A",2.92,3.3,2.58,"0-1","0-1",25,4,4,3,1,3,0,0,9,2,12,21,1,11,33,"9-2","N","N","N",4,0,11
"3386","I1",2023-11-06,"Frosinone","Empoli",2,1,"H",0,0,"D",2.13,3.58,3.52,"0-0","2-1",17,5,10,2,3,2,0,0,9,2,7,9,3,11,16,"9-2","Y","Y","N",5,0,11
"3387","I1",2023-11-06,"Torino","Sassuolo",2,1,"H",1,1,"D",2.19,3.39,3.54,"1-1","2-1",21,9,5,2,1,1,0,0,9,2,9,6,3,11,15,"9-2","Y","Y","N",2,0,11
"3388","I1",2023-11-10,"Sassuolo","Salernitana",2,2,"D",1,2,"A",1.7,4.17,4.92,"1-2","2-2",29,9,9,2,2,1,0,0,11,0,12,14,4,11,26,"11-0","Y","Y","Y",3,0,12
"3389","I1",2023-11-10,"Genoa","Verona",1,0,"H",1,0,"H",1.93,3.32,4.74,"1-0","1-0",16,6,7,1,1,4,0,0,6,7,9,16,1,13,25,"6-7","N","N","N",5,0,12
"3390","I1",2023-11-11,"Lecce","Milan",2,2,"D",0,2,"A",5.21,3.74,1.74,"0-2","2-2",14,5,10,6,4,6,0,1,3,1,12,16,4,4,28,"3-1","Y","Y","Y",10,1,12
"3391","I1",2023-11-11,"Juventus","Cagliari",2,1,"H",0,0,"D",1.38,5.01,8.82,"0-0","2-1",18,4,11,2,3,1,0,0,12,4,14,8,3,16,22,"12-4","Y","Y","N",4,0,12
"3392","I1",2023-11-11,"Monza","Torino",1,1,"D",0,0,"D",2.51,3.17,3.13,"0-0","1-1",12,5,12,5,2,2,0,0,3,1,11,11,2,4,22,"3-1","Y","N","N",4,0,12
"3393","I1",2023-11-12,"Napoli","Empoli",0,1,"A",0,0,"D",1.22,7.07,11.78,"0-0","0-1",18,7,8,3,1,1,0,0,8,3,11,13,1,11,24,"8-3","N","N","N",2,0,12
"3394","I1",2023-11-12,"Fiorentina","Bologna",2,1,"H",1,1,"D",2.09,3.51,3.69,"1-1","2-1",12,4,11,4,2,2,0,0,0,3,19,15,3,3,34,"0-3","Y","Y","N",4,0,12
"3395","I1",2023-11-12,"Udinese","Atalanta",1,1,"D",1,0,"H",3.8,3.53,2.05,"1-0","1-1",13,4,8,2,2,3,0,0,7,7,13,13,2,14,26,"7-7","Y","N","N",5,0,12
"3396","I1",2023-11-12,"Lazio","Roma",0,0,"D",0,0,"D",3,3.16,2.61,"0-0","0-0",7,2,8,1,3,4,0,0,4,1,12,13,0,5,25,"4-1","N","N","N",7,0,12
"3397","I1",2023-11-12,"Inter","Frosinone",2,0,"H",1,0,"H",1.19,7.86,13.84,"1-0","2-0",21,6,12,3,0,1,0,0,9,4,7,16,2,13,23,"9-4","Y","N","N",1,0,12
"3398","I1",2023-11-25,"Salernitana","Lazio",2,1,"H",0,1,"A",4.82,3.69,1.79,"0-1","2-1",13,6,13,2,5,3,0,0,4,9,11,12,3,13,23,"4-9","Y","Y","N",8,0,13
"3399","I1",2023-11-25,"Atalanta","Napoli",1,2,"A",0,1,"A",2.72,3.42,2.68,"0-1","1-2",16,5,11,4,2,2,0,0,5,4,15,9,3,9,24,"5-4","Y","Y","N",4,0,13
"3400","I1",2023-11-25,"Milan","Fiorentina",1,0,"H",1,0,"H",2.15,3.46,3.59,"1-0","1-0",9,6,20,4,1,2,0,0,3,11,9,10,1,14,19,"3-11","N","N","N",3,0,13
"3401","I1",2023-11-26,"Cagliari","Monza",1,1,"D",1,0,"H",2.9,3.25,2.63,"1-0","1-1",17,6,12,4,1,2,0,0,10,11,10,15,2,21,25,"10-11","Y","N","N",3,0,13
"3402","I1",2023-11-26,"Empoli","Sassuolo",3,4,"A",2,2,"D",2.8,3.6,2.51,"2-2","3-4",11,9,17,9,4,2,0,0,6,5,20,15,7,11,35,"6-5","Y","Y","Y",6,0,13
"3403","I1",2023-11-26,"Frosinone","Genoa",2,1,"H",1,1,"D",2.52,3.2,3.09,"1-1","2-1",9,5,13,3,2,4,0,0,4,2,5,14,3,6,19,"4-2","Y","Y","N",6,0,13
"3404","I1",2023-11-26,"Roma","Udinese",3,1,"H",1,0,"H",1.63,3.89,5.99,"1-0","3-1",12,5,6,2,1,3,0,0,7,1,8,15,4,8,23,"7-1","Y","Y","Y",4,0,13
"3405","I1",2023-11-26,"Juventus","Inter",1,1,"D",1,1,"D",3.5,3.21,2.29,"1-1","1-1",4,1,8,4,2,1,0,0,1,0,12,13,2,1,25,"1-0","Y","N","N",3,0,13
"3406","I1",2023-11-27,"Verona","Lecce",2,2,"D",1,1,"D",2.76,3,2.97,"1-1","2-2",19,11,14,5,1,2,0,0,4,2,15,17,4,6,32,"4-2","Y","Y","Y",3,0,13
"3407","I1",2023-11-27,"Bologna","Torino",2,0,"H",0,0,"D",2.39,3.16,3.34,"0-0","2-0",13,2,9,3,3,4,0,0,3,2,16,15,2,5,31,"3-2","Y","N","N",7,0,13
"3408","I1",2023-12-01,"Monza","Juventus",1,2,"A",0,1,"A",4.12,3.42,2.03,"0-1","1-2",16,1,18,7,1,2,0,0,7,3,12,8,3,10,20,"7-3","Y","Y","N",3,0,14
"3409","I1",2023-12-02,"Genoa","Empoli",1,1,"D",1,0,"H",1.98,3.37,4.28,"1-0","1-1",21,1,9,1,3,1,0,0,5,3,15,19,2,8,34,"5-3","Y","N","N",4,0,14
"3410","I1",2023-12-02,"Lazio","Cagliari",1,0,"H",1,0,"H",1.65,4.02,5.56,"1-0","1-0",10,5,9,2,0,2,0,1,4,3,11,12,1,7,23,"4-3","N","N","N",2,1,14
"3411","I1",2023-12-02,"Milan","Frosinone",3,1,"H",1,0,"H",1.45,4.85,6.94,"1-0","3-1",10,3,15,3,1,1,0,0,6,7,11,6,4,13,17,"6-7","Y","Y","Y",2,0,14
"3412","I1",2023-12-03,"Lecce","Bologna",1,1,"D",0,0,"D",3.16,3.09,2.55,"0-0","1-1",14,4,11,4,3,2,0,0,6,3,12,18,2,9,30,"6-3","Y","N","N",5,0,14
"3413","I1",2023-12-03,"Fiorentina","Salernitana",3,0,"H",2,0,"H",1.45,4.79,7.14,"2-0","3-0",22,9,11,1,1,0,0,0,3,2,13,12,3,5,25,"3-2","Y","Y","N",1,0,14
"3414","I1",2023-12-03,"Udinese","Verona",3,3,"D",2,1,"H",1.72,3.69,5.38,"2-1","3-3",12,6,13,4,2,5,0,0,5,3,16,13,6,8,29,"5-3","Y","Y","Y",7,0,14
"3415","I1",2023-12-03,"Sassuolo","Roma",1,2,"A",1,0,"H",3.91,3.75,1.95,"1-0","1-2",8,2,15,7,4,1,1,0,1,11,10,11,3,12,21,"1-11","Y","Y","N",5,1,14
"3416","I1",2023-12-03,"Napoli","Inter",0,3,"A",0,1,"A",2.95,3.51,2.44,"0-1","0-3",15,4,11,4,2,2,0,0,6,4,2,13,3,10,15,"6-4","Y","Y","N",4,0,14
"3417","I1",2023-12-04,"Torino","Atalanta",3,0,"H",1,0,"H",3.14,3.18,2.5,"1-0","3-0",9,5,10,4,2,2,0,0,4,3,12,14,3,7,26,"4-3","Y","Y","N",4,0,14
"3418","I1",2023-12-08,"Juventus","Napoli",1,0,"H",0,0,"D",2.31,3.32,3.4,"0-0","1-0",11,2,13,1,2,4,0,0,3,6,11,12,1,9,23,"3-6","N","N","N",6,0,15
"3419","I1",2023-12-09,"Verona","Lazio",1,1,"D",0,1,"A",4.04,3.45,2.01,"0-1","1-1",5,1,14,5,2,4,1,0,1,7,16,11,2,8,27,"1-7","Y","N","N",6,1,15
"3420","I1",2023-12-09,"Atalanta","Milan",3,2,"H",1,1,"D",2.61,3.29,2.89,"1-1","3-2",19,7,14,4,1,5,0,1,6,4,11,11,5,10,22,"6-4","Y","Y","Y",6,1,15
"3421","I1",2023-12-09,"Inter","Udinese",4,0,"H",3,0,"H",1.27,6.14,10.46,"3-0","4-0",17,8,11,1,0,1,0,0,6,1,9,6,4,7,15,"6-1","Y","Y","Y",1,0,15
"3422","I1",2023-12-10,"Frosinone","Torino",0,0,"D",0,0,"D",3.53,3.29,2.24,"0-0","0-0",11,5,16,3,3,3,0,0,3,8,13,17,0,11,30,"3-8","N","N","N",6,0,15
"3423","I1",2023-12-10,"Monza","Genoa",1,0,"H",0,0,"D",2.21,3.2,3.72,"0-0","1-0",6,3,16,1,1,2,0,0,2,3,11,13,1,5,24,"2-3","N","N","N",3,0,15
"3424","I1",2023-12-10,"Salernitana","Bologna",1,2,"A",0,2,"A",3.87,3.29,2.12,"0-2","1-2",9,2,10,5,7,2,0,0,5,1,20,15,3,6,35,"5-1","Y","Y","N",9,0,15
"3425","I1",2023-12-10,"Roma","Fiorentina",1,1,"D",1,0,"H",2.16,3.33,3.71,"1-0","1-1",4,1,14,8,5,3,2,1,1,6,14,14,2,7,28,"1-6","Y","N","N",8,3,15
"3426","I1",2023-12-11,"Empoli","Lecce",1,1,"D",0,0,"D",2.57,3.26,2.97,"0-0","1-1",18,6,14,5,2,2,0,0,8,3,14,18,2,11,32,"8-3","Y","N","N",4,0,15
"3427","I1",2023-12-11,"Cagliari","Sassuolo",2,1,"H",0,1,"A",2.35,3.56,3.06,"0-1","2-1",18,6,8,4,1,7,0,1,10,4,15,15,3,14,30,"10-4","Y","Y","N",8,1,15
"3428","I1",2023-12-15,"Genoa","Juventus",1,1,"D",0,1,"A",4.97,3.23,1.93,"0-1","1-1",11,3,11,4,2,3,0,0,6,8,14,12,2,14,26,"6-8","Y","N","N",5,0,16
"3429","I1",2023-12-16,"Lecce","Frosinone",2,1,"H",1,1,"D",2.18,3.39,3.56,"1-1","2-1",18,6,11,5,1,4,0,0,5,4,8,14,3,9,22,"5-4","Y","Y","N",5,0,16
"3430","I1",2023-12-16,"Napoli","Cagliari",2,1,"H",0,0,"D",1.33,5.63,9.17,"0-0","2-1",21,5,9,3,5,3,0,0,5,3,9,10,3,8,19,"5-3","Y","Y","N",8,0,16
"3431","I1",2023-12-16,"Torino","Empoli",1,0,"H",1,0,"H",1.61,3.96,6.07,"1-0","1-0",10,3,7,2,4,2,0,0,6,4,15,10,1,10,25,"6-4","N","N","N",6,0,16
"3432","I1",2023-12-17,"Milan","Monza",3,0,"H",2,0,"H",1.63,4.18,5.41,"2-0","3-0",17,9,21,4,1,2,0,0,4,5,8,8,3,9,16,"4-5","Y","Y","N",3,0,16
"3433","I1",2023-12-17,"Fiorentina","Verona",1,0,"H",0,0,"D",1.43,4.83,7.67,"0-0","1-0",5,3,19,7,3,1,0,0,1,6,11,12,1,7,23,"1-6","N","N","N",4,0,16
"3434","I1",2023-12-17,"Udinese","Sassuolo",2,2,"D",1,0,"H",2.27,3.6,3.17,"1-0","2-2",9,7,21,7,3,1,1,0,1,13,13,6,4,14,19,"1-13","Y","Y","Y",4,1,16
"3435","I1",2023-12-17,"Bologna","Roma",2,0,"H",1,0,"H",2.46,3.05,3.35,"1-0","2-0",8,2,8,3,4,4,0,0,0,4,16,16,2,4,32,"0-4","Y","N","N",8,0,16
"3436","I1",2023-12-17,"Lazio","Inter",0,2,"A",0,1,"A",4.91,3.73,1.78,"0-1","0-2",13,4,12,4,1,2,1,0,8,7,13,15,2,15,28,"8-7","Y","N","N",3,1,16
"3437","I1",2023-12-18,"Atalanta","Salernitana",4,1,"H",0,1,"A",1.3,5.82,9.99,"0-1","4-1",20,11,10,3,1,2,0,0,10,7,9,11,5,17,20,"10-7","Y","Y","Y",3,0,16
"3438","I1",2023-12-22,"Empoli","Lazio",0,2,"A",0,1,"A",4.27,3.46,1.98,"0-1","0-2",21,7,14,7,3,2,0,0,8,9,6,17,2,17,23,"8-9","Y","N","N",5,0,17
"3439","I1",2023-12-22,"Sassuolo","Genoa",1,2,"A",1,0,"H",2.3,3.44,3.3,"1-0","1-2",12,3,14,5,2,1,0,0,3,6,11,9,3,9,20,"3-6","Y","Y","N",3,0,17
"3440","I1",2023-12-22,"Monza","Fiorentina",0,1,"A",0,1,"A",2.96,3.26,2.61,"0-1","0-1",7,2,14,5,3,4,0,0,1,4,12,16,1,5,28,"1-4","N","N","N",7,0,17
"3441","I1",2023-12-22,"Salernitana","Milan",2,2,"D",1,1,"D",7.4,4.98,1.44,"1-1","2-2",19,7,21,9,3,1,1,0,6,6,16,11,4,12,27,"6-6","Y","Y","Y",4,1,17
"3442","I1",2023-12-23,"Frosinone","Juventus",1,2,"A",0,1,"A",5.87,3.76,1.67,"0-1","1-2",10,3,13,3,0,2,0,0,8,8,6,12,3,16,18,"8-8","Y","Y","N",2,0,17
"3443","I1",2023-12-23,"Bologna","Atalanta",1,0,"H",0,0,"D",2.78,3.1,2.85,"0-0","1-0",9,1,12,2,2,4,0,0,2,3,10,14,1,5,24,"2-3","N","N","N",6,0,17
"3444","I1",2023-12-23,"Torino","Udinese",1,1,"D",0,0,"D",1.78,3.57,5.16,"0-0","1-1",14,4,10,4,2,2,0,0,8,2,10,11,2,10,21,"8-2","Y","N","N",4,0,17
"3445","I1",2023-12-23,"Inter","Lecce",2,0,"H",1,0,"H",1.23,6.54,12.85,"1-0","2-0",20,8,11,5,1,3,0,1,16,2,8,14,2,18,22,"16-2","Y","N","N",4,1,17
"3446","I1",2023-12-23,"Verona","Cagliari",2,0,"H",0,0,"D",2.4,3.29,3.2,"0-0","2-0",13,5,12,3,3,4,0,1,11,7,8,19,2,18,27,"11-7","Y","N","N",7,1,17
"3447","I1",2023-12-23,"Roma","Napoli",2,0,"H",0,0,"D",3.05,3.17,2.57,"0-0","2-0",17,4,7,2,7,4,0,2,4,0,19,12,2,4,31,"4-0","Y","N","N",11,2,17
"3448","I1",2023-12-29,"Fiorentina","Torino",1,0,"H",0,0,"D",2.19,3.22,3.74,"0-0","1-0",12,3,6,3,4,2,0,0,4,2,11,15,1,6,26,"4-2","N","N","N",6,0,18
"3449","I1",2023-12-29,"Napoli","Monza",0,0,"D",0,0,"D",1.62,4.18,5.52,"0-0","0-0",25,9,8,3,4,4,0,0,10,1,10,21,0,11,31,"10-1","N","N","N",8,0,18
"3450","I1",2023-12-29,"Genoa","Inter",1,1,"D",1,1,"D",5.92,3.67,1.68,"1-1","1-1",13,4,16,6,2,2,0,0,8,2,13,15,2,10,28,"8-2","Y","N","N",4,0,18
"3451","I1",2023-12-29,"Lazio","Frosinone",3,1,"H",0,0,"D",1.67,3.93,5.5,"0-0","3-1",13,5,11,2,3,2,0,0,6,2,18,15,4,8,33,"6-2","Y","Y","Y",5,0,18
"3452","I1",2023-12-30,"Atalanta","Lecce",1,0,"H",0,0,"D",1.44,4.61,7.93,"0-0","1-0",17,4,15,2,2,2,0,0,5,6,10,16,1,11,26,"5-6","N","N","N",4,0,18
"3453","I1",2023-12-30,"Cagliari","Empoli",0,0,"D",0,0,"D",2.09,3.49,3.7,"0-0","0-0",15,3,5,1,1,3,0,0,8,6,18,18,0,14,36,"8-6","N","N","N",4,0,18
"3454","I1",2023-12-30,"Udinese","Bologna",3,0,"H",1,0,"H",3.64,3.12,2.28,"1-0","3-0",15,7,14,5,2,5,0,0,7,7,15,14,3,14,29,"7-7","Y","Y","N",7,0,18
"3455","I1",2023-12-30,"Milan","Sassuolo",1,0,"H",0,0,"D",1.45,4.99,6.64,"0-0","1-0",20,2,12,6,0,1,0,0,6,5,8,7,1,11,15,"6-5","N","N","N",1,0,18
"3456","I1",2023-12-30,"Verona","Salernitana",0,1,"A",0,0,"D",1.96,3.47,4.22,"0-0","0-1",11,0,9,3,2,2,0,0,7,6,14,13,1,13,27,"7-6","N","N","N",4,0,18
"3457","I1",2023-12-30,"Juventus","Roma",1,0,"H",0,0,"D",2.12,3.1,4.18,"0-0","1-0",13,4,11,2,1,1,0,0,2,2,15,14,1,4,29,"2-2","N","N","N",2,0,18
"3458","I1",2024-01-05,"Bologna","Genoa",1,1,"D",0,1,"A",2.09,3.09,4.29,"0-1","1-1",21,8,3,1,3,3,0,0,11,2,8,10,2,13,18,"11-2","Y","N","N",6,0,19
"3459","I1",2024-01-06,"Inter","Verona",2,1,"H",1,0,"H",1.17,7.94,16.21,"1-0","2-1",15,6,8,3,0,2,0,1,7,0,16,15,3,7,31,"7-0","Y","Y","N",2,1,19
"3460","I1",2024-01-06,"Frosinone","Monza",2,3,"A",0,2,"A",2.71,3.36,2.73,"0-2","2-3",10,5,7,2,3,5,0,0,5,1,11,16,5,6,27,"5-1","Y","Y","Y",8,0,19
"3461","I1",2024-01-06,"Lecce","Cagliari",1,1,"D",1,0,"H",2.24,3.31,3.51,"1-0","1-1",15,2,14,2,1,1,0,0,7,6,20,14,2,13,34,"7-6","Y","N","N",2,0,19
"3462","I1",2024-01-06,"Sassuolo","Fiorentina",1,0,"H",1,0,"H",3.37,3.49,2.22,"1-0","1-0",7,1,9,3,3,2,0,0,1,8,10,14,1,9,24,"1-8","N","N","N",5,0,19
"3463","I1",2024-01-07,"Empoli","Milan",0,3,"A",0,2,"A",5.3,4.13,1.65,"0-2","0-3",17,2,13,6,1,2,0,0,6,6,9,13,3,12,22,"6-6","Y","Y","N",3,0,19
"3464","I1",2024-01-07,"Torino","Napoli",3,0,"H",1,0,"H",2.98,3.19,2.61,"1-0","3-0",10,6,10,3,0,2,0,1,2,5,7,10,3,7,17,"2-5","Y","Y","N",2,1,19
"3465","I1",2024-01-07,"Udinese","Lazio",1,2,"A",0,1,"A",3.62,3.25,2.22,"0-1","1-2",13,2,7,2,5,3,0,0,4,4,16,22,3,8,38,"4-4","Y","Y","N",8,0,19
"3466","I1",2024-01-07,"Salernitana","Juventus",1,2,"A",1,0,"H",8.77,4.78,1.4,"1-0","1-2",8,3,18,3,3,5,1,0,2,8,9,15,3,10,24,"2-8","Y","Y","N",8,1,19
"3467","I1",2024-01-07,"Roma","Atalanta",1,1,"D",1,1,"D",2.42,3.18,3.27,"1-1","1-1",16,6,8,2,1,6,0,0,6,5,14,14,2,11,28,"6-5","Y","N","N",7,0,19
"3468","I1",2024-01-13,"Genoa","Torino",0,0,"D",0,0,"D",3.06,2.95,2.72,"0-0","0-0",11,6,6,0,3,2,0,0,8,4,11,11,0,12,22,"8-4","N","N","N",5,0,20
"3469","I1",2024-01-13,"Napoli","Salernitana",2,1,"H",1,1,"D",1.32,5.65,9.39,"1-1","2-1",20,7,6,2,3,2,0,0,8,3,15,10,3,11,25,"8-3","Y","Y","N",5,0,20
"3470","I1",2024-01-13,"Verona","Empoli",2,1,"H",1,0,"H",2.26,3.2,3.58,"1-0","2-1",12,7,14,1,4,3,1,0,5,9,20,17,3,14,37,"5-9","Y","Y","N",7,1,20
"3471","I1",2024-01-13,"Monza","Inter",1,5,"A",0,2,"A",6.57,4.57,1.5,"0-2","1-5",9,2,20,7,2,2,0,0,4,5,6,12,6,9,18,"4-5","Y","Y","Y",4,0,20
"3472","I1",2024-01-14,"Lazio","Lecce",1,0,"H",0,0,"D",1.68,3.8,5.67,"0-0","1-0",8,2,11,3,4,4,0,0,2,5,14,12,1,7,26,"2-5","N","N","N",8,0,20
"3473","I1",2024-01-14,"Cagliari","Bologna",2,1,"H",1,1,"D",3.12,3.11,2.55,"1-1","2-1",4,2,11,4,3,2,0,0,2,5,12,8,3,7,20,"2-5","Y","Y","N",5,0,20
"3474","I1",2024-01-14,"Fiorentina","Udinese",2,2,"D",0,1,"A",1.67,3.89,5.57,"0-1","2-2",10,3,12,6,1,1,0,0,4,4,14,13,4,8,27,"4-4","Y","Y","Y",2,0,20
"3475","I1",2024-01-14,"Milan","Roma",3,1,"H",1,0,"H",2.19,3.21,3.76,"1-0","3-1",17,5,12,5,2,3,0,0,2,5,12,9,4,7,21,"2-5","Y","Y","Y",5,0,20
"3476","I1",2024-01-15,"Atalanta","Frosinone",5,0,"H",3,0,"H",1.45,4.86,7.03,"3-0","5-0",21,9,8,5,0,1,0,0,8,2,11,8,5,10,19,"8-2","Y","Y","Y",1,0,20
"3477","I1",2024-01-16,"Juventus","Sassuolo",3,0,"H",2,0,"H",1.39,4.96,8.54,"2-0","3-0",12,5,8,4,0,2,0,0,5,2,9,9,3,7,18,"5-2","Y","Y","N",2,0,20
"3478","I1",2024-01-20,"Roma","Verona",2,1,"H",2,0,"H",1.46,4.34,8.03,"2-0","2-1",9,2,12,3,2,2,0,0,1,2,14,12,3,3,26,"1-2","Y","Y","N",4,0,21
"3479","I1",2024-01-20,"Udinese","Milan",2,3,"A",1,1,"D",4.19,3.71,1.9,"1-1","2-3",11,6,15,7,6,1,0,0,5,7,12,9,5,12,21,"5-7","Y","Y","Y",7,0,21
"3480","I1",2024-01-21,"Frosinone","Cagliari",3,1,"H",0,1,"A",2.38,3.5,3.05,"0-1","3-1",17,7,9,4,3,5,0,0,8,4,11,18,4,12,29,"8-4","Y","Y","Y",8,0,21
"3481","I1",2024-01-21,"Empoli","Monza",3,0,"H",2,0,"H",2.87,3.39,2.57,"2-0","3-0",9,5,15,5,1,3,0,0,1,7,15,10,3,8,25,"1-7","Y","Y","N",4,0,21
"3482","I1",2024-01-21,"Salernitana","Genoa",1,2,"A",1,1,"D",3.73,3.24,2.19,"1-1","1-2",11,2,5,5,0,5,0,0,5,5,7,15,3,10,22,"5-5","Y","Y","N",5,0,21
"3483","I1",2024-01-21,"Lecce","Juventus",0,3,"A",0,0,"D",6.23,3.69,1.65,"0-0","0-3",12,3,15,8,1,1,0,0,5,5,8,12,3,10,20,"5-5","Y","Y","N",2,0,21
"3484","I1",2024-01-26,"Cagliari","Torino",1,2,"A",0,2,"A",3.62,3.2,2.25,"0-2","1-2",25,10,16,6,2,4,0,0,8,2,12,12,3,10,24,"8-2","Y","Y","N",6,0,21
"3485","I1",2024-01-27,"Atalanta","Udinese",2,0,"H",2,0,"H",1.51,4.52,6.55,"2-0","2-0",14,11,13,5,2,1,0,0,4,4,8,11,2,8,19,"4-4","Y","N","N",3,0,21
"3486","I1",2024-01-27,"Juventus","Empoli",1,1,"D",0,0,"D",1.29,5.55,11.88,"0-0","1-1",9,3,16,5,1,1,1,0,6,7,11,6,2,13,17,"6-7","Y","N","N",2,1,21
"3487","I1",2024-01-27,"Milan","Bologna",2,2,"D",1,1,"D",1.7,3.93,5.11,"1-1","2-2",14,4,15,4,5,3,0,0,4,1,16,12,4,5,28,"4-1","Y","Y","Y",8,0,21
"3488","I1",2024-01-28,"Genoa","Lecce",2,1,"H",0,1,"A",2.1,3.13,4.2,"0-1","2-1",19,7,19,5,0,2,0,0,3,8,12,17,3,11,29,"3-8","Y","Y","N",2,0,22
"3489","I1",2024-01-28,"Monza","Sassuolo",1,0,"H",1,0,"H",2.36,3.49,3.09,"1-0","1-0",12,1,14,3,1,3,0,0,4,5,8,13,1,9,21,"4-5","N","N","N",4,0,22
"3490","I1",2024-01-28,"Verona","Frosinone",1,1,"D",1,0,"H",2.44,3.44,3.01,"1-0","1-1",15,5,11,6,2,2,0,0,1,9,17,12,2,10,29,"1-9","Y","N","N",4,0,22
"3491","I1",2024-01-28,"Lazio","Napoli",0,0,"D",0,0,"D",2.3,3.18,3.52,"0-0","0-0",10,1,5,0,3,2,0,0,4,3,11,11,0,7,22,"4-3","N","N","N",5,0,22
"3492","I1",2024-01-28,"Fiorentina","Inter",0,1,"A",0,1,"A",4.13,3.69,1.92,"0-1","0-1",14,4,8,4,2,3,0,0,7,6,6,12,1,13,18,"7-6","N","N","N",5,0,22
"3493","I1",2024-01-29,"Salernitana","Roma",1,2,"A",0,0,"D",5.79,3.91,1.64,"0-0","1-2",15,7,5,2,2,3,0,0,5,1,12,12,3,6,24,"5-1","Y","Y","N",5,0,22
"3494","I1",2024-02-02,"Lecce","Fiorentina",3,2,"H",1,0,"H",3.81,3.31,2.16,"1-0","3-2",16,8,10,3,3,3,0,0,1,3,13,14,5,4,27,"1-3","Y","Y","Y",6,0,22
"3495","I1",2024-02-03,"Empoli","Genoa",0,0,"D",0,0,"D",3.04,3.05,2.65,"0-0","0-0",15,4,10,2,2,3,0,1,6,6,11,12,0,12,23,"6-6","N","N","N",5,1,22
"3496","I1",2024-02-03,"Udinese","Monza",0,0,"D",0,0,"D",2.3,3.29,3.4,"0-0","0-0",21,6,3,2,3,2,0,0,7,4,12,13,0,11,25,"7-4","N","N","N",5,0,22
"3497","I1",2024-02-03,"Frosinone","Milan",2,3,"A",1,1,"D",4.96,4.32,1.65,"1-1","2-3",7,4,13,5,1,3,0,0,2,4,10,13,5,6,23,"2-4","Y","Y","Y",4,0,22
"3498","I1",2024-02-03,"Bologna","Sassuolo",4,2,"H",1,2,"A",1.74,3.79,5.04,"1-2","4-2",19,4,12,4,1,3,0,0,7,4,12,10,6,11,22,"7-4","Y","Y","Y",4,0,23
"3499","I1",2024-02-04,"Torino","Salernitana",0,0,"D",0,0,"D",1.52,4.22,7.02,"0-0","0-0",13,1,3,1,2,1,0,0,10,1,11,8,0,11,19,"10-1","N","N","N",3,0,23
"3500","I1",2024-02-04,"Napoli","Verona",2,1,"H",0,0,"D",1.4,4.82,8.48,"0-0","2-1",19,8,12,2,3,2,0,0,9,2,11,14,3,11,25,"9-2","Y","Y","N",5,0,23
"3501","I1",2024-02-04,"Atalanta","Lazio",3,1,"H",2,0,"H",2.12,3.32,3.83,"2-0","3-1",19,5,7,1,2,3,0,0,6,1,13,14,4,7,27,"6-1","Y","Y","Y",5,0,23
"3502","I1",2024-02-04,"Inter","Juventus",1,0,"H",1,0,"H",1.83,3.59,4.77,"1-0","1-0",15,3,12,1,2,2,0,0,6,4,8,8,1,10,16,"6-4","N","N","N",4,0,23
"3503","I1",2024-02-05,"Roma","Cagliari",4,0,"H",2,0,"H",1.48,4.54,7.13,"2-0","4-0",20,6,12,3,1,1,0,0,7,5,8,12,4,12,20,"7-5","Y","Y","Y",2,0,23
"3504","I1",2024-02-09,"Salernitana","Empoli",1,3,"A",0,1,"A",2.44,3.18,3.3,"0-1","1-3",13,4,17,3,3,2,0,0,4,8,10,17,4,12,27,"4-8","Y","Y","Y",5,0,23
"3505","I1",2024-02-10,"Cagliari","Lazio",1,3,"A",0,1,"A",3.65,3.26,2.21,"0-1","1-3",13,6,12,5,1,3,0,0,7,8,6,9,4,15,15,"7-8","Y","Y","Y",4,0,23
"3506","I1",2024-02-10,"Roma","Inter",2,4,"A",2,1,"H",4.49,3.52,1.89,"2-1","2-4",8,3,10,6,2,0,0,0,3,8,9,14,6,11,23,"3-8","Y","Y","Y",2,0,23
"3507","I1",2024-02-10,"Sassuolo","Torino",1,1,"D",1,1,"D",3.4,3.36,2.26,"1-1","1-1",11,4,13,2,1,3,0,0,5,4,12,11,2,9,23,"5-4","Y","N","N",4,0,23
"3508","I1",2024-02-11,"Fiorentina","Frosinone",5,1,"H",3,0,"H",1.54,4.46,6.13,"3-0","5-1",18,7,11,3,3,1,0,0,2,5,16,8,6,7,24,"2-5","Y","Y","Y",4,0,24
"3509","I1",2024-02-11,"Bologna","Lecce",4,0,"H",2,0,"H",1.71,3.66,5.62,"2-0","4-0",16,6,14,3,1,2,0,0,4,3,10,13,4,7,23,"4-3","Y","Y","Y",3,0,24
"3510","I1",2024-02-11,"Monza","Verona",0,0,"D",0,0,"D",2.14,3.24,3.88,"0-0","0-0",11,1,10,1,1,2,0,0,5,2,19,15,0,7,34,"5-2","N","N","N",3,0,24
"3511","I1",2024-02-11,"Genoa","Atalanta",1,4,"A",0,1,"A",3.93,3.29,2.1,"0-1","1-4",15,6,14,9,3,4,0,0,7,4,8,13,5,11,21,"7-4","Y","Y","Y",7,0,24
"3512","I1",2024-02-11,"Milan","Napoli",1,0,"H",1,0,"H",1.95,3.74,3.94,"1-0","1-0",10,6,12,2,1,1,0,0,1,2,9,12,1,3,21,"1-2","N","N","N",2,0,24
"3513","I1",2024-02-12,"Juventus","Udinese",0,1,"A",0,1,"A",1.43,4.54,8.56,"0-1","0-1",14,6,8,1,3,3,0,0,8,4,15,10,1,12,25,"8-4","N","N","N",6,0,24
"3514","I1",2024-02-14,"Bologna","Fiorentina",2,0,"H",1,0,"H",2.41,3.2,3.28,"1-0","2-0",18,7,12,3,2,3,0,0,2,3,11,8,2,5,19,"2-3","Y","N","N",5,0,24
"3515","I1",2024-02-16,"Torino","Lecce",2,0,"H",0,0,"D",1.83,3.47,5.08,"0-0","2-0",12,4,8,4,1,4,0,1,5,5,16,11,2,10,27,"5-5","Y","N","N",5,1,24
"3516","I1",2024-02-16,"Inter","Salernitana",4,0,"H",3,0,"H",1.15,9,17,"3-0","4-0",26,10,1,0,0,1,0,0,18,0,9,9,4,18,18,"18-0","Y","Y","Y",1,0,24
"3517","I1",2024-02-17,"Napoli","Genoa",1,1,"D",0,0,"D",1.64,3.84,6.02,"0-0","1-1",25,7,6,4,3,2,0,0,7,2,9,13,2,9,22,"7-2","Y","N","N",5,0,24
"3518","I1",2024-02-17,"Verona","Juventus",2,2,"D",1,1,"D",5.84,3.64,1.69,"1-1","2-2",14,9,18,4,0,0,0,0,5,4,8,10,4,9,18,"5-4","Y","Y","Y",0,0,25
"3519","I1",2024-02-17,"Atalanta","Sassuolo",3,0,"H",1,0,"H",1.36,5.58,8.03,"1-0","3-0",28,13,12,4,0,0,0,0,11,5,10,9,3,16,19,"11-5","Y","Y","N",0,0,25
"3520","I1",2024-02-18,"Lazio","Bologna",1,2,"A",1,1,"D",2.39,3.12,3.4,"1-1","1-2",12,7,11,3,2,3,0,0,8,3,5,11,3,11,16,"8-3","Y","Y","N",5,0,25
"3521","I1",2024-02-18,"Empoli","Fiorentina",1,1,"D",0,1,"A",3.65,3.38,2.16,"0-1","1-1",5,4,9,4,3,2,0,0,0,3,15,14,2,3,29,"0-3","Y","N","N",5,0,25
"3522","I1",2024-02-18,"Udinese","Cagliari",1,1,"D",1,1,"D",1.85,3.65,4.48,"1-1","1-1",17,3,5,2,3,2,0,0,3,4,14,10,2,7,24,"3-4","Y","N","N",5,0,25
"3523","I1",2024-02-18,"Frosinone","Roma",0,3,"A",0,1,"A",3.88,3.83,1.93,"0-1","0-3",25,7,13,5,0,3,0,0,10,2,10,16,3,12,26,"10-2","Y","Y","N",3,0,25
"3524","I1",2024-02-18,"Monza","Milan",4,2,"H",2,0,"H",4.63,3.78,1.8,"2-0","4-2",12,6,16,6,4,1,0,1,7,3,11,10,6,10,21,"7-3","Y","Y","Y",5,1,25
"3525","I1",2024-02-22,"Torino","Lazio",0,2,"A",0,0,"D",2.51,2.97,3.36,"0-0","0-2",24,4,7,4,3,2,0,1,7,4,11,7,2,11,18,"7-4","Y","N","N",5,1,25
"3526","I1",2024-02-23,"Bologna","Verona",2,0,"H",1,0,"H",1.59,3.9,6.83,"1-0","2-0",12,3,7,3,2,2,0,0,11,1,12,15,2,12,27,"11-1","Y","N","N",4,0,25
"3527","I1",2024-02-24,"Sassuolo","Empoli",2,3,"A",0,1,"A",2.28,3.35,3.37,"0-1","2-3",19,5,14,6,1,3,0,0,4,1,12,14,5,5,26,"4-1","Y","Y","Y",4,0,25
"3528","I1",2024-02-24,"Salernitana","Monza",0,2,"A",0,0,"D",2.99,3.27,2.55,"0-0","0-2",11,3,17,7,2,2,0,0,7,11,6,13,2,18,19,"7-11","Y","N","N",4,0,26
"3529","I1",2024-02-24,"Genoa","Udinese",2,0,"H",2,0,"H",2.38,2.92,3.69,"2-0","2-0",19,4,5,1,1,4,0,1,8,3,9,17,2,11,26,"8-3","Y","N","N",5,1,26
"3530","I1",2024-02-25,"Juventus","Frosinone",3,2,"H",2,2,"D",1.32,5.62,9.58,"2-2","3-2",22,5,7,3,2,2,0,0,8,3,12,6,5,11,18,"8-3","Y","Y","Y",4,0,26
"3531","I1",2024-02-25,"Cagliari","Napoli",1,1,"D",0,0,"D",4.31,3.73,1.87,"0-0","1-1",8,3,9,4,4,1,0,0,4,3,12,12,2,7,24,"4-3","Y","N","N",5,0,26
"3532","I1",2024-02-25,"Lecce","Inter",0,4,"A",0,1,"A",7.69,4.77,1.43,"0-1","0-4",14,2,11,7,1,2,0,0,7,10,13,6,4,17,19,"7-10","Y","Y","Y",3,0,26
"3533","I1",2024-02-25,"Milan","Atalanta",1,1,"D",1,1,"D",2.41,3.51,3.01,"1-1","1-1",20,7,8,3,1,4,0,0,5,3,12,16,2,8,28,"5-3","Y","N","N",5,0,26
"3534","I1",2024-02-26,"Roma","Torino",3,2,"H",1,1,"D",1.98,3.29,4.43,"1-1","3-2",6,3,14,6,2,2,0,0,0,4,12,16,5,4,28,"0-4","Y","Y","Y",4,0,26
"3535","I1",2024-02-26,"Fiorentina","Lazio",2,1,"H",0,1,"A",2.32,3.19,3.46,"0-1","2-1",22,7,5,1,0,2,0,0,13,2,15,12,3,15,27,"13-2","Y","Y","N",2,0,26
"3536","I1",2024-02-28,"Sassuolo","Napoli",1,6,"A",1,3,"A",4.33,4.01,1.8,"1-3","1-6",5,2,27,9,0,0,0,0,5,10,3,5,7,15,8,"5-10","Y","Y","Y",0,0,26
"3537","I1",2024-02-28,"Inter","Atalanta",4,0,"H",2,0,"H",1.63,4.14,5.47,"2-0","4-0",15,7,6,1,2,6,0,0,4,1,10,15,4,5,25,"4-1","Y","Y","Y",8,0,26
"3538","I1",2024-03-01,"Lazio","Milan",0,1,"A",0,0,"D",3.67,3.3,2.21,"0-0","0-1",11,3,14,5,5,6,3,0,2,5,17,19,1,7,36,"2-5","N","N","N",11,3,27
"3539","I1",2024-03-02,"Udinese","Salernitana",1,1,"D",1,1,"D",1.68,3.83,5.56,"1-1","1-1",18,5,17,1,6,1,1,0,5,6,13,13,2,11,26,"5-6","Y","N","N",7,1,27
"3540","I1",2024-03-02,"Monza","Roma",1,4,"A",0,2,"A",3.72,3.55,2.07,"0-2","1-4",16,5,12,6,1,4,0,0,6,3,11,18,5,9,29,"6-3","Y","Y","Y",5,0,27
"3541","I1",2024-03-02,"Torino","Fiorentina",0,0,"D",0,0,"D",2.75,3.06,2.92,"0-0","0-0",8,2,14,3,2,4,1,0,4,5,13,13,0,9,26,"4-5","N","N","N",6,1,27
"3542","I1",2024-03-03,"Verona","Sassuolo",1,0,"H",0,0,"D",2.31,3.46,3.21,"0-0","1-0",10,5,13,2,4,2,0,0,2,10,23,10,1,12,33,"2-10","N","N","N",6,0,27
"3543","I1",2024-03-03,"Empoli","Cagliari",0,1,"A",0,0,"D",2.16,3.34,3.69,"0-0","0-1",16,3,8,4,0,3,0,0,9,2,11,15,1,11,26,"9-2","N","N","N",3,0,27
"3544","I1",2024-03-03,"Frosinone","Lecce",1,1,"D",1,0,"H",2.33,3.38,3.25,"1-0","1-1",15,7,11,4,1,1,0,0,12,8,11,10,2,20,21,"12-8","Y","N","N",2,0,27
"3545","I1",2024-03-03,"Atalanta","Bologna",1,2,"A",1,0,"H",1.98,3.51,4.09,"1-0","1-2",11,2,11,6,3,2,0,0,6,2,11,12,3,8,23,"6-2","Y","Y","N",5,0,27
"3546","I1",2024-03-03,"Napoli","Juventus",2,1,"H",1,0,"H",2.43,3.14,3.3,"1-0","2-1",14,7,18,4,1,4,0,0,2,1,6,16,3,3,22,"2-1","Y","Y","N",5,0,27
"3547","I1",2024-03-04,"Inter","Genoa",2,1,"H",2,0,"H",1.27,5.96,11.92,"2-0","2-1",16,5,10,2,2,3,0,0,4,5,5,17,3,9,22,"4-5","Y","Y","N",5,0,27
"3548","I1",2024-03-08,"Napoli","Torino",1,1,"D",0,0,"D",1.78,3.65,5.14,"0-0","1-1",22,8,11,2,2,2,0,0,13,7,9,13,2,20,22,"13-7","Y","N","N",4,0,28
"3549","I1",2024-03-09,"Cagliari","Salernitana",4,2,"H",2,0,"H",1.85,3.66,4.52,"2-0","4-2",12,7,12,5,1,2,0,0,5,4,16,11,6,9,27,"5-4","Y","Y","Y",3,0,28
"3550","I1",2024-03-09,"Sassuolo","Frosinone",1,0,"H",0,0,"D",2.27,3.67,3.11,"0-0","1-0",10,4,11,1,3,1,0,0,1,2,14,9,1,3,23,"1-2","N","N","N",4,0,28
"3551","I1",2024-03-09,"Bologna","Inter",0,1,"A",0,1,"A",3.51,3.32,2.24,"0-1","0-1",19,3,5,4,2,1,0,0,7,2,17,12,1,9,29,"7-2","N","N","N",3,0,28
"3552","I1",2024-03-09,"Genoa","Monza",2,3,"A",0,2,"A",2.18,3.11,3.94,"0-2","2-3",22,6,9,5,1,1,0,0,10,1,11,10,5,11,21,"10-1","Y","Y","Y",2,0,28
"3553","I1",2024-03-10,"Lecce","Verona",0,1,"A",0,1,"A",2.34,3.09,3.55,"0-1","0-1",15,3,13,4,3,3,0,1,11,6,15,19,1,17,34,"11-6","N","N","N",6,1,28
"3554","I1",2024-03-10,"Milan","Empoli",1,0,"H",1,0,"H",1.45,4.74,7.19,"1-0","1-0",15,5,5,2,1,4,0,0,11,4,18,13,1,15,31,"11-4","N","N","N",5,0,28
"3555","I1",2024-03-10,"Juventus","Atalanta",2,2,"D",0,1,"A",2.32,3.27,3.37,"0-1","2-2",18,5,7,3,0,1,0,0,4,3,12,10,4,7,22,"4-3","Y","Y","Y",1,0,28
"3556","I1",2024-03-10,"Fiorentina","Roma",2,2,"D",1,0,"H",2.69,3.27,2.81,"1-0","2-2",15,5,10,5,2,5,0,0,8,2,10,15,4,10,25,"8-2","Y","Y","Y",7,0,28
"3557","I1",2024-03-11,"Lazio","Udinese",1,2,"A",0,0,"D",1.95,3.38,4.42,"0-0","1-2",18,6,14,5,3,6,0,1,9,5,9,15,3,14,24,"9-5","Y","Y","N",9,1,28
"3558","I1",2024-03-15,"Empoli","Bologna",0,1,"A",0,0,"D",4.04,3.28,2.08,"0-0","0-1",10,1,20,9,4,0,0,0,7,6,19,12,1,13,31,"7-6","N","N","N",4,0,29
"3559","I1",2024-03-16,"Monza","Cagliari",1,0,"H",1,0,"H",2.09,3.46,3.75,"1-0","1-0",15,3,10,0,2,1,0,0,3,7,11,9,1,10,20,"3-7","N","N","N",3,0,29
"3560","I1",2024-03-16,"Udinese","Torino",0,2,"A",0,1,"A",2.94,2.96,2.82,"0-1","0-2",12,1,12,5,3,2,0,0,3,4,11,17,2,7,28,"3-4","Y","N","N",5,0,29
"3561","I1",2024-03-16,"Salernitana","Lecce",0,1,"A",0,1,"A",3.02,3.19,2.57,"0-1","0-1",15,6,17,4,4,3,0,0,7,1,9,18,1,8,27,"7-1","N","N","N",7,0,29
"3562","I1",2024-03-16,"Frosinone","Lazio",2,3,"A",1,1,"D",3.41,3.61,2.16,"1-1","2-3",14,5,22,7,1,3,0,0,9,4,10,15,5,13,25,"9-4","Y","Y","Y",4,0,29
"3563","I1",2024-03-17,"Juventus","Genoa",0,0,"D",0,0,"D",1.52,4.08,7.37,"0-0","0-0",17,2,5,2,4,1,1,0,12,2,11,11,0,14,22,"12-2","N","N","N",5,1,29
"3564","I1",2024-03-17,"Verona","Milan",1,3,"A",0,1,"A",5.2,3.81,1.72,"0-1","1-3",15,4,18,6,1,3,0,0,3,5,9,8,4,8,17,"3-5","Y","Y","Y",4,0,29
"3565","I1",2024-03-17,"Roma","Sassuolo",1,0,"H",0,0,"D",1.4,5.15,7.67,"0-0","1-0",10,4,8,2,2,1,0,0,4,7,11,10,1,11,21,"4-7","N","N","N",3,0,29
"3566","I1",2024-03-17,"Inter","Napoli",1,1,"D",1,0,"H",1.57,4.33,5.89,"1-0","1-1",19,6,11,3,2,1,0,0,5,7,19,6,2,12,25,"5-7","Y","N","N",3,0,29
"3567","I2",2023-08-18,"Bari","Palermo",0,0,"D",0,0,"D",2.83,3.12,2.83,"0-0","0-0",11,3,16,2,7,4,2,0,3,5,13,15,0,8,28,"3-5","N","N","N",11,2,1
"3568","I2",2023-08-19,"Cosenza","Ascoli",3,0,"H",1,0,"H",2.84,2.96,2.97,"1-0","3-0",22,6,4,0,1,4,0,3,7,0,11,12,3,7,23,"7-0","Y","Y","N",5,3,1
"3569","I2",2023-08-19,"Cremonese","Catanzaro",0,0,"D",0,0,"D",1.98,3.37,4.41,"0-0","0-0",17,3,6,2,3,1,0,0,6,2,7,18,0,8,25,"6-2","N","N","N",4,0,1
"3570","I2",2023-08-19,"Ternana","Sampdoria",1,2,"A",0,1,"A",3.3,3.55,2.26,"0-1","1-2",14,3,13,6,4,1,0,0,5,4,11,10,3,9,21,"5-4","Y","Y","N",5,0,1
"3571","I2",2023-08-20,"Sudtirol","Spezia",3,3,"D",1,2,"A",3.75,3.07,2.3,"1-2","3-3",10,4,17,5,3,3,0,0,2,1,17,20,6,3,37,"2-1","Y","Y","Y",6,0,1
"3572","I2",2023-08-20,"Cittadella","Reggiana",1,0,"H",1,0,"H",2.15,3.28,3.87,"1-0","1-0",13,3,8,1,3,3,0,0,6,2,20,17,1,8,37,"6-2","N","N","N",6,0,1
"3573","I2",2023-08-20,"Parma","FeralpiSalo",2,0,"H",1,0,"H",1.54,4.06,7.38,"1-0","2-0",15,4,13,2,1,4,0,0,7,7,11,11,2,14,22,"7-7","Y","N","N",5,0,1
"3574","I2",2023-08-20,"Venezia","Como",3,0,"H",2,0,"H",2.1,3.41,3.87,"2-0","3-0",18,6,12,3,0,0,0,0,9,3,17,9,3,12,26,"9-3","Y","Y","N",0,0,1
"3575","I2",2023-08-25,"Sampdoria","Pisa",0,2,"A",0,1,"A",1.97,3.35,4.47,"0-1","0-2",12,2,8,3,1,4,0,0,5,3,16,16,2,8,32,"5-3","Y","N","N",5,0,1
"3576","I2",2023-08-26,"Venezia","Cosenza",1,1,"D",0,1,"A",1.78,3.64,5.16,"0-1","1-1",20,4,4,1,1,1,0,0,8,2,6,9,2,10,15,"8-2","Y","N","N",2,0,1
"3577","I2",2023-08-26,"Como","Reggiana",2,2,"D",1,0,"H",2.09,3.46,3.82,"1-0","2-2",10,4,12,5,3,2,0,0,3,4,18,14,4,7,32,"3-4","Y","Y","Y",5,0,2
"3578","I2",2023-08-26,"Cremonese","Bari",0,1,"A",0,1,"A",2.04,3.41,4.08,"0-1","0-1",25,5,7,1,1,3,0,0,5,4,9,10,1,9,19,"5-4","N","N","N",4,0,2
"3579","I2",2023-08-26,"FeralpiSalo","Sudtirol",0,2,"A",0,1,"A",2.71,3.07,3,"0-1","0-2",7,1,9,4,2,3,0,0,6,1,16,12,2,7,28,"6-1","Y","N","N",5,0,2
"3580","I2",2023-08-26,"Modena","Ascoli",1,0,"H",0,0,"D",1.95,3.25,4.78,"0-0","1-0",13,3,8,5,1,1,0,1,9,1,12,17,1,10,29,"9-1","N","N","N",2,1,2
"3581","I2",2023-08-26,"Parma","Cittadella",2,0,"H",1,0,"H",1.89,3.42,4.77,"1-0","2-0",10,3,19,0,1,2,0,0,2,11,16,14,2,13,30,"2-11","Y","N","N",3,0,2
"3582","I2",2023-08-27,"Catanzaro","Ternana",2,1,"H",1,1,"D",2.31,3.34,3.38,"1-1","2-1",15,5,25,7,1,2,0,0,4,7,16,9,3,11,25,"4-7","Y","Y","N",3,0,2
"3583","I2",2023-08-29,"Ascoli","FeralpiSalo",3,0,"H",2,0,"H",1.95,3.53,4.28,"2-0","3-0",19,5,5,4,0,3,0,0,7,3,12,14,3,10,26,"7-3","Y","Y","N",3,0,2
"3584","I2",2023-08-29,"Cosenza","Modena",1,2,"A",1,1,"D",2.55,3.24,3.06,"1-1","1-2",12,2,10,5,4,2,0,0,6,4,12,10,3,10,22,"6-4","Y","Y","N",6,0,2
"3585","I2",2023-08-29,"Pisa","Parma",1,2,"A",0,1,"A",2.6,2.98,3.25,"0-1","1-2",16,2,9,2,1,3,1,1,7,4,11,15,3,11,26,"7-4","Y","Y","N",4,2,2
"3586","I2",2023-08-29,"Reggiana","Palermo",1,3,"A",0,1,"A",3.22,3.29,2.42,"0-1","1-3",15,2,18,9,3,0,1,0,7,3,18,9,4,10,27,"7-3","Y","Y","Y",3,1,2
"3587","I2",2023-08-30,"Bari","Cittadella",1,1,"D",1,0,"H",2.37,3.13,3.51,"1-0","1-1",14,4,17,5,1,1,0,0,1,8,12,12,2,9,24,"1-8","Y","N","N",2,0,3
"3588","I2",2023-08-30,"Catanzaro","Spezia",3,0,"H",0,0,"D",3.09,3.4,2.44,"0-0","3-0",10,5,8,2,2,3,1,0,6,5,21,14,3,11,35,"6-5","Y","Y","N",5,1,3
"3589","I2",2023-08-30,"Sampdoria","Venezia",1,2,"A",0,0,"D",2.21,3.55,3.39,"0-0","1-2",17,5,13,5,5,0,0,0,7,4,7,10,3,11,17,"7-4","Y","Y","N",5,0,3
"3590","I2",2023-08-30,"Ternana","Cremonese",0,1,"A",0,0,"D",3.36,3.28,2.35,"0-0","0-1",10,4,17,4,2,3,0,1,8,5,10,8,1,13,18,"8-5","N","N","N",5,1,3
"3591","I2",2023-09-02,"Modena","Pisa",2,0,"H",1,0,"H",2.53,2.95,3.41,"1-0","2-0",14,4,6,2,2,2,0,1,7,7,10,13,2,14,23,"7-7","Y","N","N",4,1,3
"3592","I2",2023-09-02,"Palermo","FeralpiSalo",3,0,"H",1,0,"H",1.67,3.91,5.68,"1-0","3-0",16,6,8,0,1,1,0,0,5,6,8,14,3,11,22,"5-6","Y","Y","N",2,0,3
"3593","I2",2023-09-02,"Parma","Reggiana",0,0,"D",0,0,"D",1.7,3.77,5.59,"0-0","0-0",18,4,8,1,2,2,0,0,6,2,7,15,0,8,22,"6-2","N","N","N",4,0,3
"3594","I2",2023-09-02,"Sudtirol","Ascoli",3,1,"H",0,1,"A",2.33,2.9,3.95,"0-1","3-1",7,4,14,4,2,4,0,0,0,8,11,16,4,8,27,"0-8","Y","Y","Y",6,0,3
"3595","I2",2023-09-03,"Brescia","Cosenza",1,0,"H",0,0,"D",2.17,3.28,3.8,"0-0","1-0",7,1,13,1,4,2,0,1,5,7,18,18,1,12,36,"5-7","N","N","N",6,1,3
"3596","I2",2023-09-03,"Cremonese","Sampdoria",1,1,"D",1,0,"H",2.07,3.43,3.88,"1-0","1-1",19,11,8,4,2,4,0,0,3,2,12,14,2,5,26,"3-2","Y","N","N",6,0,3
"3597","I2",2023-09-03,"Lecco","Catanzaro",3,4,"A",0,1,"A",NA,NA,NA,"0-1","3-4",17,7,20,8,2,1,0,0,3,6,10,7,7,9,17,"3-6","Y","Y","Y",3,0,4
"3598","I2",2023-09-03,"Spezia","Como",0,1,"A",0,1,"A",1.81,3.42,5.44,"0-1","0-1",9,1,12,5,5,4,0,0,6,6,19,14,1,12,33,"6-6","N","N","N",9,0,4
"3599","I2",2023-09-03,"Ternana","Bari",0,0,"D",0,0,"D",2.76,3.1,2.92,"0-0","0-0",13,2,10,1,3,2,0,0,3,3,14,16,0,6,30,"3-3","N","N","N",5,0,4
"3600","I2",2023-09-03,"Cittadella","Venezia",0,0,"D",0,0,"D",2.57,3.15,3.12,"0-0","0-0",8,4,10,3,3,2,0,0,5,5,13,12,0,10,25,"5-5","N","N","N",5,0,4
"3601","I2",2023-09-15,"Venezia","Spezia",1,0,"H",0,0,"D",2.2,3.51,3.48,"0-0","1-0",9,3,23,7,2,3,0,0,3,5,17,15,1,8,32,"3-5","N","N","N",5,0,4
"3602","I2",2023-09-16,"Ascoli","Palermo",0,1,"A",0,0,"D",3.56,3.3,2.25,"0-0","0-1",16,1,11,4,0,2,0,0,8,10,21,7,1,18,28,"8-10","N","N","N",2,0,4
"3603","I2",2023-09-16,"Cosenza","Sudtirol",2,2,"D",1,0,"H",2.33,3.08,3.66,"1-0","2-2",12,5,6,2,4,1,0,0,5,2,10,13,4,7,23,"5-2","Y","Y","Y",5,0,4
"3604","I2",2023-09-16,"FeralpiSalo","Modena",1,1,"D",1,1,"D",3.59,3.28,2.25,"1-1","1-1",10,1,17,6,4,4,1,0,4,7,15,7,2,11,22,"4-7","Y","N","N",8,1,4
"3605","I2",2023-09-16,"Lecco","Brescia",0,2,"A",0,1,"A",2.91,3.23,2.67,"0-1","0-2",24,7,11,5,3,2,0,0,7,5,16,19,2,12,35,"7-5","Y","N","N",5,0,4
"3606","I2",2023-09-16,"Pisa","Bari",1,1,"D",1,0,"H",2.17,3.23,3.87,"1-0","1-1",7,1,10,3,4,2,1,0,3,5,10,17,2,8,27,"3-5","Y","N","N",6,1,4
"3607","I2",2023-09-16,"Reggiana","Cremonese",2,2,"D",2,0,"H",3.35,3.22,2.39,"2-0","2-2",7,5,37,8,0,1,0,0,0,14,10,5,4,14,15,"0-14","Y","Y","Y",1,0,5
"3608","I2",2023-09-17,"Catanzaro","Parma",0,5,"A",0,3,"A",2.25,3.39,3.47,"0-3","0-5",12,2,10,7,1,4,0,0,8,3,13,5,5,11,18,"8-3","Y","Y","Y",5,0,5
"3609","I2",2023-09-17,"Como","Ternana",2,1,"H",0,0,"D",2.1,3.45,3.76,"0-0","2-1",19,5,10,4,2,2,0,0,1,3,13,16,3,4,29,"1-3","Y","Y","N",4,0,5
"3610","I2",2023-09-18,"Sampdoria","Cittadella",1,2,"A",1,0,"H",2.33,3.33,3.29,"1-0","1-2",12,5,11,6,3,3,0,0,2,4,22,13,3,6,35,"2-4","Y","Y","N",6,0,5
"3611","I2",2023-09-22,"Palermo","Cosenza",0,1,"A",0,0,"D",1.77,3.6,5.36,"0-0","0-1",19,6,14,4,1,3,0,0,4,2,11,11,1,6,22,"4-2","N","N","N",4,0,5
"3612","I2",2023-09-23,"Brescia","Venezia",0,0,"D",0,0,"D",3.31,3.1,2.48,"0-0","0-0",11,3,15,0,3,2,0,0,3,8,12,7,0,11,19,"3-8","N","N","N",5,0,5
"3613","I2",2023-09-23,"Cremonese","Ascoli",2,2,"D",1,1,"D",1.7,3.82,5.54,"1-1","2-2",13,4,17,8,3,4,1,1,6,5,16,11,4,11,27,"6-5","Y","Y","Y",7,2,5
"3614","I2",2023-09-23,"FeralpiSalo","Pisa",0,1,"A",0,0,"D",3.29,3.16,2.46,"0-0","0-1",12,3,16,4,3,4,0,0,4,4,19,11,1,8,30,"4-4","N","N","N",7,0,5
"3615","I2",2023-09-23,"Modena","Lecco",0,0,"D",0,0,"D",1.6,3.86,6.89,"0-0","0-0",17,5,14,4,3,1,0,0,8,8,15,7,0,16,22,"8-8","N","N","N",4,0,5
"3616","I2",2023-09-23,"Ternana","Sudtirol",1,1,"D",1,0,"H",2.19,3.22,3.83,"1-0","1-1",10,3,10,3,3,1,0,0,5,7,10,17,2,12,27,"5-7","Y","N","N",4,0,5
"3617","I2",2023-09-23,"Spezia","Reggiana",1,2,"A",0,0,"D",1.93,3.56,4.38,"0-0","1-2",15,3,11,4,3,5,0,0,7,5,13,16,3,12,29,"7-5","Y","Y","N",8,0,6
"3618","I2",2023-09-24,"Bari","Catanzaro",2,2,"D",1,2,"A",2.45,3.14,3.32,"1-2","2-2",12,4,11,5,1,4,0,1,2,4,13,17,4,6,30,"2-4","Y","Y","Y",5,1,6
"3619","I2",2023-09-24,"Cittadella","Como",0,3,"A",0,2,"A",2.12,3.31,3.95,"0-2","0-3",12,3,9,4,1,2,0,0,5,2,21,13,3,7,34,"5-2","Y","Y","N",3,0,6
"3620","I2",2023-09-24,"Parma","Sampdoria",1,1,"D",0,1,"A",2.15,3.45,3.66,"0-1","1-1",12,7,8,3,3,5,0,0,9,1,11,15,2,10,26,"9-1","Y","N","N",8,0,6
"3621","I2",2023-09-26,"Cosenza","Cremonese",1,2,"A",0,0,"D",3.31,3.24,2.4,"0-0","1-2",9,4,20,4,2,1,0,0,4,7,9,15,3,11,24,"4-7","Y","Y","N",3,0,6
"3622","I2",2023-09-26,"Lecco","FeralpiSalo",1,2,"A",0,0,"D",2.56,3.12,3.17,"0-0","1-2",13,3,12,4,2,3,0,0,4,1,10,13,3,5,23,"4-1","Y","Y","N",5,0,6
"3623","I2",2023-09-26,"Ascoli","Ternana",2,0,"H",1,0,"H",2.4,3.22,3.34,"1-0","2-0",13,5,17,3,2,3,0,0,2,8,20,13,2,10,33,"2-8","Y","N","N",5,0,6
"3624","I2",2023-09-26,"Reggiana","Pisa",0,0,"D",0,0,"D",2.61,3.13,3.08,"0-0","0-0",13,2,12,5,4,4,0,0,3,2,16,12,0,5,28,"3-2","N","N","N",8,0,6
"3625","I2",2023-09-26,"Spezia","Brescia",0,0,"D",0,0,"D",1.84,3.68,4.65,"0-0","0-0",12,5,11,3,1,2,0,0,7,5,8,16,0,12,24,"7-5","N","N","N",3,0,6
"3626","I2",2023-09-26,"Sudtirol","Modena",0,0,"D",0,0,"D",3.11,2.83,2.83,"0-0","0-0",7,1,25,2,1,2,0,0,5,3,13,6,0,8,19,"5-3","N","N","N",3,0,6
"3627","I2",2023-09-26,"Venezia","Palermo",1,3,"A",1,1,"D",2.49,3.27,3.13,"1-1","1-3",17,1,7,4,1,2,0,0,8,1,10,10,4,9,20,"8-1","Y","Y","Y",3,0,7
"3628","I2",2023-09-27,"Catanzaro","Cittadella",1,1,"D",1,1,"D",2.34,3.13,3.54,"1-1","1-1",14,8,10,3,0,3,0,0,5,2,12,14,2,7,26,"5-2","Y","N","N",3,0,7
"3629","I2",2023-09-27,"Como","Sampdoria",1,0,"H",0,0,"D",2.43,3.4,3.1,"0-0","1-0",8,4,13,5,2,5,0,0,2,5,17,15,1,7,32,"2-5","N","N","N",7,0,7
"3630","I2",2023-09-27,"Parma","Bari",2,1,"H",1,0,"H",1.94,3.45,4.44,"1-0","2-1",12,5,14,4,1,3,0,0,5,3,16,12,3,8,28,"5-3","Y","Y","N",4,0,7
"3631","I2",2023-09-30,"Brescia","Ascoli",1,1,"D",0,1,"A",2.23,3.28,3.63,"0-1","1-1",21,3,9,3,2,3,0,0,7,2,13,11,2,9,24,"7-2","Y","N","N",5,0,7
"3632","I2",2023-09-30,"FeralpiSalo","Spezia",1,2,"A",0,2,"A",3.53,3.27,2.28,"0-2","1-2",9,3,13,5,1,6,0,0,2,5,16,17,3,7,33,"2-5","Y","Y","N",7,0,7
"3633","I2",2023-09-30,"Modena","Venezia",1,3,"A",0,0,"D",2.53,3.32,3.02,"0-0","1-3",14,4,9,4,2,2,0,0,7,3,9,5,4,10,14,"7-3","Y","Y","Y",4,0,7
"3634","I2",2023-09-30,"Pisa","Cosenza",1,2,"A",0,1,"A",1.88,3.63,4.45,"0-1","1-2",8,6,15,5,3,6,1,0,2,3,13,13,3,5,26,"2-3","Y","Y","N",9,1,7
"3635","I2",2023-09-30,"Ternana","Reggiana",3,0,"H",2,0,"H",2.17,3.37,3.7,"2-0","3-0",13,7,10,3,6,3,0,0,3,2,13,9,3,5,22,"3-2","Y","Y","N",9,0,7
"3636","I2",2023-10-01,"Bari","Como",1,1,"D",0,0,"D",2.44,3.2,3.28,"0-0","1-1",18,5,9,6,3,4,0,1,6,4,18,16,2,10,34,"6-4","Y","N","N",7,1,7
"3637","I2",2023-10-01,"Cittadella","Lecco",2,1,"H",0,1,"A",1.66,4.02,5.52,"0-1","2-1",15,5,16,6,4,4,0,0,4,5,26,10,3,9,36,"4-5","Y","Y","N",8,0,8
"3638","I2",2023-10-01,"Palermo","Sudtirol",2,1,"H",0,1,"A",1.64,3.91,5.96,"0-1","2-1",24,6,8,2,5,3,0,0,13,1,15,17,3,14,32,"13-1","Y","Y","N",8,0,8
"3639","I2",2023-10-01,"Sampdoria","Catanzaro",1,2,"A",1,2,"A",2.19,3.55,3.46,"1-2","1-2",17,6,4,3,1,4,0,0,11,2,12,23,3,13,35,"11-2","Y","Y","N",5,0,8
"3640","I2",2023-10-01,"Cremonese","Parma",1,2,"A",0,0,"D",2.19,3.4,3.61,"0-0","1-2",15,3,9,3,1,1,0,0,2,4,12,13,3,6,25,"2-4","Y","Y","N",2,0,8
"3641","I2",2023-10-06,"Brescia","FeralpiSalo",1,1,"D",0,1,"A",1.93,3.32,4.76,"0-1","1-1",19,4,16,6,2,3,0,0,2,5,13,11,2,7,24,"2-5","Y","N","N",5,0,8
"3642","I2",2023-10-07,"Cosenza","Lecco",3,0,"H",2,0,"H",1.8,3.44,5.42,"2-0","3-0",22,8,15,6,2,3,0,0,4,3,11,7,3,7,18,"4-3","Y","Y","N",5,0,8
"3643","I2",2023-10-07,"Modena","Palermo",0,2,"A",0,0,"D",2.64,3.07,3.09,"0-0","0-2",11,2,11,4,2,3,1,0,7,2,11,11,2,9,22,"7-2","Y","N","N",5,1,8
"3644","I2",2023-10-07,"Reggiana","Bari",1,1,"D",1,1,"D",2.75,3.15,2.89,"1-1","1-1",14,3,10,2,2,1,0,0,6,9,11,18,2,15,29,"6-9","Y","N","N",3,0,8
"3645","I2",2023-10-07,"Sudtirol","Catanzaro",0,1,"A",0,1,"A",2.64,2.99,3.18,"0-1","0-1",9,3,13,6,1,3,0,0,4,4,11,10,1,8,21,"4-4","N","N","N",4,0,8
"3646","I2",2023-10-07,"Ascoli","Sampdoria",1,1,"D",1,0,"H",2.64,3.24,2.95,"1-0","1-1",14,4,12,4,2,4,0,0,6,1,20,14,2,7,34,"6-1","Y","N","N",6,0,8
"3647","I2",2023-10-07,"Cittadella","Ternana",2,2,"D",2,1,"H",2.27,3.27,3.56,"2-1","2-2",12,4,17,5,2,1,0,0,3,4,10,11,4,7,21,"3-4","Y","Y","Y",3,0,9
"3648","I2",2023-10-07,"Venezia","Parma",3,2,"H",0,0,"D",2.55,3.35,2.97,"0-0","3-2",12,5,15,4,0,2,0,0,5,8,5,8,5,13,13,"5-8","Y","Y","Y",2,0,9
"3649","I2",2023-10-08,"Como","Cremonese",1,3,"A",0,2,"A",2.82,3.26,2.73,"0-2","1-3",16,5,10,3,0,3,0,1,10,6,7,12,4,16,19,"10-6","Y","Y","Y",3,1,9
"3650","I2",2023-10-08,"Spezia","Pisa",0,0,"D",0,0,"D",1.92,3.32,4.84,"0-0","0-0",20,6,10,3,3,2,1,0,6,3,11,12,0,9,23,"6-3","N","N","N",5,1,9
"3651","I2",2023-10-20,"Parma","Como",2,1,"H",1,0,"H",1.99,3.42,4.28,"1-0","2-1",14,4,18,6,2,2,0,0,3,4,11,10,3,7,21,"3-4","Y","Y","N",4,0,9
"3652","I2",2023-10-21,"Bari","Modena",1,1,"D",0,0,"D",2.3,3.19,3.58,"0-0","1-1",11,3,10,4,3,5,0,0,8,4,26,11,2,12,37,"8-4","Y","N","N",8,0,9
"3653","I2",2023-10-21,"Cremonese","Sudtirol",0,1,"A",0,0,"D",1.67,3.8,5.89,"0-0","0-1",20,6,9,4,3,2,0,0,11,8,11,8,1,19,19,"11-8","N","N","N",5,0,9
"3654","I2",2023-10-21,"Lecco","Ascoli",0,2,"A",0,1,"A",2.7,3.41,2.75,"0-1","0-2",12,4,14,5,3,2,0,0,5,2,15,14,2,7,29,"5-2","Y","N","N",5,0,9
"3655","I2",2023-10-21,"Pisa","Cittadella",2,1,"H",1,0,"H",2.29,2.94,3.28,"1-0","2-1",13,6,15,4,3,3,0,0,6,7,14,14,3,13,28,"6-7","Y","Y","N",6,0,9
"3656","I2",2023-10-21,"Ternana","Brescia",0,1,"A",0,0,"D",2.45,3.24,3.21,"0-0","0-1",9,0,14,5,3,1,1,0,4,4,7,9,1,8,16,"4-4","N","N","N",4,1,9
"3657","I2",2023-10-21,"Catanzaro","FeralpiSalo",3,0,"H",0,0,"D",1.64,4.17,5.48,"0-0","3-0",11,6,7,2,3,2,0,0,5,4,13,11,3,9,24,"5-4","Y","Y","N",5,0,10
"3658","I2",2023-10-22,"Sampdoria","Cosenza",2,0,"H",0,0,"D",2.07,3.45,3.93,"0-0","2-0",17,5,14,5,3,5,0,0,4,4,15,16,2,8,31,"4-4","Y","N","N",8,0,10
"3659","I2",2023-10-22,"Reggiana","Venezia",1,0,"H",0,0,"D",2.9,3.37,2.59,"0-0","1-0",11,2,15,5,3,5,0,1,5,9,13,15,1,14,28,"5-9","N","N","N",8,1,10
"3660","I2",2023-10-23,"Palermo","Spezia",2,2,"D",0,1,"A",2.02,3.36,3.39,"0-1","2-2",16,7,10,5,3,6,0,1,4,5,14,12,4,9,26,"4-5","Y","Y","Y",9,1,10
"3661","I2",2023-10-24,"Brescia","Modena",0,1,"A",0,0,"D",2.79,3.08,2.91,"0-0","0-1",6,0,14,3,3,3,0,0,2,7,13,20,1,9,33,"2-7","N","N","N",6,0,10
"3662","I2",2023-10-24,"Pisa","Lecco",1,2,"A",0,1,"A",1.67,3.78,5.95,"0-1","1-2",24,4,10,2,3,4,0,0,8,1,11,13,3,9,24,"8-1","Y","Y","N",7,0,10
"3663","I2",2023-10-27,"Cittadella","Cremonese",1,2,"A",0,0,"D",3.35,3.3,2.35,"0-0","1-2",8,3,20,4,4,1,0,0,4,8,15,13,3,12,28,"4-8","Y","Y","N",5,0,10
"3664","I2",2023-10-28,"Como","Catanzaro",1,0,"H",1,0,"H",2.26,3.34,3.49,"1-0","1-0",15,2,9,4,4,0,0,0,4,4,6,21,1,8,27,"4-4","N","N","N",4,0,10
"3665","I2",2023-10-28,"FeralpiSalo","Reggiana",0,3,"A",0,2,"A",2.58,3.04,3.22,"0-2","0-3",19,4,9,9,2,1,0,0,6,3,15,14,3,9,29,"6-3","Y","Y","N",3,0,10
"3666","I2",2023-10-28,"Spezia","Cosenza",0,0,"D",0,0,"D",1.96,3.49,4.32,"0-0","0-0",19,5,13,3,3,5,0,0,8,4,11,14,0,12,25,"8-4","N","N","N",8,0,10
"3667","I2",2023-10-28,"Sudtirol","Sampdoria",3,1,"H",0,0,"D",2.74,3.26,2.81,"0-0","3-1",9,3,16,4,3,3,0,0,2,9,15,14,4,11,29,"2-9","Y","Y","Y",6,0,11
"3668","I2",2023-10-28,"Ascoli","Parma",1,3,"A",1,2,"A",3.6,3.13,2.32,"1-2","1-3",13,4,9,4,7,2,1,0,9,8,12,12,4,17,24,"9-8","Y","Y","Y",9,1,11
"3669","I2",2023-10-29,"Brescia","Bari",1,2,"A",1,0,"H",2.94,3.05,2.78,"1-0","1-2",16,3,19,6,3,3,0,0,2,5,16,21,3,7,37,"2-5","Y","Y","N",6,0,11
"3670","I2",2023-10-29,"Modena","Ternana",2,1,"H",1,0,"H",2.07,3.48,3.87,"1-0","2-1",19,5,13,3,3,2,0,0,5,5,13,9,3,10,22,"5-5","Y","Y","N",5,0,11
"3671","I2",2023-10-29,"Palermo","Lecco",1,2,"A",0,2,"A",1.47,4.72,7.28,"0-2","1-2",26,9,12,7,2,2,0,0,6,5,10,15,3,11,25,"6-5","Y","Y","N",4,0,11
"3672","I2",2023-10-29,"Venezia","Pisa",2,1,"H",1,1,"D",2.18,3.27,3.78,"1-1","2-1",13,3,8,3,2,4,0,0,6,4,8,11,3,10,19,"6-4","Y","Y","N",6,0,11
"3673","I2",2023-11-04,"Bari","Ascoli",1,0,"H",0,0,"D",2.04,3.18,4.45,"0-0","1-0",18,3,7,3,3,4,0,0,10,7,15,17,1,17,32,"10-7","N","N","N",7,0,11
"3674","I2",2023-11-04,"Catanzaro","Modena",1,2,"A",1,1,"D",2.35,3.46,3.19,"1-1","1-2",10,5,9,4,2,4,0,0,2,2,27,13,3,4,40,"2-2","Y","Y","N",6,0,11
"3675","I2",2023-11-04,"Cittadella","Brescia",3,2,"H",2,1,"H",2.59,2.99,3.26,"2-1","3-2",16,5,16,4,2,3,0,0,5,4,12,14,5,9,26,"5-4","Y","Y","Y",5,0,11
"3676","I2",2023-11-04,"Cosenza","FeralpiSalo",1,1,"D",1,0,"H",1.85,3.57,4.74,"1-0","1-1",8,3,19,5,2,4,0,0,6,8,12,13,2,14,25,"6-8","Y","N","N",6,0,11
"3677","I2",2023-11-04,"Pisa","Como",1,1,"D",0,1,"A",2.28,3.26,3.54,"0-1","1-1",15,4,12,2,3,3,0,0,4,6,11,10,2,10,21,"4-6","Y","N","N",6,0,12
"3678","I2",2023-11-04,"Ternana","Venezia",0,1,"A",0,0,"D",2.73,3.19,2.67,"0-0","0-1",11,2,8,2,1,2,0,0,4,4,14,8,1,8,22,"4-4","N","N","N",3,0,12
"3679","I2",2023-11-04,"Sampdoria","Palermo",1,0,"H",1,0,"H",3.01,3.33,2.53,"1-0","1-0",16,6,9,4,4,1,0,0,2,8,16,17,1,10,33,"2-8","N","N","N",5,0,12
"3680","I2",2023-11-05,"Cremonese","Spezia",3,0,"H",2,0,"H",2.04,3.48,4,"2-0","3-0",21,12,17,5,3,1,0,1,5,7,10,15,3,12,25,"5-7","Y","Y","N",4,1,12
"3681","I2",2023-11-05,"Parma","Sudtirol",2,0,"H",1,0,"H",1.64,3.9,6.05,"1-0","2-0",10,3,10,2,0,5,0,0,4,3,13,14,2,7,27,"4-3","Y","N","N",5,0,12
"3682","I2",2023-11-05,"Reggiana","Lecco",1,1,"D",1,0,"H",1.81,3.76,4.71,"1-0","1-1",16,6,16,4,4,3,0,0,2,7,15,10,2,9,25,"2-7","Y","N","N",7,0,12
"3683","I2",2023-11-08,"Lecco","Spezia",0,0,"D",0,0,"D",3.85,3.56,2.05,"0-0","0-0",20,4,17,4,3,6,0,0,5,2,17,14,0,7,31,"5-2","N","N","N",9,0,12
"3684","I2",2023-11-08,"Palermo","Brescia",1,0,"H",1,0,"H",1.69,3.87,5.56,"1-0","1-0",9,3,18,4,3,4,0,0,2,4,19,8,1,6,27,"2-4","N","N","N",7,0,12
"3685","I2",2023-11-10,"Venezia","Catanzaro",2,1,"H",2,1,"H",2.06,3.4,4.02,"2-1","2-1",10,5,6,2,2,1,1,0,1,3,8,17,3,4,25,"1-3","Y","Y","N",3,1,12
"3686","I2",2023-11-11,"Ascoli","Como",0,1,"A",0,1,"A",3.04,3.01,2.73,"0-1","0-1",8,4,9,3,3,5,0,0,3,3,19,19,1,6,38,"3-3","N","N","N",8,0,12
"3687","I2",2023-11-11,"Cosenza","Reggiana",2,0,"H",1,0,"H",2.16,3.35,3.75,"1-0","2-0",12,5,6,2,4,3,0,0,3,2,16,9,2,5,25,"3-2","Y","N","N",7,0,13
"3688","I2",2023-11-11,"FeralpiSalo","Bari",3,3,"D",0,1,"A",3.5,3.07,2.4,"0-1","3-3",11,5,15,5,4,5,0,0,1,3,19,18,6,4,37,"1-3","Y","Y","Y",9,0,13
"3689","I2",2023-11-11,"Sudtirol","Pisa",1,2,"A",0,1,"A",2.73,2.95,3.11,"0-1","1-2",10,2,8,5,2,6,0,0,3,0,20,15,3,3,35,"3-0","Y","Y","N",8,0,13
"3690","I2",2023-11-11,"Modena","Sampdoria",0,2,"A",0,1,"A",2.15,3.16,4.04,"0-1","0-2",8,2,14,4,5,3,1,0,5,2,13,13,2,7,26,"5-2","Y","N","N",8,1,13
"3691","I2",2023-11-12,"Brescia","Cremonese",0,3,"A",0,2,"A",3.79,3.39,2.11,"0-2","0-3",15,1,25,5,3,3,0,0,4,9,11,13,3,13,24,"4-9","Y","Y","N",6,0,13
"3692","I2",2023-11-12,"Lecco","Parma",3,2,"H",2,1,"H",4.54,3.9,1.81,"2-1","3-2",16,7,12,7,3,4,0,1,5,3,10,13,5,8,23,"5-3","Y","Y","Y",7,1,13
"3693","I2",2023-11-12,"Palermo","Cittadella",0,1,"A",0,0,"D",1.73,3.92,5.06,"0-0","0-1",10,0,15,3,1,4,0,0,2,4,15,11,1,6,26,"2-4","N","N","N",5,0,13
"3694","I2",2023-11-12,"Spezia","Ternana",2,2,"D",1,1,"D",1.85,3.61,4.62,"1-1","2-2",22,9,13,5,2,3,0,0,4,5,19,16,4,9,35,"4-5","Y","Y","Y",5,0,13
"3695","I2",2023-11-24,"Sampdoria","Spezia",2,1,"H",1,1,"D",2.31,3.29,3.44,"1-1","2-1",14,4,9,2,5,4,0,0,2,6,19,19,3,8,38,"2-6","Y","Y","N",9,0,13
"3696","I2",2023-11-25,"Bari","Venezia",0,3,"A",0,1,"A",2.63,3.01,2.92,"0-1","0-3",17,4,13,6,3,0,0,0,8,2,7,14,3,10,21,"8-2","Y","Y","N",3,0,13
"3697","I2",2023-11-25,"Cittadella","Sudtirol",2,1,"H",1,0,"H",1.94,3.14,4.44,"1-0","2-1",14,6,5,2,3,5,0,0,5,2,14,13,3,7,27,"5-2","Y","Y","N",8,0,14
"3698","I2",2023-11-25,"Como","FeralpiSalo",2,1,"H",1,0,"H",1.65,3.77,5.24,"1-0","2-1",14,7,11,3,2,2,1,1,3,5,8,12,3,8,20,"3-5","Y","Y","N",4,2,14
"3699","I2",2023-11-25,"Cremonese","Lecco",1,0,"H",1,0,"H",1.38,4.85,7.42,"1-0","1-0",16,2,11,3,4,2,0,0,6,7,11,19,1,13,30,"6-7","N","N","N",6,0,14
"3700","I2",2023-11-25,"Parma","Modena",1,1,"D",0,0,"D",2.03,3.26,3.87,"0-0","1-1",18,7,6,1,3,2,1,0,10,5,9,16,2,15,25,"10-5","Y","N","N",5,1,14
"3701","I2",2023-11-25,"Reggiana","Ascoli",1,1,"D",0,1,"A",2.32,3.13,3.3,"0-1","1-1",18,3,6,3,2,4,0,0,9,5,11,11,2,14,22,"9-5","Y","N","N",6,0,14
"3702","I2",2023-11-25,"Pisa","Brescia",1,1,"D",1,1,"D",2.08,3.08,4,"1-1","1-1",12,2,18,7,2,2,0,0,3,6,9,8,2,9,17,"3-6","Y","N","N",4,0,14
"3703","I2",2023-11-26,"Catanzaro","Cosenza",2,0,"H",1,0,"H",1.88,3.43,4.19,"1-0","2-0",12,3,14,4,3,4,0,0,6,8,21,16,2,14,37,"6-8","Y","N","N",7,0,14
"3704","I2",2023-11-26,"Ternana","Palermo",1,1,"D",0,1,"A",3.19,3.26,2.28,"0-1","1-1",16,4,16,5,3,2,1,0,7,8,8,10,2,15,18,"7-8","Y","N","N",5,1,14
"3705","I2",2023-11-28,"Como","Lecco",0,0,"D",0,0,"D",1.69,3.97,5.35,"0-0","0-0",16,3,11,4,2,3,0,0,3,2,11,14,0,5,25,"3-2","N","N","N",5,0,14
"3706","I2",2023-11-28,"Sudtirol","Brescia",1,1,"D",1,0,"H",2.55,2.91,3.44,"1-0","1-1",10,4,8,3,1,4,0,1,5,5,18,15,2,10,33,"5-5","Y","N","N",5,1,14
"3707","I2",2023-12-01,"Palermo","Catanzaro",1,2,"A",0,1,"A",1.98,3.44,4.27,"0-1","1-2",14,8,17,7,4,5,0,0,8,4,9,19,3,12,28,"8-4","Y","Y","N",9,0,15
"3708","I2",2023-12-02,"Cosenza","Ternana",1,3,"A",0,0,"D",2.19,3.44,3.55,"0-0","1-3",18,6,16,7,2,4,1,0,11,4,14,9,4,15,23,"11-4","Y","Y","Y",6,1,15
"3709","I2",2023-12-02,"FeralpiSalo","Cittadella",0,1,"A",0,1,"A",3.22,3.09,2.54,"0-1","0-1",14,4,9,5,2,2,0,0,6,2,18,11,1,8,29,"6-2","N","N","N",4,0,15
"3710","I2",2023-12-02,"Modena","Reggiana",2,1,"H",1,0,"H",1.9,3.64,4.38,"1-0","2-1",12,7,8,3,2,4,0,1,6,6,17,20,3,12,37,"6-6","Y","Y","N",6,1,15
"3711","I2",2023-12-02,"Pisa","Cremonese",0,0,"D",0,0,"D",3.54,3.43,2.2,"0-0","0-0",15,4,10,2,3,4,0,0,5,4,16,9,0,9,25,"5-4","N","N","N",7,0,15
"3712","I2",2023-12-02,"Venezia","Ascoli",3,1,"H",2,0,"H",1.83,3.59,4.92,"2-0","3-1",23,6,17,4,1,3,0,0,6,4,13,12,4,10,25,"6-4","Y","Y","Y",4,0,15
"3713","I2",2023-12-02,"Spezia","Parma",0,1,"A",0,0,"D",2.62,3.35,2.87,"0-0","0-1",6,1,13,6,1,2,0,0,3,7,15,6,1,10,21,"3-7","N","N","N",3,0,15
"3714","I2",2023-12-03,"Brescia","Sampdoria",3,1,"H",3,0,"H",2.94,3.17,2.69,"3-0","3-1",13,4,9,3,4,3,0,0,4,7,15,19,4,11,34,"4-7","Y","Y","Y",7,0,15
"3715","I2",2023-12-03,"Lecco","Bari",1,0,"H",0,0,"D",2.99,3.44,2.48,"0-0","1-0",10,5,13,1,5,3,0,0,3,4,12,13,1,7,25,"3-4","N","N","N",8,0,15
"3716","I2",2023-12-03,"Sudtirol","Como",0,1,"A",0,0,"D",3.26,3.05,2.55,"0-0","0-1",8,1,16,4,1,3,0,0,6,2,8,17,1,8,25,"6-2","N","N","N",4,0,15
"3717","I2",2023-12-09,"Ascoli","Spezia",1,2,"A",0,1,"A",3.11,3.14,2.58,"0-1","1-2",12,4,7,5,3,3,0,0,7,3,12,17,3,10,29,"7-3","Y","Y","N",6,0,16
"3718","I2",2023-12-09,"Bari","Sudtirol",2,1,"H",1,1,"D",1.93,3.19,5.02,"1-1","2-1",17,3,10,5,3,4,0,1,10,5,16,11,3,15,27,"10-5","Y","Y","N",7,1,16
"3719","I2",2023-12-09,"Cittadella","Cosenza",2,0,"H",2,0,"H",2.11,3.26,4.03,"2-0","2-0",13,3,11,5,3,5,0,0,3,1,16,15,2,4,31,"3-1","Y","N","N",8,0,16
"3720","I2",2023-12-09,"Cremonese","Venezia",1,0,"H",0,0,"D",1.89,3.47,4.13,"0-0","1-0",9,2,13,4,4,2,1,0,3,6,12,13,1,9,25,"3-6","N","N","N",6,1,16
"3721","I2",2023-12-09,"Sampdoria","Lecco",2,0,"H",1,0,"H",1.78,3.68,5.11,"1-0","2-0",20,5,13,5,5,3,0,0,4,10,15,12,2,14,27,"4-10","Y","N","N",8,0,16
"3722","I2",2023-12-09,"Ternana","FeralpiSalo",2,1,"H",1,0,"H",1.92,3.56,4.39,"1-0","2-1",16,4,16,2,2,3,0,0,7,3,9,12,3,10,21,"7-3","Y","Y","N",5,0,16
"3723","I2",2023-12-09,"Catanzaro","Pisa",2,0,"H",0,0,"D",2.34,3.25,3.42,"0-0","2-0",8,5,14,5,3,2,0,0,2,6,10,6,2,8,16,"2-6","Y","N","N",5,0,16
"3724","I2",2023-12-10,"Como","Modena",2,1,"H",1,0,"H",2.19,3.22,3.47,"1-0","2-1",7,4,22,7,1,4,1,0,2,7,12,10,3,9,22,"2-7","Y","Y","N",5,1,16
"3725","I2",2023-12-10,"Parma","Palermo",3,3,"D",0,2,"A",2.15,3.48,3.63,"0-2","3-3",24,7,8,3,4,3,0,0,10,1,16,13,6,11,29,"10-1","Y","Y","Y",7,0,16
"3726","I2",2023-12-10,"Reggiana","Brescia",1,1,"D",0,0,"D",2.32,3.12,3.3,"0-0","1-1",8,2,12,4,5,4,1,0,0,5,13,15,2,5,28,"0-5","Y","N","N",9,1,16
"3727","I2",2023-12-15,"Spezia","Bari",1,0,"H",0,0,"D",2.1,3.16,4.22,"0-0","1-0",18,2,12,4,5,4,1,0,10,7,14,15,1,17,29,"10-7","N","N","N",9,1,17
"3728","I2",2023-12-16,"Brescia","Como",2,0,"H",0,0,"D",2.61,2.96,3.27,"0-0","2-0",11,5,21,5,2,2,0,0,2,5,13,14,2,7,27,"2-5","Y","N","N",4,0,17
"3729","I2",2023-12-16,"FeralpiSalo","Cremonese",1,0,"H",1,0,"H",5.38,4.08,1.67,"1-0","1-0",7,4,18,6,0,4,0,0,1,6,10,12,1,7,22,"1-6","N","N","N",4,0,17
"3730","I2",2023-12-16,"Modena","Cittadella",1,1,"D",1,1,"D",2.11,3.18,4.16,"1-1","1-1",9,2,11,4,2,4,0,0,5,6,21,17,2,11,38,"5-6","Y","N","N",6,0,17
"3731","I2",2023-12-16,"Reggiana","Sampdoria",1,2,"A",0,1,"A",2.93,3.12,2.74,"0-1","1-2",8,3,14,6,4,4,0,1,3,7,16,15,3,10,31,"3-7","Y","Y","N",8,1,17
"3732","I2",2023-12-16,"Venezia","Sudtirol",2,3,"A",2,1,"H",1.68,3.69,5.98,"2-1","2-3",9,3,10,3,3,3,1,0,6,2,9,12,5,8,21,"6-2","Y","Y","Y",6,1,17
"3733","I2",2023-12-16,"Ascoli","Catanzaro",1,0,"H",1,0,"H",2.84,3.12,2.82,"1-0","1-0",10,5,6,2,6,5,0,0,3,2,15,19,1,5,34,"3-2","N","N","N",11,0,17
"3734","I2",2023-12-16,"Cosenza","Parma",0,0,"D",0,0,"D",3.94,3.56,2.02,"0-0","0-0",13,1,11,2,6,4,0,1,5,4,7,18,0,9,25,"5-4","N","N","N",10,1,17
"3735","I2",2023-12-16,"Palermo","Pisa",3,2,"H",2,0,"H",1.89,3.46,4.73,"2-0","3-2",17,7,15,7,4,1,0,1,2,9,10,10,5,11,20,"2-9","Y","Y","Y",5,1,17
"3736","I2",2023-12-17,"Lecco","Ternana",2,3,"A",2,0,"H",2.52,3.38,2.99,"2-0","2-3",20,7,13,5,0,4,0,1,5,1,12,8,5,6,20,"5-1","Y","Y","Y",4,1,17
"3737","I2",2023-12-23,"Cittadella","Spezia",4,1,"H",1,0,"H",2.47,3.03,3.42,"1-0","4-1",24,7,16,5,2,4,0,0,7,3,12,13,5,10,25,"7-3","Y","Y","Y",6,0,18
"3738","I2",2023-12-23,"Como","Palermo",3,3,"D",0,1,"A",2.32,3.29,3.42,"0-1","3-3",12,8,12,6,4,2,0,1,4,6,13,10,6,10,23,"4-6","Y","Y","Y",6,1,18
"3739","I2",2023-12-23,"Cremonese","Modena",4,0,"H",4,0,"H",1.84,3.65,4.7,"4-0","4-0",15,7,8,4,2,1,0,0,1,4,18,13,4,5,31,"1-4","Y","Y","Y",3,0,18
"3740","I2",2023-12-23,"Parma","Ternana",3,1,"H",1,1,"D",1.64,4.08,5.68,"1-1","3-1",21,8,12,2,0,3,0,0,5,8,10,7,4,13,17,"5-8","Y","Y","Y",3,0,18
"3741","I2",2023-12-23,"Venezia","Lecco",2,2,"D",0,1,"A",1.64,4.13,5.65,"0-1","2-2",10,5,6,2,2,3,0,1,3,1,12,12,4,4,24,"3-1","Y","Y","Y",5,1,18
"3742","I2",2023-12-23,"Catanzaro","Brescia",2,3,"A",2,0,"H",2.26,3.18,3.69,"2-0","2-3",10,5,8,6,1,3,0,0,6,3,17,11,5,9,28,"6-3","Y","Y","Y",4,0,18
"3743","I2",2023-12-23,"Bari","Cosenza",0,0,"D",0,0,"D",2.22,3.08,3.95,"0-0","0-0",16,4,14,2,5,4,0,1,7,7,15,19,0,14,34,"7-7","N","N","N",9,1,18
"3744","I2",2023-12-23,"Pisa","Ascoli",1,0,"H",1,0,"H",2.02,3.19,4.05,"1-0","1-0",6,2,10,1,5,3,0,0,3,1,13,10,1,4,23,"3-1","N","N","N",8,0,18
"3745","I2",2023-12-23,"Sampdoria","FeralpiSalo",2,3,"A",1,2,"A",1.63,3.97,6.04,"1-2","2-3",15,5,21,7,1,5,1,0,3,5,17,9,5,8,26,"3-5","Y","Y","Y",6,1,18
"3746","I2",2023-12-23,"Sudtirol","Reggiana",2,3,"A",1,1,"D",2.51,2.97,3.43,"1-1","2-3",13,4,7,4,3,3,0,1,0,1,16,14,5,1,30,"0-1","Y","Y","Y",6,1,18
"3747","I2",2023-12-26,"Reggiana","Catanzaro",1,0,"H",1,0,"H",2.93,3.09,2.76,"1-0","1-0",8,2,7,4,2,5,0,0,2,5,20,8,1,7,28,"2-5","N","N","N",7,0,19
"3748","I2",2023-12-26,"Ascoli","Cittadella",0,0,"D",0,0,"D",2.88,3.01,2.88,"0-0","0-0",12,5,11,3,3,4,0,0,6,2,17,16,0,8,33,"6-2","N","N","N",7,0,19
"3749","I2",2023-12-26,"Brescia","Parma",0,2,"A",0,2,"A",3.45,3.24,2.33,"0-2","0-2",8,0,10,6,5,4,0,0,2,6,13,12,2,8,25,"2-6","Y","N","N",9,0,19
"3750","I2",2023-12-26,"Cosenza","Como",1,2,"A",1,1,"D",2.82,3.13,2.83,"1-1","1-2",4,2,10,6,3,2,0,0,6,3,16,17,3,9,33,"6-3","Y","Y","N",5,0,19
"3751","I2",2023-12-26,"FeralpiSalo","Venezia",2,2,"D",1,1,"D",4.17,3.5,1.99,"1-1","2-2",8,3,11,4,2,2,0,0,3,4,12,13,4,7,25,"3-4","Y","Y","Y",4,0,19
"3752","I2",2023-12-26,"Lecco","Sudtirol",2,1,"H",0,0,"D",2.52,3.13,3.21,"0-0","2-1",10,4,12,5,5,3,0,0,1,2,18,16,3,3,34,"1-2","Y","Y","N",8,0,19
"3753","I2",2023-12-26,"Spezia","Modena",1,1,"D",0,0,"D",2.38,3.23,3.35,"0-0","1-1",19,2,12,6,2,3,0,0,6,4,15,12,2,10,27,"6-4","Y","N","N",5,0,19
"3754","I2",2023-12-26,"Ternana","Pisa",1,1,"D",0,1,"A",2.54,3.33,3,"0-1","1-1",12,7,14,2,5,3,0,0,4,10,7,15,2,14,22,"4-10","Y","N","N",8,0,19
"3755","I2",2023-12-26,"Palermo","Cremonese",3,2,"H",1,2,"A",2.62,3.49,2.79,"1-2","3-2",11,6,17,5,2,2,0,0,6,4,17,5,5,10,22,"6-4","Y","Y","Y",4,0,19
"3756","I2",2023-12-26,"Sampdoria","Bari",1,1,"D",0,0,"D",2.22,3.18,3.81,"0-0","1-1",23,4,11,2,1,5,0,1,5,2,12,20,2,7,32,"5-2","Y","N","N",6,1,19
"3757","I2",2024-01-12,"Catanzaro","Lecco",5,3,"H",1,2,"A",1.86,3.46,4.92,"1-2","5-3",20,9,14,4,3,2,0,0,9,4,13,12,8,13,25,"9-4","Y","Y","Y",5,0,20
"3758","I2",2024-01-13,"Bari","Ternana",3,1,"H",2,0,"H",2.29,3.22,3.57,"2-0","3-1",16,6,11,1,1,3,0,0,5,6,15,9,4,11,24,"5-6","Y","Y","Y",4,0,20
"3759","I2",2024-01-13,"Cittadella","Palermo",2,0,"H",1,0,"H",2.44,3.15,3.34,"1-0","2-0",16,6,8,3,1,2,0,1,2,4,10,17,2,6,27,"2-4","Y","N","N",3,1,20
"3760","I2",2024-01-13,"Como","Spezia",4,0,"H",2,0,"H",2,3.46,4.19,"2-0","4-0",26,8,13,4,1,1,0,0,5,6,9,21,4,11,30,"5-6","Y","Y","Y",2,0,20
"3761","I2",2024-01-13,"Modena","Brescia",1,2,"A",0,2,"A",2.1,3.13,4.29,"0-2","1-2",14,2,11,5,4,5,0,0,10,5,18,13,3,15,31,"10-5","Y","Y","N",9,0,20
"3762","I2",2024-01-13,"Sudtirol","FeralpiSalo",1,0,"H",0,0,"D",2.32,3.07,3.7,"0-0","1-0",13,2,17,5,2,3,0,0,6,6,12,11,1,12,23,"6-6","N","N","N",5,0,20
"3763","I2",2024-01-13,"Pisa","Reggiana",2,2,"D",1,2,"A",2.05,3.09,4.6,"1-2","2-2",17,8,7,2,7,2,0,0,6,3,14,19,4,9,33,"6-3","Y","Y","Y",9,0,20
"3764","I2",2024-01-14,"Cremonese","Cosenza",1,0,"H",0,0,"D",1.63,3.98,6.02,"0-0","1-0",12,6,7,4,3,5,0,0,11,2,7,14,1,13,21,"11-2","N","N","N",8,0,20
"3765","I2",2024-01-14,"Parma","Ascoli",1,1,"D",0,0,"D",1.69,3.77,5.72,"0-0","1-1",19,5,9,3,2,4,0,1,3,1,16,14,2,4,30,"3-1","Y","N","N",6,1,20
"3766","I2",2024-01-14,"Venezia","Sampdoria",5,3,"H",2,1,"H",2.14,3.35,3.58,"2-1","5-3",17,8,7,3,3,4,0,1,1,2,15,11,8,3,26,"1-2","Y","Y","Y",7,1,20
"3767","I2",2024-01-19,"Sampdoria","Parma",0,3,"A",0,2,"A",3.37,3.31,2.33,"0-2","0-3",11,4,12,3,1,1,0,0,2,6,10,7,3,8,17,"2-6","Y","Y","N",2,0,21
"3768","I2",2024-01-20,"Brescia","Sudtirol",1,1,"D",0,0,"D",1.87,2.9,4.83,"0-0","1-1",10,4,9,2,2,3,0,0,6,4,14,11,2,10,25,"6-4","Y","N","N",5,0,21
"3769","I2",2024-01-20,"FeralpiSalo","Catanzaro",3,0,"H",1,0,"H",3.09,3.17,2.57,"1-0","3-0",13,8,11,3,3,5,0,0,3,3,16,10,3,6,26,"3-3","Y","Y","N",8,0,21
"3770","I2",2024-01-20,"Reggiana","Como",2,2,"D",1,2,"A",3.27,2.94,2.29,"1-2","2-2",14,4,13,6,3,4,0,0,2,9,10,10,4,11,20,"2-9","Y","Y","Y",7,0,21
"3771","I2",2024-01-20,"Spezia","Cremonese",0,1,"A",0,0,"D",3.4,3.51,2.23,"0-0","0-1",11,3,10,4,4,2,0,0,5,5,21,12,1,10,33,"5-5","N","N","N",6,0,21
"3772","I2",2024-01-20,"Ternana","Cittadella",3,1,"H",1,1,"D",2.93,3.13,2.73,"1-1","3-1",15,7,18,4,3,2,0,0,5,8,15,9,4,13,24,"5-8","Y","Y","Y",5,0,21
"3773","I2",2024-01-20,"Cosenza","Venezia",4,2,"H",3,1,"H",3.39,3.04,2.47,"3-1","4-2",22,7,16,5,3,2,0,0,5,8,9,13,6,13,22,"5-8","Y","Y","Y",5,0,21
"3774","I2",2024-01-20,"Lecco","Pisa",1,3,"A",0,1,"A",2.96,3.2,2.65,"0-1","1-3",18,3,14,5,5,2,0,0,6,4,13,14,4,10,27,"6-4","Y","Y","Y",7,0,21
"3775","I2",2024-01-20,"Palermo","Modena",4,2,"H",2,1,"H",2.28,3.24,3.55,"2-1","4-2",16,7,11,4,1,5,0,0,7,8,15,13,6,15,28,"7-8","Y","Y","Y",6,0,21
"3776","I2",2024-01-21,"Ascoli","Bari",2,2,"D",0,2,"A",2.62,2.93,3.29,"0-2","2-2",25,7,11,4,4,5,0,0,11,4,18,17,4,15,35,"11-4","Y","Y","Y",9,0,21
"3777","I2",2024-01-26,"Catanzaro","Palermo",1,1,"D",1,0,"H",2.86,3.14,2.79,"1-0","1-1",12,1,6,3,1,1,0,0,4,5,12,9,2,9,21,"4-5","Y","N","N",2,0,22
"3778","I2",2024-01-27,"Como","Ascoli",0,2,"A",0,0,"D",1.83,3.5,5.02,"0-0","0-2",9,5,14,2,2,4,1,0,2,8,18,16,2,10,34,"2-8","Y","N","N",6,1,22
"3779","I2",2024-01-27,"Cremonese","Brescia",1,0,"H",1,0,"H",1.71,3.59,6,"1-0","1-0",10,3,5,1,3,0,0,0,6,3,12,24,1,9,36,"6-3","N","N","N",3,0,22
"3780","I2",2024-01-27,"Modena","Parma",3,0,"H",2,0,"H",3.19,3.33,2.42,"2-0","3-0",6,4,17,5,2,1,0,0,1,4,12,15,3,5,27,"1-4","Y","Y","N",3,0,22
"3781","I2",2024-01-27,"Sudtirol","Cosenza",0,1,"A",0,0,"D",2.7,2.98,3.11,"0-0","0-1",12,3,16,5,0,3,0,0,5,3,13,19,1,8,32,"5-3","N","N","N",3,0,22
"3782","I2",2024-01-27,"Venezia","Ternana",1,0,"H",0,0,"D",1.67,4.27,5.05,"0-0","1-0",18,5,6,0,2,1,0,1,7,4,11,17,1,11,28,"7-4","N","N","N",3,1,22
"3783","I2",2024-01-27,"Bari","Reggiana",0,2,"A",0,1,"A",2.04,3.17,4.47,"0-1","0-2",11,2,11,2,2,2,0,0,6,3,14,17,2,9,31,"6-3","Y","N","N",4,0,22
"3784","I2",2024-01-27,"FeralpiSalo","Lecco",5,1,"H",1,0,"H",2.25,3.47,3.38,"1-0","5-1",11,7,12,7,3,1,0,0,1,7,12,12,6,8,24,"1-7","Y","Y","Y",4,0,22
"3785","I2",2024-01-27,"Pisa","Spezia",2,3,"A",1,3,"A",2.3,3.29,3.46,"1-3","2-3",27,12,6,3,6,3,0,0,14,0,14,16,5,14,30,"14-0","Y","Y","Y",9,0,22
"3786","I2",2024-01-28,"Cittadella","Sampdoria",1,2,"A",0,0,"D",2.1,3.28,4.06,"0-0","1-2",9,1,7,2,4,2,0,0,2,1,18,15,3,3,33,"2-1","Y","Y","N",6,0,22
"3787","I2",2024-02-02,"Palermo","Bari",3,0,"H",1,0,"H",1.78,3.54,5.36,"1-0","3-0",18,9,11,2,3,2,0,0,4,8,8,16,3,12,24,"4-8","Y","Y","N",5,0,23
"3788","I2",2024-02-03,"Brescia","Cittadella",2,0,"H",0,0,"D",2.55,2.98,3.33,"0-0","2-0",15,9,16,3,2,3,0,0,5,6,16,17,2,11,33,"5-6","Y","N","N",5,0,23
"3789","I2",2024-02-03,"Cosenza","Pisa",1,1,"D",0,0,"D",2.51,3,3.37,"0-0","1-1",8,2,11,2,5,3,0,1,4,5,14,14,2,9,28,"4-5","Y","N","N",8,1,23
"3790","I2",2024-02-03,"Parma","Venezia",2,1,"H",1,1,"D",2.08,3.44,3.9,"1-1","2-1",15,6,14,5,2,2,0,0,11,5,10,6,3,16,16,"11-5","Y","Y","N",4,0,23
"3791","I2",2024-02-03,"Reggiana","FeralpiSalo",1,1,"D",0,0,"D",2.25,3.23,3.64,"0-0","1-1",27,4,5,2,2,3,0,2,11,2,14,13,2,13,27,"11-2","Y","N","N",5,2,23
"3792","I2",2024-02-03,"Spezia","Catanzaro",1,1,"D",1,1,"D",2.42,3.33,3.19,"1-1","1-1",15,5,10,2,2,5,0,0,6,3,14,18,2,9,32,"6-3","Y","N","N",7,0,23
"3793","I2",2024-02-03,"Lecco","Cremonese",0,1,"A",0,0,"D",4.3,3.87,1.85,"0-0","0-1",8,1,7,3,2,3,0,0,5,6,14,16,1,11,30,"5-6","N","N","N",5,0,23
"3794","I2",2024-02-03,"Sampdoria","Modena",2,2,"D",2,0,"H",2.21,3.28,3.7,"2-0","2-2",10,5,17,3,3,4,0,0,3,4,19,14,4,7,33,"3-4","Y","Y","Y",7,0,23
"3795","I2",2024-02-03,"Ternana","Como",0,1,"A",0,1,"A",3.01,3.31,2.54,"0-1","0-1",7,1,28,7,1,2,0,0,1,6,14,19,1,7,33,"1-6","N","N","N",3,0,23
"3796","I2",2024-02-04,"Ascoli","Sudtirol",1,2,"A",0,1,"A",2.28,3.05,3.84,"0-1","1-2",11,3,7,2,1,4,0,0,2,1,20,17,3,3,37,"2-1","Y","Y","N",5,0,23
"3797","I2",2024-02-09,"Como","Brescia",1,0,"H",1,0,"H",1.79,3.48,5.49,"1-0","1-0",14,3,9,1,2,4,0,0,4,3,15,17,1,7,32,"4-3","N","N","N",6,0,24
"3798","I2",2024-02-10,"Cittadella","Parma",1,2,"A",1,2,"A",3.53,3.02,2.42,"1-2","1-2",23,3,16,4,2,2,0,0,6,4,13,10,3,10,23,"6-4","Y","Y","N",4,0,24
"3799","I2",2024-02-10,"Cremonese","Reggiana",1,1,"D",0,0,"D",1.52,4.1,7.66,"0-0","1-1",23,7,12,2,5,1,1,0,9,4,7,20,2,13,27,"9-4","Y","N","N",6,1,24
"3800","I2",2024-02-10,"FeralpiSalo","Palermo",1,2,"A",0,0,"D",3.84,3.53,2.06,"0-0","1-2",27,8,13,4,1,4,0,0,10,4,10,9,3,14,19,"10-4","Y","Y","N",5,0,24
"3801","I2",2024-02-10,"Modena","Cosenza",1,1,"D",1,1,"D",2.18,3.29,3.77,"1-1","1-1",10,5,9,3,3,3,0,1,2,1,14,13,2,3,27,"2-1","Y","N","N",6,1,24
"3802","I2",2024-02-10,"Sudtirol","Venezia",0,3,"A",0,1,"A",3.91,3.17,2.19,"0-1","0-3",12,2,14,4,7,2,1,0,5,3,15,18,3,8,33,"5-3","Y","Y","N",9,1,24
"3803","I2",2024-02-10,"Bari","Lecco",3,1,"H",1,0,"H",1.99,3.47,4.19,"1-0","3-1",10,3,12,3,3,2,0,0,4,9,10,10,4,13,20,"4-9","Y","Y","Y",5,0,24
"3804","I2",2024-02-10,"Catanzaro","Ascoli",3,2,"H",1,2,"A",1.94,3.41,4.5,"1-2","3-2",11,2,10,3,5,4,0,1,4,4,21,18,5,8,39,"4-4","Y","Y","Y",9,1,24
"3805","I2",2024-02-10,"Pisa","Sampdoria",2,0,"H",0,0,"D",2.27,3.3,3.51,"0-0","2-0",10,4,8,2,3,5,0,1,2,3,15,15,2,5,30,"2-3","Y","N","N",8,1,24
"3806","I2",2024-02-11,"Ternana","Spezia",1,1,"D",0,0,"D",2.55,3.26,3.03,"0-0","1-1",13,5,12,4,2,2,0,0,3,3,23,19,2,6,42,"3-3","Y","N","N",4,0,24
"3807","I2",2024-02-16,"Ascoli","Cremonese",0,0,"D",0,0,"D",3.89,3.32,2.13,"0-0","0-0",10,1,9,1,3,4,0,0,4,1,20,18,0,5,38,"4-1","N","N","N",7,0,25
"3808","I2",2024-02-17,"Bari","FeralpiSalo",1,0,"H",0,0,"D",1.98,3.28,4.56,"0-0","1-0",8,3,8,2,3,1,0,0,4,0,17,14,1,4,31,"4-0","N","N","N",4,0,25
"3809","I2",2024-02-17,"Lecco","Cosenza",1,3,"A",0,2,"A",2.73,3.15,2.92,"0-2","1-3",25,6,15,6,5,4,0,0,13,2,12,12,4,15,24,"13-2","Y","Y","Y",9,0,25
"3810","I2",2024-02-17,"Parma","Pisa",3,2,"H",1,1,"D",1.79,3.63,5.05,"1-1","3-2",16,9,8,3,2,3,0,0,3,2,12,10,5,5,22,"3-2","Y","Y","Y",5,0,25
"3811","I2",2024-02-17,"Reggiana","Ternana",0,2,"A",0,1,"A",2.3,3.34,3.41,"0-1","0-2",17,6,10,6,3,3,0,0,7,4,17,18,2,11,35,"7-4","Y","N","N",6,0,25
"3812","I2",2024-02-17,"Spezia","Cittadella",4,2,"H",2,1,"H",2.54,3.12,3.2,"2-1","4-2",15,8,7,3,1,6,0,2,4,4,18,19,6,8,37,"4-4","Y","Y","Y",7,2,25
"3813","I2",2024-02-17,"Catanzaro","Sudtirol",2,2,"D",1,1,"D",2,3.29,4.44,"1-1","2-2",16,6,6,3,3,3,1,0,6,2,24,13,4,8,37,"6-2","Y","Y","Y",6,1,25
"3814","I2",2024-02-17,"Palermo","Como",3,0,"H",1,0,"H",2.28,3.34,3.46,"1-0","3-0",7,4,17,3,1,3,0,0,0,8,16,14,3,8,30,"0-8","Y","Y","N",4,0,25
"3815","I2",2024-02-17,"Sampdoria","Brescia",1,1,"D",0,0,"D",2.16,3.16,4.03,"0-0","1-1",13,3,8,4,1,2,0,0,2,6,17,12,2,8,29,"2-6","Y","N","N",3,0,25
"3816","I2",2024-02-18,"Venezia","Modena",2,2,"D",1,0,"H",1.7,3.59,5.15,"1-0","2-2",14,4,13,4,2,3,0,0,7,4,12,11,4,11,23,"7-4","Y","Y","Y",5,0,25
"3817","I2",2024-02-23,"Cosenza","Sampdoria",1,2,"A",0,2,"A",2.5,3.21,3.16,"0-2","1-2",19,6,7,3,2,5,0,0,12,0,10,8,3,12,18,"12-0","Y","Y","N",7,0,26
"3818","I2",2024-02-24,"Brescia","Reggiana",0,0,"D",0,0,"D",2.34,3.07,3.64,"0-0","0-0",11,2,11,5,2,1,0,0,0,2,13,14,0,2,27,"0-2","N","N","N",3,0,26
"3819","I2",2024-02-24,"Cittadella","Catanzaro",1,2,"A",1,1,"D",2.19,3.22,3.83,"1-1","1-2",12,4,11,5,1,4,0,0,5,5,16,21,3,10,37,"5-5","Y","Y","N",5,0,26
"3820","I2",2024-02-24,"Cremonese","Palermo",2,2,"D",0,2,"A",1.97,3.66,4.01,"0-2","2-2",17,5,16,8,1,3,1,0,5,9,17,5,4,14,22,"5-9","Y","Y","Y",4,1,26
"3821","I2",2024-02-24,"FeralpiSalo","Ascoli",0,1,"A",0,1,"A",2.74,2.97,3.07,"0-1","0-1",15,4,10,4,2,3,0,0,7,3,19,16,1,10,35,"7-3","N","N","N",5,0,26
"3822","I2",2024-02-24,"Sudtirol","Bari",1,0,"H",0,0,"D",2.74,2.8,3.27,"0-0","1-0",7,1,4,1,3,1,0,0,3,4,18,11,1,7,29,"3-4","N","N","N",4,0,26
"3823","I2",2024-02-24,"Como","Parma",1,1,"D",1,1,"D",2.69,3.29,2.85,"1-1","1-1",5,2,14,5,2,2,0,0,3,3,11,14,2,6,25,"3-3","Y","N","N",4,0,26
"3824","I2",2024-02-24,"Pisa","Venezia",1,2,"A",0,0,"D",2.66,3.16,2.98,"0-0","1-2",15,2,12,4,2,3,0,0,4,3,10,13,3,7,23,"4-3","Y","Y","N",5,0,26
"3825","I2",2024-02-24,"Ternana","Lecco",0,0,"D",0,0,"D",2.1,3.53,3.72,"0-0","0-0",7,2,18,4,2,1,0,0,7,9,14,17,0,16,31,"7-9","N","N","N",3,0,26
"3826","I2",2024-02-25,"Modena","Spezia",0,0,"D",0,0,"D",2.34,3.26,3.41,"0-0","0-0",31,7,3,0,4,4,0,1,11,0,12,18,0,11,30,"11-0","N","N","N",8,1,26
"3827","I2",2024-02-27,"Ascoli","Brescia",1,1,"D",1,1,"D",2.16,2.96,4.37,"1-1","1-1",15,5,5,1,1,1,0,0,4,0,21,16,2,4,37,"4-0","Y","N","N",2,0,27
"3828","I2",2024-02-27,"Reggiana","Sudtirol",1,1,"D",0,0,"D",2.48,2.79,3.75,"0-0","1-1",9,1,9,4,2,2,0,0,2,2,11,12,2,4,23,"2-2","Y","N","N",4,0,27
"3829","I2",2024-02-27,"Catanzaro","Bari",2,0,"H",1,0,"H",2.36,3.02,3.68,"1-0","2-0",7,4,21,4,2,3,0,0,2,3,16,10,2,5,26,"2-3","Y","N","N",5,0,27
"3830","I2",2024-02-27,"Lecco","Como",0,3,"A",0,2,"A",4.15,3.47,2,"0-2","0-3",6,1,18,6,2,0,0,0,4,6,7,17,3,10,24,"4-6","Y","Y","N",2,0,27
"3831","I2",2024-02-27,"Palermo","Ternana",2,3,"A",1,1,"D",1.61,4.34,5.61,"1-1","2-3",10,3,16,4,2,2,0,0,3,4,14,11,5,7,25,"3-4","Y","Y","Y",4,0,27
"3832","I2",2024-02-27,"Parma","Cosenza",1,1,"D",1,1,"D",1.52,4.32,6.99,"1-1","1-1",12,2,8,3,4,3,1,0,7,5,16,14,2,12,30,"7-5","Y","N","N",7,1,27
"3833","I2",2024-02-27,"Sampdoria","Cremonese",1,2,"A",1,1,"D",3.08,3.19,2.57,"1-1","1-2",8,2,22,7,2,4,0,0,3,10,16,14,3,13,30,"3-10","Y","Y","N",6,0,27
"3834","I2",2024-02-28,"Pisa","Modena",2,2,"D",1,0,"H",2.27,3.11,3.74,"1-0","2-2",5,4,9,4,3,5,1,0,3,6,12,11,4,9,23,"3-6","Y","Y","Y",8,1,27
"3835","I2",2024-02-28,"Spezia","FeralpiSalo",0,2,"A",0,1,"A",1.88,3.64,4.47,"0-1","0-2",19,2,9,2,3,1,0,0,8,3,13,15,2,11,28,"8-3","Y","N","N",4,0,27
"3836","I2",2024-02-28,"Venezia","Cittadella",2,0,"H",1,0,"H",1.91,3.55,4.48,"1-0","2-0",11,4,23,5,1,2,0,0,4,14,10,8,2,18,18,"4-14","Y","N","N",3,0,27
"3837","I2",2024-03-02,"Brescia","Palermo",4,2,"H",4,2,"H",3.1,3.34,2.47,"4-2","4-2",16,7,15,7,3,3,0,1,5,5,15,11,6,10,26,"5-5","Y","Y","Y",6,1,28
"3838","I2",2024-03-02,"Sudtirol","Lecco",1,0,"H",0,0,"D",2.08,3.21,4.21,"0-0","1-0",14,2,7,0,4,3,0,0,10,4,17,13,1,14,30,"10-4","N","N","N",7,0,28
"3839","I2",2024-03-02,"Ternana","Parma",1,3,"A",0,2,"A",3.99,3.77,1.95,"0-2","1-3",15,5,15,7,3,5,0,0,5,5,11,10,4,10,21,"5-5","Y","Y","Y",8,0,28
"3840","I2",2024-03-03,"Ascoli","Reggiana",0,0,"D",0,0,"D",2.27,2.98,3.98,"0-0","0-0",8,3,11,3,2,2,1,0,3,7,22,18,0,10,40,"3-7","N","N","N",4,1,28
"3841","I2",2024-03-03,"Bari","Spezia",1,1,"D",0,0,"D",2.45,3.15,3.31,"0-0","1-1",11,3,10,4,3,3,0,0,5,8,17,9,2,13,26,"5-8","Y","N","N",6,0,28
"3842","I2",2024-03-03,"Cittadella","Pisa",0,1,"A",0,0,"D",2.36,3.13,3.51,"0-0","0-1",6,0,12,3,2,2,0,0,4,3,10,14,1,7,24,"4-3","N","N","N",4,0,28
"3843","I2",2024-03-03,"Como","Venezia",2,1,"H",1,1,"D",2.42,3.27,3.23,"1-1","2-1",8,4,10,3,1,2,0,0,5,5,13,10,3,10,23,"5-5","Y","Y","N",3,0,28
"3844","I2",2024-03-03,"Cosenza","Catanzaro",0,2,"A",0,1,"A",2.53,3.21,3.12,"0-1","0-2",13,2,6,4,6,1,1,0,8,1,4,24,2,9,28,"8-1","Y","N","N",7,1,28
"3845","I2",2024-03-03,"FeralpiSalo","Sampdoria",1,3,"A",0,2,"A",2.85,3.16,2.78,"0-2","1-3",11,4,8,4,1,6,0,0,5,2,19,8,4,7,27,"5-2","Y","Y","Y",7,0,28
"3846","I2",2024-03-03,"Modena","Cremonese",0,1,"A",0,0,"D",3.11,3.16,2.57,"0-0","0-1",15,5,16,4,4,1,0,1,8,1,12,12,1,9,24,"8-1","N","N","N",5,1,28
"3847","I2",2024-03-08,"Parma","Brescia",2,1,"H",0,1,"A",1.65,3.87,5.96,"0-1","2-1",14,5,15,6,2,3,0,1,2,2,11,10,3,4,21,"2-2","Y","Y","N",5,1,29
"3848","I2",2024-03-09,"Cosenza","Cittadella",0,0,"D",0,0,"D",2.74,2.98,3.06,"0-0","0-0",14,4,9,3,2,4,0,0,6,4,15,14,0,10,29,"6-4","N","N","N",6,0,29
"3849","I2",2024-03-09,"Modena","FeralpiSalo",2,3,"A",1,2,"A",1.76,3.67,5.31,"1-2","2-3",21,6,14,5,3,2,0,0,7,5,17,14,5,12,31,"7-5","Y","Y","Y",5,0,29
"3850","I2",2024-03-09,"Spezia","Sudtirol",2,1,"H",1,1,"D",2.09,3.15,4.32,"1-1","2-1",12,4,9,2,2,4,0,0,5,6,17,12,3,11,29,"5-6","Y","Y","N",6,0,29
"3851","I2",2024-03-09,"Catanzaro","Reggiana",0,1,"A",0,1,"A",2.11,3.34,3.98,"0-1","0-1",16,5,5,2,2,1,0,0,7,2,17,8,1,9,25,"7-2","N","N","N",3,0,29
"3852","I2",2024-03-09,"Cremonese","Como",2,1,"H",1,0,"H",2.15,3.32,3.81,"1-0","2-1",14,3,3,1,2,3,0,1,7,1,10,14,3,8,24,"7-1","Y","Y","N",5,1,29
"3853","I2",2024-03-09,"Pisa","Ternana",1,0,"H",0,0,"D",1.88,3.63,4.51,"0-0","1-0",16,3,15,6,1,2,0,0,5,8,13,16,1,13,29,"5-8","N","N","N",3,0,29
"3854","I2",2024-03-10,"Lecco","Palermo",0,1,"A",0,1,"A",4.16,3.97,1.86,"0-1","0-1",17,3,7,4,1,0,0,0,7,3,6,16,1,10,22,"7-3","N","N","N",1,0,29
"3855","I2",2024-03-10,"Venezia","Bari",3,1,"H",2,1,"H",1.75,3.39,5.14,"2-1","3-1",15,5,16,2,2,2,0,0,6,6,10,14,4,12,24,"6-6","Y","Y","Y",4,0,29
"3856","I2",2024-03-11,"Sampdoria","Ascoli",2,1,"H",0,1,"A",2.14,2.97,3.89,"0-1","2-1",16,6,12,2,3,3,0,0,7,3,27,14,3,10,41,"7-3","Y","Y","N",6,0,29
"3857","I2",2024-03-15,"Palermo","Venezia",0,3,"A",0,2,"A",2.7,3.34,2.8,"0-2","0-3",14,3,17,8,1,1,0,0,6,3,13,14,3,9,27,"6-3","Y","Y","N",2,0,30
"3858","I2",2024-03-16,"Brescia","Catanzaro",1,1,"D",0,1,"A",2.6,3.02,3.21,"0-1","1-1",18,3,13,6,2,2,0,0,9,6,7,15,2,15,22,"9-6","Y","N","N",4,0,30
"3859","I2",2024-03-16,"Como","Pisa",3,1,"H",2,0,"H",2.15,3.27,3.89,"2-0","3-1",10,6,9,2,4,2,0,0,1,2,11,17,4,3,28,"1-2","Y","Y","Y",6,0,30
"3860","I2",2024-03-16,"FeralpiSalo","Parma",1,2,"A",0,1,"A",4.7,3.58,1.82,"0-1","1-2",11,2,17,5,1,1,0,0,4,9,11,6,3,13,17,"4-9","Y","Y","N",2,0,30
"3861","I2",2024-03-16,"Sudtirol","Cremonese",3,0,"H",1,0,"H",4.29,3.13,2.11,"1-0","3-0",7,4,18,2,0,0,0,0,0,7,9,6,3,7,15,"0-7","Y","Y","N",0,0,30
"3862","I2",2024-03-16,"Ternana","Cosenza",1,0,"H",0,0,"D",2.52,3.12,3.22,"0-0","1-0",17,3,13,7,4,2,0,0,9,6,6,13,1,15,19,"9-6","N","N","N",6,0,30
"3863","I2",2024-03-16,"Bari","Sampdoria",0,1,"A",0,0,"D",2.72,3.05,3.02,"0-0","0-1",14,3,11,4,3,3,0,0,7,5,8,17,1,12,25,"7-5","N","N","N",6,0,30
"3864","I2",2024-03-16,"Cittadella","Modena",1,1,"D",1,1,"D",2.67,3.09,3.03,"1-1","1-1",9,3,14,4,2,2,0,0,6,5,12,13,2,11,25,"6-5","Y","N","N",4,0,30
"3865","I2",2024-03-16,"Reggiana","Spezia",0,0,"D",0,0,"D",2.75,2.88,3.16,"0-0","0-0",11,0,15,5,3,4,1,0,3,7,9,16,0,10,25,"3-7","N","N","N",7,1,30
"3866","I2",2024-03-17,"Ascoli","Lecco",4,1,"H",2,1,"H",1.94,3.39,4.54,"2-1","4-1",10,7,15,6,2,2,0,0,5,4,16,14,5,9,30,"5-4","Y","Y","Y",4,0,30
"4100","N1",2023-08-11,"Volendam","Vitesse",1,2,"A",1,0,"H",3.47,3.88,2.07,"1-0","1-2",4,4,13,9,3,1,1,0,3,7,12,10,3,10,22,"3-7","Y","Y","N",4,1,1
"4101","N1",2023-08-12,"PSV Eindhoven","Utrecht",2,0,"H",1,0,"H",1.37,5.75,7.93,"1-0","2-0",23,8,7,1,2,1,0,0,4,2,15,14,2,6,29,"4-2","Y","N","N",3,0,1
"4102","N1",2023-08-12,"Heerenveen","Waalwijk",3,1,"H",3,0,"H",1.78,4.1,4.46,"3-0","3-1",19,9,13,5,0,1,0,0,7,2,9,8,4,9,17,"7-2","Y","Y","Y",1,0,1
"4103","N1",2023-08-12,"Ajax","Heracles",4,1,"H",1,1,"D",1.19,8.58,12.96,"1-1","4-1",31,13,7,2,2,5,0,0,13,4,11,14,5,17,25,"13-4","Y","Y","Y",7,0,1
"4104","N1",2023-08-12,"Zwolle","Sparta Rotterdam",1,2,"A",0,1,"A",2.51,3.51,2.91,"0-1","1-2",20,7,9,4,2,4,0,0,7,1,8,15,3,8,23,"7-1","Y","Y","N",6,0,1
"4105","N1",2023-08-13,"Nijmegen","Excelsior",3,4,"A",2,1,"H",1.53,4.76,6,"2-1","3-4",8,6,6,6,1,2,0,0,2,7,4,10,7,9,14,"2-7","Y","Y","Y",3,0,1
"4106","N1",2023-08-13,"AZ Alkmaar","Go Ahead Eagles",5,1,"H",2,0,"H",1.35,5.34,9.01,"2-0","5-1",13,8,9,4,2,3,0,0,5,4,8,13,6,9,21,"5-4","Y","Y","Y",5,0,1
"4107","N1",2023-08-13,"Feyenoord","For Sittard",0,0,"D",0,0,"D",1.17,8.25,16.82,"0-0","0-0",22,6,14,5,0,6,1,0,8,3,4,21,0,11,25,"8-3","N","N","N",6,1,1
"4108","N1",2023-08-13,"Almere City","Twente",1,4,"A",0,0,"D",5.67,4.35,1.6,"0-0","1-4",12,4,20,8,4,0,1,0,2,11,15,10,5,13,25,"2-11","Y","Y","Y",4,1,1
"4109","N1",2023-08-18,"Heracles","Nijmegen",2,1,"H",0,1,"A",2.5,3.68,2.81,"0-1","2-1",16,7,17,4,2,2,0,0,5,9,10,10,3,14,20,"5-9","Y","Y","N",4,0,2
"4110","N1",2023-08-19,"Excelsior","Ajax",2,2,"D",1,1,"D",10.04,6.56,1.27,"1-1","2-2",13,2,15,8,0,0,0,0,4,10,7,7,4,14,14,"4-10","Y","Y","Y",0,0,2
"4111","N1",2023-08-19,"Vitesse","PSV Eindhoven",1,3,"A",1,0,"H",5.98,4.62,1.54,"1-0","1-3",12,2,19,7,0,1,0,0,4,7,7,2,4,11,9,"4-7","Y","Y","Y",1,0,2
"4112","N1",2023-08-19,"For Sittard","Almere City",2,1,"H",2,1,"H",1.97,3.97,3.72,"2-1","2-1",21,7,8,5,3,2,0,0,5,6,8,13,3,11,21,"5-6","Y","Y","N",5,0,2
"4113","N1",2023-08-19,"Go Ahead Eagles","Volendam",4,1,"H",3,0,"H",1.65,4.48,4.94,"3-0","4-1",8,6,19,5,1,3,1,0,4,12,3,8,5,16,11,"4-12","Y","Y","Y",4,1,2
"4114","N1",2023-08-20,"Utrecht","Heerenveen",0,2,"A",0,0,"D",1.83,3.83,4.47,"0-0","0-2",12,6,12,6,0,1,0,0,9,2,11,10,2,11,21,"9-2","Y","N","N",1,0,2
"4115","N1",2023-08-20,"Sparta Rotterdam","Feyenoord",2,2,"D",1,0,"H",5.17,4.61,1.61,"1-0","2-2",10,5,24,8,2,0,0,0,3,12,9,5,4,15,14,"3-12","Y","Y","Y",2,0,2
"4116","N1",2023-08-20,"Twente","Zwolle",3,1,"H",1,1,"D",1.36,5.61,8.29,"1-1","3-1",18,3,9,4,2,5,0,0,8,3,6,15,4,11,21,"8-3","Y","Y","Y",7,0,2
"4117","N1",2023-08-20,"Waalwijk","AZ Alkmaar",1,3,"A",1,0,"H",5.06,4.39,1.65,"1-0","1-3",7,5,15,7,2,1,0,0,1,10,9,12,4,11,21,"1-10","Y","Y","Y",3,0,2
"4118","N1",2023-08-26,"Nijmegen","Waalwijk",3,0,"H",1,0,"H",1.79,4.3,4.19,"1-0","3-0",13,10,10,1,1,2,0,0,2,4,10,9,3,6,19,"2-4","Y","Y","N",3,0,3
"4119","N1",2023-08-26,"Excelsior","For Sittard",2,2,"D",1,0,"H",2.46,3.75,2.82,"1-0","2-2",9,6,13,5,1,1,0,0,0,6,5,9,4,6,14,"0-6","Y","Y","Y",2,0,3
"4120","N1",2023-08-27,"Zwolle","Utrecht",1,0,"H",0,0,"D",2.86,3.83,2.4,"0-0","1-0",9,2,10,1,2,3,0,0,2,8,13,8,1,10,21,"2-8","N","N","N",5,0,3
"4121","N1",2023-08-27,"Feyenoord","Almere City",6,1,"H",3,0,"H",1.16,9.16,16.46,"3-0","6-1",31,18,6,1,0,1,0,0,8,2,8,15,7,10,23,"8-2","Y","Y","Y",1,0,3
"4122","N1",2023-08-27,"Heerenveen","Sparta Rotterdam",1,3,"A",0,1,"A",2.35,3.79,2.95,"0-1","1-3",19,6,16,7,0,0,1,0,6,7,4,8,4,13,12,"6-7","Y","Y","Y",0,1,3
"4123","N1",2023-09-01,"Sparta Rotterdam","Nijmegen",1,1,"D",0,0,"D",1.9,3.83,4.11,"0-0","1-1",15,6,13,6,1,4,0,0,10,1,11,10,2,11,21,"10-1","Y","N","N",5,0,3
"4124","N1",2023-09-02,"Almere City","Zwolle",1,2,"A",0,1,"A",3.26,3.66,2.23,"0-1","1-2",10,3,13,6,3,4,0,1,7,4,12,10,3,11,22,"7-4","Y","Y","N",7,1,3
"4125","N1",2023-09-02,"Go Ahead Eagles","Heerenveen",3,2,"H",2,1,"H",2.21,3.76,3.24,"2-1","3-2",21,7,13,3,3,0,0,1,9,8,10,9,5,17,19,"9-8","Y","Y","Y",3,1,3
"4126","N1",2023-09-02,"Waalwijk","PSV Eindhoven",0,4,"A",0,1,"A",8.33,5.63,1.36,"0-1","0-4",10,3,22,9,0,0,0,0,4,8,1,13,4,12,14,"4-8","Y","Y","Y",0,0,3
"4127","N1",2023-09-02,"Heracles","Excelsior",3,1,"H",0,1,"A",1.84,3.92,4.34,"0-1","3-1",15,5,9,3,1,4,0,1,8,1,6,11,4,9,17,"8-1","Y","Y","Y",5,1,4
"4128","N1",2023-09-03,"Utrecht","Feyenoord",1,5,"A",1,2,"A",4.89,4.55,1.65,"1-2","1-5",5,1,21,11,1,0,0,0,5,8,13,13,6,13,26,"5-8","Y","Y","Y",1,0,4
"4129","N1",2023-09-03,"For Sittard","Ajax",0,0,"D",0,0,"D",7.39,5.51,1.4,"0-0","0-0",12,4,12,4,3,2,0,0,3,7,20,7,0,10,27,"3-7","N","N","N",5,0,4
"4130","N1",2023-09-03,"Volendam","Twente",0,2,"A",0,1,"A",5.22,4.57,1.61,"0-1","0-2",7,2,12,4,1,2,0,0,1,5,10,7,2,6,17,"1-5","Y","N","N",3,0,4
"4131","N1",2023-09-03,"Vitesse","AZ Alkmaar",0,2,"A",0,0,"D",3.62,3.83,2.04,"0-0","0-2",4,2,16,7,3,0,0,0,0,9,12,10,2,9,22,"0-9","Y","N","N",3,0,4
"4132","N1",2023-09-16,"Feyenoord","Heerenveen",6,1,"H",3,1,"H",1.24,6.83,12.31,"3-1","6-1",21,9,7,1,1,0,0,0,6,3,8,9,7,9,17,"6-3","Y","Y","Y",1,0,4
"4133","N1",2023-09-16,"Vitesse","Waalwijk",0,2,"A",0,1,"A",1.53,4.75,5.99,"0-1","0-2",16,2,18,9,1,5,1,0,8,6,9,9,2,14,18,"8-6","Y","N","N",6,1,4
"4134","N1",2023-09-16,"For Sittard","Volendam",3,1,"H",0,1,"A",1.66,4.4,4.99,"0-1","3-1",27,11,7,2,1,0,0,0,15,3,9,6,4,18,15,"15-3","Y","Y","Y",1,0,4
"4135","N1",2023-09-16,"PSV Eindhoven","Nijmegen",4,0,"H",2,0,"H",1.17,8.54,15.69,"2-0","4-0",28,11,3,0,1,2,0,0,8,3,11,11,4,11,22,"8-3","Y","Y","Y",3,0,4
"4136","N1",2023-09-16,"Heracles","Utrecht",1,3,"A",0,2,"A",2.56,3.62,2.78,"0-2","1-3",11,1,11,7,3,3,0,0,4,4,12,13,4,8,25,"4-4","Y","Y","Y",6,0,5
"4137","N1",2023-09-17,"Zwolle","Go Ahead Eagles",1,1,"D",0,0,"D",2.45,3.59,2.93,"0-0","1-1",27,11,9,2,1,4,0,1,11,4,9,6,2,15,15,"11-4","Y","N","N",5,1,5
"4138","N1",2023-09-17,"Excelsior","Almere City",0,0,"D",0,0,"D",2.1,4.05,3.23,"0-0","0-0",14,2,16,3,2,3,0,0,4,5,7,13,0,9,20,"4-5","N","N","N",5,0,5
"4139","N1",2023-09-17,"Twente","Ajax",3,1,"H",2,1,"H",2.58,3.72,2.7,"2-1","3-1",24,9,11,2,1,2,0,0,5,9,13,9,4,14,22,"5-9","Y","Y","Y",3,0,5
"4140","N1",2023-09-17,"AZ Alkmaar","Sparta Rotterdam",2,0,"H",2,0,"H",1.53,4.6,6.13,"2-0","2-0",18,7,10,3,0,3,0,0,9,4,8,5,2,13,13,"9-4","Y","N","N",3,0,5
"4141","N1",2023-09-22,"Go Ahead Eagles","For Sittard",3,0,"H",1,0,"H",2.26,3.7,3.17,"1-0","3-0",20,9,21,2,0,4,0,0,2,5,2,14,3,7,16,"2-5","Y","Y","N",4,0,5
"4142","N1",2023-09-23,"Volendam","Heracles",2,2,"D",0,0,"D",2.86,3.81,2.4,"0-0","2-2",16,6,15,5,1,1,0,0,5,7,14,14,4,12,28,"5-7","Y","Y","Y",2,0,5
"4143","N1",2023-09-23,"Nijmegen","Utrecht",3,0,"H",2,0,"H",2.67,3.67,2.63,"2-0","3-0",9,5,17,4,1,2,0,0,4,4,8,11,3,8,19,"4-4","Y","Y","N",3,0,5
"4144","N1",2023-09-23,"Almere City","PSV Eindhoven",0,4,"A",0,2,"A",13.47,7.38,1.21,"0-2","0-4",9,2,20,9,1,1,0,0,5,8,15,6,4,13,21,"5-8","Y","Y","Y",2,0,5
"4145","N1",2023-09-23,"Heerenveen","Excelsior",0,3,"A",0,2,"A",1.67,4.45,4.82,"0-2","0-3",9,2,7,4,4,2,0,0,3,2,10,11,3,5,21,"3-2","Y","Y","N",6,0,6
"4146","N1",2023-09-24,"Sparta Rotterdam","Vitesse",1,0,"H",1,0,"H",1.91,3.91,3.99,"1-0","1-0",17,5,6,0,1,2,0,0,5,3,13,19,1,8,32,"5-3","N","N","N",3,0,6
"4147","N1",2023-09-24,"Waalwijk","Twente",1,0,"H",0,0,"D",5.91,4.58,1.55,"0-0","1-0",9,3,7,2,1,1,0,0,1,6,12,13,1,7,25,"1-6","N","N","N",2,0,6
"4148","N1",2023-09-24,"Zwolle","AZ Alkmaar",0,3,"A",0,1,"A",4.78,3.99,1.75,"0-1","0-3",7,3,15,5,3,3,0,0,2,6,13,8,3,8,21,"2-6","Y","Y","N",6,0,6
"4149","N1",2023-09-27,"Ajax","Feyenoord",0,4,"A",0,3,"A",2.85,3.86,2.39,"0-3","0-4",9,2,14,7,3,2,0,0,4,0,15,14,4,4,29,"4-0","Y","Y","Y",5,0,6
"4150","N1",2023-09-27,"PSV Eindhoven","Go Ahead Eagles",3,0,"H",1,0,"H",1.17,8.61,14.81,"1-0","3-0",23,11,9,2,0,2,0,0,9,2,10,7,3,11,17,"9-2","Y","Y","N",2,0,6
"4151","N1",2023-09-27,"Twente","Vitesse",1,0,"H",1,0,"H",1.4,5.13,8.1,"1-0","1-0",18,5,10,3,1,4,0,0,5,2,10,15,1,7,25,"5-2","N","N","N",5,0,6
"4152","N1",2023-09-28,"AZ Alkmaar","Heracles",1,1,"D",1,0,"H",1.27,6.44,10.66,"1-0","1-1",21,7,4,2,1,2,0,0,16,0,9,8,2,16,17,"16-0","Y","N","N",3,0,6
"4153","N1",2023-09-30,"Feyenoord","Go Ahead Eagles",3,1,"H",1,0,"H",1.16,9.16,15.85,"1-0","3-1",29,9,7,3,1,2,0,0,11,0,10,11,4,11,21,"11-0","Y","Y","Y",3,0,6
"4154","N1",2023-09-30,"PSV Eindhoven","Volendam",3,1,"H",1,0,"H",1.07,16,31.33,"1-0","3-1",38,17,2,1,1,2,0,1,7,0,11,8,4,7,19,"7-0","Y","Y","Y",3,1,7
"4155","N1",2023-09-30,"Utrecht","Almere City",0,2,"A",0,0,"D",1.56,4.65,5.78,"0-0","0-2",11,2,17,5,4,4,1,0,4,6,18,15,2,10,33,"4-6","Y","N","N",8,1,7
"4156","N1",2023-09-30,"Twente","Heerenveen",1,0,"H",0,0,"D",1.36,5.75,8.23,"0-0","1-0",11,3,5,1,3,1,0,0,8,1,10,12,1,9,22,"8-1","N","N","N",4,0,7
"4157","N1",2023-10-01,"Nijmegen","Vitesse",1,3,"A",1,1,"D",2.19,3.82,3.23,"1-1","1-3",9,5,10,5,2,5,0,0,6,5,9,18,4,11,27,"6-5","Y","Y","Y",7,0,7
"4158","N1",2023-10-01,"Excelsior","Sparta Rotterdam",2,1,"H",0,0,"D",3.59,3.59,2.12,"0-0","2-1",15,7,9,5,4,1,0,0,2,7,9,12,3,9,21,"2-7","Y","Y","N",5,0,7
"4159","N1",2023-10-01,"Heracles","Zwolle",2,1,"H",0,0,"D",2.29,3.82,3.03,"0-0","2-1",13,6,13,5,1,3,0,0,2,2,8,12,3,4,20,"2-2","Y","Y","N",4,0,7
"4160","N1",2023-10-01,"AZ Alkmaar","For Sittard",4,0,"H",1,0,"H",1.39,5.44,7.8,"1-0","4-0",12,7,8,1,1,3,0,0,1,3,14,12,4,4,26,"1-3","Y","Y","Y",4,0,7
"4161","N1",2023-10-06,"Volendam","Utrecht",1,0,"H",0,0,"D",3.93,4.23,1.85,"0-0","1-0",15,5,7,3,3,2,0,1,6,0,20,11,1,6,31,"6-0","N","N","N",5,1,7
"4162","N1",2023-10-07,"Heerenveen","Nijmegen",1,1,"D",1,1,"D",2.18,3.7,3.34,"1-1","1-1",18,7,9,3,1,0,0,0,7,1,4,12,2,8,16,"7-1","Y","N","N",1,0,7
"4163","N1",2023-10-07,"Almere City","Waalwijk",1,0,"H",1,0,"H",2.37,3.92,2.85,"1-0","1-0",18,6,13,4,1,1,0,0,4,3,12,8,1,7,20,"4-3","N","N","N",2,0,8
"4164","N1",2023-10-07,"Go Ahead Eagles","Heracles",4,0,"H",2,0,"H",1.84,4.12,4.11,"2-0","4-0",22,13,17,8,0,2,0,0,9,5,10,11,4,14,21,"9-5","Y","Y","Y",2,0,8
"4165","N1",2023-10-07,"Vitesse","Excelsior",0,0,"D",0,0,"D",1.78,4.2,4.38,"0-0","0-0",21,7,11,5,2,0,0,0,11,5,9,10,0,16,19,"11-5","N","N","N",2,0,8
"4166","N1",2023-10-08,"Zwolle","Feyenoord",0,2,"A",0,1,"A",9.24,6,1.31,"0-1","0-2",4,1,13,5,1,0,0,0,3,4,11,6,2,7,17,"3-4","Y","N","N",1,0,8
"4167","N1",2023-10-08,"Ajax","AZ Alkmaar",1,2,"A",0,1,"A",2.26,3.98,2.98,"0-1","1-2",6,1,12,4,2,1,0,0,6,4,7,12,3,10,19,"6-4","Y","Y","N",3,0,8
"4168","N1",2023-10-08,"For Sittard","Twente",0,3,"A",0,1,"A",3.95,3.83,1.94,"0-1","0-3",3,1,15,6,2,2,1,0,3,7,13,16,3,10,29,"3-7","Y","Y","N",4,1,8
"4169","N1",2023-10-08,"Sparta Rotterdam","PSV Eindhoven",0,4,"A",0,0,"D",8.72,5.45,1.36,"0-0","0-4",8,3,30,11,3,1,0,0,1,8,12,14,4,9,26,"1-8","Y","Y","Y",4,0,8
"4170","N1",2023-10-21,"PSV Eindhoven","For Sittard",3,1,"H",1,0,"H",1.11,12.4,21.49,"1-0","3-1",18,6,2,1,0,1,0,0,10,1,8,5,4,11,13,"10-1","Y","Y","Y",1,0,8
"4171","N1",2023-10-21,"Waalwijk","Volendam",2,1,"H",1,0,"H",1.72,4.63,4.3,"1-0","2-1",10,4,11,3,3,2,0,0,3,4,6,10,3,7,16,"3-4","Y","Y","N",5,0,8
"4172","N1",2023-10-21,"Nijmegen","Almere City",1,1,"D",0,1,"A",1.89,3.86,4.15,"0-1","1-1",12,4,14,2,2,2,1,0,6,5,11,19,2,11,30,"6-5","Y","N","N",4,1,9
"4173","N1",2023-10-21,"AZ Alkmaar","Heerenveen",3,0,"H",1,0,"H",1.29,6.16,10.42,"1-0","3-0",11,3,9,3,1,1,0,0,6,3,3,10,3,9,13,"6-3","Y","Y","N",2,0,9
"4174","N1",2023-10-21,"Feyenoord","Vitesse",4,0,"H",2,0,"H",1.15,9.03,17.56,"2-0","4-0",23,8,4,1,0,1,0,0,9,2,9,6,4,11,15,"9-2","Y","Y","Y",1,0,9
"4175","N1",2023-10-22,"Utrecht","Ajax",4,3,"H",1,0,"H",3.69,4.1,1.94,"1-0","4-3",14,8,11,6,1,2,0,0,6,5,11,9,7,11,20,"6-5","Y","Y","Y",3,0,9
"4176","N1",2023-10-22,"Excelsior","Zwolle",2,4,"A",1,0,"H",2.45,3.69,2.84,"1-0","2-4",18,6,11,6,0,2,0,0,2,4,8,10,6,6,18,"2-4","Y","Y","Y",2,0,9
"4177","N1",2023-10-22,"Heracles","Twente",2,2,"D",0,2,"A",5.38,4.34,1.63,"0-2","2-2",16,3,17,5,1,4,0,0,6,6,21,14,4,12,35,"6-6","Y","Y","Y",5,0,9
"4178","N1",2023-10-22,"Go Ahead Eagles","Sparta Rotterdam",0,0,"D",0,0,"D",2.2,3.71,3.28,"0-0","0-0",16,6,15,6,0,0,0,0,3,6,4,10,0,9,14,"3-6","N","N","N",0,0,9
"4179","N1",2023-10-27,"Vitesse","Zwolle",1,1,"D",0,1,"A",2.05,3.72,3.68,"0-1","1-1",29,12,5,2,0,1,0,0,18,2,7,12,2,20,19,"18-2","Y","N","N",1,0,9
"4180","N1",2023-10-28,"Heerenveen","Heracles",3,0,"H",2,0,"H",1.98,3.93,3.72,"2-0","3-0",18,9,9,3,2,2,0,0,10,4,11,9,3,14,20,"10-4","Y","Y","N",4,0,9
"4181","N1",2023-10-28,"Almere City","Go Ahead Eagles",0,0,"D",0,0,"D",2.8,3.59,2.55,"0-0","0-0",12,1,9,3,1,0,0,0,6,5,19,7,0,11,26,"6-5","N","N","N",1,0,10
"4182","N1",2023-10-28,"Sparta Rotterdam","Waalwijk",2,0,"H",0,0,"D",1.75,4,4.79,"0-0","2-0",15,4,11,3,2,1,1,0,8,4,7,7,2,12,14,"8-4","Y","N","N",3,1,10
"4183","N1",2023-10-28,"For Sittard","Utrecht",0,0,"D",0,0,"D",2.51,3.68,2.79,"0-0","0-0",12,6,12,3,1,1,0,0,5,5,7,5,0,10,12,"5-5","N","N","N",2,0,10
"4184","N1",2023-10-29,"Twente","Feyenoord",2,1,"H",1,0,"H",3.17,3.73,2.25,"1-0","2-1",12,5,11,6,5,1,0,0,2,5,12,16,3,7,28,"2-5","Y","Y","N",6,0,10
"4185","N1",2023-10-29,"PSV Eindhoven","Ajax",5,2,"H",1,2,"A",1.31,6.24,8.94,"1-2","5-2",26,9,16,7,1,2,0,0,5,5,9,8,7,10,17,"5-5","Y","Y","Y",3,0,10
"4186","N1",2023-10-29,"Volendam","Excelsior",3,1,"H",0,1,"A",2.77,3.9,2.44,"0-1","3-1",20,12,10,2,1,2,0,0,8,6,5,13,4,14,18,"8-6","Y","Y","Y",3,0,10
"4187","N1",2023-11-02,"Ajax","Volendam",2,0,"H",0,0,"D",1.31,6.42,8.49,"0-0","2-0",30,10,7,3,0,1,0,0,9,4,6,6,2,13,12,"9-4","Y","N","N",1,0,10
"4188","N1",2023-11-04,"Heracles","PSV Eindhoven",0,6,"A",0,2,"A",12.28,7.36,1.22,"0-2","0-6",7,1,34,11,1,0,1,0,1,7,9,7,6,8,16,"1-7","Y","Y","Y",1,1,10
"4189","N1",2023-11-04,"Excelsior","AZ Alkmaar",1,1,"D",0,0,"D",7.81,5.17,1.41,"0-0","1-1",15,5,11,4,2,3,0,0,3,7,11,9,2,10,20,"3-7","Y","N","N",5,0,10
"4190","N1",2023-11-04,"Waalwijk","Feyenoord",1,2,"A",1,1,"D",13.32,7.51,1.21,"1-1","1-2",5,1,27,12,0,2,1,0,2,10,6,5,3,12,11,"2-10","Y","Y","N",2,1,11
"4191","N1",2023-11-04,"Go Ahead Eagles","Vitesse",5,1,"H",1,0,"H",1.96,3.91,3.81,"1-0","5-1",22,14,13,3,0,4,0,0,4,6,5,13,6,10,18,"4-6","Y","Y","Y",4,0,11
"4192","N1",2023-11-05,"Utrecht","Twente",1,1,"D",1,1,"D",4.98,4.06,1.71,"1-1","1-1",14,6,10,1,3,4,0,1,5,2,6,10,2,7,16,"5-2","Y","N","N",7,1,11
"4193","N1",2023-11-05,"Nijmegen","Volendam",3,3,"D",1,1,"D",1.63,4.42,5.21,"1-1","3-3",13,7,15,7,4,2,1,0,8,4,6,11,6,12,17,"8-4","Y","Y","Y",6,1,11
"4194","N1",2023-11-05,"Zwolle","For Sittard",2,0,"H",1,0,"H",2.23,3.68,3.25,"1-0","2-0",15,6,8,2,3,1,0,0,2,2,11,9,2,4,20,"2-2","Y","N","N",4,0,11
"4195","N1",2023-11-05,"Ajax","Heerenveen",4,1,"H",2,1,"H",1.5,5.4,5.64,"2-1","4-1",14,8,12,3,1,2,0,0,5,8,10,8,5,13,18,"5-8","Y","Y","Y",3,0,11
"4196","N1",2023-11-05,"Sparta Rotterdam","Almere City",1,2,"A",0,1,"A",1.71,4.27,4.71,"0-1","1-2",24,6,11,4,0,0,0,0,10,3,2,13,3,13,15,"10-3","Y","Y","N",0,0,11
"4197","N1",2023-11-10,"For Sittard","Heracles",4,1,"H",4,0,"H",1.76,4.06,4.61,"4-0","4-1",15,8,7,3,0,4,0,0,9,7,10,10,5,16,20,"9-7","Y","Y","Y",4,0,11
"4198","N1",2023-11-11,"Waalwijk","Go Ahead Eagles",0,1,"A",0,1,"A",2.89,3.74,2.42,"0-1","0-1",19,5,9,2,1,0,0,0,7,0,8,5,1,7,13,"7-0","N","N","N",1,0,11
"4199","N1",2023-11-11,"Twente","Nijmegen",3,3,"D",1,0,"H",1.32,5.81,9.83,"1-0","3-3",35,7,14,8,1,3,0,0,13,3,9,14,6,16,23,"13-3","Y","Y","Y",4,0,12
"4200","N1",2023-11-11,"Vitesse","Heerenveen",1,3,"A",1,1,"D",2.38,3.7,2.97,"1-1","1-3",9,5,19,7,2,1,1,0,4,7,10,3,4,11,13,"4-7","Y","Y","Y",3,1,12
"4201","N1",2023-11-12,"PSV Eindhoven","Zwolle",4,0,"H",2,0,"H",1.1,12.68,22.26,"2-0","4-0",21,6,3,2,0,2,0,0,12,0,8,7,4,12,15,"12-0","Y","Y","Y",2,0,12
"4202","N1",2023-11-12,"Almere City","Ajax",2,2,"D",0,0,"D",5.43,4.87,1.56,"0-0","2-2",13,5,22,13,5,2,0,0,4,6,12,10,4,10,22,"4-6","Y","Y","Y",7,0,12
"4203","N1",2023-11-12,"Volendam","Sparta Rotterdam",1,4,"A",1,2,"A",3.28,3.9,2.14,"1-2","1-4",17,1,16,7,0,1,0,0,3,5,4,10,5,8,14,"3-5","Y","Y","Y",1,0,12
"4204","N1",2023-11-12,"Feyenoord","AZ Alkmaar",1,0,"H",1,0,"H",1.57,4.62,5.58,"1-0","1-0",10,5,7,1,2,1,0,0,2,0,8,13,1,2,21,"2-0","N","N","N",3,0,12
"4205","N1",2023-11-12,"Utrecht","Excelsior",2,2,"D",0,0,"D",1.73,3.84,4,"0-0","2-2",13,6,12,6,0,1,0,0,13,2,6,11,4,15,17,"13-2","Y","Y","Y",1,0,12
"4206","N1",2023-11-25,"Excelsior","Feyenoord",2,4,"A",1,1,"D",12.46,7.59,1.21,"1-1","2-4",13,3,20,9,1,1,0,0,2,5,5,9,6,7,14,"2-5","Y","Y","Y",2,0,12
"4207","N1",2023-11-25,"Heerenveen","For Sittard",3,0,"H",1,0,"H",2.09,3.63,3.64,"1-0","3-0",16,5,10,4,1,2,0,0,3,7,8,6,3,10,14,"3-7","Y","Y","N",3,0,12
"4208","N1",2023-11-25,"Twente","PSV Eindhoven",0,3,"A",0,1,"A",3.75,3.9,1.98,"0-1","0-3",12,1,17,7,1,2,1,0,3,4,9,8,3,7,17,"3-4","Y","Y","N",3,1,13
"4209","N1",2023-11-25,"Ajax","Vitesse",5,0,"H",2,0,"H",1.31,6.35,8.36,"2-0","5-0",19,12,9,4,1,2,0,0,7,4,9,5,5,11,14,"7-4","Y","Y","Y",3,0,13
"4210","N1",2023-11-25,"Zwolle","Waalwijk",1,2,"A",1,1,"D",1.82,4.01,4.34,"1-1","1-2",17,6,13,4,1,2,0,0,5,8,7,12,3,13,19,"5-8","Y","Y","N",3,0,13
"4211","N1",2023-11-26,"Almere City","Heracles",0,5,"A",0,1,"A",2.01,3.85,3.68,"0-1","0-5",17,3,17,6,0,3,0,0,6,4,6,15,5,10,21,"6-4","Y","Y","Y",3,0,13
"4212","N1",2023-11-26,"AZ Alkmaar","Volendam",3,0,"H",1,0,"H",1.15,9.34,16.26,"1-0","3-0",19,8,7,1,0,0,0,0,5,4,6,8,3,9,14,"5-4","Y","Y","N",0,0,13
"4213","N1",2023-11-26,"Nijmegen","Go Ahead Eagles",1,1,"D",0,0,"D",2.42,3.81,2.82,"0-0","1-1",15,5,13,4,0,3,0,0,4,10,9,11,2,14,20,"4-10","Y","N","N",3,0,13
"4214","N1",2023-11-26,"Sparta Rotterdam","Utrecht",1,2,"A",1,1,"D",2.45,3.42,3.06,"1-1","1-2",19,6,7,2,0,3,0,0,5,4,9,6,3,9,15,"5-4","Y","Y","N",3,0,13
"4215","N1",2023-12-01,"Heerenveen","Almere City",3,0,"H",2,0,"H",1.68,4.05,5.25,"2-0","3-0",15,8,13,2,1,2,0,0,7,8,6,12,3,15,18,"7-8","Y","Y","N",3,0,13
"4216","N1",2023-12-02,"Volendam","Zwolle",0,5,"A",0,0,"D",2.68,3.72,2.59,"0-0","0-5",9,3,20,10,2,0,0,0,6,5,5,4,5,11,9,"6-5","Y","Y","Y",2,0,13
"4217","N1",2023-12-02,"For Sittard","Vitesse",3,1,"H",2,0,"H",2.02,3.63,3.86,"2-0","3-1",15,11,8,4,1,3,0,1,5,4,16,14,4,9,30,"5-4","Y","Y","Y",4,1,14
"4218","N1",2023-12-02,"Waalwijk","Excelsior",2,2,"D",1,0,"H",2.12,3.92,3.31,"1-0","2-2",17,8,13,6,0,0,0,0,2,2,4,4,4,4,8,"2-2","Y","Y","Y",0,0,14
"4219","N1",2023-12-02,"Heracles","Sparta Rotterdam",0,1,"A",0,0,"D",2.68,3.75,2.58,"0-0","0-1",13,3,10,4,1,0,0,0,6,3,11,7,1,9,18,"6-3","N","N","N",1,0,14
"4220","N1",2023-12-03,"Feyenoord","PSV Eindhoven",1,2,"A",0,0,"D",2.22,3.93,3.1,"0-0","1-2",14,3,14,7,1,3,0,0,10,5,10,13,3,15,23,"10-5","Y","Y","N",4,0,14
"4221","N1",2023-12-03,"Go Ahead Eagles","Twente",1,3,"A",0,2,"A",3.87,3.82,1.96,"0-2","1-3",15,9,13,5,1,0,0,0,4,4,7,17,4,8,24,"4-4","Y","Y","Y",1,0,14
"4222","N1",2023-12-03,"Nijmegen","Ajax",1,2,"A",0,0,"D",4.32,4.39,1.75,"0-0","1-2",7,3,22,10,0,0,0,0,2,6,4,7,3,8,11,"2-6","Y","Y","N",0,0,14
"4223","N1",2023-12-03,"Utrecht","AZ Alkmaar",1,1,"D",0,1,"A",4.24,3.75,1.9,"0-1","1-1",15,4,20,9,0,1,0,0,7,5,10,13,2,12,23,"7-5","Y","N","N",1,0,14
"4224","N1",2023-12-06,"AZ Alkmaar","Nijmegen",1,2,"A",0,2,"A",1.28,6.15,10.59,"0-2","1-2",26,4,4,2,0,1,0,0,13,1,4,6,3,14,10,"13-1","Y","Y","N",1,0,14
"4225","N1",2023-12-06,"Waalwijk","Ajax",2,3,"A",1,2,"A",5.15,4.57,1.62,"1-2","2-3",10,2,16,6,2,0,0,0,8,9,12,9,5,17,21,"8-9","Y","Y","Y",2,0,14
"4226","N1",2023-12-07,"PSV Eindhoven","Heerenveen",2,0,"H",1,0,"H",1.17,9.01,14.21,"1-0","2-0",30,8,12,1,2,1,0,0,11,2,4,10,2,13,14,"11-2","Y","N","N",3,0,15
"4227","N1",2023-12-07,"Feyenoord","Volendam",3,1,"H",1,1,"D",1.06,17.73,29.18,"1-1","3-1",30,10,2,2,1,1,0,0,12,3,4,5,4,15,9,"12-3","Y","Y","Y",2,0,15
"4228","N1",2023-12-08,"Twente","Excelsior",4,2,"H",1,2,"A",1.26,6.73,10.6,"1-2","4-2",31,9,5,4,2,4,0,1,10,2,5,7,6,12,12,"10-2","Y","Y","Y",6,1,15
"4229","N1",2023-12-09,"Ajax","Sparta Rotterdam",2,1,"H",2,0,"H",1.4,5.68,7.01,"2-0","2-1",23,6,10,2,0,1,0,0,7,7,6,7,3,14,13,"7-7","Y","Y","N",1,0,15
"4230","N1",2023-12-09,"Zwolle","Nijmegen",1,3,"A",0,1,"A",2.34,3.69,3.04,"0-1","1-3",16,3,17,9,1,0,0,0,1,6,12,3,4,7,15,"1-6","Y","Y","Y",1,0,15
"4231","N1",2023-12-09,"AZ Alkmaar","Almere City",4,1,"H",1,0,"H",1.19,7.88,14.68,"1-0","4-1",13,7,13,6,2,5,0,0,6,5,9,17,5,11,26,"6-5","Y","Y","Y",7,0,15
"4232","N1",2023-12-10,"Go Ahead Eagles","Utrecht",0,2,"A",0,2,"A",2.22,3.62,3.32,"0-2","0-2",22,7,12,3,0,0,0,0,11,1,8,7,2,12,15,"11-1","Y","N","N",0,0,15
"4233","N1",2023-12-10,"For Sittard","Waalwijk",1,0,"H",0,0,"D",1.95,3.82,3.91,"0-0","1-0",11,3,13,2,2,2,0,0,9,6,9,10,1,15,19,"9-6","N","N","N",4,0,15
"4234","N1",2023-12-10,"Vitesse","Heracles",2,0,"H",1,0,"H",2.04,3.78,3.65,"1-0","2-0",12,2,12,3,2,1,0,0,3,5,12,7,2,8,19,"3-5","Y","N","N",3,0,15
"4235","N1",2023-12-15,"Nijmegen","For Sittard",4,1,"H",2,0,"H",2.03,3.59,3.9,"2-0","4-1",16,7,11,4,3,2,1,1,5,7,11,12,5,12,23,"5-7","Y","Y","Y",5,2,16
"4236","N1",2023-12-16,"Utrecht","Waalwijk",1,1,"D",1,1,"D",1.66,4.21,5.26,"1-1","1-1",17,6,12,4,0,4,0,0,10,4,13,13,2,14,26,"10-4","Y","N","N",4,0,16
"4237","N1",2023-12-16,"Excelsior","Go Ahead Eagles",1,1,"D",0,0,"D",3.04,3.85,2.28,"0-0","1-1",11,3,11,5,0,2,0,0,1,4,6,7,2,5,13,"1-4","Y","N","N",2,0,16
"4238","N1",2023-12-16,"Heerenveen","Volendam",1,2,"A",0,1,"A",1.38,5.43,8.25,"0-1","1-2",20,7,3,2,1,2,0,0,19,2,7,10,3,21,17,"19-2","Y","Y","N",3,0,16
"4239","N1",2023-12-17,"Almere City","Vitesse",5,0,"H",2,0,"H",2.43,3.69,2.9,"2-0","5-0",11,7,7,4,0,0,0,0,6,2,16,16,5,8,32,"6-2","Y","Y","Y",0,0,16
"4240","N1",2023-12-17,"Heracles","Feyenoord",0,4,"A",0,2,"A",11.93,7.62,1.22,"0-2","0-4",2,0,26,12,3,0,0,0,3,10,12,10,4,13,22,"3-10","Y","Y","Y",3,0,16
"4241","N1",2023-12-17,"Sparta Rotterdam","Twente",2,2,"D",0,1,"A",4.4,3.81,1.85,"0-1","2-2",12,8,39,9,2,1,1,0,3,14,11,7,4,17,18,"3-14","Y","Y","Y",3,1,16
"4242","N1",2023-12-17,"Ajax","Zwolle",2,2,"D",1,0,"H",1.28,6.57,9.45,"1-0","2-2",16,5,11,4,1,3,0,0,5,0,5,10,4,5,15,"5-0","Y","Y","Y",4,0,16
"4243","N1",2023-12-17,"AZ Alkmaar","PSV Eindhoven",0,4,"A",0,3,"A",4.16,4,1.85,"0-3","0-4",1,0,23,8,2,0,0,0,1,5,11,12,4,6,23,"1-5","Y","Y","Y",2,0,16
"4244","N1",2024-01-12,"Waalwijk","Heracles",1,2,"A",0,1,"A",1.88,3.7,4.39,"0-1","1-2",18,8,9,2,1,1,0,0,7,4,13,8,3,11,21,"7-4","Y","Y","N",2,0,17
"4245","N1",2024-01-13,"For Sittard","Sparta Rotterdam",0,2,"A",0,1,"A",2.42,3.49,3.06,"0-1","0-2",25,6,10,7,3,1,0,0,7,2,8,8,2,9,16,"7-2","Y","N","N",4,0,17
"4246","N1",2024-01-13,"Twente","AZ Alkmaar",2,1,"H",1,1,"D",2.25,3.5,3.35,"1-1","2-1",19,8,5,2,3,2,0,0,5,3,9,12,3,8,21,"5-3","Y","Y","N",5,0,17
"4247","N1",2024-01-13,"Zwolle","Heerenveen",2,2,"D",0,1,"A",2.67,3.74,2.59,"0-1","2-2",13,5,20,10,1,2,0,0,4,6,13,10,4,10,23,"4-6","Y","Y","Y",3,0,17
"4248","N1",2024-01-13,"PSV Eindhoven","Excelsior",3,1,"H",2,0,"H",1.08,13.45,27.67,"2-0","3-1",27,15,8,3,0,0,0,0,12,2,2,3,4,14,5,"12-2","Y","Y","Y",0,0,17
"4249","N1",2024-01-14,"Volendam","Almere City",0,1,"A",0,1,"A",2.69,3.66,2.61,"0-1","0-1",5,2,10,2,1,1,0,0,5,4,11,12,1,9,23,"5-4","N","N","N",2,0,17
"4250","N1",2024-01-14,"Go Ahead Eagles","Ajax",2,3,"A",1,2,"A",3.74,4.28,1.89,"1-2","2-3",24,12,17,6,0,2,0,0,6,4,7,10,5,10,17,"6-4","Y","Y","Y",2,0,17
"4251","N1",2024-01-14,"Vitesse","Utrecht",0,0,"D",0,0,"D",3.07,3.61,2.36,"0-0","0-0",12,6,20,4,1,1,0,0,1,14,11,12,0,15,23,"1-14","N","N","N",2,0,17
"4252","N1",2024-01-14,"Feyenoord","Nijmegen",2,2,"D",2,1,"H",1.15,9.41,16.2,"2-1","2-2",25,5,2,2,2,2,0,0,9,0,8,13,4,9,21,"9-0","Y","Y","Y",4,0,17
"4253","N1",2024-01-19,"Excelsior","Heerenveen",3,0,"H",2,0,"H",3.25,3.71,2.22,"2-0","3-0",14,7,9,1,2,1,0,0,6,5,11,7,3,11,18,"6-5","Y","Y","N",3,0,18
"4254","N1",2024-01-20,"Nijmegen","Twente",1,0,"H",0,0,"D",4.43,3.95,1.81,"0-0","1-0",23,8,11,2,0,1,0,1,6,5,7,11,1,11,18,"6-5","N","N","N",1,1,18
"4255","N1",2024-01-20,"Heracles","Volendam",1,1,"D",0,1,"A",1.75,4.14,4.6,"0-1","1-1",16,8,10,2,1,0,0,0,9,3,8,8,2,12,16,"9-3","Y","N","N",1,0,18
"4256","N1",2024-01-20,"AZ Alkmaar","Zwolle",2,2,"D",0,0,"D",1.36,5.66,8.15,"0-0","2-2",19,8,8,5,2,0,0,0,11,3,8,5,4,14,13,"11-3","Y","Y","Y",2,0,18
"4257","N1",2024-01-21,"Utrecht","PSV Eindhoven",1,1,"D",0,1,"A",8.14,5.97,1.35,"0-1","1-1",17,4,13,5,2,1,0,0,7,3,15,5,2,10,20,"7-3","Y","N","N",3,0,18
"4258","N1",2024-01-21,"Sparta Rotterdam","Go Ahead Eagles",0,2,"A",0,1,"A",2.22,3.71,3.25,"0-1","0-2",20,4,7,3,0,3,0,0,5,1,11,14,2,6,25,"5-1","Y","N","N",3,0,18
"4259","N1",2024-01-21,"Vitesse","Feyenoord",1,2,"A",0,1,"A",11.71,6.9,1.24,"0-1","1-2",5,1,16,5,3,3,0,0,1,4,18,9,3,5,27,"1-4","Y","Y","N",6,0,18
"4260","N1",2024-01-21,"Ajax","Waalwijk",4,1,"H",2,1,"H",1.27,6.92,9.69,"2-1","4-1",14,7,8,5,1,0,0,0,6,0,8,10,5,6,18,"6-0","Y","Y","Y",1,0,18
"4261","N1",2024-01-24,"Almere City","For Sittard",0,0,"D",0,0,"D",2.47,3.49,2.98,"0-0","0-0",4,1,11,2,2,1,0,0,3,2,9,13,0,5,22,"3-2","N","N","N",3,0,18
"4262","N1",2024-01-26,"Zwolle","Vitesse",1,0,"H",1,0,"H",2.01,3.78,3.75,"1-0","1-0",16,9,8,2,3,2,0,0,5,4,10,12,1,9,22,"5-4","N","N","N",5,0,19
"4263","N1",2024-01-27,"PSV Eindhoven","Almere City",2,0,"H",1,0,"H",1.09,13.74,24,"1-0","2-0",17,8,4,2,0,2,0,0,4,1,5,15,2,5,20,"4-1","Y","N","N",2,0,19
"4264","N1",2024-01-27,"Waalwijk","Sparta Rotterdam",1,1,"D",0,0,"D",2.64,3.64,2.67,"0-0","1-1",10,2,15,7,5,2,1,0,3,3,21,6,2,6,27,"3-3","Y","N","N",7,1,19
"4265","N1",2024-01-27,"Excelsior","Utrecht",1,1,"D",0,0,"D",3.19,3.8,2.22,"0-0","1-1",9,5,16,3,0,0,0,0,5,8,3,5,2,13,8,"5-8","Y","N","N",0,0,19
"4266","N1",2024-01-27,"Heracles","Ajax",2,4,"A",1,1,"D",6.3,5.06,1.48,"1-1","2-4",13,7,31,12,2,1,0,0,3,11,9,5,6,14,14,"3-11","Y","Y","Y",3,0,19
"4267","N1",2024-01-28,"Heerenveen","AZ Alkmaar",2,2,"D",1,1,"D",3.57,3.82,2.06,"1-1","2-2",16,2,12,2,2,2,0,1,4,5,11,10,4,9,21,"4-5","Y","Y","Y",4,1,19
"4268","N1",2024-01-28,"Feyenoord","Twente",0,0,"D",0,0,"D",1.46,4.94,6.97,"0-0","0-0",23,6,2,0,0,1,0,0,9,0,8,6,0,9,14,"9-0","N","N","N",1,0,19
"4269","N1",2024-01-28,"Go Ahead Eagles","Nijmegen",2,2,"D",0,1,"A",2.17,3.78,3.3,"0-1","2-2",17,5,16,5,2,4,0,0,9,5,10,13,4,14,23,"9-5","Y","Y","Y",6,0,19
"4270","N1",2024-01-28,"Volendam","For Sittard",0,1,"A",0,0,"D",3.35,3.59,2.22,"0-0","0-1",8,2,12,1,2,1,0,0,7,2,7,10,1,9,17,"7-2","N","N","N",3,0,19
"4271","N1",2024-02-02,"Almere City","Excelsior",2,1,"H",1,1,"D",2.2,3.39,3.6,"1-1","2-1",11,2,8,4,1,3,0,0,7,3,9,14,3,10,23,"7-3","Y","Y","N",4,0,20
"4272","N1",2024-02-03,"Twente","Waalwijk",3,0,"H",1,0,"H",1.3,6.15,9.86,"1-0","3-0",16,10,14,5,0,1,0,0,9,3,5,12,3,12,17,"9-3","Y","Y","N",1,0,20
"4273","N1",2024-02-03,"For Sittard","Heerenveen",3,3,"D",0,2,"A",2.41,3.4,3.15,"0-2","3-3",13,3,10,6,1,2,0,0,6,0,10,13,6,6,23,"6-0","Y","Y","Y",3,0,20
"4274","N1",2024-02-03,"Ajax","PSV Eindhoven",1,1,"D",1,1,"D",3.49,4.27,1.97,"1-1","1-1",13,4,18,5,1,3,0,0,3,5,8,14,2,8,22,"3-5","Y","N","N",4,0,20
"4275","N1",2024-02-03,"Nijmegen","Heracles",3,1,"H",0,1,"A",1.74,4.16,4.64,"0-1","3-1",26,12,7,1,1,1,0,0,7,6,0,7,4,13,7,"7-6","Y","Y","Y",2,0,20
"4276","N1",2024-02-04,"Vitesse","Go Ahead Eagles",0,2,"A",0,1,"A",2.92,3.53,2.49,"0-1","0-2",15,5,16,7,1,1,0,1,5,6,15,14,2,11,29,"5-6","Y","N","N",2,1,20
"4277","N1",2024-02-04,"AZ Alkmaar","Feyenoord",0,1,"A",0,1,"A",4.76,3.9,1.78,"0-1","0-1",14,4,6,2,2,1,0,0,5,2,13,11,1,7,24,"5-2","N","N","N",3,0,20
"4278","N1",2024-02-04,"Utrecht","Volendam",4,2,"H",2,1,"H",1.35,5.5,8.96,"2-1","4-2",24,10,5,3,2,1,0,0,9,2,9,9,6,11,18,"9-2","Y","Y","Y",3,0,20
"4279","N1",2024-02-04,"Sparta Rotterdam","Zwolle",0,2,"A",0,1,"A",1.96,3.76,3.94,"0-1","0-2",21,11,12,4,1,3,0,0,13,3,7,10,2,16,17,"13-3","Y","N","N",4,0,20
"4280","N1",2024-02-09,"Waalwijk","Nijmegen",2,0,"H",2,0,"H",2.9,3.64,2.45,"2-0","2-0",11,4,17,6,2,3,0,0,4,10,11,8,2,14,19,"4-10","Y","N","N",5,0,21
"4281","N1",2024-02-10,"Excelsior","Twente",0,3,"A",0,3,"A",6.08,4.18,1.6,"0-3","0-3",12,3,14,3,1,1,0,0,1,4,5,10,3,5,15,"1-4","Y","Y","N",2,0,21
"4282","N1",2024-02-10,"Almere City","AZ Alkmaar",0,0,"D",0,0,"D",4.8,4.01,1.75,"0-0","0-0",11,1,10,3,2,1,0,0,5,6,19,11,0,11,30,"5-6","N","N","N",3,0,21
"4283","N1",2024-02-10,"Heracles","Vitesse",3,2,"H",1,2,"A",2.1,3.65,3.6,"1-2","3-2",20,8,12,4,1,2,0,1,8,6,6,6,5,14,12,"8-6","Y","Y","Y",3,1,21
"4284","N1",2024-02-11,"Go Ahead Eagles","Zwolle",1,1,"D",0,0,"D",1.75,4.18,4.59,"0-0","1-1",16,4,15,4,2,2,0,0,8,4,9,12,2,12,21,"8-4","Y","N","N",4,0,21
"4285","N1",2024-02-11,"Heerenveen","Ajax",3,2,"H",2,0,"H",4.15,4.57,1.75,"2-0","3-2",17,5,12,6,4,0,0,0,7,4,12,8,5,11,20,"7-4","Y","Y","Y",4,0,21
"4286","N1",2024-02-11,"Utrecht","For Sittard",4,0,"H",1,0,"H",1.78,3.87,4.8,"1-0","4-0",16,8,9,1,0,0,0,0,3,6,12,11,4,9,23,"3-6","Y","Y","Y",0,0,21
"4287","N1",2024-02-11,"Volendam","PSV Eindhoven",1,5,"A",1,1,"D",23.39,12.61,1.1,"1-1","1-5",8,2,34,14,2,1,0,0,4,7,10,3,6,11,13,"4-7","Y","Y","Y",3,0,21
"4288","N1",2024-02-11,"Feyenoord","Sparta Rotterdam",2,0,"H",0,0,"D",1.15,8.99,17.83,"0-0","2-0",23,4,5,1,0,2,0,0,8,4,7,3,2,12,10,"8-4","Y","N","N",2,0,21
"4289","N1",2024-02-16,"PSV Eindhoven","Heracles",2,0,"H",1,0,"H",1.07,15.1,28.52,"1-0","2-0",39,14,3,0,0,3,0,1,15,0,6,8,2,15,14,"15-0","Y","N","N",3,1,22
"4290","N1",2024-02-17,"For Sittard","AZ Alkmaar",1,2,"A",1,0,"H",4.45,3.49,1.93,"1-0","1-2",14,5,19,5,1,1,0,0,3,10,9,9,3,13,18,"3-10","Y","Y","N",2,0,22
"4291","N1",2024-02-17,"Sparta Rotterdam","Excelsior",4,2,"H",2,2,"D",1.85,4.08,4.13,"2-2","4-2",12,9,11,4,4,2,0,0,4,4,12,9,6,8,21,"4-4","Y","Y","Y",6,0,22
"4292","N1",2024-02-17,"Heerenveen","Go Ahead Eagles",0,2,"A",0,0,"D",2.02,3.86,3.65,"0-0","0-2",21,3,14,7,0,2,0,0,3,5,9,13,2,8,22,"3-5","Y","N","N",2,0,22
"4293","N1",2024-02-17,"Zwolle","Almere City",0,1,"A",0,0,"D",2.18,3.45,3.58,"0-0","0-1",16,2,5,2,0,4,0,0,4,2,9,16,1,6,25,"4-2","N","N","N",4,0,22
"4294","N1",2024-02-18,"Twente","Utrecht",0,1,"A",0,1,"A",1.63,4.27,5.48,"0-1","0-1",13,2,4,2,0,1,0,0,11,0,5,12,1,11,17,"11-0","N","N","N",1,0,22
"4295","N1",2024-02-18,"Ajax","Nijmegen",2,2,"D",1,0,"H",1.44,5.34,6.6,"1-0","2-2",8,4,16,9,2,0,0,0,2,5,5,10,4,7,15,"2-5","Y","Y","Y",2,0,22
"4296","N1",2024-02-18,"Vitesse","Volendam",1,1,"D",1,1,"D",1.78,3.9,4.73,"1-1","1-1",30,8,8,4,1,3,0,0,12,3,3,7,2,15,10,"12-3","Y","N","N",4,0,22
"4297","N1",2024-02-18,"Feyenoord","Waalwijk",1,0,"H",0,0,"D",1.1,12.37,22.99,"0-0","1-0",32,14,5,1,0,2,0,1,19,2,6,9,1,21,15,"19-2","N","N","N",2,1,22
"4298","N1",2024-02-23,"Utrecht","Heracles",1,0,"H",0,0,"D",1.4,5.26,8,"0-0","1-0",11,3,4,0,3,2,0,0,9,3,14,10,1,12,24,"9-3","N","N","N",5,0,23
"4299","N1",2024-02-24,"Waalwijk","For Sittard",0,1,"A",0,0,"D",2.5,3.31,3.07,"0-0","0-1",9,0,15,6,0,0,0,0,1,2,13,15,1,3,28,"1-2","N","N","N",0,0,23
"4300","N1",2024-02-24,"Zwolle","PSV Eindhoven",1,7,"A",1,2,"A",12.27,7.54,1.22,"1-2","1-7",8,1,25,12,2,0,0,0,3,7,7,8,8,10,15,"3-7","Y","Y","Y",2,0,23
"4301","N1",2024-02-24,"Nijmegen","Sparta Rotterdam",2,0,"H",2,0,"H",1.96,3.76,3.97,"2-0","2-0",22,5,13,6,1,4,0,0,2,9,16,12,2,11,28,"2-9","Y","N","N",5,0,23
"4302","N1",2024-02-25,"Excelsior","Vitesse",1,2,"A",0,0,"D",2.15,3.62,3.49,"0-0","1-2",12,7,14,5,0,1,0,0,10,11,9,7,3,21,16,"10-11","Y","Y","N",1,0,23
"4303","N1",2024-02-25,"Almere City","Feyenoord",0,2,"A",0,0,"D",10.03,6.07,1.3,"0-0","0-2",12,6,8,2,3,1,0,0,5,5,8,13,2,10,21,"5-5","Y","N","N",4,0,23
"4304","N1",2024-02-25,"Twente","Go Ahead Eagles",3,0,"H",2,0,"H",1.56,4.73,5.62,"2-0","3-0",21,6,10,2,0,2,0,0,6,4,11,9,3,10,20,"6-4","Y","Y","N",2,0,23
"4305","N1",2024-02-25,"AZ Alkmaar","Ajax",2,0,"H",1,0,"H",2,4.05,3.56,"1-0","2-0",8,3,9,3,2,0,0,0,2,1,7,15,2,3,22,"2-1","Y","N","N",2,0,23
"4306","N1",2024-02-25,"Volendam","Heerenveen",0,4,"A",0,1,"A",4.57,4.12,1.76,"0-1","0-4",10,4,22,12,0,0,0,1,4,10,6,10,4,14,16,"4-10","Y","Y","Y",0,1,23
"4307","N1",2024-03-01,"Volendam","Nijmegen",2,5,"A",0,3,"A",5.32,4.48,1.61,"0-3","2-5",14,6,20,11,2,2,0,0,7,5,6,10,7,12,16,"7-5","Y","Y","Y",4,0,24
"4308","N1",2024-03-02,"Go Ahead Eagles","Waalwijk",1,0,"H",0,0,"D",1.71,4.06,4.98,"0-0","1-0",22,8,19,6,0,1,0,0,9,7,15,9,1,16,24,"9-7","N","N","N",1,0,24
"4309","N1",2024-03-02,"Vitesse","Twente",1,2,"A",1,1,"D",5.53,4.15,1.64,"1-1","1-2",6,3,15,5,0,2,0,0,2,8,13,11,3,10,24,"2-8","Y","Y","N",2,0,24
"4310","N1",2024-03-02,"Sparta Rotterdam","AZ Alkmaar",1,1,"D",0,1,"A",4.37,3.67,1.89,"0-1","1-1",14,6,15,4,0,2,0,0,5,6,18,5,2,11,23,"5-6","Y","N","N",2,0,24
"4311","N1",2024-03-03,"Ajax","Utrecht",2,0,"H",1,0,"H",1.83,4.31,3.97,"1-0","2-0",14,8,6,2,1,2,1,0,1,3,11,12,2,4,23,"1-3","Y","N","N",3,1,24
"4312","N1",2024-03-03,"Heerenveen","Zwolle",2,0,"H",1,0,"H",1.66,4.45,4.94,"1-0","2-0",15,6,11,3,3,2,0,0,4,6,18,9,2,10,27,"4-6","Y","N","N",5,0,24
"4313","N1",2024-03-03,"PSV Eindhoven","Feyenoord",2,2,"D",1,1,"D",2.08,3.66,3.65,"1-1","2-2",17,8,9,6,4,3,0,0,9,2,10,10,4,11,20,"9-2","Y","Y","Y",7,0,24
"4314","N1",2024-03-03,"For Sittard","Excelsior",5,2,"H",4,0,"H",1.93,3.7,4.13,"4-0","5-2",17,8,5,2,2,3,0,0,6,1,9,6,7,7,15,"6-1","Y","Y","Y",5,0,24
"4315","N1",2024-03-03,"Heracles","Almere City",2,2,"D",0,2,"A",2.69,3.38,2.78,"0-2","2-2",16,5,14,6,2,3,0,1,5,1,17,12,4,6,29,"5-1","Y","Y","Y",5,1,24
"4316","N1",2024-03-08,"Go Ahead Eagles","PSV Eindhoven",0,1,"A",0,1,"A",6.88,5.39,1.43,"0-1","0-1",12,4,21,11,0,2,0,1,4,9,9,5,1,13,14,"4-9","N","N","N",2,1,25
"4317","N1",2024-03-09,"Twente","Sparta Rotterdam",2,1,"H",1,0,"H",1.43,4.85,7.79,"1-0","2-1",19,5,5,2,1,1,0,0,7,3,7,11,3,10,18,"7-3","Y","Y","N",2,0,25
"4318","N1",2024-03-09,"Almere City","Utrecht",1,1,"D",1,1,"D",3.87,3.35,2.12,"1-1","1-1",9,1,12,4,1,2,0,0,6,7,15,15,2,13,30,"6-7","Y","N","N",3,0,25
"4319","N1",2024-03-09,"Waalwijk","Vitesse",3,1,"H",1,0,"H",2.33,3.58,3.12,"1-0","3-1",17,6,19,5,2,0,0,0,4,5,11,9,4,9,20,"4-5","Y","Y","Y",2,0,25
"4320","N1",2024-03-10,"AZ Alkmaar","Excelsior",4,0,"H",3,0,"H",1.27,6.41,10.85,"3-0","4-0",16,10,4,0,0,1,0,0,3,0,5,9,4,3,14,"3-0","Y","Y","Y",1,0,25
"4321","N1",2024-03-10,"Ajax","For Sittard",2,2,"D",1,0,"H",1.47,4.89,6.74,"1-0","2-2",18,8,9,4,1,0,0,0,10,2,8,12,4,12,20,"10-2","Y","Y","Y",1,0,25
"4322","N1",2024-03-10,"Zwolle","Volendam",1,1,"D",0,0,"D",1.6,4.5,5.43,"0-0","1-1",23,10,10,4,0,1,0,0,8,3,11,2,2,11,13,"8-3","Y","N","N",1,0,25
"4323","N1",2024-03-10,"Nijmegen","Heerenveen",2,0,"H",0,0,"D",2.1,3.66,3.59,"0-0","2-0",12,5,12,0,0,0,0,0,8,6,12,8,2,14,20,"8-6","Y","N","N",0,0,25
"4324","N1",2024-03-10,"Feyenoord","Heracles",3,0,"H",2,0,"H",1.08,15.09,25.91,"2-0","3-0",20,5,3,2,0,0,0,0,9,5,5,5,3,14,10,"9-5","Y","Y","N",0,0,25
"4325","N1",2024-03-15,"Heracles","Go Ahead Eagles",2,0,"H",0,0,"D",3.23,3.68,2.24,"0-0","2-0",11,3,18,4,2,2,0,0,2,8,8,13,2,10,21,"2-8","Y","N","N",4,0,26
"4326","N1",2024-03-16,"For Sittard","Zwolle",3,1,"H",1,0,"H",1.79,4.02,4.47,"1-0","3-1",22,12,5,3,1,3,0,0,7,5,11,9,4,12,20,"7-5","Y","Y","Y",4,0,26
"4327","N1",2024-03-16,"Excelsior","Waalwijk",1,1,"D",1,0,"H",2.3,3.64,3.14,"1-0","1-1",18,5,16,5,1,2,0,0,7,4,11,6,2,11,17,"7-4","Y","N","N",3,0,26
"4328","N1",2024-03-16,"Vitesse","Almere City",1,1,"D",0,1,"A",2.3,3.3,3.44,"0-1","1-1",22,7,8,4,3,3,0,0,8,2,19,13,2,10,32,"8-2","Y","N","N",6,0,26
"4329","N1",2024-03-17,"Volendam","AZ Alkmaar",0,4,"A",0,2,"A",11.26,6.47,1.26,"0-2","0-4",6,2,20,8,0,2,0,0,3,4,8,7,4,7,15,"3-4","Y","Y","Y",2,0,26
"4330","N1",2024-03-17,"Heerenveen","Feyenoord",2,3,"A",1,1,"D",6.28,4.87,1.5,"1-1","2-3",8,3,21,5,1,1,0,0,3,8,8,13,5,11,21,"3-8","Y","Y","Y",2,0,26
"4331","N1",2024-03-17,"Utrecht","Nijmegen",1,0,"H",0,0,"D",1.9,3.86,4.11,"0-0","1-0",14,4,9,5,2,1,0,0,5,4,9,14,1,9,23,"5-4","N","N","N",3,0,26
"4332","N1",2024-03-17,"Sparta Rotterdam","Ajax",2,2,"D",1,0,"H",3.41,3.69,2.16,"1-0","2-2",11,5,13,7,0,1,0,1,2,7,9,5,4,9,14,"2-7","Y","Y","Y",1,1,26
"4333","N1",2024-03-17,"PSV Eindhoven","Twente",1,0,"H",0,0,"D",1.43,5.05,7.32,"0-0","1-0",17,5,11,2,2,4,0,0,4,7,13,7,1,11,20,"4-7","N","N","N",6,0,26
"3867","P1",2023-08-11,"Sp Braga","Famalicao",1,2,"A",1,0,"H",1.45,4.86,7.21,"1-0","1-2",13,2,12,4,4,4,0,0,3,4,17,12,3,7,29,"3-4","Y","Y","N",8,0,1
"3868","P1",2023-08-12,"Gil Vicente","Portimonense",5,0,"H",2,0,"H",2.05,3.38,4.07,"2-0","5-0",8,5,9,3,0,0,0,0,1,1,11,14,5,2,25,"1-1","Y","Y","Y",0,0,1
"3869","P1",2023-08-12,"Farense","Casa Pia",0,3,"A",0,1,"A",2.59,3.07,3.17,"0-1","0-3",12,5,14,5,2,4,0,0,5,6,13,13,3,11,26,"5-6","Y","Y","N",6,0,1
"3870","P1",2023-08-12,"Sp Lisbon","Vizela",3,2,"H",2,0,"H",1.18,7.76,16.94,"2-0","3-2",19,6,10,4,4,0,0,0,8,3,16,9,5,11,25,"8-3","Y","Y","Y",4,0,1
"3871","P1",2023-08-13,"Rio Ave","Chaves",2,0,"H",0,0,"D",2.14,3.37,3.79,"0-0","2-0",21,8,6,1,3,4,0,1,14,3,12,20,2,17,32,"14-3","Y","N","N",7,1,1
"3872","P1",2023-08-13,"Estrela","Guimaraes",0,1,"A",0,1,"A",NA,NA,NA,"0-1","0-1",5,0,11,3,3,3,1,0,3,10,13,18,1,13,31,"3-10","N","N","N",6,1,1
"3873","P1",2023-08-13,"Arouca","Estoril",4,3,"H",1,1,"D",2.22,3.13,3.89,"1-1","4-3",11,5,12,8,4,2,1,0,2,6,11,17,7,8,28,"2-6","Y","Y","Y",6,1,1
"3874","P1",2023-08-14,"Moreirense","Porto",1,2,"A",0,0,"D",8.32,5.36,1.37,"0-0","1-2",8,1,18,7,4,7,0,1,5,10,22,15,3,15,37,"5-10","Y","Y","N",11,1,1
"3875","P1",2023-08-14,"Boavista","Benfica",3,2,"H",0,1,"A",11.02,5.89,1.29,"0-1","3-2",11,3,15,5,6,4,1,1,3,3,18,15,5,6,33,"3-3","Y","Y","Y",10,2,1
"3876","P1",2023-08-18,"Casa Pia","Sp Lisbon",1,2,"A",0,1,"A",7.6,4.77,1.45,"0-1","1-2",13,3,17,5,4,1,0,0,4,5,14,11,3,9,25,"4-5","Y","Y","N",5,0,2
"3877","P1",2023-08-19,"Guimaraes","Gil Vicente",2,1,"H",0,0,"D",2.11,3.39,3.86,"0-0","2-1",15,3,11,3,3,3,0,0,6,4,14,14,3,10,28,"6-4","Y","Y","N",6,0,2
"3878","P1",2023-08-19,"Chaves","Sp Braga",2,4,"A",1,1,"D",4.98,4.2,1.69,"1-1","2-4",15,4,13,6,2,2,1,0,5,6,12,12,6,11,24,"5-6","Y","Y","Y",4,1,2
"3879","P1",2023-08-19,"Benfica","Estrela",2,0,"H",0,0,"D",1.09,13.06,27.99,"0-0","2-0",27,10,6,1,3,3,0,0,9,4,8,14,2,13,22,"9-4","Y","N","N",6,0,2
"3880","P1",2023-08-19,"Portimonense","Boavista",1,4,"A",0,3,"A",2.81,3.18,2.8,"0-3","1-4",10,5,9,6,3,2,0,0,11,2,19,13,5,13,32,"11-2","Y","Y","Y",5,0,2
"3881","P1",2023-08-20,"Estoril","Rio Ave",2,0,"H",0,0,"D",2.54,3.24,3.07,"0-0","2-0",5,4,9,3,4,2,0,0,3,3,14,13,2,6,27,"3-3","Y","N","N",6,0,2
"3882","P1",2023-08-20,"Porto","Farense",2,1,"H",1,1,"D",1.13,9.69,19.53,"1-1","2-1",26,8,7,1,2,3,0,0,17,3,9,11,3,20,20,"17-3","Y","Y","N",5,0,2
"3883","P1",2023-08-20,"Vizela","Arouca",2,2,"D",1,1,"D",2.17,3.31,3.78,"1-1","2-2",13,7,9,2,6,6,1,1,6,3,24,11,4,9,35,"6-3","Y","Y","Y",12,2,2
"3884","P1",2023-08-21,"Famalicao","Moreirense",0,0,"D",0,0,"D",1.95,3.55,4.14,"0-0","0-0",4,2,12,3,4,3,1,0,3,6,15,10,0,9,25,"3-6","N","N","N",7,1,2
"3885","P1",2023-08-25,"Estrela","Estoril",2,1,"H",0,0,"D",2.37,3.19,3.43,"0-0","2-1",15,3,11,4,1,1,0,0,8,8,8,6,3,16,14,"8-8","Y","Y","N",2,0,3
"3886","P1",2023-08-26,"Arouca","Portimonense",1,1,"D",0,1,"A",1.66,4,5.64,"0-1","1-1",21,4,5,2,1,2,0,0,16,2,12,19,2,18,31,"16-2","Y","N","N",3,0,3
"3887","P1",2023-08-26,"Farense","Chaves",5,0,"H",4,0,"H",2.36,3.37,3.25,"4-0","5-0",18,10,19,7,2,1,0,0,7,4,24,15,5,11,39,"7-4","Y","Y","Y",3,0,3
"3888","P1",2023-08-26,"Gil Vicente","Benfica",2,3,"A",0,1,"A",9.93,6.01,1.31,"0-1","2-3",11,7,14,7,3,3,0,0,1,5,15,14,5,6,29,"1-5","Y","Y","Y",6,0,3
"3889","P1",2023-08-27,"Boavista","Casa Pia",1,1,"D",0,1,"A",2.3,3.29,3.45,"0-1","1-1",10,5,10,7,1,0,0,0,11,4,18,14,2,15,32,"11-4","Y","N","N",1,0,3
"3890","P1",2023-08-27,"Guimaraes","Vizela",2,0,"H",0,0,"D",1.93,3.58,4.35,"0-0","2-0",6,3,9,4,1,3,1,0,3,4,11,9,2,7,20,"3-4","Y","N","N",4,1,3
"3891","P1",2023-08-27,"Sp Lisbon","Famalicao",1,0,"H",0,0,"D",1.25,6.56,11.91,"0-0","1-0",10,6,7,1,3,2,0,0,8,1,17,13,1,9,30,"8-1","N","N","N",5,0,3
"3892","P1",2023-08-28,"Rio Ave","Porto",1,2,"A",0,0,"D",7.11,4.83,1.45,"0-0","1-2",4,1,9,5,4,3,0,0,1,7,22,17,3,8,39,"1-7","Y","Y","N",7,0,3
"3893","P1",2023-09-01,"Vizela","Gil Vicente",1,0,"H",0,0,"D",2.27,3.4,3.42,"0-0","1-0",13,5,5,1,0,3,0,0,4,3,20,16,1,7,36,"4-3","N","N","N",3,0,3
"3894","P1",2023-09-02,"Casa Pia","Rio Ave",1,1,"D",1,0,"H",2.22,3.39,3.53,"1-0","1-1",10,5,11,5,1,2,0,0,12,0,18,15,2,12,33,"12-0","Y","N","N",3,0,4
"3895","P1",2023-09-02,"Famalicao","Farense",1,0,"H",0,0,"D",1.79,3.72,4.92,"0-0","1-0",21,4,6,1,1,3,0,1,12,4,16,14,1,16,30,"12-4","N","N","N",4,1,4
"3896","P1",2023-09-02,"Portimonense","Estrela",1,1,"D",1,1,"D",2.7,3.22,2.89,"1-1","1-1",15,4,10,1,3,6,0,0,3,7,12,16,2,10,28,"3-7","Y","N","N",9,0,4
"3897","P1",2023-09-02,"Benfica","Guimaraes",4,0,"H",3,0,"H",1.21,7.46,13.1,"3-0","4-0",20,9,7,1,2,4,0,1,11,2,9,14,4,13,23,"11-2","Y","Y","Y",6,1,4
"3898","P1",2023-09-03,"Chaves","Moreirense",1,2,"A",0,1,"A",2.54,3.34,2.99,"0-1","1-2",13,3,9,2,3,4,0,0,3,4,14,21,3,7,35,"3-4","Y","Y","N",7,0,4
"3899","P1",2023-09-03,"Estoril","Boavista",1,2,"A",1,2,"A",2.48,3.37,3.01,"1-2","1-2",13,4,14,8,3,1,0,0,10,5,21,12,3,15,33,"10-5","Y","Y","N",4,0,4
"3900","P1",2023-09-03,"Porto","Arouca",1,1,"D",0,0,"D",1.26,6.43,11.28,"0-0","1-1",12,3,10,2,3,2,0,0,5,2,9,14,2,7,23,"5-2","Y","N","N",5,0,4
"3901","P1",2023-09-03,"Sp Braga","Sp Lisbon",1,1,"D",0,1,"A",3.04,3.63,2.36,"0-1","1-1",6,2,4,2,2,5,0,0,4,2,16,9,2,6,25,"4-2","Y","N","N",7,0,4
"3902","P1",2023-09-09,"Moreirense","Sp Braga",2,3,"A",2,1,"H",4.28,3.97,1.84,"2-1","2-3",11,3,12,5,2,2,0,0,4,5,12,11,5,9,23,"4-5","Y","Y","Y",4,0,4
"3903","P1",2023-09-15,"Estrela","Porto",0,1,"A",0,1,"A",9.42,5.38,1.35,"0-1","0-1",9,1,10,4,3,5,0,0,10,6,12,21,1,16,33,"10-6","N","N","N",8,0,5
"3904","P1",2023-09-16,"Rio Ave","Famalicao",1,1,"D",0,1,"A",2.66,3.15,3,"0-1","1-1",5,0,12,4,1,3,0,0,3,3,15,20,2,6,35,"3-3","Y","N","N",4,0,5
"3905","P1",2023-09-16,"Farense","Sp Braga",3,1,"H",2,0,"H",4.72,4.26,1.71,"2-0","3-1",16,4,17,7,4,5,0,0,7,3,16,10,4,10,26,"7-3","Y","Y","Y",9,0,5
"3906","P1",2023-09-16,"Vizela","Benfica",1,2,"A",0,2,"A",8.67,5.89,1.34,"0-2","1-2",12,2,17,7,2,1,0,0,2,3,15,6,3,5,21,"2-3","Y","Y","N",3,0,5
"3907","P1",2023-09-17,"Arouca","Casa Pia",0,1,"A",0,0,"D",2.46,3.25,3.19,"0-0","0-1",11,5,12,2,2,3,0,0,2,7,12,7,1,9,19,"2-7","N","N","N",5,0,5
"3908","P1",2023-09-17,"Gil Vicente","Estoril",5,3,"H",3,0,"H",2.18,3.55,3.49,"3-0","5-3",12,7,14,6,3,2,0,0,5,8,11,15,8,13,26,"5-8","Y","Y","Y",5,0,5
"3909","P1",2023-09-17,"Guimaraes","Portimonense",1,2,"A",1,0,"H",1.58,4.21,6.2,"1-0","1-2",11,3,9,2,2,4,0,0,10,3,16,13,3,13,29,"10-3","Y","Y","N",6,0,5
"3910","P1",2023-09-17,"Sp Lisbon","Moreirense",3,0,"H",0,0,"D",1.23,7.02,12.49,"0-0","3-0",20,9,7,1,3,3,0,1,8,2,10,16,3,10,26,"8-2","Y","Y","N",6,1,5
"3911","P1",2023-09-18,"Boavista","Chaves",4,1,"H",4,0,"H",1.74,4.1,4.64,"4-0","4-1",7,4,21,10,1,3,0,0,3,12,12,15,5,15,27,"3-12","Y","Y","Y",4,0,5
"3912","P1",2023-09-22,"Famalicao","Arouca",1,0,"H",1,0,"H",2.04,3.4,4.1,"1-0","1-0",7,4,13,6,5,2,1,1,6,8,15,23,1,14,38,"6-8","N","N","N",7,2,6
"3913","P1",2023-09-23,"Estoril","Vizela",2,2,"D",0,0,"D",2.56,3.48,2.87,"0-0","2-2",16,6,11,7,1,2,0,0,5,3,13,15,4,8,28,"5-3","Y","Y","Y",3,0,6
"3914","P1",2023-09-23,"Moreirense","Farense",1,0,"H",1,0,"H",2.23,3.52,3.39,"1-0","1-0",15,3,10,2,1,2,0,0,11,3,10,17,1,14,27,"11-3","N","N","N",3,0,6
"3915","P1",2023-09-23,"Casa Pia","Guimaraes",0,0,"D",0,0,"D",2.43,3.26,3.23,"0-0","0-0",10,2,14,3,3,2,0,0,8,9,16,11,0,17,27,"8-9","N","N","N",5,0,6
"3916","P1",2023-09-23,"Porto","Gil Vicente",2,1,"H",1,1,"D",1.22,7.32,11.96,"1-1","2-1",20,7,12,4,1,3,0,0,6,3,15,12,3,9,27,"6-3","Y","Y","N",4,0,6
"3917","P1",2023-09-24,"Chaves","Estrela",2,2,"D",0,1,"A",2.73,3.55,2.64,"0-1","2-2",17,8,10,3,4,4,0,1,9,5,11,11,4,14,22,"9-5","Y","Y","Y",8,1,6
"3918","P1",2023-09-24,"Portimonense","Benfica",1,3,"A",0,2,"A",11.17,6.7,1.25,"0-2","1-3",9,2,13,7,1,0,0,0,3,4,7,7,4,7,14,"3-4","Y","Y","Y",1,0,6
"3919","P1",2023-09-24,"Sp Braga","Boavista",4,1,"H",2,1,"H",1.55,4.78,5.69,"2-1","4-1",24,9,6,2,2,3,0,1,6,2,8,9,5,8,17,"6-2","Y","Y","Y",5,1,6
"3920","P1",2023-09-25,"Sp Lisbon","Rio Ave",2,0,"H",2,0,"H",1.2,7.3,13.69,"2-0","2-0",10,6,7,2,1,5,0,0,4,2,14,12,2,6,26,"4-2","Y","N","N",6,0,6
"3921","P1",2023-09-28,"Estrela","Sp Braga",2,4,"A",0,1,"A",4.72,4.16,1.71,"0-1","2-4",17,9,17,9,1,3,0,0,8,6,9,13,6,14,22,"8-6","Y","Y","Y",4,0,7
"3922","P1",2023-09-29,"Benfica","Porto",1,0,"H",0,0,"D",1.93,3.69,4.14,"0-0","1-0",12,2,6,3,4,5,0,1,9,5,18,10,1,14,28,"9-5","N","N","N",9,1,7
"3923","P1",2023-09-30,"Vizela","Portimonense",2,3,"A",0,2,"A",1.83,3.76,4.62,"0-2","2-3",14,4,9,7,3,3,0,0,13,2,11,16,5,15,27,"13-2","Y","Y","Y",6,0,7
"3924","P1",2023-09-30,"Boavista","Famalicao",2,2,"D",1,1,"D",2.21,3.51,3.44,"1-1","2-2",10,6,7,3,5,4,1,2,2,4,23,21,4,6,44,"2-4","Y","Y","Y",9,3,7
"3925","P1",2023-09-30,"Farense","Sp Lisbon",2,3,"A",1,2,"A",6.17,4.58,1.44,"1-2","2-3",9,4,23,10,5,6,1,0,2,8,13,12,5,10,25,"2-8","Y","Y","Y",11,1,7
"3926","P1",2023-10-01,"Arouca","Chaves",0,2,"A",0,0,"D",1.85,3.76,4.39,"0-0","0-2",11,2,5,3,3,5,1,0,5,3,16,10,2,8,26,"5-3","Y","N","N",8,1,7
"3927","P1",2023-10-01,"Guimaraes","Estoril",3,2,"H",0,2,"A",1.85,3.79,4.45,"0-2","3-2",25,8,10,5,4,4,0,1,11,2,16,13,5,13,29,"11-2","Y","Y","Y",8,1,7
"3928","P1",2023-10-01,"Rio Ave","Moreirense",0,4,"A",0,2,"A",2.38,3.46,3.13,"0-2","0-4",10,4,11,6,3,5,0,0,4,2,13,26,4,6,39,"4-2","Y","Y","Y",8,0,7
"3929","P1",2023-10-02,"Gil Vicente","Casa Pia",2,0,"H",0,0,"D",2.41,3.34,3.14,"0-0","2-0",16,9,8,1,3,3,0,1,5,5,10,15,2,10,25,"5-5","Y","N","N",6,1,7
"3930","P1",2023-10-06,"Moreirense","Boavista",1,1,"D",1,1,"D",1.94,3.72,4.07,"1-1","1-1",11,6,8,1,0,3,0,0,6,1,13,13,2,7,26,"6-1","Y","N","N",3,0,8
"3931","P1",2023-10-07,"Chaves","Gil Vicente",4,2,"H",1,2,"A",2.65,3.61,2.68,"1-2","4-2",15,9,9,5,3,3,1,0,6,1,17,14,6,7,31,"6-1","Y","Y","Y",6,1,8
"3932","P1",2023-10-07,"Farense","Vizela",0,0,"D",0,0,"D",2.19,3.58,3.43,"0-0","0-0",20,6,17,6,1,1,0,0,14,6,21,11,0,20,32,"14-6","N","N","N",2,0,8
"3933","P1",2023-10-07,"Sp Braga","Rio Ave",2,1,"H",0,1,"A",1.32,5.88,9.83,"0-1","2-1",33,11,9,3,1,2,0,0,16,1,8,11,3,17,19,"16-1","Y","Y","N",3,0,8
"3934","P1",2023-10-07,"Estoril","Benfica",0,1,"A",0,0,"D",10.21,6.4,1.28,"0-0","0-1",16,4,21,5,3,2,0,0,4,7,15,8,1,11,23,"4-7","N","N","N",5,0,8
"3935","P1",2023-10-08,"Casa Pia","Estrela",0,1,"A",0,0,"D",2.09,3.4,3.9,"0-0","0-1",7,2,11,6,1,1,0,0,3,6,16,8,1,9,24,"3-6","N","N","N",2,0,8
"3936","P1",2023-10-08,"Famalicao","Guimaraes",1,3,"A",0,2,"A",2.71,3.17,2.92,"0-2","1-3",13,6,12,4,4,3,0,0,11,3,15,20,4,14,35,"11-3","Y","Y","Y",7,0,8
"3937","P1",2023-10-08,"Porto","Portimonense",1,0,"H",1,0,"H",1.16,8.85,16.19,"1-0","1-0",18,7,4,2,4,6,1,0,10,5,12,19,1,15,31,"10-5","N","N","N",10,1,8
"3938","P1",2023-10-08,"Sp Lisbon","Arouca",2,1,"H",1,0,"H",1.25,6.6,11.63,"1-0","2-1",10,5,11,5,4,7,1,1,5,2,7,18,3,7,25,"5-2","Y","Y","N",11,2,8
"3939","P1",2023-10-27,"Arouca","Moreirense",0,1,"A",0,1,"A",2.61,3.28,2.94,"0-1","0-1",13,3,12,5,2,2,0,1,7,5,11,14,1,12,25,"7-5","N","N","N",4,1,9
"3940","P1",2023-10-28,"Portimonense","Estoril",1,0,"H",1,0,"H",2.52,3.5,2.9,"1-0","1-0",14,8,14,4,6,1,0,0,6,4,14,8,1,10,22,"6-4","N","N","N",7,0,9
"3941","P1",2023-10-28,"Benfica","Casa Pia",1,1,"D",1,0,"H",1.19,7.53,15.99,"1-0","1-1",13,7,6,3,1,2,0,0,10,2,12,20,2,12,32,"10-2","Y","N","N",3,0,9
"3942","P1",2023-10-28,"Guimaraes","Chaves",5,0,"H",3,0,"H",1.62,4.22,5.63,"3-0","5-0",13,6,7,3,0,3,0,1,4,3,16,6,5,7,22,"4-3","Y","Y","Y",3,1,9
"3943","P1",2023-10-28,"Gil Vicente","Sp Braga",3,3,"D",1,0,"H",4.16,4.28,1.8,"1-0","3-3",13,6,18,7,4,2,0,1,4,9,14,21,6,13,35,"4-9","Y","Y","Y",6,1,9
"3944","P1",2023-10-29,"Rio Ave","Farense",3,4,"A",2,2,"D",2.37,3.45,3.17,"2-2","3-4",11,4,13,7,3,3,0,0,5,6,19,12,7,11,31,"5-6","Y","Y","Y",6,0,9
"3945","P1",2023-10-29,"Estrela","Famalicao",1,0,"H",0,0,"D",2.58,3.29,2.98,"0-0","1-0",12,4,9,1,3,3,0,1,3,2,18,15,1,5,33,"3-2","N","N","N",6,1,9
"3946","P1",2023-10-29,"Vizela","Porto",0,2,"A",0,2,"A",7.81,4.73,1.44,"0-2","0-2",8,1,13,3,3,4,0,0,4,4,16,17,2,8,33,"4-4","Y","N","N",7,0,9
"3947","P1",2023-10-30,"Boavista","Sp Lisbon",0,2,"A",0,1,"A",6.59,4.69,1.49,"0-1","0-2",7,2,14,6,3,2,0,0,4,8,16,13,2,12,29,"4-8","Y","N","N",5,0,9
"3948","P1",2023-11-03,"Porto","Estoril",0,1,"A",0,0,"D",1.17,8.39,15.51,"0-0","0-1",16,4,7,3,5,7,0,0,9,6,16,16,1,15,32,"9-6","N","N","N",12,0,10
"3949","P1",2023-11-04,"Chaves","Benfica",0,2,"A",0,0,"D",9.53,6.19,1.3,"0-0","0-2",8,0,14,5,5,2,0,0,3,8,13,11,2,11,24,"3-8","Y","N","N",7,0,10
"3950","P1",2023-11-04,"Famalicao","Gil Vicente",3,1,"H",2,0,"H",2.09,3.6,3.68,"2-0","3-1",12,5,9,4,3,3,0,0,7,2,11,10,4,9,21,"7-2","Y","Y","Y",6,0,10
"3951","P1",2023-11-04,"Sp Braga","Portimonense",6,1,"H",0,1,"A",1.25,6.8,11,"0-1","6-1",19,10,8,3,1,2,0,0,5,5,10,10,7,10,20,"5-5","Y","Y","Y",3,0,10
"3952","P1",2023-11-05,"Casa Pia","Vizela",0,1,"A",0,0,"D",2.2,3.39,3.6,"0-0","0-1",11,2,14,4,3,3,0,0,6,6,16,17,1,12,33,"6-6","N","N","N",6,0,10
"3953","P1",2023-11-05,"Moreirense","Guimaraes",1,0,"H",0,0,"D",2.75,3.25,2.8,"0-0","1-0",12,3,10,2,1,2,0,0,4,12,10,11,1,16,21,"4-12","N","N","N",3,0,10
"3954","P1",2023-11-05,"Rio Ave","Boavista",2,0,"H",1,0,"H",2.66,3.45,2.74,"1-0","2-0",9,3,10,2,3,2,0,0,3,3,17,15,2,6,32,"3-3","Y","N","N",5,0,10
"3955","P1",2023-11-05,"Sp Lisbon","Estrela",3,2,"H",1,0,"H",1.24,7.12,11.43,"1-0","3-2",23,8,6,4,1,1,0,0,6,1,7,5,5,7,12,"6-1","Y","Y","Y",2,0,10
"3956","P1",2023-11-06,"Farense","Arouca",2,0,"H",2,0,"H",2.25,3.4,3.38,"2-0","2-0",7,2,15,5,1,1,0,0,6,6,16,14,2,12,30,"6-6","Y","N","N",2,0,10
"3957","P1",2023-11-10,"Estoril","Casa Pia",4,0,"H",2,0,"H",2.59,3.26,2.98,"2-0","4-0",18,6,12,3,3,4,0,0,4,7,15,16,4,11,31,"4-7","Y","Y","Y",7,0,11
"3958","P1",2023-11-11,"Portimonense","Chaves",2,1,"H",2,0,"H",2.34,3.44,3.23,"2-0","2-1",12,7,19,8,4,2,0,0,3,8,15,12,3,11,27,"3-8","Y","Y","N",6,0,11
"3959","P1",2023-11-11,"Estrela","Moreirense",0,1,"A",0,0,"D",2.65,3.41,2.8,"0-0","0-1",8,3,12,2,3,6,0,1,2,5,22,17,1,7,39,"2-5","N","N","N",9,1,11
"3960","P1",2023-11-11,"Vizela","Famalicao",0,0,"D",0,0,"D",2.72,3.31,2.8,"0-0","0-0",9,4,13,2,1,3,0,0,5,7,17,17,0,12,34,"5-7","N","N","N",4,0,11
"3961","P1",2023-11-11,"Guimaraes","Porto",1,2,"A",1,1,"D",5.16,3.98,1.71,"1-1","1-2",14,8,7,4,3,3,0,0,10,6,19,17,3,16,36,"10-6","Y","Y","N",6,0,11
"3962","P1",2023-11-12,"Boavista","Farense",1,3,"A",0,1,"A",2.05,3.7,3.7,"0-1","1-3",15,2,13,7,3,1,0,0,9,2,19,9,4,11,28,"9-2","Y","Y","Y",4,0,11
"3963","P1",2023-11-12,"Gil Vicente","Rio Ave",1,1,"D",0,0,"D",2.02,3.64,3.8,"0-0","1-1",8,2,16,5,1,1,0,0,4,7,10,18,2,11,28,"4-7","Y","N","N",2,0,11
"3964","P1",2023-11-12,"Arouca","Sp Braga",0,1,"A",0,1,"A",5.32,4.36,1.63,"0-1","0-1",12,7,17,5,2,4,0,0,3,8,14,14,1,11,28,"3-8","N","N","N",6,0,11
"3965","P1",2023-11-12,"Benfica","Sp Lisbon",2,1,"H",0,1,"A",2.34,3.58,3.11,"0-1","2-1",11,4,8,3,2,5,0,1,6,4,10,12,3,10,22,"6-4","Y","Y","N",7,1,11
"3966","P1",2023-12-01,"Chaves","Vizela",2,1,"H",1,1,"D",2.73,3.23,2.73,"1-1","2-1",15,5,8,2,5,3,0,0,2,1,14,16,3,3,30,"2-1","Y","Y","N",8,0,12
"3967","P1",2023-12-02,"Farense","Guimaraes",1,2,"A",0,1,"A",3.15,3.46,2.28,"0-1","1-2",5,2,16,5,3,3,1,0,1,7,12,14,3,8,26,"1-7","Y","Y","N",6,1,12
"3968","P1",2023-12-02,"Rio Ave","Estrela",1,1,"D",0,0,"D",2.2,3.46,3.31,"0-0","1-1",13,3,8,0,4,1,0,0,7,0,15,13,2,7,28,"7-0","Y","N","N",5,0,12
"3969","P1",2023-12-02,"Famalicao","Porto",0,3,"A",0,2,"A",5.17,3.84,1.64,"0-2","0-3",12,0,9,5,4,5,1,0,7,2,16,22,3,9,38,"7-2","Y","Y","N",9,1,12
"3970","P1",2023-12-02,"Casa Pia","Portimonense",1,0,"H",0,0,"D",1.95,3.51,4.02,"0-0","1-0",11,3,10,2,3,3,0,1,5,5,20,15,1,10,35,"5-5","N","N","N",6,1,12
"3971","P1",2023-12-03,"Sp Braga","Estoril",3,1,"H",1,1,"D",1.34,5.77,7.59,"1-1","3-1",18,6,4,1,2,2,0,0,5,2,13,14,4,7,27,"5-2","Y","Y","Y",4,0,12
"3972","P1",2023-12-03,"Moreirense","Benfica",0,0,"D",0,0,"D",6.42,4.41,1.5,"0-0","0-0",11,4,12,3,4,1,0,0,2,7,13,13,0,9,26,"2-7","N","N","N",5,0,12
"3973","P1",2023-12-03,"Boavista","Arouca",0,4,"A",0,3,"A",2.17,3.31,3.55,"0-3","0-4",8,2,12,7,5,4,1,1,8,1,12,10,4,9,22,"8-1","Y","Y","Y",9,2,12
"3974","P1",2023-12-04,"Sp Lisbon","Gil Vicente",3,1,"H",1,1,"D",1.16,7.91,13.5,"1-1","3-1",12,4,5,1,4,1,0,0,9,0,14,9,4,9,23,"9-0","Y","Y","Y",5,0,12
"3975","P1",2023-12-08,"Vizela","Sp Braga",1,3,"A",0,1,"A",5.87,4.32,1.59,"0-1","1-3",11,5,13,4,3,1,0,0,7,6,19,9,4,13,28,"7-6","Y","Y","Y",4,0,13
"3976","P1",2023-12-08,"Benfica","Farense",1,1,"D",0,0,"D",1.18,8.23,15.33,"0-0","1-1",37,13,8,5,2,3,0,0,15,3,10,11,2,18,21,"15-3","Y","N","N",5,0,13
"3977","P1",2023-12-09,"Portimonense","Famalicao",1,1,"D",0,1,"A",2.98,3.4,2.51,"0-1","1-1",8,4,16,8,4,1,1,0,2,5,14,19,2,7,33,"2-5","Y","N","N",5,1,13
"3978","P1",2023-12-09,"Guimaraes","Sp Lisbon",3,2,"H",1,1,"D",5.42,4.2,1.65,"1-1","3-2",7,5,11,4,4,1,0,0,1,6,14,5,5,7,19,"1-6","Y","Y","Y",5,0,13
"3979","P1",2023-12-09,"Porto","Casa Pia",3,1,"H",1,0,"H",1.23,6.36,14.69,"1-0","3-1",16,6,7,3,3,1,0,0,4,1,11,9,4,5,20,"4-1","Y","Y","Y",4,0,13
"3980","P1",2023-12-10,"Estrela","Boavista",3,1,"H",0,0,"D",2.32,3.49,3.23,"0-0","3-1",4,2,9,6,4,2,0,0,2,4,18,11,4,6,29,"2-4","Y","Y","Y",6,0,13
"3981","P1",2023-12-10,"Arouca","Rio Ave",2,2,"D",0,2,"A",2.19,3.32,3.69,"0-2","2-2",16,5,12,9,1,5,0,0,5,3,11,14,4,8,25,"5-3","Y","Y","Y",6,0,13
"3982","P1",2023-12-10,"Estoril","Chaves",4,0,"H",1,0,"H",2.01,3.8,3.75,"1-0","4-0",14,10,7,2,4,3,0,0,3,6,16,11,4,9,27,"3-6","Y","Y","Y",7,0,13
"3983","P1",2023-12-11,"Gil Vicente","Moreirense",1,1,"D",1,0,"H",2.87,3.54,2.49,"1-0","1-1",11,4,11,4,5,3,0,0,3,6,15,19,2,9,34,"3-6","Y","N","N",8,0,13
"3984","P1",2023-12-15,"Farense","Estrela",0,0,"D",0,0,"D",2.18,3.54,3.48,"0-0","0-0",12,1,9,2,2,1,0,0,6,9,11,8,0,15,19,"6-9","N","N","N",3,0,14
"3985","P1",2023-12-16,"Rio Ave","Vizela",1,1,"D",0,0,"D",2.21,3.4,3.56,"0-0","1-1",13,4,6,4,3,3,0,1,7,2,16,15,2,9,31,"7-2","Y","N","N",6,1,14
"3986","P1",2023-12-16,"Arouca","Gil Vicente",3,0,"H",1,0,"H",1.99,3.62,4,"1-0","3-0",10,7,9,5,2,0,0,0,4,6,11,8,3,10,19,"4-6","Y","Y","N",2,0,14
"3987","P1",2023-12-16,"Boavista","Guimaraes",1,1,"D",0,1,"A",3.74,3.6,2.07,"0-1","1-1",10,4,14,3,6,2,0,0,7,8,17,9,2,15,26,"7-8","Y","N","N",8,0,14
"3988","P1",2023-12-17,"Chaves","Casa Pia",1,3,"A",1,2,"A",2.81,3.2,2.79,"1-2","1-3",15,5,9,6,1,1,0,0,4,2,16,14,4,6,30,"4-2","Y","Y","Y",2,0,14
"3989","P1",2023-12-17,"Moreirense","Portimonense",5,2,"H",2,1,"H",1.76,3.89,4.92,"2-1","5-2",16,5,9,3,2,2,0,0,7,7,12,12,7,14,24,"7-7","Y","Y","Y",4,0,14
"3990","P1",2023-12-17,"Famalicao","Estoril",1,1,"D",1,1,"D",2.26,3.56,3.28,"1-1","1-1",10,3,12,5,3,1,0,0,1,7,9,19,2,8,28,"1-7","Y","N","N",4,0,14
"3991","P1",2023-12-17,"Sp Braga","Benfica",0,1,"A",0,1,"A",2.87,3.9,2.37,"0-1","0-1",16,6,11,6,3,3,0,0,5,2,11,9,1,7,20,"5-2","N","N","N",6,0,14
"3992","P1",2023-12-18,"Sp Lisbon","Porto",2,0,"H",1,0,"H",2.13,3.6,3.49,"1-0","2-0",11,6,5,3,4,4,0,1,2,2,21,15,2,4,36,"2-2","Y","N","N",8,1,14
"3993","P1",2023-12-23,"Guimaraes","Rio Ave",1,0,"H",0,0,"D",1.69,3.93,5.43,"0-0","1-0",5,3,9,4,4,3,0,0,4,8,13,18,1,12,31,"4-8","N","N","N",7,0,15
"3994","P1",2023-12-23,"Vizela","Moreirense",0,0,"D",0,0,"D",2.91,3.24,2.67,"0-0","0-0",9,3,10,5,3,1,0,0,3,9,16,8,0,12,24,"3-9","N","N","N",4,0,15
"3995","P1",2023-12-28,"Estrela","Arouca",1,4,"A",1,0,"H",2.63,3.38,2.8,"1-0","1-4",6,2,18,5,0,2,1,0,3,5,6,12,5,8,18,"3-5","Y","Y","Y",2,1,15
"3996","P1",2023-12-29,"Benfica","Famalicao",3,0,"H",1,0,"H",1.25,6.36,12.42,"1-0","3-0",17,10,12,3,2,3,0,0,6,4,21,14,3,10,35,"6-4","Y","Y","N",5,0,15
"3997","P1",2023-12-29,"Porto","Chaves",1,0,"H",0,0,"D",1.16,8.57,17.28,"0-0","1-0",17,10,5,2,3,5,0,0,8,3,20,11,1,11,31,"8-3","N","N","N",8,0,15
"3998","P1",2023-12-30,"Estoril","Farense",4,0,"H",2,0,"H",2.06,3.87,3.52,"2-0","4-0",12,7,14,4,2,2,0,0,10,8,8,18,4,18,26,"10-8","Y","Y","Y",4,0,15
"3999","P1",2023-12-30,"Gil Vicente","Boavista",1,0,"H",0,0,"D",2.29,3.46,3.32,"0-0","1-0",11,3,8,1,0,1,0,0,4,3,15,15,1,7,30,"4-3","N","N","N",1,0,15
"4000","P1",2023-12-30,"Casa Pia","Sp Braga",1,3,"A",0,0,"D",5.49,4.25,1.63,"0-0","1-3",7,3,11,6,1,0,0,0,2,3,9,7,4,5,16,"2-3","Y","Y","Y",1,0,15
"4001","P1",2023-12-30,"Portimonense","Sp Lisbon",1,2,"A",0,0,"D",9.47,5.99,1.32,"0-0","1-2",7,3,14,6,4,3,0,0,0,12,11,12,3,12,23,"0-12","Y","Y","N",7,0,15
"4002","P1",2024-01-05,"Sp Lisbon","Estoril",5,1,"H",2,0,"H",1.23,6.97,12.24,"2-0","5-1",21,8,11,3,1,3,0,0,5,7,6,10,6,12,16,"5-7","Y","Y","Y",4,0,16
"4003","P1",2024-01-05,"Boavista","Porto",1,1,"D",1,1,"D",7.55,5.09,1.42,"1-1","1-1",7,2,24,7,5,1,1,0,1,6,18,14,2,7,32,"1-6","Y","N","N",6,1,16
"4004","P1",2024-01-06,"Estrela","Vizela",1,1,"D",1,0,"H",2.61,3.34,2.9,"1-0","1-1",12,4,16,7,0,1,0,0,6,4,14,13,2,10,27,"6-4","Y","N","N",1,0,16
"4005","P1",2024-01-06,"Farense","Gil Vicente",1,0,"H",0,0,"D",2.19,3.67,3.35,"0-0","1-0",11,5,14,6,2,2,0,0,6,5,9,7,1,11,16,"6-5","N","N","N",4,0,16
"4006","P1",2024-01-06,"Arouca","Benfica",0,3,"A",0,1,"A",6.3,4.85,1.5,"0-1","0-3",11,1,11,5,2,2,0,0,1,3,12,5,3,4,17,"1-3","Y","Y","N",4,0,16
"4007","P1",2024-01-06,"Sp Braga","Guimaraes",1,1,"D",0,0,"D",1.58,4.52,5.58,"0-0","1-1",11,4,13,4,2,0,0,0,5,6,7,9,2,11,16,"5-6","Y","N","N",2,0,16
"4008","P1",2024-01-07,"Rio Ave","Portimonense",2,0,"H",0,0,"D",1.81,3.79,4.68,"0-0","2-0",9,3,7,3,1,3,0,0,3,6,9,13,2,9,22,"3-6","Y","N","N",4,0,16
"4009","P1",2024-01-07,"Famalicao","Chaves",2,2,"D",2,1,"H",1.79,3.8,4.79,"2-1","2-2",17,7,10,5,3,2,0,0,5,8,17,23,4,13,40,"5-8","Y","Y","Y",5,0,16
"4010","P1",2024-01-08,"Moreirense","Casa Pia",1,4,"A",1,3,"A",1.92,3.4,4.53,"1-3","1-4",13,4,10,7,2,2,0,0,4,3,15,24,5,7,39,"4-3","Y","Y","Y",4,0,16
"4011","P1",2024-01-12,"Portimonense","Farense",1,0,"H",0,0,"D",2.72,3.36,2.76,"0-0","1-0",12,4,8,3,2,3,0,0,4,4,19,9,1,8,28,"4-4","N","N","N",5,0,17
"4012","P1",2024-01-13,"Casa Pia","Famalicao",0,2,"A",0,1,"A",2.58,3.1,3.16,"0-1","0-2",8,1,13,4,1,1,1,0,6,3,13,15,2,9,28,"6-3","Y","N","N",2,1,17
"4013","P1",2024-01-13,"Chaves","Sp Lisbon",0,3,"A",0,1,"A",11.36,6.63,1.25,"0-1","0-3",5,0,17,10,1,2,0,0,2,5,11,14,3,7,25,"2-5","Y","Y","N",3,0,17
"4014","P1",2024-01-13,"Estoril","Moreirense",1,3,"A",0,2,"A",2.46,3.55,2.95,"0-2","1-3",9,5,12,7,2,3,0,0,8,1,15,11,4,9,26,"8-1","Y","Y","Y",5,0,17
"4015","P1",2024-01-14,"Gil Vicente","Estrela",1,1,"D",1,0,"H",2.18,3.57,3.45,"1-0","1-1",9,2,15,6,2,4,0,0,7,5,14,10,2,12,24,"7-5","Y","N","N",6,0,17
"4016","P1",2024-01-14,"Benfica","Rio Ave",4,1,"H",1,1,"D",1.19,7.68,14.49,"1-1","4-1",15,12,9,5,1,3,0,1,5,3,12,11,5,8,23,"5-3","Y","Y","Y",4,1,17
"4017","P1",2024-01-14,"Vizela","Boavista",1,4,"A",0,2,"A",2.22,3.35,3.58,"0-2","1-4",27,7,10,7,2,2,0,0,11,1,19,4,5,12,23,"11-1","Y","Y","Y",4,0,17
"4018","P1",2024-01-14,"Porto","Sp Braga",2,0,"H",1,0,"H",1.82,3.99,4.37,"1-0","2-0",8,4,10,5,3,5,0,0,5,5,12,15,2,10,27,"5-5","Y","N","N",8,0,17
"4019","P1",2024-01-15,"Guimaraes","Arouca",2,1,"H",1,1,"D",1.89,3.61,4.33,"1-1","2-1",15,6,9,2,0,3,0,0,10,1,8,7,3,11,15,"10-1","Y","Y","N",3,0,17
"4020","P1",2024-01-18,"Famalicao","Sp Braga",1,2,"A",0,0,"D",4.31,3.96,1.83,"0-0","1-2",11,3,12,7,4,4,1,0,3,4,9,11,3,7,20,"3-4","Y","Y","N",8,1,18
"4021","P1",2024-01-18,"Vizela","Sp Lisbon",2,5,"A",1,1,"D",8.31,5.24,1.39,"1-1","2-5",4,3,18,9,3,1,0,0,0,6,16,13,7,6,29,"0-6","Y","Y","Y",4,0,18
"4022","P1",2024-01-19,"Benfica","Boavista",2,0,"H",0,0,"D",1.12,10.26,21.81,"0-0","2-0",20,7,5,1,3,3,0,0,12,4,15,11,2,16,26,"12-4","Y","N","N",6,0,18
"4023","P1",2024-01-20,"Estoril","Arouca",1,2,"A",1,2,"A",2.47,3.47,2.99,"1-2","1-2",13,4,15,7,3,2,0,0,7,4,16,13,3,11,29,"7-4","Y","Y","N",5,0,18
"4024","P1",2024-01-20,"Casa Pia","Farense",1,3,"A",0,2,"A",2.29,3.38,3.37,"0-2","1-3",21,6,7,4,0,1,0,0,14,3,10,13,4,17,23,"14-3","Y","Y","Y",1,0,18
"4025","P1",2024-01-20,"Porto","Moreirense",5,0,"H",1,0,"H",1.28,6.07,12.06,"1-0","5-0",16,8,5,1,0,3,0,0,5,1,13,16,5,6,29,"5-1","Y","Y","Y",3,0,18
"4026","P1",2024-01-21,"Portimonense","Gil Vicente",0,2,"A",0,1,"A",2.54,3.36,2.97,"0-1","0-2",8,0,15,8,3,1,0,0,3,8,19,15,2,11,34,"3-8","Y","N","N",4,0,18
"4027","P1",2024-01-21,"Chaves","Rio Ave",0,0,"D",0,0,"D",3.15,3.3,2.46,"0-0","0-0",19,6,6,1,2,3,0,0,11,0,15,13,0,11,28,"11-0","N","N","N",5,0,18
"4028","P1",2024-01-21,"Guimaraes","Estrela",3,0,"H",1,0,"H",1.6,4.12,6.06,"1-0","3-0",12,4,5,1,1,1,0,1,8,5,13,10,3,13,23,"8-5","Y","Y","N",2,1,18
"4029","P1",2024-01-28,"Boavista","Portimonense",1,4,"A",0,3,"A",1.98,3.54,4.15,"0-3","1-4",20,5,12,5,2,2,0,0,11,1,14,14,5,12,28,"11-1","Y","Y","Y",4,0,19
"4030","P1",2024-01-28,"Moreirense","Famalicao",1,0,"H",0,0,"D",2.32,3.36,3.34,"0-0","1-0",7,2,8,1,3,2,0,0,3,4,14,13,1,7,27,"3-4","N","N","N",5,0,19
"4031","P1",2024-01-28,"Farense","Porto",1,3,"A",0,2,"A",8.22,5.06,1.4,"0-2","1-3",9,4,18,4,1,0,0,0,4,10,16,7,4,14,23,"4-10","Y","Y","Y",1,0,19
"4032","P1",2024-01-28,"Arouca","Vizela",5,0,"H",2,0,"H",2.09,3.57,3.73,"2-0","5-0",13,7,9,3,1,2,0,0,1,2,15,11,5,3,26,"1-2","Y","Y","Y",3,0,19
"4033","P1",2024-01-28,"Gil Vicente","Guimaraes",1,0,"H",0,0,"D",3.53,3.37,2.23,"0-0","1-0",7,4,8,2,1,2,0,0,4,4,12,14,1,8,26,"4-4","N","N","N",3,0,19
"4034","P1",2024-01-29,"Estrela","Benfica",1,4,"A",1,2,"A",10.53,6,1.29,"1-2","1-4",9,5,16,7,2,1,1,0,5,6,10,10,5,11,20,"5-6","Y","Y","Y",3,1,19
"4035","P1",2024-01-29,"Sp Lisbon","Casa Pia",8,0,"H",5,0,"H",1.2,7.02,14.9,"5-0","8-0",21,11,2,2,1,1,0,0,9,0,10,14,8,9,24,"9-0","Y","Y","Y",2,0,19
"4036","P1",2024-01-31,"Rio Ave","Estoril",1,1,"D",0,0,"D",2.28,3.52,3.27,"0-0","1-1",8,4,12,5,4,3,0,0,4,3,10,9,2,7,19,"4-3","Y","N","N",7,0,19
"4037","P1",2024-01-31,"Sp Braga","Chaves",1,1,"D",0,0,"D",1.24,6.7,11.96,"0-0","1-1",27,10,7,2,1,5,0,1,9,1,11,10,2,10,21,"9-1","Y","N","N",6,1,19
"4038","P1",2024-02-03,"Portimonense","Arouca",1,2,"A",0,0,"D",2.96,3.53,2.46,"0-0","1-2",11,4,8,3,4,1,0,0,3,2,17,10,3,5,27,"3-2","Y","Y","N",5,0,20
"4039","P1",2024-02-03,"Porto","Rio Ave",0,0,"D",0,0,"D",1.2,7.21,15.59,"0-0","0-0",17,5,3,0,4,5,0,1,23,0,15,24,0,23,39,"23-0","N","N","N",9,1,20
"4040","P1",2024-02-04,"Chaves","Farense",1,1,"D",0,1,"A",2.64,3.33,2.88,"0-1","1-1",2,2,15,7,2,4,1,0,3,6,19,15,2,9,34,"3-6","Y","N","N",6,1,20
"4041","P1",2024-02-04,"Vizela","Guimaraes",0,1,"A",0,0,"D",3.58,3.53,2.15,"0-0","0-1",10,2,19,3,4,2,0,0,4,9,15,15,1,13,30,"4-9","N","N","N",6,0,20
"4042","P1",2024-02-04,"Benfica","Gil Vicente",3,0,"H",2,0,"H",1.15,9.2,18.9,"2-0","3-0",10,5,5,3,0,1,0,0,6,4,11,5,3,10,16,"6-4","Y","Y","N",1,0,20
"4043","P1",2024-02-04,"Estoril","Estrela",1,0,"H",0,0,"D",2,3.65,3.94,"0-0","1-0",10,5,11,6,3,2,0,0,6,1,15,10,1,7,25,"6-1","N","N","N",5,0,20
"4044","P1",2024-02-04,"Sp Braga","Moreirense",1,0,"H",1,0,"H",1.5,4.63,6.67,"1-0","1-0",13,5,8,1,1,2,0,0,6,1,13,16,1,7,29,"6-1","N","N","N",3,0,20
"4045","P1",2024-02-05,"Casa Pia","Boavista",0,0,"D",0,0,"D",2.39,3.4,3.11,"0-0","0-0",5,0,4,0,3,1,0,0,4,3,13,14,0,7,27,"4-3","N","N","N",4,0,20
"4046","P1",2024-02-09,"Estrela","Portimonense",3,0,"H",3,0,"H",1.92,3.61,4.32,"3-0","3-0",10,3,11,1,4,3,0,0,4,7,7,13,3,11,20,"4-7","Y","Y","N",7,0,20
"4047","P1",2024-02-10,"Farense","Famalicao",1,1,"D",0,1,"A",2.73,3.18,2.88,"0-1","1-1",17,7,18,4,0,6,0,0,7,6,17,20,2,13,37,"7-6","Y","N","N",6,0,21
"4048","P1",2024-02-10,"Moreirense","Chaves",1,0,"H",0,0,"D",1.85,3.58,4.79,"0-0","1-0",15,5,10,4,3,2,0,0,11,4,12,10,1,15,22,"11-4","N","N","N",5,0,21
"4049","P1",2024-02-10,"Boavista","Estoril",2,1,"H",2,0,"H",2.48,3.41,3.03,"2-0","2-1",7,3,14,4,5,5,0,0,7,5,16,10,3,12,26,"7-5","Y","Y","N",10,0,21
"4050","P1",2024-02-11,"Rio Ave","Casa Pia",1,0,"H",0,0,"D",2.07,3.27,4.15,"0-0","1-0",8,3,6,1,1,3,0,0,5,3,14,20,1,8,34,"5-3","N","N","N",4,0,21
"4051","P1",2024-02-11,"Sp Lisbon","Sp Braga",5,0,"H",2,0,"H",1.51,4.75,6.22,"2-0","5-0",12,5,7,1,0,0,0,0,3,7,10,10,5,10,20,"3-7","Y","Y","Y",0,0,21
"4052","P1",2024-02-11,"Guimaraes","Benfica",2,2,"D",1,1,"D",5.37,4.23,1.65,"1-1","2-2",8,6,6,3,4,3,1,0,6,11,15,9,4,17,24,"6-11","Y","Y","Y",7,1,21
"4053","P1",2024-02-12,"Arouca","Porto",3,2,"H",2,1,"H",6.89,4.65,1.48,"2-1","3-2",10,6,14,6,3,4,0,1,3,7,20,9,5,10,29,"3-7","Y","Y","Y",7,1,21
"4054","P1",2024-02-13,"Gil Vicente","Vizela",0,1,"A",0,1,"A",2.06,3.52,3.84,"0-1","0-1",16,4,8,2,3,5,0,1,8,3,13,15,1,11,28,"8-3","N","N","N",8,1,21
"4055","P1",2024-02-16,"Famalicao","Rio Ave",2,1,"H",1,1,"D",2.16,3.12,4.08,"1-1","2-1",15,6,9,4,4,6,0,0,4,7,18,20,3,11,38,"4-7","Y","Y","N",10,0,21
"4056","P1",2024-02-17,"Chaves","Boavista",2,1,"H",1,1,"D",2.48,3.31,3.1,"1-1","2-1",7,3,14,3,6,1,1,0,4,3,17,16,3,7,33,"4-3","Y","Y","N",7,1,22
"4057","P1",2024-02-17,"Portimonense","Guimaraes",1,1,"D",0,1,"A",4.48,3.7,1.86,"0-1","1-1",10,6,10,2,3,5,0,0,9,6,10,17,2,15,27,"9-6","Y","N","N",8,0,22
"4058","P1",2024-02-17,"Porto","Estrela",2,0,"H",1,0,"H",1.2,7.42,14.7,"1-0","2-0",16,6,8,2,0,2,0,0,8,6,12,13,2,14,25,"8-6","Y","N","N",2,0,22
"4059","P1",2024-02-18,"Casa Pia","Arouca",1,0,"H",0,0,"D",3.38,3.25,2.36,"0-0","1-0",10,2,14,4,0,2,0,0,2,6,5,12,1,8,17,"2-6","N","N","N",2,0,22
"4060","P1",2024-02-18,"Benfica","Vizela",6,1,"H",5,0,"H",1.13,9.8,19.9,"5-0","6-1",14,8,8,4,0,4,0,0,6,1,14,9,7,7,23,"6-1","Y","Y","Y",4,0,22
"4061","P1",2024-02-18,"Estoril","Gil Vicente",1,3,"A",0,0,"D",2.15,3.57,3.56,"0-0","1-3",8,4,11,7,2,3,1,0,2,4,15,15,4,6,30,"2-4","Y","Y","Y",5,1,22
"4062","P1",2024-02-18,"Sp Braga","Farense",2,1,"H",0,0,"D",1.36,5.48,8.6,"0-0","2-1",17,8,5,2,5,3,0,0,6,1,19,15,3,7,34,"6-1","Y","Y","N",8,0,22
"4063","P1",2024-02-19,"Moreirense","Sp Lisbon",0,2,"A",0,2,"A",8.47,4.92,1.4,"0-2","0-2",4,0,16,7,0,1,0,0,5,4,12,13,2,9,25,"5-4","Y","N","N",1,0,22
"4064","P1",2024-02-23,"Arouca","Famalicao",3,2,"H",2,1,"H",2.34,3.35,3.31,"2-1","3-2",14,4,11,8,2,5,0,1,3,4,20,14,5,7,34,"3-4","Y","Y","Y",7,1,22
"4065","P1",2024-02-24,"Farense","Moreirense",0,1,"A",0,1,"A",2.59,3.17,3.07,"0-1","0-1",6,1,11,2,1,0,1,0,5,5,14,14,1,10,28,"5-5","N","N","N",1,1,23
"4066","P1",2024-02-24,"Estrela","Chaves",1,1,"D",1,1,"D",2.16,3.37,3.72,"1-1","1-1",10,4,9,2,2,2,0,0,7,6,13,18,2,13,31,"7-6","Y","N","N",4,0,23
"4067","P1",2024-02-24,"Guimaraes","Casa Pia",0,2,"A",0,2,"A",1.59,3.95,6.68,"0-2","0-2",25,5,9,5,1,3,0,0,8,2,12,13,2,10,25,"8-2","Y","N","N",4,0,23
"4068","P1",2024-02-25,"Vizela","Estoril",3,3,"D",2,0,"H",2.58,3.43,2.87,"2-0","3-3",12,7,18,4,2,3,0,0,4,7,9,14,6,11,23,"4-7","Y","Y","Y",5,0,23
"4069","P1",2024-02-25,"Benfica","Portimonense",4,0,"H",0,0,"D",1.11,11.59,23.04,"0-0","4-0",19,13,10,2,0,1,0,0,8,1,13,6,4,9,19,"8-1","Y","Y","Y",1,0,23
"4070","P1",2024-02-25,"Gil Vicente","Porto",1,1,"D",0,0,"D",8.22,4.94,1.41,"0-0","1-1",7,1,14,5,3,3,0,0,2,4,16,14,2,6,30,"2-4","Y","N","N",6,0,23
"4071","P1",2024-02-25,"Rio Ave","Sp Lisbon",3,3,"D",2,2,"D",9.47,5.26,1.36,"2-2","3-3",8,3,13,6,6,3,1,0,2,5,17,10,6,7,27,"2-5","Y","Y","Y",9,1,23
"4072","P1",2024-02-26,"Boavista","Sp Braga",0,4,"A",0,2,"A",4.27,3.89,1.83,"0-2","0-4",8,3,11,5,1,3,0,0,1,3,12,14,4,4,26,"1-3","Y","Y","Y",4,0,23
"4073","P1",2024-03-01,"Chaves","Arouca",1,5,"A",1,2,"A",3.24,3.36,2.38,"1-2","1-5",11,5,7,5,1,2,0,0,4,2,15,15,6,6,30,"4-2","Y","Y","Y",3,0,23
"4074","P1",2024-03-02,"Moreirense","Rio Ave",0,0,"D",0,0,"D",2.27,3.19,3.65,"0-0","0-0",14,5,4,1,1,1,0,0,6,2,13,10,0,8,23,"6-2","N","N","N",2,0,24
"4075","P1",2024-03-02,"Estoril","Guimaraes",1,3,"A",0,3,"A",3.42,3.58,2.19,"0-3","1-3",14,4,9,4,1,5,0,0,9,4,12,20,4,13,32,"9-4","Y","Y","Y",6,0,24
"4076","P1",2024-03-02,"Sp Braga","Estrela",3,0,"H",0,0,"D",1.36,5.5,8.82,"0-0","3-0",15,8,7,1,2,1,0,0,6,4,11,13,3,10,24,"6-4","Y","Y","N",3,0,24
"4077","P1",2024-03-03,"Casa Pia","Gil Vicente",0,0,"D",0,0,"D",2.51,3.15,3.2,"0-0","0-0",11,3,9,2,1,2,0,0,2,4,12,7,0,6,19,"2-4","N","N","N",3,0,24
"4078","P1",2024-03-03,"Portimonense","Vizela",0,0,"D",0,0,"D",2.73,3.29,2.81,"0-0","0-0",11,4,13,3,3,1,1,0,1,8,18,10,0,9,28,"1-8","N","N","N",4,1,24
"4079","P1",2024-03-03,"Sp Lisbon","Farense",3,2,"H",2,1,"H",1.13,10.38,20.69,"2-1","3-2",17,5,8,5,1,3,0,0,12,1,7,11,5,13,18,"12-1","Y","Y","Y",4,0,24
"4080","P1",2024-03-03,"Porto","Benfica",5,0,"H",2,0,"H",2.45,3.61,2.92,"2-0","5-0",16,8,3,1,1,3,0,1,6,2,12,16,5,8,28,"6-2","Y","Y","Y",4,1,24
"4081","P1",2024-03-04,"Famalicao","Boavista",1,1,"D",1,0,"H",1.98,3.51,4.06,"1-0","1-1",7,1,5,3,2,2,0,0,9,5,14,19,2,14,33,"9-5","Y","N","N",4,0,24
"4082","P1",2024-03-08,"Portimonense","Porto",0,3,"A",0,1,"A",12.41,6.58,1.24,"0-1","0-3",7,2,16,6,2,0,0,0,1,13,16,11,3,14,27,"1-13","Y","Y","N",2,0,24
"4083","P1",2024-03-08,"Estrela","Casa Pia",3,1,"H",0,0,"D",2.3,3.17,3.61,"0-0","3-1",14,6,6,3,0,2,0,0,8,4,16,9,4,12,25,"8-4","Y","Y","Y",2,0,25
"4084","P1",2024-03-09,"Vizela","Farense",2,1,"H",0,1,"A",2.43,3.35,3.14,"0-1","2-1",15,6,8,4,1,3,0,0,10,3,17,12,3,13,29,"10-3","Y","Y","N",4,0,25
"4085","P1",2024-03-09,"Boavista","Moreirense",1,0,"H",0,0,"D",2.71,3.14,2.94,"0-0","1-0",9,3,8,3,4,2,0,0,4,4,13,19,1,8,32,"4-4","N","N","N",6,0,25
"4086","P1",2024-03-09,"Rio Ave","Sp Braga",0,0,"D",0,0,"D",4.81,3.93,1.76,"0-0","0-0",8,5,10,4,1,4,0,0,6,5,13,10,0,11,23,"6-5","N","N","N",5,0,25
"4087","P1",2024-03-09,"Guimaraes","Famalicao",1,0,"H",1,0,"H",1.87,3.63,4.59,"1-0","1-0",12,6,13,0,1,3,0,0,10,4,12,18,1,14,30,"10-4","N","N","N",4,0,25
"4088","P1",2024-03-10,"Arouca","Sp Lisbon",0,3,"A",0,1,"A",7.77,5.08,1.41,"0-1","0-3",10,2,10,6,2,0,0,0,2,0,13,11,3,2,24,"2-0","Y","Y","N",2,0,25
"4089","P1",2024-03-10,"Benfica","Estoril",3,1,"H",2,1,"H",1.16,9.08,16.34,"2-1","3-1",13,6,10,5,0,0,0,0,6,4,10,7,4,10,17,"6-4","Y","Y","Y",0,0,25
"4090","P1",2024-03-11,"Gil Vicente","Chaves",0,0,"D",0,0,"D",1.85,3.63,4.6,"0-0","0-0",20,6,5,0,4,2,1,0,12,1,13,8,0,13,21,"12-1","N","N","N",6,1,25
"4091","P1",2024-03-15,"Estoril","Portimonense",1,0,"H",0,0,"D",1.64,4.18,5.54,"0-0","1-0",9,3,15,2,1,2,0,0,2,7,15,10,1,9,25,"2-7","N","N","N",3,0,25
"4092","P1",2024-03-16,"Famalicao","Estrela",0,0,"D",0,0,"D",2.05,3.39,4.06,"0-0","0-0",12,3,9,2,1,4,0,0,4,7,15,19,0,11,34,"4-7","N","N","N",5,0,26
"4093","P1",2024-03-16,"Farense","Rio Ave",1,1,"D",1,0,"H",2.8,3.17,2.82,"1-0","1-1",14,7,13,3,2,1,0,0,5,2,17,15,2,7,32,"5-2","Y","N","N",3,0,26
"4094","P1",2024-03-16,"Sp Braga","Gil Vicente",2,1,"H",1,0,"H",1.42,5.02,7.77,"1-0","2-1",19,5,10,4,0,3,0,0,8,2,12,9,3,10,21,"8-2","Y","Y","N",3,0,26
"4095","P1",2024-03-16,"Porto","Vizela",4,1,"H",0,1,"A",1.15,9.03,18.85,"0-1","4-1",36,9,3,0,0,3,0,1,12,3,19,12,5,15,31,"12-3","Y","Y","Y",3,1,26
"4096","P1",2024-03-17,"Chaves","Guimaraes",1,2,"A",1,1,"D",4.46,3.6,1.9,"1-1","1-2",6,2,16,5,3,3,0,0,3,10,15,14,3,13,29,"3-10","Y","Y","N",6,0,26
"4097","P1",2024-03-17,"Moreirense","Arouca",1,0,"H",1,0,"H",2.6,3.26,2.97,"1-0","1-0",12,3,9,1,1,1,0,0,2,3,11,9,1,5,20,"2-3","N","N","N",2,0,26
"4098","P1",2024-03-17,"Casa Pia","Benfica",0,1,"A",0,0,"D",10.07,5.33,1.34,"0-0","0-1",6,3,19,6,0,2,0,0,4,13,8,5,1,17,13,"4-13","N","N","N",2,0,26
"4099","P1",2024-03-17,"Sp Lisbon","Boavista",6,1,"H",1,1,"D",1.14,9.51,18.79,"1-1","6-1",22,12,3,2,2,3,0,0,8,1,9,14,7,9,23,"8-1","Y","Y","Y",5,0,26
"5061","SC0",2023-08-05,"Celtic","Ross County",4,2,"H",3,0,"H",1.12,11.1,20.81,"3-0","4-2",18,12,7,2,0,4,0,0,4,8,6,14,6,12,20,"4-8","Y","Y","Y",4,0,1
"5062","SC0",2023-08-05,"Dundee","Motherwell",1,1,"D",0,1,"A",2.65,3.38,2.82,"0-1","1-1",17,2,13,3,0,2,0,0,7,12,12,12,2,19,24,"7-12","Y","N","N",2,0,1
"5063","SC0",2023-08-05,"Livingston","Aberdeen",0,0,"D",0,0,"D",2.99,3.32,2.55,"0-0","0-0",12,2,11,0,3,4,0,0,7,7,22,13,0,14,35,"7-7","N","N","N",7,0,1
"5064","SC0",2023-08-05,"St Johnstone","Hearts",0,2,"A",0,0,"D",3.27,3.68,2.22,"0-0","0-2",9,3,16,9,2,3,0,0,6,9,14,13,2,15,27,"6-9","Y","N","N",5,0,1
"5065","SC0",2023-08-05,"Kilmarnock","Rangers",1,0,"H",0,0,"D",7.25,4.98,1.44,"0-0","1-0",10,3,18,4,0,0,0,0,2,8,7,10,1,10,17,"2-8","N","N","N",0,0,1
"5066","SC0",2023-08-06,"Hibernian","St Mirren",2,3,"A",0,2,"A",1.93,3.65,4.17,"0-2","2-3",14,7,8,4,2,2,0,0,2,7,14,7,5,9,21,"2-7","Y","Y","Y",4,0,1
"5067","SC0",2023-08-12,"Rangers","Livingston",4,0,"H",1,0,"H",1.28,6.16,10.41,"1-0","4-0",21,9,6,2,1,1,0,0,5,4,9,9,4,9,18,"5-4","Y","Y","Y",2,0,2
"5068","SC0",2023-08-12,"Ross County","St Johnstone",2,0,"H",1,0,"H",2.2,3.34,3.64,"1-0","2-0",19,8,12,3,2,2,0,0,6,7,11,14,2,13,25,"6-7","Y","N","N",4,0,2
"5069","SC0",2023-08-12,"St Mirren","Dundee",2,1,"H",2,0,"H",2.09,3.45,3.83,"2-0","2-1",15,2,7,4,2,3,0,0,4,3,8,8,3,7,16,"4-3","Y","Y","N",5,0,2
"5070","SC0",2023-08-13,"Aberdeen","Celtic",1,3,"A",1,2,"A",8.1,5.6,1.37,"1-2","1-3",11,2,15,10,0,2,0,0,9,9,12,11,4,18,23,"9-9","Y","Y","Y",2,0,2
"5071","SC0",2023-08-13,"Hearts","Kilmarnock",0,0,"D",0,0,"D",1.89,3.73,4.31,"0-0","0-0",8,1,15,5,3,4,0,0,6,5,12,15,0,11,27,"6-5","N","N","N",7,0,2
"5072","SC0",2023-08-13,"Motherwell","Hibernian",2,1,"H",0,0,"D",2.69,3.32,2.82,"0-0","2-1",10,3,4,1,1,4,0,0,5,2,14,16,3,7,30,"5-2","Y","Y","N",5,0,2
"5073","SC0",2023-08-26,"Ross County","Rangers",0,2,"A",0,2,"A",8.67,5.53,1.36,"0-2","0-2",8,2,24,9,3,1,0,0,4,8,10,11,2,12,21,"4-8","Y","N","N",4,0,3
"5074","SC0",2023-08-26,"Celtic","St Johnstone",0,0,"D",0,0,"D",1.05,19.42,39.84,"0-0","0-0",19,5,5,2,1,3,0,0,19,1,9,12,0,20,21,"19-1","N","N","N",4,0,3
"5075","SC0",2023-08-26,"Hibernian","Livingston",2,3,"A",0,1,"A",1.88,3.82,4.25,"0-1","2-3",13,3,8,4,2,4,0,0,9,3,12,10,5,12,22,"9-3","Y","Y","Y",6,0,3
"5076","SC0",2023-08-26,"Motherwell","Kilmarnock",2,1,"H",0,1,"A",2.52,3.28,3.07,"0-1","2-1",13,7,12,3,6,3,0,0,1,6,15,19,3,7,34,"1-6","Y","Y","N",9,0,3
"5077","SC0",2023-08-27,"Dundee","Hearts",1,0,"H",0,0,"D",2.93,3.49,2.47,"0-0","1-0",12,4,10,5,1,1,0,0,3,8,16,10,1,11,26,"3-8","N","N","N",2,0,3
"5078","SC0",2023-08-27,"St Mirren","Aberdeen",2,2,"D",0,1,"A",2.35,3.33,3.32,"0-1","2-2",13,6,4,2,2,2,0,0,4,3,9,14,4,7,23,"4-3","Y","Y","Y",4,0,3
"5079","SC0",2023-09-02,"Kilmarnock","Ross County",0,1,"A",0,0,"D",1.93,3.6,4.33,"0-0","0-1",15,4,9,4,0,5,0,0,14,2,9,17,1,16,26,"14-2","N","N","N",5,0,4
"5080","SC0",2023-09-02,"Livingston","St Mirren",1,1,"D",0,0,"D",2.97,3.06,2.75,"0-0","1-1",13,2,8,4,3,1,0,0,6,2,17,13,2,8,30,"6-2","Y","N","N",4,0,4
"5081","SC0",2023-09-02,"St Johnstone","Dundee",2,2,"D",0,1,"A",2.72,3.34,2.77,"0-1","2-2",8,3,12,4,3,0,0,0,4,6,13,11,4,10,24,"4-6","Y","Y","Y",3,0,4
"5082","SC0",2023-09-03,"Rangers","Celtic",0,1,"A",0,1,"A",2.43,3.78,2.84,"0-1","0-1",17,3,7,5,1,1,0,0,6,2,15,15,1,8,30,"6-2","N","N","N",2,0,4
"5083","SC0",2023-09-03,"Aberdeen","Hibernian",0,2,"A",0,0,"D",2.34,3.47,3.19,"0-0","0-2",10,3,15,7,2,4,0,0,7,5,15,11,2,12,26,"7-5","Y","N","N",6,0,4
"5084","SC0",2023-09-03,"Hearts","Motherwell",0,1,"A",0,1,"A",2.01,3.69,3.8,"0-1","0-1",18,1,8,4,1,2,0,1,16,5,10,16,1,21,26,"16-5","N","N","N",3,1,4
"5085","SC0",2023-09-16,"St Johnstone","Rangers",0,2,"A",0,1,"A",12.28,6.42,1.25,"0-1","0-2",3,0,20,6,5,2,0,0,3,5,13,13,2,8,26,"3-5","Y","N","N",7,0,5
"5086","SC0",2023-09-16,"Celtic","Dundee",3,0,"H",0,0,"D",1.13,10.55,19.28,"0-0","3-0",19,7,4,1,0,0,0,0,9,1,6,7,3,10,13,"9-1","Y","Y","N",0,0,5
"5087","SC0",2023-09-16,"Hearts","Aberdeen",2,0,"H",1,0,"H",2.15,3.65,3.45,"1-0","2-0",12,4,11,5,4,2,0,0,9,3,11,12,2,12,23,"9-3","Y","N","N",6,0,5
"5088","SC0",2023-09-16,"Kilmarnock","Hibernian",2,2,"D",0,1,"A",2.65,3.27,2.91,"0-1","2-2",16,5,11,4,5,4,0,0,4,4,16,8,4,8,24,"4-4","Y","Y","Y",9,0,5
"5089","SC0",2023-09-16,"Motherwell","St Mirren",0,1,"A",0,0,"D",2.41,3.19,3.34,"0-0","0-1",20,7,9,3,0,5,0,0,8,3,6,18,1,11,24,"8-3","N","N","N",5,0,5
"5090","SC0",2023-09-16,"Ross County","Livingston",1,1,"D",0,0,"D",2.44,3.34,3.14,"0-0","1-1",16,5,5,2,0,3,0,0,6,2,14,13,2,8,27,"6-2","Y","N","N",3,0,5
"5091","SC0",2023-09-23,"Livingston","Celtic",0,3,"A",0,1,"A",10.91,6.27,1.27,"0-1","0-3",15,4,14,7,5,2,0,1,2,4,17,6,3,6,23,"2-4","Y","Y","N",7,1,6
"5092","SC0",2023-09-23,"Dundee","Kilmarnock",2,2,"D",1,1,"D",2.56,3.29,3.01,"1-1","2-2",10,3,23,3,1,3,1,0,4,7,8,12,4,11,20,"4-7","Y","Y","Y",4,1,6
"5093","SC0",2023-09-23,"Hibernian","St Johnstone",2,0,"H",1,0,"H",1.61,4.29,5.5,"1-0","2-0",17,8,12,1,1,3,0,0,4,4,9,10,2,8,19,"4-4","Y","N","N",4,0,6
"5094","SC0",2023-09-23,"St Mirren","Hearts",1,0,"H",1,0,"H",2.74,3.2,2.86,"1-0","1-0",13,5,11,3,2,1,0,0,4,8,13,12,1,12,25,"4-8","N","N","N",3,0,6
"5095","SC0",2023-09-24,"Aberdeen","Ross County",4,0,"H",2,0,"H",2,3.49,4.04,"2-0","4-0",13,6,11,2,0,4,0,0,5,5,9,10,4,10,19,"5-5","Y","Y","Y",4,0,6
"5096","SC0",2023-09-24,"Rangers","Motherwell",1,0,"H",1,0,"H",1.24,6.72,12.04,"1-0","1-0",17,7,9,4,2,2,0,0,2,2,14,15,1,4,29,"2-2","N","N","N",4,0,6
"5097","SC0",2023-09-30,"Motherwell","Celtic",1,2,"A",0,0,"D",10.22,5.91,1.31,"0-0","1-2",10,4,24,6,3,1,0,0,4,6,12,11,3,10,23,"4-6","Y","Y","N",4,0,7
"5098","SC0",2023-09-30,"Hibernian","Dundee",0,0,"D",0,0,"D",1.79,4.05,4.44,"0-0","0-0",23,9,11,2,1,4,0,0,14,1,7,10,0,15,17,"14-1","N","N","N",5,0,7
"5099","SC0",2023-09-30,"Kilmarnock","St Mirren",1,1,"D",1,1,"D",2.44,3.31,3.17,"1-1","1-1",12,2,8,3,2,3,0,0,7,6,15,16,2,13,31,"7-6","Y","N","N",5,0,7
"5100","SC0",2023-09-30,"Rangers","Aberdeen",1,3,"A",0,1,"A",1.28,6.23,10.73,"0-1","1-3",18,5,14,6,2,1,1,0,5,8,18,4,4,13,22,"5-8","Y","Y","Y",3,1,7
"5101","SC0",2023-09-30,"Ross County","Hearts",0,1,"A",0,0,"D",3.25,3.6,2.26,"0-0","0-1",9,1,17,3,3,2,0,0,5,5,15,10,1,10,25,"5-5","N","N","N",5,0,7
"5102","SC0",2023-09-30,"St Johnstone","Livingston",1,1,"D",1,0,"H",2.71,3.1,2.96,"1-0","1-1",12,2,7,3,2,2,1,0,5,2,14,14,2,7,28,"5-2","Y","N","N",4,1,7
"5103","SC0",2023-10-07,"Celtic","Kilmarnock",3,1,"H",2,0,"H",1.19,7.92,13.83,"2-0","3-1",27,12,6,1,2,2,0,0,11,1,9,7,4,12,16,"11-1","Y","Y","Y",4,0,8
"5104","SC0",2023-10-07,"Hearts","Hibernian",2,2,"D",1,0,"H",2.35,3.52,3.14,"1-0","2-2",21,5,17,3,2,1,0,0,7,4,12,9,4,11,21,"7-4","Y","Y","Y",3,0,8
"5105","SC0",2023-10-07,"Livingston","Motherwell",2,0,"H",0,0,"D",2.88,3.14,2.77,"0-0","2-0",11,3,3,2,1,3,0,1,3,5,12,15,2,8,27,"3-5","Y","N","N",4,1,8
"5106","SC0",2023-10-08,"St Mirren","Rangers",0,3,"A",0,1,"A",6.31,4.62,1.52,"0-1","0-3",3,0,13,8,1,2,1,0,3,10,8,16,3,13,24,"3-10","Y","Y","N",3,1,8
"5107","SC0",2023-10-08,"Aberdeen","St Johnstone",0,0,"D",0,0,"D",1.62,4.1,5.86,"0-0","0-0",10,3,9,0,0,2,0,0,5,3,11,11,0,8,22,"5-3","N","N","N",2,0,8
"5108","SC0",2023-10-21,"Kilmarnock","Livingston",3,1,"H",2,1,"H",1.93,3.54,4.38,"2-1","3-1",13,5,8,1,2,1,0,0,5,4,9,10,4,9,19,"5-4","Y","Y","Y",3,0,8
"5109","SC0",2023-10-21,"Rangers","Hibernian",4,0,"H",2,0,"H",1.36,5.38,8.91,"2-0","4-0",23,8,7,1,1,2,0,0,5,4,12,5,4,9,17,"5-4","Y","Y","Y",3,0,9
"5110","SC0",2023-10-22,"Hearts","Celtic",1,4,"A",0,2,"A",6.55,4.85,1.49,"0-2","1-4",13,6,19,7,2,1,0,0,3,5,16,11,5,8,27,"3-5","Y","Y","Y",3,0,9
"5111","SC0",2023-10-24,"Dundee","Ross County",0,0,"D",0,0,"D",2.04,3.56,3.88,"0-0","0-0",15,9,6,4,1,6,0,0,7,4,7,13,0,11,20,"7-4","N","N","N",7,0,9
"5112","SC0",2023-10-28,"Hibernian","Celtic",0,0,"D",0,0,"D",6.55,4.82,1.49,"0-0","0-0",6,1,21,4,0,2,0,0,3,6,4,12,0,9,16,"3-6","N","N","N",2,0,9
"5113","SC0",2023-10-28,"Livingston","Dundee",0,2,"A",0,0,"D",2.52,3.25,3.1,"0-0","0-2",4,0,18,7,0,0,1,0,1,5,13,15,2,6,28,"1-5","Y","N","N",0,1,9
"5114","SC0",2023-10-28,"Motherwell","Ross County",3,3,"D",0,0,"D",1.93,3.68,4.17,"0-0","3-3",13,3,13,6,2,2,0,0,6,4,10,9,6,10,19,"6-4","Y","Y","Y",4,0,9
"5115","SC0",2023-10-28,"St Mirren","St Johnstone",4,0,"H",1,0,"H",1.57,4.15,6.5,"1-0","4-0",9,5,14,3,2,0,0,0,4,8,9,5,4,12,14,"4-8","Y","Y","Y",2,0,10
"5116","SC0",2023-10-29,"Kilmarnock","Aberdeen",2,0,"H",1,0,"H",2.56,3.32,2.98,"1-0","2-0",19,8,5,1,1,3,0,0,9,3,12,14,2,12,26,"9-3","Y","N","N",4,0,10
"5117","SC0",2023-10-29,"Rangers","Hearts",2,1,"H",0,1,"A",1.31,5.92,10.1,"0-1","2-1",28,5,5,1,1,5,0,0,11,2,6,13,3,13,19,"11-2","Y","Y","N",6,0,10
"5118","SC0",2023-10-31,"Hibernian","Ross County",2,2,"D",1,0,"H",1.58,4.19,6.25,"1-0","2-2",7,2,8,3,1,2,0,0,5,5,12,16,4,10,28,"5-5","Y","Y","Y",3,0,10
"5119","SC0",2023-11-01,"Celtic","St Mirren",2,1,"H",1,1,"D",1.21,7.58,13.12,"1-1","2-1",23,8,6,2,2,2,0,0,12,2,9,12,3,14,21,"12-2","Y","Y","N",4,0,10
"5120","SC0",2023-11-01,"Dundee","Rangers",0,5,"A",0,1,"A",7.93,5.08,1.41,"0-1","0-5",9,4,32,11,4,1,0,0,6,7,13,3,5,13,16,"6-7","Y","Y","Y",5,0,10
"5121","SC0",2023-11-01,"Hearts","Livingston",1,0,"H",0,0,"D",1.65,3.92,5.86,"0-0","1-0",25,10,3,0,2,4,0,0,12,1,9,12,1,13,21,"12-1","N","N","N",6,0,11
"5122","SC0",2023-11-01,"Motherwell","Aberdeen",2,4,"A",0,2,"A",2.55,3.42,2.92,"0-2","2-4",9,2,15,6,6,1,0,0,1,4,14,6,6,5,20,"1-4","Y","Y","Y",7,0,11
"5123","SC0",2023-11-01,"St Johnstone","Kilmarnock",2,1,"H",2,0,"H",3.39,3.3,2.33,"2-0","2-1",15,4,23,5,2,2,1,0,5,12,13,9,3,17,22,"5-12","Y","Y","N",4,1,11
"5124","SC0",2023-11-04,"Ross County","Celtic",0,3,"A",0,1,"A",13.53,7.01,1.22,"0-1","0-3",3,0,39,16,0,1,1,0,2,13,9,10,3,15,19,"2-13","Y","Y","N",1,1,11
"5125","SC0",2023-11-04,"Kilmarnock","Motherwell",1,0,"H",0,0,"D",2.18,3.54,3.48,"0-0","1-0",20,8,11,1,2,1,0,0,9,3,9,12,1,12,21,"9-3","N","N","N",3,0,11
"5126","SC0",2023-11-05,"Dundee","Livingston",1,0,"H",0,0,"D",2.1,3.41,3.88,"0-0","1-0",10,3,16,3,2,3,0,0,5,12,14,14,1,17,28,"5-12","N","N","N",5,0,11
"5127","SC0",2023-11-07,"St Johnstone","Motherwell",2,2,"D",2,0,"H",2.91,3.1,2.77,"2-0","2-2",10,3,11,5,1,2,0,0,6,7,11,18,4,13,29,"6-7","Y","Y","Y",3,0,12
"5128","SC0",2023-11-08,"St Mirren","Hibernian",2,2,"D",0,1,"A",2.55,3.28,3.02,"0-1","2-2",18,4,9,4,3,2,0,0,3,1,9,9,4,4,18,"3-1","Y","Y","Y",5,0,12
"5129","SC0",2023-11-11,"Dundee","St Mirren",4,0,"H",2,0,"H",2.33,3.36,3.31,"2-0","4-0",11,7,5,0,1,1,0,0,7,4,6,12,4,11,18,"7-4","Y","Y","Y",2,0,12
"5130","SC0",2023-11-11,"Hibernian","Kilmarnock",1,0,"H",1,0,"H",2.17,3.6,3.47,"1-0","1-0",7,5,9,1,2,5,0,0,5,10,6,14,1,15,20,"5-10","N","N","N",7,0,12
"5131","SC0",2023-11-11,"Motherwell","Hearts",1,2,"A",0,1,"A",2.99,3.51,2.45,"0-1","1-2",8,1,14,3,4,2,0,0,4,10,13,12,3,14,25,"4-10","Y","Y","N",6,0,12
"5132","SC0",2023-11-11,"St Johnstone","Ross County",1,0,"H",0,0,"D",2.71,3.39,2.76,"0-0","1-0",10,3,8,2,4,3,0,0,3,4,11,13,1,7,24,"3-4","N","N","N",7,0,12
"5133","SC0",2023-11-12,"Livingston","Rangers",0,2,"A",0,1,"A",10.93,5.89,1.29,"0-1","0-2",4,1,18,6,1,1,0,0,3,9,14,7,2,12,21,"3-9","Y","N","N",2,0,13
"5134","SC0",2023-11-12,"Celtic","Aberdeen",6,0,"H",2,0,"H",1.23,7.21,12.14,"2-0","6-0",21,10,3,1,0,3,0,0,11,0,5,8,6,11,13,"11-0","Y","Y","Y",3,0,13
"5135","SC0",2023-11-25,"Celtic","Motherwell",1,1,"D",0,0,"D",1.14,9.94,18.23,"0-0","1-1",20,4,6,2,1,4,0,0,13,2,8,9,2,15,17,"13-2","Y","N","N",5,0,13
"5136","SC0",2023-11-25,"Dundee","Hibernian",1,2,"A",0,1,"A",2.74,3.33,2.76,"0-1","1-2",19,7,10,3,2,1,0,1,7,3,6,9,3,10,15,"7-3","Y","Y","N",3,1,13
"5137","SC0",2023-11-25,"Hearts","St Johnstone",1,0,"H",0,0,"D",1.58,4.17,6.31,"0-0","1-0",18,4,10,3,2,2,0,0,6,5,5,17,1,11,22,"6-5","N","N","N",4,0,13
"5138","SC0",2023-11-25,"Ross County","Kilmarnock",0,0,"D",0,0,"D",2.9,3.33,2.61,"0-0","0-0",15,5,13,1,1,0,0,0,9,5,10,9,0,14,19,"9-5","N","N","N",1,0,13
"5139","SC0",2023-11-25,"St Mirren","Livingston",1,0,"H",1,0,"H",1.8,3.71,4.89,"1-0","1-0",15,1,11,1,1,0,0,0,7,3,13,10,1,10,23,"7-3","N","N","N",1,0,14
"5140","SC0",2023-11-26,"Aberdeen","Rangers",1,1,"D",1,0,"H",6.19,4.59,1.53,"1-0","1-1",5,4,22,10,4,1,0,0,0,5,16,11,2,5,27,"0-5","Y","N","N",5,0,14
"5141","SC0",2023-11-28,"Ross County","St Mirren",1,0,"H",0,0,"D",2.81,3.04,2.91,"0-0","1-0",6,2,6,1,0,2,0,0,7,5,11,14,1,12,25,"7-5","N","N","N",2,0,14
"5142","SC0",2023-12-02,"Kilmarnock","Hearts",0,1,"A",0,1,"A",3.03,3.39,2.48,"0-1","0-1",17,3,11,1,2,1,0,0,7,3,14,12,1,10,26,"7-3","N","N","N",3,0,14
"5143","SC0",2023-12-02,"Motherwell","Dundee",3,3,"D",1,2,"A",2.34,3.41,3.25,"1-2","3-3",9,4,16,4,3,2,1,0,4,4,6,9,6,8,15,"4-4","Y","Y","Y",5,1,14
"5144","SC0",2023-12-03,"St Johnstone","Celtic",1,3,"A",1,0,"H",11.88,7.19,1.23,"1-0","1-3",5,3,25,7,2,1,0,0,2,12,8,7,4,14,15,"2-12","Y","Y","Y",3,0,14
"5145","SC0",2023-12-03,"Hibernian","Aberdeen",2,0,"H",1,0,"H",2.07,3.59,3.74,"1-0","2-0",11,3,23,5,3,2,0,0,6,6,13,13,2,12,26,"6-6","Y","N","N",5,0,15
"5146","SC0",2023-12-03,"Rangers","St Mirren",2,0,"H",1,0,"H",1.21,7.05,15.15,"1-0","2-0",21,6,4,3,1,3,0,0,8,5,9,8,2,13,17,"8-5","Y","N","N",4,0,15
"5147","SC0",2023-12-05,"Ross County","Motherwell",3,0,"H",2,0,"H",2.35,3.15,3.52,"2-0","3-0",13,6,14,4,1,2,1,0,6,3,14,9,3,9,23,"6-3","Y","Y","N",3,1,15
"5148","SC0",2023-12-06,"Aberdeen","Kilmarnock",0,1,"A",0,0,"D",2.37,3.38,3.23,"0-0","0-1",18,3,8,2,3,1,0,0,4,5,11,21,1,9,32,"4-5","N","N","N",4,0,15
"5149","SC0",2023-12-06,"Celtic","Hibernian",4,1,"H",2,0,"H",1.22,7.23,12.83,"2-0","4-1",26,12,6,3,2,2,0,0,11,4,10,8,5,15,18,"11-4","Y","Y","Y",4,0,15
"5150","SC0",2023-12-06,"St Johnstone","St Mirren",1,0,"H",0,0,"D",3.18,3.12,2.55,"0-0","1-0",11,5,13,5,2,1,0,0,0,7,9,10,1,7,19,"0-7","N","N","N",3,0,15
"5151","SC0",2023-12-06,"Hearts","Rangers",0,1,"A",0,1,"A",6.16,4.47,1.55,"0-1","0-1",12,5,22,5,3,1,0,0,6,5,13,11,1,11,24,"6-5","N","N","N",4,0,16
"5152","SC0",2023-12-09,"Aberdeen","Hearts",2,1,"H",0,1,"A",2.65,3.48,2.76,"0-1","2-1",14,6,5,3,3,7,0,0,3,8,13,20,3,11,33,"3-8","Y","Y","N",10,0,16
"5153","SC0",2023-12-09,"Livingston","Hibernian",0,1,"A",0,1,"A",3.62,3.48,2.15,"0-1","0-1",14,3,4,2,3,1,0,0,6,0,11,13,1,6,24,"6-0","N","N","N",4,0,16
"5154","SC0",2023-12-09,"Motherwell","St Johnstone",1,1,"D",0,0,"D",2.2,3.25,3.76,"0-0","1-1",17,8,11,2,0,0,0,0,3,2,11,11,2,5,22,"3-2","Y","N","N",0,0,16
"5155","SC0",2023-12-09,"Rangers","Dundee",3,1,"H",3,1,"H",1.17,8.34,16.65,"3-1","3-1",20,9,9,3,1,3,1,0,5,7,12,9,4,12,21,"5-7","Y","Y","Y",4,1,16
"5156","SC0",2023-12-09,"St Mirren","Ross County",2,0,"H",0,0,"D",2.26,3.24,3.62,"0-0","2-0",15,6,9,2,2,0,0,0,10,4,9,12,2,14,21,"10-4","Y","N","N",2,0,16
"5157","SC0",2023-12-10,"Kilmarnock","Celtic",2,1,"H",0,1,"A",8.83,5.41,1.36,"0-1","2-1",13,6,16,7,3,1,0,0,5,9,14,12,3,14,26,"5-9","Y","Y","N",4,0,17
"5158","SC0",2023-12-16,"Celtic","Hearts",0,2,"A",0,2,"A",1.25,6.59,11.28,"0-2","0-2",22,5,5,2,1,0,0,0,18,3,12,3,2,21,15,"18-3","Y","N","N",1,0,17
"5159","SC0",2023-12-16,"Livingston","Kilmarnock",0,0,"D",0,0,"D",3.64,3.26,2.24,"0-0","0-0",8,1,11,3,2,1,0,0,0,8,17,11,0,8,28,"0-8","N","N","N",3,0,17
"5160","SC0",2023-12-16,"Ross County","Dundee",0,1,"A",0,0,"D",2.36,3.3,3.33,"0-0","0-1",10,3,17,3,1,2,0,0,2,9,10,10,1,11,20,"2-9","N","N","N",3,0,17
"5161","SC0",2023-12-16,"St Johnstone","Hibernian",1,0,"H",0,0,"D",3.65,3.35,2.19,"0-0","1-0",14,7,3,0,2,3,0,0,5,5,10,8,1,10,18,"5-5","N","N","N",5,0,17
"5162","SC0",2023-12-16,"St Mirren","Motherwell",0,0,"D",0,0,"D",2.02,3.36,4.22,"0-0","0-0",11,3,8,4,1,1,0,0,6,4,11,11,0,10,22,"6-4","N","N","N",2,0,17
"5163","SC0",2023-12-20,"Aberdeen","Livingston",2,1,"H",1,1,"D",1.72,3.92,5.14,"1-1","2-1",11,6,11,4,0,3,0,0,1,3,8,15,3,4,23,"1-3","Y","Y","N",3,0,18
"5164","SC0",2023-12-20,"Rangers","St Johnstone",2,0,"H",1,0,"H",1.13,9.84,21.17,"1-0","2-0",28,8,2,0,2,2,0,1,10,2,7,11,2,12,18,"10-2","Y","N","N",4,1,18
"5165","SC0",2023-12-23,"Celtic","Livingston",2,0,"H",0,0,"D",1.1,11.68,25.45,"0-0","2-0",22,7,0,0,0,1,0,0,14,0,5,4,2,14,9,"14-0","Y","N","N",1,0,18
"5166","SC0",2023-12-23,"Hearts","St Mirren",2,0,"H",1,0,"H",2,3.49,4.11,"1-0","2-0",12,6,11,4,2,3,0,0,8,6,16,9,2,14,25,"8-6","Y","N","N",5,0,18
"5167","SC0",2023-12-23,"Kilmarnock","St Johnstone",2,1,"H",2,0,"H",1.75,3.67,5.4,"2-0","2-1",14,5,9,4,0,1,0,0,5,1,12,8,3,6,20,"5-1","Y","Y","N",1,0,18
"5168","SC0",2023-12-24,"Motherwell","Rangers",0,2,"A",0,2,"A",9.66,5.57,1.34,"0-2","0-2",7,0,14,6,3,1,0,0,3,5,16,10,2,8,26,"3-5","Y","N","N",4,0,18
"5169","SC0",2023-12-26,"Dundee","Celtic",0,3,"A",0,0,"D",9.98,6.14,1.3,"0-0","0-3",5,1,38,7,1,1,0,0,1,23,3,9,3,24,12,"1-23","Y","Y","N",2,0,19
"5170","SC0",2023-12-27,"Livingston","St Johnstone",0,0,"D",0,0,"D",2.38,3.13,3.41,"0-0","0-0",14,3,4,2,2,2,0,0,6,3,12,12,0,9,24,"6-3","N","N","N",4,0,19
"5171","SC0",2023-12-27,"St Mirren","Kilmarnock",0,1,"A",0,1,"A",2.71,3.08,2.94,"0-1","0-1",11,6,12,3,3,2,0,0,4,4,7,10,1,8,17,"4-4","N","N","N",5,0,19
"5172","SC0",2023-12-27,"Hibernian","Hearts",0,1,"A",0,0,"D",2.59,3.39,2.84,"0-0","0-1",16,3,10,3,2,3,0,0,6,5,11,10,1,11,21,"6-5","N","N","N",5,0,19
"5173","SC0",2023-12-30,"Celtic","Rangers",2,1,"H",1,0,"H",2.21,3.56,3.39,"1-0","2-1",12,5,14,3,7,3,0,1,4,2,18,14,3,6,32,"4-2","Y","Y","N",10,1,19
"5174","SC0",2023-12-30,"Aberdeen","St Mirren",0,3,"A",0,1,"A",1.99,3.47,4.17,"0-1","0-3",18,3,10,5,1,0,0,0,13,2,9,11,3,15,20,"13-2","Y","Y","N",1,0,19
"5175","SC0",2023-12-30,"Hearts","Ross County",2,2,"D",0,0,"D",1.72,3.84,5.3,"0-0","2-2",20,7,14,2,2,2,0,0,9,5,14,14,4,14,28,"9-5","Y","Y","Y",4,0,20
"5176","SC0",2023-12-30,"Kilmarnock","Dundee",2,2,"D",0,1,"A",1.86,3.63,4.63,"0-1","2-2",11,4,7,2,2,1,0,0,7,8,12,10,4,15,22,"7-8","Y","Y","Y",3,0,20
"5177","SC0",2023-12-30,"Motherwell","Livingston",3,1,"H",3,1,"H",2.03,3.37,4.18,"3-1","3-1",7,4,10,1,4,3,0,0,4,3,12,14,4,7,26,"4-3","Y","Y","Y",7,0,20
"5178","SC0",2024-01-02,"Hibernian","Motherwell",2,2,"D",1,1,"D",2.03,3.52,3.99,"1-1","2-2",12,3,9,4,2,2,0,0,7,3,10,10,4,10,20,"7-3","Y","Y","Y",4,0,20
"5179","SC0",2024-01-02,"Livingston","Hearts",1,2,"A",0,0,"D",4.35,3.6,1.92,"0-0","1-2",10,3,10,5,1,3,0,0,2,3,12,16,3,5,28,"2-3","Y","Y","N",4,0,20
"5180","SC0",2024-01-02,"Rangers","Kilmarnock",3,1,"H",2,0,"H",1.24,6.52,13.01,"2-0","3-1",18,6,6,2,1,3,0,0,7,5,10,13,4,12,23,"7-5","Y","Y","Y",4,0,20
"5181","SC0",2024-01-02,"Ross County","Aberdeen",0,3,"A",0,2,"A",3.34,3.37,2.31,"0-2","0-3",5,3,16,7,4,3,1,0,4,5,14,9,3,9,23,"4-5","Y","Y","N",7,1,21
"5182","SC0",2024-01-02,"St Mirren","Celtic",0,3,"A",0,2,"A",12.95,6.28,1.25,"0-2","0-3",3,0,24,11,0,0,1,0,1,12,9,8,3,13,17,"1-12","Y","Y","N",0,1,21
"5183","SC0",2024-01-23,"Hearts","Dundee",3,2,"H",0,2,"A",1.75,3.87,4.95,"0-2","3-2",15,6,8,4,1,6,0,0,7,1,10,12,5,8,22,"7-1","Y","Y","Y",7,0,21
"5184","SC0",2024-01-24,"Hibernian","Rangers",0,3,"A",0,2,"A",8.56,4.88,1.41,"0-2","0-3",9,3,22,8,1,0,0,0,4,10,6,7,3,14,13,"4-10","Y","Y","N",1,0,21
"5185","SC0",2024-01-24,"St Johnstone","Aberdeen",1,1,"D",0,0,"D",4.09,3.49,2.01,"0-0","1-1",14,5,8,4,4,1,0,0,1,4,20,8,2,5,28,"1-4","Y","N","N",5,0,21
"5186","SC0",2024-01-27,"St Mirren","Rangers",0,1,"A",0,1,"A",10.02,5.41,1.34,"0-1","0-1",7,2,10,2,0,2,0,0,4,3,10,9,1,7,19,"4-3","N","N","N",2,0,21
"5187","SC0",2024-01-27,"Celtic","Ross County",1,0,"H",1,0,"H",1.11,11.17,24.25,"1-0","1-0",17,7,7,1,1,1,0,0,7,7,12,14,1,14,26,"7-7","N","N","N",2,0,22
"5188","SC0",2024-01-27,"Hearts","Aberdeen",2,0,"H",0,0,"D",2.15,3.41,3.7,"0-0","2-0",15,5,16,1,1,2,0,0,7,7,10,14,2,14,24,"7-7","Y","N","N",3,0,22
"5189","SC0",2024-01-27,"Kilmarnock","Hibernian",2,2,"D",1,0,"H",2.09,3.54,3.75,"1-0","2-2",12,1,15,5,2,1,1,0,7,3,15,11,4,10,26,"7-3","Y","Y","Y",3,1,22
"5190","SC0",2024-01-27,"Livingston","Dundee",1,4,"A",0,1,"A",2.89,3.11,2.77,"0-1","1-4",15,3,7,5,0,1,0,1,5,3,7,14,5,8,21,"5-3","Y","Y","Y",1,1,22
"5191","SC0",2024-01-27,"St Johnstone","Motherwell",1,1,"D",1,1,"D",2.66,3.15,2.99,"1-1","1-1",7,4,11,2,2,3,0,0,0,6,13,16,2,6,29,"0-6","Y","N","N",5,0,22
"5192","SC0",2024-01-30,"Aberdeen","Dundee",1,1,"D",1,0,"H",1.73,3.85,5.17,"1-0","1-1",10,4,9,3,2,3,0,0,0,3,13,17,2,3,30,"0-3","Y","N","N",5,0,22
"5193","SC0",2024-01-30,"Livingston","Ross County",2,2,"D",1,1,"D",2.41,3.1,3.45,"1-1","2-2",13,4,10,4,1,2,0,0,5,3,10,16,4,8,26,"5-3","Y","Y","Y",3,0,23
"5194","SC0",2024-02-03,"Aberdeen","Celtic",1,1,"D",0,0,"D",8.03,5.33,1.39,"0-0","1-1",7,3,22,4,3,1,0,0,1,12,6,9,2,13,15,"1-12","Y","N","N",4,0,23
"5195","SC0",2024-02-03,"Dundee","Hearts",2,3,"A",1,0,"H",3.25,3.52,2.29,"1-0","2-3",14,8,18,6,3,1,0,0,8,5,7,6,5,13,13,"8-5","Y","Y","Y",4,0,23
"5196","SC0",2024-02-03,"Hibernian","St Mirren",0,3,"A",0,3,"A",2.04,3.52,3.94,"0-3","0-3",6,1,13,5,3,3,0,0,6,7,11,17,3,13,28,"6-7","Y","Y","N",6,0,23
"5197","SC0",2024-02-03,"Motherwell","Kilmarnock",1,1,"D",1,1,"D",3.04,3.38,2.49,"1-1","1-1",11,4,3,1,2,5,0,0,6,5,11,15,2,11,26,"6-5","Y","N","N",7,0,23
"5198","SC0",2024-02-03,"Rangers","Livingston",3,0,"H",2,0,"H",1.1,11.68,26.45,"2-0","3-0",32,8,0,0,0,0,0,0,14,0,9,6,3,14,15,"14-0","Y","Y","N",0,0,23
"5199","SC0",2024-02-03,"Ross County","St Johnstone",0,1,"A",0,1,"A",2.42,3.08,3.45,"0-1","0-1",12,5,8,2,3,1,0,0,8,4,11,7,1,12,18,"8-4","N","N","N",4,0,24
"5200","SC0",2024-02-06,"Motherwell","Ross County",5,0,"H",3,0,"H",2.07,3.41,3.95,"3-0","5-0",17,8,12,2,2,2,0,0,3,6,10,11,5,9,21,"3-6","Y","Y","Y",4,0,24
"5201","SC0",2024-02-06,"Rangers","Aberdeen",2,1,"H",1,1,"D",1.25,6.48,12.46,"1-1","2-1",23,7,9,4,0,2,1,0,13,2,7,10,3,15,17,"13-2","Y","Y","N",2,1,24
"5202","SC0",2024-02-07,"Kilmarnock","Livingston",1,0,"H",0,0,"D",1.6,3.99,6.53,"0-0","1-0",12,6,11,4,0,2,0,0,9,2,8,9,1,11,17,"9-2","N","N","N",2,0,24
"5203","SC0",2024-02-07,"St Johnstone","Hearts",0,1,"A",0,0,"D",4.01,3.45,2.04,"0-0","0-1",10,2,8,4,4,1,0,0,2,4,9,10,1,6,19,"2-4","N","N","N",5,0,24
"5204","SC0",2024-02-07,"St Mirren","Dundee",2,0,"H",0,0,"D",2.38,3.31,3.27,"0-0","2-0",19,6,5,0,0,1,1,0,6,5,9,9,2,11,18,"6-5","Y","N","N",1,1,24
"5205","SC0",2024-02-07,"Hibernian","Celtic",1,2,"A",0,1,"A",8.51,5.52,1.36,"0-1","1-2",12,4,8,3,4,2,0,0,4,5,14,18,3,9,32,"4-5","Y","Y","N",6,0,25
"5206","SC0",2024-02-11,"Dundee","St Johnstone",2,1,"H",0,1,"A",2.09,3.34,3.98,"0-1","2-1",26,6,15,3,4,3,0,0,13,7,6,15,3,20,21,"13-7","Y","Y","N",7,0,25
"5207","SC0",2024-02-14,"Aberdeen","Motherwell",3,3,"D",2,3,"A",1.97,3.64,4.05,"2-3","3-3",14,7,11,7,2,4,0,0,7,3,6,14,6,10,20,"7-3","Y","Y","Y",6,0,25
"5208","SC0",2024-02-14,"Rangers","Ross County",3,1,"H",2,1,"H",1.09,12.94,28.77,"2-1","3-1",43,23,5,1,1,3,0,0,20,3,10,12,4,23,22,"20-3","Y","Y","Y",4,0,25
"5209","SC0",2024-02-17,"Aberdeen","Hibernian",2,2,"D",1,1,"D",2.32,3.54,3.19,"1-1","2-2",22,12,7,6,1,3,0,0,4,2,13,14,4,6,27,"4-2","Y","Y","Y",4,0,25
"5210","SC0",2024-02-17,"Celtic","Kilmarnock",1,1,"D",1,0,"H",1.22,6.93,13.6,"1-0","1-1",15,5,13,6,0,3,0,0,8,4,12,8,2,12,20,"8-4","Y","N","N",3,0,25
"5211","SC0",2024-02-17,"Dundee","Ross County",2,0,"H",1,0,"H",1.81,3.82,4.66,"1-0","2-0",14,4,17,3,2,2,0,0,6,2,9,15,2,8,24,"6-2","Y","N","N",4,0,26
"5212","SC0",2024-02-17,"Hearts","Motherwell",2,0,"H",0,0,"D",1.72,3.87,5.23,"0-0","2-0",22,7,10,3,1,2,0,0,9,7,9,14,2,16,23,"9-7","Y","N","N",3,0,26
"5213","SC0",2024-02-17,"Livingston","St Mirren",1,0,"H",1,0,"H",3.17,3.18,2.51,"1-0","1-0",6,3,21,3,1,1,0,0,4,9,12,11,1,13,23,"4-9","N","N","N",2,0,26
"5214","SC0",2024-02-18,"St Johnstone","Rangers",0,3,"A",0,1,"A",12.93,6.54,1.24,"0-1","0-3",4,0,15,5,3,0,0,0,3,1,24,6,3,4,30,"3-1","Y","Y","N",3,0,26
"5215","SC0",2024-02-24,"Hibernian","Dundee",2,1,"H",1,0,"H",2.08,3.7,3.6,"1-0","2-1",16,9,7,1,0,2,0,0,10,2,11,11,3,12,22,"10-2","Y","Y","N",2,0,26
"5216","SC0",2024-02-24,"Kilmarnock","Aberdeen",2,0,"H",1,0,"H",2.21,3.54,3.4,"1-0","2-0",20,9,9,1,1,0,0,0,5,3,17,15,2,8,32,"5-3","Y","N","N",1,0,26
"5217","SC0",2024-02-24,"Rangers","Hearts",5,0,"H",3,0,"H",1.3,6.19,9.66,"3-0","5-0",17,12,11,5,2,2,0,0,4,2,17,9,5,6,26,"4-2","Y","Y","Y",4,0,27
"5218","SC0",2024-02-24,"Ross County","Livingston",3,2,"H",2,0,"H",2.31,3.28,3.46,"2-0","3-2",12,6,18,6,2,1,0,0,6,4,11,15,5,10,26,"6-4","Y","Y","Y",3,0,27
"5219","SC0",2024-02-24,"St Mirren","St Johnstone",2,0,"H",1,0,"H",1.86,3.36,5.15,"1-0","2-0",15,5,5,2,1,2,0,0,5,6,10,12,2,11,22,"5-6","Y","N","N",3,0,27
"5220","SC0",2024-02-25,"Motherwell","Celtic",1,3,"A",1,0,"H",9.11,5.71,1.34,"1-0","1-3",10,3,18,7,1,2,0,0,4,4,7,10,4,8,17,"4-4","Y","Y","Y",3,0,27
"5221","SC0",2024-02-27,"Ross County","St Mirren",1,1,"D",1,0,"H",3.67,3.31,2.2,"1-0","1-1",6,1,9,3,2,2,0,0,3,4,13,6,2,7,19,"3-4","Y","N","N",4,0,27
"5222","SC0",2024-02-28,"Aberdeen","St Johnstone",0,2,"A",0,1,"A",1.69,3.86,5.52,"0-1","0-2",17,5,8,4,0,4,0,0,11,7,7,11,2,18,18,"11-7","Y","N","N",4,0,27
"5223","SC0",2024-02-28,"Celtic","Dundee",7,1,"H",6,0,"H",1.21,7.32,13.06,"6-0","7-1",17,10,9,2,2,1,0,1,5,5,7,5,8,10,12,"5-5","Y","Y","Y",3,1,28
"5224","SC0",2024-02-28,"Hearts","Hibernian",1,1,"D",1,1,"D",1.93,3.75,4.09,"1-1","1-1",14,2,21,5,2,1,0,0,4,9,8,9,2,13,17,"4-9","Y","N","N",3,0,28
"5225","SC0",2024-02-28,"Kilmarnock","Rangers",1,2,"A",1,0,"H",8.3,4.85,1.42,"1-0","1-2",10,3,14,5,3,2,0,0,8,6,8,16,3,14,24,"8-6","Y","Y","N",5,0,28
"5226","SC0",2024-02-28,"Livingston","Motherwell",1,3,"A",1,0,"H",2.89,3.26,2.67,"1-0","1-3",14,4,15,5,1,1,0,0,1,4,12,8,4,5,20,"1-4","Y","Y","Y",2,0,28
"5227","SC0",2024-03-02,"Dundee","Kilmarnock",2,2,"D",1,1,"D",2.75,3.3,2.77,"1-1","2-2",14,5,9,7,3,4,0,1,4,6,11,10,4,10,21,"4-6","Y","Y","Y",7,1,28
"5228","SC0",2024-03-02,"Hibernian","Ross County",2,0,"H",0,0,"D",1.64,4.26,5.35,"0-0","2-0",14,6,4,2,0,1,0,0,8,2,9,14,2,10,23,"8-2","Y","N","N",1,0,28
"5229","SC0",2024-03-02,"Rangers","Motherwell",1,2,"A",0,1,"A",1.16,8.51,17.6,"0-1","1-2",31,11,15,5,0,3,0,0,15,2,9,10,3,17,19,"15-2","Y","Y","N",3,0,29
"5230","SC0",2024-03-02,"St Johnstone","Livingston",1,1,"D",0,1,"A",2.4,3.19,3.36,"0-1","1-1",10,3,8,4,2,2,0,0,2,2,15,16,2,4,31,"2-2","Y","N","N",4,0,29
"5231","SC0",2024-03-02,"St Mirren","Aberdeen",2,1,"H",0,1,"A",2.31,3.42,3.32,"0-1","2-1",14,5,9,3,1,4,0,0,3,2,16,22,3,5,38,"3-2","Y","Y","N",5,0,29
"5232","SC0",2024-03-03,"Hearts","Celtic",2,0,"H",1,0,"H",6.36,4.73,1.51,"1-0","2-0",14,6,17,6,2,2,0,1,7,7,10,11,2,14,21,"7-7","Y","N","N",4,1,29
"5233","SC0",2024-03-13,"Dundee","Aberdeen",1,0,"H",0,0,"D",2.52,3.44,2.94,"0-0","1-0",18,6,10,2,2,1,0,0,6,4,12,8,1,10,20,"6-4","N","N","N",3,0,29
"5234","SC0",2024-03-13,"Ross County","Hibernian",2,2,"D",1,0,"H",4.18,3.79,1.9,"1-0","2-2",6,3,11,6,1,2,0,0,2,6,7,12,4,8,19,"2-6","Y","Y","Y",3,0,29
"5235","SC0",2024-03-16,"Celtic","St Johnstone",3,1,"H",1,0,"H",1.12,9.91,24.14,"1-0","3-1",22,9,6,2,0,3,0,0,10,2,6,13,4,12,19,"10-2","Y","Y","Y",3,0,30
"5236","SC0",2024-03-16,"Hibernian","Livingston",3,0,"H",3,0,"H",1.55,4.38,6.34,"3-0","3-0",14,4,9,3,0,6,0,0,3,2,13,16,3,5,29,"3-2","Y","Y","N",6,0,30
"5237","SC0",2024-03-16,"Kilmarnock","St Mirren",5,2,"H",0,2,"A",2.16,3.23,3.92,"0-2","5-2",13,8,7,2,3,1,0,0,1,3,15,13,7,4,28,"1-3","Y","Y","Y",4,0,30
"5238","SC0",2024-03-16,"Motherwell","Aberdeen",0,1,"A",0,1,"A",2.38,3.34,3.25,"0-1","0-1",14,5,14,4,1,2,0,0,6,6,13,10,1,12,23,"6-6","N","N","N",3,0,30
"5239","SC0",2024-03-16,"Ross County","Hearts",2,1,"H",1,0,"H",4.48,3.76,1.85,"1-0","2-1",11,3,21,6,2,1,0,0,2,15,7,6,3,17,13,"2-15","Y","Y","N",3,0,30
"5240","SC1",2023-08-04,"Arbroath","Dundee United",0,4,"A",0,4,"A",3.88,3.26,2.08,"0-4","0-4",3,1,15,7,2,0,0,0,6,10,13,3,4,16,16,"6-10","Y","Y","Y",2,0,1
"5241","SC1",2023-08-05,"Dunfermline","Airdrie Utd",2,1,"H",1,1,"D",1.96,3.69,3.78,"1-1","2-1",13,5,12,3,1,1,1,0,4,5,11,9,3,9,20,"4-5","Y","Y","N",2,1,1
"5242","SC1",2023-08-05,"Inverness C","Queens Park",1,2,"A",0,1,"A",2.21,3.63,3.16,"0-1","1-2",12,6,12,7,1,3,0,0,5,4,9,10,3,9,19,"5-4","Y","Y","N",4,0,1
"5243","SC1",2023-08-05,"Morton","Ayr",3,1,"H",0,0,"D",2.6,3.29,2.81,"0-0","3-1",19,6,7,4,3,5,0,0,3,4,9,16,4,7,25,"3-4","Y","Y","Y",8,0,1
"5244","SC1",2023-08-05,"Partick","Raith Rvs",2,2,"D",2,0,"H",1.75,3.87,4.59,"2-0","2-2",14,5,14,6,1,2,0,0,7,4,8,9,4,11,17,"7-4","Y","Y","Y",3,0,1
"5245","SC1",2023-08-12,"Airdrie Utd","Partick",2,1,"H",0,1,"A",3,3.61,2.21,"0-1","2-1",11,2,7,2,0,0,0,0,6,4,6,9,3,10,15,"6-4","Y","Y","N",0,0,2
"5246","SC1",2023-08-12,"Ayr","Inverness C",1,0,"H",1,0,"H",2.01,3.63,3.66,"1-0","1-0",7,3,10,4,2,2,0,0,5,3,10,13,1,8,23,"5-3","N","N","N",4,0,2
"5247","SC1",2023-08-12,"Dundee United","Dunfermline",1,1,"D",0,0,"D",1.65,4.24,4.79,"0-0","1-1",16,4,5,2,0,2,0,0,10,4,14,3,2,14,17,"10-4","Y","N","N",2,0,2
"5248","SC1",2023-08-12,"Queens Park","Arbroath",2,1,"H",1,0,"H",1.69,3.99,4.68,"1-0","2-1",14,5,6,1,3,1,0,0,15,2,8,7,3,17,15,"15-2","Y","Y","N",4,0,2
"5249","SC1",2023-08-12,"Raith Rvs","Morton",3,2,"H",2,1,"H",2.52,3.46,2.79,"2-1","3-2",4,4,3,2,5,8,0,0,5,6,8,13,5,11,21,"5-6","Y","Y","Y",13,0,2
"5250","SC1",2023-08-19,"Arbroath","Queens Park",0,1,"A",0,0,"D",3.49,3.44,2.14,"0-0","0-1",12,3,4,3,1,2,0,0,3,6,15,9,1,9,24,"3-6","N","N","N",3,0,3
"5251","SC1",2023-08-26,"Airdrie Utd","Inverness C",2,1,"H",2,0,"H",2.17,3.58,3.28,"2-0","2-1",8,3,19,6,1,3,1,0,1,3,11,15,3,4,26,"1-3","Y","Y","N",4,1,3
"5252","SC1",2023-08-26,"Ayr","Dundee United",0,3,"A",0,0,"D",3.21,3.34,2.31,"0-0","0-3",2,2,13,8,1,2,0,0,4,11,8,9,3,15,17,"4-11","Y","Y","N",3,0,3
"5253","SC1",2023-08-26,"Dunfermline","Raith Rvs",0,1,"A",0,1,"A",2.34,3.41,3.09,"0-1","0-1",5,2,3,2,2,2,0,0,12,2,8,7,1,14,15,"12-2","N","N","N",4,0,3
"5254","SC1",2023-08-26,"Morton","Arbroath",0,3,"A",0,1,"A",1.69,3.7,5.33,"0-1","0-3",17,8,13,6,2,3,0,0,14,6,11,17,3,20,28,"14-6","Y","Y","N",5,0,3
"5255","SC1",2023-08-26,"Partick","Queens Park",3,1,"H",2,1,"H",2.01,3.82,3.5,"2-1","3-1",10,6,14,4,2,1,0,0,1,6,8,10,4,7,18,"1-6","Y","Y","Y",3,0,4
"5256","SC1",2023-09-02,"Arbroath","Ayr",2,1,"H",1,1,"D",2.8,2.96,2.87,"1-1","2-1",11,6,9,3,3,1,0,0,5,7,9,7,3,12,16,"5-7","Y","Y","N",4,0,4
"5257","SC1",2023-09-02,"Dundee United","Airdrie Utd",2,0,"H",1,0,"H",1.64,4,5.26,"1-0","2-0",9,3,9,3,2,2,0,0,5,3,14,8,2,8,22,"5-3","Y","N","N",4,0,4
"5258","SC1",2023-09-02,"Inverness C","Dunfermline",1,1,"D",1,0,"H",2.35,3.39,3.09,"1-0","1-1",7,2,10,4,2,1,0,0,2,7,10,7,2,9,17,"2-7","Y","N","N",3,0,4
"5259","SC1",2023-09-02,"Morton","Partick",1,4,"A",1,1,"D",2.56,3.61,2.66,"1-1","1-4",15,8,13,6,1,0,0,1,2,7,6,6,5,9,12,"2-7","Y","Y","Y",1,1,4
"5260","SC1",2023-09-02,"Raith Rvs","Queens Park",3,2,"H",1,0,"H",2.14,3.68,3.28,"1-0","3-2",8,7,4,2,1,0,0,1,8,1,5,10,5,9,15,"8-1","Y","Y","Y",1,1,5
"5261","SC1",2023-09-15,"Ayr","Partick",0,4,"A",0,1,"A",3.29,3.73,2.12,"0-1","0-4",13,10,11,5,3,1,0,0,9,3,6,7,4,12,13,"9-3","Y","Y","Y",4,0,5
"5262","SC1",2023-09-16,"Arbroath","Airdrie Utd",4,0,"H",2,0,"H",2.43,3.68,2.77,"2-0","4-0",11,6,6,0,0,1,1,1,2,5,13,8,4,7,21,"2-5","Y","Y","Y",1,2,5
"5263","SC1",2023-09-16,"Dundee United","Morton",1,1,"D",1,0,"H",1.67,4.02,4.94,"1-0","1-1",9,1,7,1,1,3,1,0,5,4,15,12,2,9,27,"5-4","Y","N","N",4,1,5
"5264","SC1",2023-09-16,"Queens Park","Dunfermline",0,2,"A",0,0,"D",2.31,3.52,3.05,"0-0","0-2",14,2,15,5,2,3,0,0,8,9,11,7,2,17,18,"8-9","Y","N","N",5,0,5
"5265","SC1",2023-09-16,"Raith Rvs","Inverness C",1,0,"H",0,0,"D",1.88,3.69,3.95,"0-0","1-0",7,2,8,5,2,2,0,0,3,7,9,15,1,10,24,"3-7","N","N","N",4,0,6
"5266","SC1",2023-09-22,"Queens Park","Ayr",2,5,"A",1,4,"A",2.07,3.61,3.49,"1-4","2-5",12,4,10,6,2,0,0,0,4,2,8,7,7,6,15,"4-2","Y","Y","Y",2,0,6
"5267","SC1",2023-09-23,"Airdrie Utd","Raith Rvs",1,0,"H",0,0,"D",2.41,3.57,2.86,"0-0","1-0",7,3,11,6,1,4,0,0,2,1,8,9,1,3,17,"2-1","N","N","N",5,0,6
"5268","SC1",2023-09-23,"Dunfermline","Morton",3,1,"H",2,0,"H",2.07,3.48,3.65,"2-0","3-1",10,5,9,2,0,3,0,0,10,4,8,14,4,14,22,"10-4","Y","Y","Y",3,0,6
"5269","SC1",2023-09-23,"Inverness C","Dundee United",0,1,"A",0,0,"D",3.69,3.48,2.05,"0-0","0-1",8,2,12,4,2,3,0,1,4,2,6,13,1,6,19,"4-2","N","N","N",5,1,6
"5270","SC1",2023-09-23,"Partick","Arbroath",0,3,"A",0,2,"A",1.62,4.17,5.18,"0-2","0-3",8,1,19,7,3,2,0,0,4,6,12,10,3,10,22,"4-6","Y","Y","N",5,0,7
"5271","SC1",2023-09-30,"Arbroath","Inverness C",2,3,"A",0,2,"A",2.19,3.6,3.14,"0-2","2-3",11,3,7,6,1,1,0,0,8,2,14,18,5,10,32,"8-2","Y","Y","Y",2,0,7
"5272","SC1",2023-09-30,"Ayr","Raith Rvs",1,2,"A",0,2,"A",2.78,3.45,2.5,"0-2","1-2",13,4,8,3,2,2,0,0,8,4,10,6,3,12,16,"8-4","Y","Y","N",4,0,7
"5273","SC1",2023-09-30,"Dundee United","Queens Park",4,1,"H",1,1,"D",1.56,4.24,5.82,"1-1","4-1",14,5,8,3,0,2,0,0,4,2,7,7,5,6,14,"4-2","Y","Y","Y",2,0,7
"5274","SC1",2023-09-30,"Morton","Airdrie Utd",0,1,"A",0,1,"A",2.16,3.81,3.13,"0-1","0-1",13,1,8,2,2,3,0,0,6,3,12,13,1,9,25,"6-3","N","N","N",5,0,7
"5275","SC1",2023-09-30,"Partick","Dunfermline",3,0,"H",1,0,"H",1.99,3.78,3.5,"1-0","3-0",23,12,19,4,3,1,0,0,4,9,8,5,3,13,13,"4-9","Y","Y","N",4,0,8
"5276","SC1",2023-10-07,"Airdrie Utd","Ayr",1,2,"A",0,1,"A",2.09,3.51,3.55,"0-1","1-2",8,3,11,3,1,1,0,0,7,7,5,9,3,14,14,"7-7","Y","Y","N",2,0,8
"5277","SC1",2023-10-07,"Inverness C","Partick",0,0,"D",0,0,"D",3.01,3.47,2.36,"0-0","0-0",4,1,4,3,0,1,0,0,6,4,10,8,0,10,18,"6-4","N","N","N",1,0,8
"5278","SC1",2023-10-07,"Queens Park","Morton",0,0,"D",0,0,"D",2.3,3.67,2.96,"0-0","0-0",11,4,7,2,1,3,0,0,10,3,10,8,0,13,18,"10-3","N","N","N",4,0,8
"5279","SC1",2023-10-07,"Raith Rvs","Dundee United",1,1,"D",1,0,"H",3.01,3.56,2.32,"1-0","1-1",7,6,7,4,3,4,0,0,3,3,15,13,2,6,28,"3-3","Y","N","N",7,0,8
"5280","SC1",2023-10-20,"Airdrie Utd","Queens Park",1,1,"D",1,0,"H",2.28,3.69,2.98,"1-0","1-1",10,6,13,6,0,3,0,1,1,5,12,12,2,6,24,"1-5","Y","N","N",3,1,9
"5281","SC1",2023-10-21,"Dunfermline","Ayr",0,1,"A",0,1,"A",1.94,3.5,4.08,"0-1","0-1",9,1,15,5,0,1,0,0,4,11,8,14,1,15,22,"4-11","N","N","N",1,0,9
"5282","SC1",2023-10-21,"Partick","Dundee United",0,5,"A",0,1,"A",2.81,3.58,2.4,"0-1","0-5",7,2,13,8,1,2,1,0,2,4,9,12,5,6,21,"2-4","Y","Y","Y",3,1,9
"5283","SC1",2023-10-27,"Dundee United","Arbroath",6,0,"H",3,0,"H",1.5,4.43,6.43,"3-0","6-0",18,10,5,2,0,1,0,0,10,5,5,7,6,15,12,"10-5","Y","Y","Y",1,0,9
"5284","SC1",2023-10-27,"Queens Park","Partick",2,2,"D",0,1,"A",2.82,3.66,2.4,"0-1","2-2",18,8,5,4,2,0,0,0,9,1,7,11,4,10,18,"9-1","Y","Y","Y",2,0,9
"5285","SC1",2023-10-28,"Ayr","Morton",0,1,"A",0,0,"D",2.02,3.7,3.57,"0-0","0-1",13,6,10,5,2,4,0,0,4,10,15,17,1,14,32,"4-10","N","N","N",6,0,10
"5286","SC1",2023-10-28,"Inverness C","Airdrie Utd",1,0,"H",1,0,"H",2.28,3.64,3.03,"1-0","1-0",7,2,9,4,2,2,0,0,3,5,9,12,1,8,21,"3-5","N","N","N",4,0,10
"5287","SC1",2023-10-28,"Raith Rvs","Dunfermline",1,0,"H",0,0,"D",2.19,3.44,3.36,"0-0","1-0",8,2,10,6,1,3,0,0,6,9,5,11,1,15,16,"6-9","N","N","N",4,0,10
"5288","SC1",2023-10-31,"Airdrie Utd","Dundee United",0,2,"A",0,1,"A",5.07,4.17,1.63,"0-1","0-2",10,3,10,5,0,0,0,0,9,3,8,6,2,12,14,"9-3","Y","N","N",0,0,10
"5289","SC1",2023-10-31,"Morton","Raith Rvs",1,2,"A",0,2,"A",3.01,3.08,2.58,"0-2","1-2",10,5,13,3,4,2,0,0,5,5,11,9,3,10,20,"5-5","Y","Y","N",6,0,10
"5290","SC1",2023-10-31,"Partick","Ayr",2,2,"D",1,1,"D",1.96,4,3.5,"1-1","2-2",13,6,8,4,1,0,0,0,4,3,12,13,4,7,25,"4-3","Y","Y","Y",1,0,11
"5291","SC1",2023-11-03,"Morton","Dunfermline",1,2,"A",0,2,"A",2.61,3.17,2.9,"0-2","1-2",10,7,11,5,4,2,0,0,7,6,11,9,3,13,20,"7-6","Y","Y","N",6,0,11
"5292","SC1",2023-11-04,"Arbroath","Partick",1,3,"A",0,1,"A",2.76,3.55,2.5,"0-1","1-3",7,3,10,8,2,1,0,0,7,9,13,12,4,16,25,"7-9","Y","Y","Y",3,0,11
"5293","SC1",2023-11-04,"Ayr","Queens Park",2,2,"D",2,0,"H",2.1,3.84,3.25,"2-0","2-2",10,6,7,3,0,2,0,0,2,7,5,9,4,9,14,"2-7","Y","Y","Y",2,0,11
"5294","SC1",2023-11-04,"Dundee United","Inverness C",1,1,"D",0,0,"D",1.37,5.09,7.93,"0-0","1-1",13,7,4,2,1,1,0,0,5,3,11,7,2,8,18,"5-3","Y","N","N",2,0,11
"5295","SC1",2023-11-04,"Raith Rvs","Airdrie Utd",1,1,"D",1,0,"H",1.68,4.08,4.78,"1-0","1-1",10,5,16,9,0,1,0,0,6,3,10,8,2,9,18,"6-3","Y","N","N",1,0,12
"5296","SC1",2023-11-10,"Dunfermline","Dundee United",1,2,"A",0,1,"A",4.08,3.88,1.83,"0-1","1-2",6,2,16,5,4,3,0,0,3,7,7,9,3,10,16,"3-7","Y","Y","N",7,0,12
"5297","SC1",2023-11-11,"Airdrie Utd","Arbroath",2,0,"H",1,0,"H",2.24,3.65,3.08,"1-0","2-0",6,5,8,1,0,0,0,0,5,5,10,12,2,10,22,"5-5","Y","N","N",0,0,12
"5298","SC1",2023-11-11,"Inverness C","Ayr",3,1,"H",3,0,"H",2.44,3.5,2.87,"3-0","3-1",5,5,5,1,2,0,0,0,5,4,8,9,4,9,17,"5-4","Y","Y","Y",2,0,12
"5299","SC1",2023-11-11,"Partick","Morton",2,1,"H",1,1,"D",1.79,4.12,4.06,"1-1","2-1",10,5,6,2,2,3,1,0,2,2,15,14,3,4,29,"2-2","Y","Y","N",5,1,12
"5300","SC1",2023-11-11,"Queens Park","Raith Rvs",2,3,"A",0,1,"A",3.18,3.39,2.3,"0-1","2-3",18,9,12,6,2,1,1,0,5,1,11,6,5,6,17,"5-1","Y","Y","Y",3,1,13
"5301","SC1",2023-11-18,"Dunfermline","Inverness C",1,1,"D",0,1,"A",2.31,3.37,3.18,"0-1","1-1",12,2,5,2,2,3,0,0,10,7,2,5,2,17,7,"10-7","Y","N","N",5,0,13
"5302","SC1",2023-11-28,"Dunfermline","Arbroath",3,0,"H",0,0,"D",1.96,3.7,3.74,"0-0","3-0",17,9,6,0,1,1,0,0,12,1,8,7,3,13,15,"12-1","Y","Y","N",2,0,13
"5303","SC1",2023-12-02,"Inverness C","Raith Rvs",1,2,"A",0,0,"D",3.43,3.39,2.18,"0-0","1-2",6,2,13,5,2,2,0,0,3,10,12,5,3,13,17,"3-10","Y","Y","N",4,0,13
"5304","SC1",2023-12-02,"Partick","Airdrie Utd",2,1,"H",2,0,"H",1.76,4.18,4.15,"2-0","2-1",7,3,7,4,1,0,0,0,4,8,7,7,3,12,14,"4-8","Y","Y","N",1,0,13
"5305","SC1",2023-12-08,"Raith Rvs","Partick",4,3,"H",1,0,"H",2.31,3.6,2.99,"1-0","4-3",17,9,10,3,2,3,0,0,10,9,13,11,7,19,24,"10-9","Y","Y","Y",5,0,14
"5306","SC1",2023-12-09,"Airdrie Utd","Dunfermline",1,2,"A",0,1,"A",2.69,3.33,2.69,"0-1","1-2",12,5,9,6,2,0,0,0,8,4,10,3,3,12,13,"8-4","Y","Y","N",2,0,14
"5307","SC1",2023-12-09,"Arbroath","Morton",1,2,"A",0,1,"A",2.74,3.42,2.58,"0-1","1-2",10,2,10,5,1,3,0,0,7,4,8,10,3,11,18,"7-4","Y","Y","N",4,0,14
"5308","SC1",2023-12-09,"Dundee United","Ayr",1,0,"H",0,0,"D",1.41,4.91,7.26,"0-0","1-0",14,5,5,2,0,3,0,0,13,4,1,9,1,17,10,"13-4","N","N","N",3,0,14
"5309","SC1",2023-12-09,"Queens Park","Inverness C",1,4,"A",1,1,"D",2.42,3.6,2.83,"1-1","1-4",5,3,16,11,2,0,0,0,2,3,7,4,5,5,11,"2-3","Y","Y","Y",2,0,14
"5310","SC1",2023-12-12,"Morton","Inverness C",2,1,"H",1,0,"H",2.77,3.24,2.67,"1-0","2-1",13,5,7,2,5,2,0,0,8,2,11,7,3,10,18,"8-2","Y","Y","N",7,0,15
"5311","SC1",2023-12-13,"Arbroath","Raith Rvs",1,2,"A",1,1,"D",4.42,3.9,1.78,"1-1","1-2",5,2,8,5,2,2,0,0,3,6,17,9,3,9,26,"3-6","Y","Y","N",4,0,15
"5312","SC1",2023-12-16,"Ayr","Airdrie Utd",1,0,"H",1,0,"H",2.22,3.42,3.31,"1-0","1-0",9,2,14,4,1,3,0,0,4,1,7,8,1,5,15,"4-1","N","N","N",4,0,15
"5313","SC1",2023-12-16,"Dundee United","Raith Rvs",0,1,"A",0,0,"D",1.57,4.15,5.85,"0-0","0-1",13,4,5,3,3,2,0,0,9,3,18,11,1,12,29,"9-3","N","N","N",5,0,15
"5314","SC1",2023-12-16,"Dunfermline","Partick",1,2,"A",0,2,"A",2.57,3.5,2.71,"0-2","1-2",5,3,4,3,1,3,0,0,3,5,4,10,3,8,14,"3-5","Y","Y","N",4,0,15
"5315","SC1",2023-12-16,"Inverness C","Arbroath",1,2,"A",1,2,"A",1.72,3.89,4.79,"1-2","1-2",11,2,8,6,1,4,0,0,7,4,11,15,3,11,26,"7-4","Y","Y","N",5,0,16
"5316","SC1",2023-12-16,"Morton","Queens Park",1,0,"H",1,0,"H",2.16,3.64,3.25,"1-0","1-0",8,5,14,6,3,1,1,0,3,7,9,12,1,10,21,"3-7","N","N","N",4,1,16
"5317","SC1",2023-12-22,"Queens Park","Dundee United",0,0,"D",0,0,"D",5.86,4.55,1.52,"0-0","0-0",5,1,16,5,2,1,0,0,4,8,9,8,0,12,17,"4-8","N","N","N",3,0,16
"5318","SC1",2023-12-22,"Raith Rvs","Ayr",4,4,"D",2,1,"H",1.71,3.88,4.82,"2-1","4-4",13,7,10,8,1,0,0,1,9,3,9,11,8,12,20,"9-3","Y","Y","Y",1,1,16
"5319","SC1",2023-12-23,"Airdrie Utd","Morton",0,0,"D",0,0,"D",2.28,3.37,3.23,"0-0","0-0",5,1,7,1,1,1,0,0,3,6,13,7,0,9,20,"3-6","N","N","N",2,0,16
"5320","SC1",2023-12-23,"Arbroath","Dunfermline",1,1,"D",1,0,"H",4.12,3.93,1.82,"1-0","1-1",16,4,11,2,1,1,1,0,10,8,8,7,2,18,15,"10-8","Y","N","N",2,1,17
"5321","SC1",2023-12-23,"Partick","Inverness C",1,1,"D",1,1,"D",1.78,3.98,4.24,"1-1","1-1",8,3,6,1,1,3,0,0,5,6,6,8,2,11,14,"5-6","Y","N","N",4,0,17
"5322","SC1",2023-12-29,"Dundee United","Partick",3,0,"H",1,0,"H",1.48,4.62,6.34,"1-0","3-0",21,6,5,1,1,3,0,0,9,7,11,8,3,16,19,"9-7","Y","Y","N",4,0,17
"5323","SC1",2023-12-30,"Ayr","Dunfermline",2,2,"D",1,2,"A",2.6,3.57,2.65,"1-2","2-2",12,4,11,5,1,2,0,0,9,6,7,6,4,15,13,"9-6","Y","Y","Y",3,0,17
"5324","SC1",2023-12-30,"Inverness C","Morton",0,0,"D",0,0,"D",2.28,3.32,3.27,"0-0","0-0",7,2,3,0,0,1,0,0,2,4,6,7,0,6,13,"2-4","N","N","N",1,0,17
"5325","SC1",2023-12-30,"Queens Park","Airdrie Utd",1,2,"A",1,0,"H",2.61,3.4,2.73,"1-0","1-2",5,2,10,6,2,0,0,0,6,4,15,14,3,10,29,"6-4","Y","Y","N",2,0,18
"5326","SC1",2023-12-30,"Raith Rvs","Arbroath",2,2,"D",1,0,"H",1.41,4.96,7.02,"1-0","2-2",7,4,5,5,1,1,0,0,9,7,11,3,4,16,14,"9-7","Y","Y","Y",2,0,18
"5327","SC1",2024-01-02,"Airdrie Utd","Inverness C",2,0,"H",0,0,"D",2.37,3.12,3.31,"0-0","2-0",6,5,1,0,0,1,0,0,6,5,13,7,2,11,20,"6-5","Y","N","N",1,0,18
"5328","SC1",2024-01-02,"Arbroath","Dundee United",0,3,"A",0,1,"A",12.35,6.82,1.21,"0-1","0-3",2,2,11,6,1,2,0,0,3,6,9,7,3,9,16,"3-6","Y","Y","N",3,0,18
"5329","SC1",2024-01-02,"Dunfermline","Raith Rvs",1,2,"A",1,1,"D",3.35,3.82,2.06,"1-1","1-2",8,4,11,5,4,1,0,0,3,7,11,9,3,10,20,"3-7","Y","Y","N",5,0,18
"5330","SC1",2024-01-02,"Morton","Ayr",3,0,"H",1,0,"H",2.25,3.54,3.16,"1-0","3-0",15,6,2,0,2,2,0,0,8,1,14,13,3,9,27,"8-1","Y","Y","N",4,0,19
"5331","SC1",2024-01-02,"Partick","Queens Park",3,2,"H",1,1,"D",1.56,4.79,4.98,"1-1","3-2",14,5,9,5,3,3,0,0,8,2,6,13,5,10,19,"8-2","Y","Y","Y",6,0,19
"5332","SC1",2024-01-05,"Queens Park","Dunfermline",2,1,"H",0,0,"D",3.1,3.83,2.17,"0-0","2-1",13,4,4,1,2,1,0,0,7,0,14,7,3,7,21,"7-0","Y","Y","N",3,0,19
"5333","SC1",2024-01-06,"Airdrie Utd","Raith Rvs",1,0,"H",1,0,"H",3.96,3.63,1.93,"1-0","1-0",8,4,8,3,3,5,0,1,5,6,12,10,1,11,22,"5-6","N","N","N",8,1,19
"5334","SC1",2024-01-06,"Ayr","Inverness C",1,3,"A",0,1,"A",2.55,3.47,2.75,"0-1","1-3",11,5,5,4,2,3,0,0,6,3,9,9,4,9,18,"6-3","Y","Y","Y",5,0,19
"5335","SC1",2024-01-06,"Dundee United","Morton",2,3,"A",2,2,"D",1.36,5.17,8.05,"2-2","2-3",9,3,7,4,4,4,1,0,10,2,13,11,5,12,24,"10-2","Y","Y","Y",8,1,20
"5336","SC1",2024-01-06,"Partick","Arbroath",4,0,"H",1,0,"H",1.45,4.47,5.73,"1-0","4-0",10,7,10,4,0,2,0,0,3,7,14,9,4,10,23,"3-7","Y","Y","Y",2,0,20
"5337","SC1",2024-01-12,"Inverness C","Dundee United",0,1,"A",0,0,"D",6.21,4.3,1.52,"0-0","0-1",10,4,7,2,1,2,0,0,4,1,10,7,1,5,17,"4-1","N","N","N",3,0,20
"5338","SC1",2024-01-13,"Arbroath","Ayr",0,0,"D",0,0,"D",3.04,3.88,2.18,"0-0","0-0",7,1,14,2,1,2,0,0,4,4,8,6,0,8,14,"4-4","N","N","N",3,0,20
"5339","SC1",2024-01-13,"Morton","Partick",1,1,"D",1,0,"H",2.56,3.8,2.57,"1-0","1-1",12,5,9,4,5,6,0,0,3,6,18,13,2,9,31,"3-6","Y","N","N",11,0,20
"5340","SC1",2024-01-13,"Raith Rvs","Queens Park",1,2,"A",1,1,"D",1.49,4.71,6.01,"1-1","1-2",11,6,8,7,4,3,0,0,9,2,9,11,3,11,20,"9-2","Y","Y","N",7,0,21
"5341","SC1",2024-01-23,"Ayr","Arbroath",2,0,"H",0,0,"D",1.67,4.06,4.88,"0-0","2-0",10,5,3,2,1,3,0,0,6,2,15,8,2,8,23,"6-2","Y","N","N",4,0,21
"5342","SC1",2024-01-27,"Airdrie Utd","Partick",1,1,"D",1,1,"D",2.47,3.48,2.85,"1-1","1-1",6,1,4,3,2,3,0,0,3,5,13,6,2,8,19,"3-5","Y","N","N",5,0,21
"5343","SC1",2024-01-27,"Dundee United","Dunfermline",0,0,"D",0,0,"D",1.3,5.58,9.56,"0-0","0-0",12,3,7,1,0,0,0,0,13,2,11,3,0,15,14,"13-2","N","N","N",0,0,21
"5344","SC1",2024-01-27,"Morton","Arbroath",3,0,"H",0,0,"D",1.55,4.27,5.91,"0-0","3-0",17,8,5,2,1,3,0,1,10,3,14,14,3,13,28,"10-3","Y","Y","N",4,1,21
"5345","SC1",2024-01-27,"Queens Park","Ayr",1,2,"A",0,1,"A",2.45,3.8,2.69,"0-1","1-2",7,2,13,6,1,3,1,0,1,3,7,8,3,4,15,"1-3","Y","Y","N",4,1,22
"5346","SC1",2024-01-27,"Raith Rvs","Inverness C",2,3,"A",1,3,"A",1.76,3.91,4.46,"1-3","2-3",8,3,7,4,0,2,0,0,6,1,11,11,5,7,22,"6-1","Y","Y","Y",2,0,22
"5347","SC1",2024-02-03,"Ayr","Dundee United",1,2,"A",1,0,"H",4.69,3.97,1.71,"1-0","1-2",7,3,9,4,2,3,1,0,6,11,16,7,3,17,23,"6-11","Y","Y","N",5,1,22
"5348","SC1",2024-02-03,"Dunfermline","Morton",0,5,"A",0,2,"A",2.58,3.54,2.67,"0-2","0-5",7,1,13,7,0,1,0,0,5,3,9,9,5,8,18,"5-3","Y","Y","Y",1,0,22
"5349","SC1",2024-02-03,"Inverness C","Queens Park",0,1,"A",0,0,"D",2.25,3.53,3.15,"0-0","0-1",17,5,4,3,2,2,0,0,4,4,14,10,1,8,24,"4-4","N","N","N",4,0,22
"5350","SC1",2024-02-10,"Dunfermline","Queens Park",0,3,"A",0,0,"D",2.71,3.73,2.46,"0-0","0-3",6,2,13,5,2,1,0,0,0,3,13,14,3,3,27,"0-3","Y","Y","N",3,0,23
"5351","SC1",2024-02-16,"Raith Rvs","Dundee United",2,1,"H",1,1,"D",3.57,3.57,2.06,"1-1","2-1",6,5,13,5,2,3,0,0,4,7,4,11,3,11,15,"4-7","Y","Y","N",5,0,23
"5352","SC1",2024-02-17,"Airdrie Utd","Ayr",2,3,"A",1,1,"D",2.3,3.47,3.11,"1-1","2-3",8,3,5,5,1,1,0,0,3,3,15,12,5,6,27,"3-3","Y","Y","Y",2,0,23
"5353","SC1",2024-02-17,"Dunfermline","Arbroath",1,1,"D",1,0,"H",1.62,4.18,5.16,"1-0","1-1",10,3,7,3,4,3,0,0,8,5,10,9,2,13,19,"8-5","Y","N","N",7,0,23
"5354","SC1",2024-02-17,"Inverness C","Partick",3,3,"D",1,0,"H",2.84,3.39,2.52,"1-0","3-3",8,4,7,4,1,2,1,0,6,8,7,12,6,14,19,"6-8","Y","Y","Y",3,1,23
"5355","SC1",2024-02-17,"Queens Park","Morton",0,0,"D",0,0,"D",2.89,3.53,2.41,"0-0","0-0",4,1,9,5,0,1,0,0,1,5,7,11,0,6,18,"1-5","N","N","N",1,0,24
"5356","SC1",2024-02-23,"Partick","Dunfermline",1,3,"A",1,1,"D",1.65,3.99,5.2,"1-1","1-3",7,4,15,7,2,1,0,0,4,9,14,7,4,13,21,"4-9","Y","Y","Y",3,0,24
"5357","SC1",2024-02-24,"Arbroath","Inverness C",1,1,"D",0,0,"D",4.36,3.91,1.78,"0-0","1-1",9,2,17,4,3,3,0,0,4,2,12,12,2,6,24,"4-2","Y","N","N",6,0,24
"5358","SC1",2024-02-24,"Ayr","Raith Rvs",1,2,"A",1,2,"A",3.15,3.39,2.31,"1-2","1-2",11,3,6,5,2,1,0,0,3,6,8,7,3,9,15,"3-6","Y","Y","N",3,0,24
"5359","SC1",2024-02-24,"Dundee United","Queens Park",3,1,"H",2,1,"H",1.27,6.2,9.69,"2-1","3-1",12,7,6,4,1,4,0,0,5,2,16,16,4,7,32,"5-2","Y","Y","Y",5,0,24
"5360","SC1",2024-02-24,"Morton","Airdrie Utd",2,1,"H",2,0,"H",2.07,3.53,3.59,"2-0","2-1",7,4,7,2,3,2,0,0,6,5,10,12,3,11,22,"6-5","Y","Y","N",5,0,25
"5361","SC1",2024-02-27,"Ayr","Partick",4,3,"H",3,1,"H",2.81,3.44,2.52,"3-1","4-3",8,5,13,6,2,0,0,0,4,11,12,8,7,15,20,"4-11","Y","Y","Y",2,0,25
"5362","SC1",2024-02-27,"Dundee United","Airdrie Utd",0,2,"A",0,0,"D",1.42,4.72,7.37,"0-0","0-2",12,2,10,4,3,1,0,0,7,7,7,12,2,14,19,"7-7","Y","N","N",4,0,25
"5363","SC1",2024-02-27,"Inverness C","Dunfermline",0,0,"D",0,0,"D",2.19,3.39,3.41,"0-0","0-0",6,1,6,0,2,2,0,0,5,8,8,15,0,13,23,"5-8","N","N","N",4,0,25
"5364","SC1",2024-02-27,"Queens Park","Arbroath",6,0,"H",3,0,"H",1.69,3.91,4.94,"3-0","6-0",19,8,6,3,0,1,0,0,5,2,4,6,6,7,10,"5-2","Y","Y","Y",1,0,25
"5365","SC1",2024-02-27,"Raith Rvs","Morton",0,0,"D",0,0,"D",2.1,3.68,3.37,"0-0","0-0",3,1,10,4,3,3,0,0,4,7,13,12,0,11,25,"4-7","N","N","N",6,0,26
"5366","SC1",2024-03-01,"Arbroath","Raith Rvs",3,2,"H",0,1,"A",5.89,4.15,1.56,"0-1","3-2",9,3,17,7,0,1,0,0,1,9,13,13,5,10,26,"1-9","Y","Y","Y",1,0,26
"5367","SC1",2024-03-02,"Airdrie Utd","Queens Park",1,1,"D",0,1,"A",2.25,3.53,3.15,"0-1","1-1",17,8,12,3,2,3,0,0,8,4,6,12,2,12,18,"8-4","Y","N","N",5,0,26
"5368","SC1",2024-03-02,"Dunfermline","Ayr",2,0,"H",2,0,"H",2.44,3.52,2.85,"2-0","2-0",7,4,3,1,1,1,0,0,8,4,7,10,2,12,17,"8-4","Y","N","N",2,0,26
"5369","SC1",2024-03-02,"Morton","Inverness C",0,2,"A",0,2,"A",1.76,3.71,4.71,"0-2","0-2",7,2,7,4,4,4,0,0,6,1,16,17,2,7,33,"6-1","Y","N","N",8,0,26
"5370","SC1",2024-03-02,"Partick","Dundee United",1,1,"D",1,0,"H",4.03,3.64,1.91,"1-0","1-1",5,1,8,3,2,3,0,0,6,5,10,14,2,11,24,"6-5","Y","N","N",5,0,27
"5371","SC1",2024-03-05,"Dunfermline","Airdrie Utd",0,2,"A",0,1,"A",2.45,3.28,3.02,"0-1","0-2",9,1,6,2,2,5,0,0,5,2,3,14,2,7,17,"5-2","Y","N","N",7,0,27
"5372","SC1",2024-03-05,"Morton","Dundee United",0,1,"A",0,1,"A",3.69,3.34,2.11,"0-1","0-1",6,1,6,4,5,4,0,0,1,1,15,10,1,2,25,"1-1","N","N","N",9,0,27
"5373","SC1",2024-03-09,"Dundee United","Arbroath",4,0,"H",2,0,"H",1.15,8.38,15.91,"2-0","4-0",16,12,2,1,1,2,0,1,10,1,12,11,4,11,23,"10-1","Y","Y","Y",3,1,27
"5374","SC1",2024-03-09,"Inverness C","Airdrie Utd",0,0,"D",0,0,"D",2.2,3.35,3.43,"0-0","0-0",8,2,4,2,1,4,0,0,6,4,8,15,0,10,23,"6-4","N","N","N",5,0,27
"5375","SC1",2024-03-09,"Queens Park","Partick",2,2,"D",1,0,"H",3.1,3.99,2.12,"1-0","2-2",12,6,12,7,5,3,0,0,6,7,12,6,4,13,18,"6-7","Y","Y","Y",8,0,28
"5376","SC1",2024-03-09,"Raith Rvs","Dunfermline",2,0,"H",1,0,"H",1.85,3.75,4.19,"1-0","2-0",10,6,13,5,3,3,0,0,5,8,9,10,2,13,19,"5-8","Y","N","N",6,0,28
"5377","SC1",2024-03-12,"Partick","Raith Rvs",0,1,"A",0,1,"A",2.2,3.64,3.16,"0-1","0-1",14,4,5,3,2,1,0,0,5,2,9,11,1,7,20,"5-2","N","N","N",3,0,28
"5378","SC1",2024-03-15,"Dunfermline","Dundee United",3,1,"H",2,0,"H",5.54,3.73,1.67,"2-0","3-1",11,4,14,3,1,2,0,0,4,4,8,10,4,8,18,"4-4","Y","Y","Y",3,0,28
"5379","SC1",2024-03-16,"Airdrie Utd","Arbroath",5,2,"H",2,1,"H",1.56,4.19,5.89,"2-1","5-2",14,9,5,2,2,4,0,0,11,5,10,14,7,16,24,"11-5","Y","Y","Y",6,0,28
"5380","SC1",2024-03-16,"Inverness C","Ayr",1,2,"A",1,1,"D",2.26,3.39,3.26,"1-1","1-2",8,2,5,3,2,1,0,0,6,4,11,17,3,10,28,"6-4","Y","Y","N",3,0,29
"5381","SC1",2024-03-16,"Partick","Morton",2,1,"H",1,0,"H",2.33,3.68,2.92,"1-0","2-1",11,6,8,4,2,2,0,0,4,5,11,13,3,9,24,"4-5","Y","Y","N",4,0,29
"5382","SC1",2024-03-16,"Queens Park","Raith Rvs",0,0,"D",0,0,"D",3.45,3.75,2.04,"0-0","0-0",10,1,14,4,2,1,0,0,9,11,10,6,0,20,16,"9-11","N","N","N",3,0,29
"5383","SC2",2023-08-05,"Falkirk","Annan Athletic",3,0,"H",0,0,"D",NA,NA,NA,"0-0","3-0",17,8,4,0,3,1,0,0,11,1,14,5,3,12,19,"11-1","Y","Y","N",4,0,1
"5384","SC2",2023-08-05,"Hamilton","Cove Rangers",1,0,"H",1,0,"H",NA,NA,NA,"1-0","1-0",9,6,4,0,2,1,0,1,7,5,8,2,1,12,10,"7-5","N","N","N",3,1,1
"5385","SC2",2023-08-05,"Montrose","Kelty Hearts",0,2,"A",0,0,"D",2.26,3.4,2.93,"0-0","0-2",11,4,11,4,3,3,0,0,12,5,17,13,2,17,30,"12-5","Y","N","N",6,0,1
"5386","SC2",2023-08-05,"Queen of Sth","Alloa",3,4,"A",2,4,"A",1.93,3.61,3.68,"2-4","3-4",9,4,10,8,3,2,0,0,8,3,9,18,7,11,27,"8-3","Y","Y","Y",5,0,1
"5387","SC2",2023-08-05,"Stirling","Edinburgh City",1,0,"H",0,0,"D",NA,NA,NA,"0-0","1-0",12,5,5,4,0,3,0,0,10,1,12,10,1,11,22,"10-1","N","N","N",3,0,1
"5388","SC2",2023-08-12,"Alloa","Stirling",0,1,"A",0,0,"D",NA,NA,NA,"0-0","0-1",3,1,4,2,3,2,1,0,3,5,11,10,1,8,21,"3-5","N","N","N",5,1,2
"5389","SC2",2023-08-12,"Annan Athletic","Montrose",1,3,"A",0,3,"A",2.51,3.43,2.67,"0-3","1-3",16,5,4,3,0,2,0,0,4,3,7,11,4,7,18,"4-3","Y","Y","Y",2,0,2
"5390","SC2",2023-08-12,"Cove Rangers","Falkirk",2,2,"D",0,0,"D",NA,NA,NA,"0-0","2-2",7,4,13,7,3,3,0,0,3,8,17,11,4,11,28,"3-8","Y","Y","Y",6,0,2
"5391","SC2",2023-08-12,"Edinburgh City","Queen of Sth",1,2,"A",1,0,"H",NA,NA,NA,"1-0","1-2",8,3,14,8,1,1,0,1,3,10,14,8,3,13,22,"3-10","Y","Y","N",2,1,2
"5392","SC2",2023-08-12,"Kelty Hearts","Hamilton",0,2,"A",0,0,"D",NA,NA,NA,"0-0","0-2",5,1,16,11,0,2,0,0,3,7,6,6,2,10,12,"3-7","Y","N","N",2,0,2
"5393","SC2",2023-08-19,"Edinburgh City","Hamilton",0,3,"A",0,1,"A",3.81,3.77,1.86,"0-1","0-3",9,1,23,9,0,2,1,0,3,8,11,6,3,11,17,"3-8","Y","Y","N",2,1,3
"5394","SC2",2023-08-19,"Kelty Hearts","Alloa",2,1,"H",1,0,"H",2.49,3.25,2.82,"1-0","2-1",7,3,9,3,2,6,0,0,2,2,16,9,3,4,25,"2-2","Y","Y","N",8,0,3
"5395","SC2",2023-08-19,"Montrose","Cove Rangers",0,3,"A",0,2,"A",2.5,3.41,2.7,"0-2","0-3",8,5,19,8,0,0,0,0,6,3,8,9,3,9,17,"6-3","Y","Y","N",0,0,3
"5396","SC2",2023-08-19,"Queen of Sth","Annan Athletic",3,1,"H",0,1,"A",1.58,4.16,5.23,"0-1","3-1",13,4,6,1,2,2,0,0,5,1,14,6,4,6,20,"5-1","Y","Y","Y",4,0,3
"5397","SC2",2023-08-22,"Falkirk","Stirling",3,0,"H",3,0,"H",1.66,3.97,4.46,"3-0","3-0",12,4,3,3,2,2,0,0,10,2,11,11,3,12,22,"10-2","Y","Y","N",4,0,3
"5398","SC2",2023-08-26,"Annan Athletic","Edinburgh City",3,2,"H",1,2,"A",2.11,3.45,3.32,"1-2","3-2",16,8,15,7,3,2,0,0,2,8,7,8,5,10,15,"2-8","Y","Y","Y",5,0,4
"5399","SC2",2023-08-26,"Cove Rangers","Queen of Sth",1,2,"A",0,2,"A",2.07,3.62,3.27,"0-2","1-2",15,3,6,2,1,2,1,1,6,5,12,14,3,11,26,"6-5","Y","Y","N",3,2,4
"5400","SC2",2023-08-26,"Hamilton","Montrose",1,0,"H",1,0,"H",1.43,4.58,6.8,"1-0","1-0",7,4,4,2,2,3,0,0,10,1,13,8,1,11,21,"10-1","N","N","N",5,0,4
"5401","SC2",2023-08-26,"Stirling","Kelty Hearts",1,0,"H",0,0,"D",1.9,3.72,3.71,"0-0","1-0",8,3,7,2,1,1,0,0,9,4,8,5,1,13,13,"9-4","N","N","N",2,0,4
"5402","SC2",2023-08-26,"Alloa","Falkirk",1,4,"A",0,2,"A",3.99,3.88,1.8,"0-2","1-4",6,4,14,7,3,2,0,0,2,9,9,13,5,11,22,"2-9","Y","Y","Y",5,0,4
"5403","SC2",2023-09-02,"Alloa","Cove Rangers",1,0,"H",1,0,"H",2.64,3.33,2.6,"1-0","1-0",10,5,9,3,3,1,0,0,5,3,10,10,1,8,20,"5-3","N","N","N",4,0,5
"5404","SC2",2023-09-02,"Edinburgh City","Falkirk",0,2,"A",0,1,"A",7.01,4.84,1.4,"0-1","0-2",2,0,28,12,4,0,0,0,4,7,12,7,2,11,19,"4-7","Y","N","N",4,0,5
"5405","SC2",2023-09-02,"Kelty Hearts","Annan Athletic",1,1,"D",0,0,"D",1.71,3.87,4.21,"0-0","1-1",6,3,11,2,1,2,0,0,2,3,8,6,2,5,14,"2-3","Y","N","N",3,0,5
"5406","SC2",2023-09-02,"Queen of Sth","Montrose",2,3,"A",0,2,"A",1.79,3.9,3.99,"0-2","2-3",10,6,6,4,1,1,0,0,4,5,6,8,5,9,14,"4-5","Y","Y","Y",2,0,5
"5407","SC2",2023-09-02,"Stirling","Hamilton",2,2,"D",1,2,"A",3.63,3.58,1.96,"1-2","2-2",8,5,17,7,2,0,0,0,1,7,15,7,4,8,22,"1-7","Y","Y","Y",2,0,5
"5408","SC2",2023-09-16,"Annan Athletic","Stirling",3,0,"H",1,0,"H",2.72,3.44,2.47,"1-0","3-0",14,8,11,3,1,3,0,0,4,9,9,14,3,13,23,"4-9","Y","Y","N",4,0,6
"5409","SC2",2023-09-16,"Cove Rangers","Kelty Hearts",2,2,"D",1,2,"A",1.94,3.61,3.65,"1-2","2-2",7,4,5,5,2,3,0,1,4,3,8,8,4,7,16,"4-3","Y","Y","Y",5,1,6
"5410","SC2",2023-09-16,"Falkirk","Queen of Sth",1,0,"H",0,0,"D",1.56,3.88,4.62,"0-0","1-0",11,4,4,0,0,2,0,0,5,1,9,9,1,6,18,"5-1","N","N","N",2,0,6
"5411","SC2",2023-09-16,"Hamilton","Alloa",2,1,"H",0,0,"D",1.56,4.2,5.4,"0-0","2-1",15,8,9,4,2,2,0,0,11,3,9,13,3,14,22,"11-3","Y","Y","N",4,0,6
"5412","SC2",2023-09-16,"Montrose","Edinburgh City",5,2,"H",4,0,"H",1.72,3.92,4.35,"4-0","5-2",15,8,14,7,2,4,0,0,7,5,9,18,7,12,27,"7-5","Y","Y","Y",6,0,6
"5413","SC2",2023-09-23,"Annan Athletic","Alloa",1,1,"D",0,1,"A",2.62,3.45,2.55,"0-1","1-1",15,8,8,2,2,1,0,0,7,0,9,15,2,7,24,"7-0","Y","N","N",3,0,7
"5414","SC2",2023-09-23,"Edinburgh City","Cove Rangers",2,2,"D",1,1,"D",4.34,4.11,1.69,"1-1","2-2",12,5,17,7,1,2,0,0,7,3,8,7,4,10,15,"7-3","Y","Y","Y",3,0,7
"5415","SC2",2023-09-23,"Montrose","Stirling",1,0,"H",0,0,"D",2.5,3.44,2.68,"0-0","1-0",5,3,4,0,3,4,0,0,5,5,11,13,1,10,24,"5-5","N","N","N",7,0,7
"5416","SC2",2023-09-23,"Queen of Sth","Hamilton",1,2,"A",1,1,"D",3.31,3.54,2.09,"1-1","1-2",7,1,16,8,5,1,0,0,1,6,21,11,3,7,32,"1-6","Y","Y","N",6,0,7
"5417","SC2",2023-09-23,"Kelty Hearts","Falkirk",1,5,"A",1,3,"A",4.9,4.02,1.64,"1-3","1-5",2,1,22,14,2,2,0,0,3,6,9,13,6,9,22,"3-6","Y","Y","Y",4,0,7
"5418","SC2",2023-09-29,"Hamilton","Annan Athletic",5,0,"H",1,0,"H",1.34,5.34,7.83,"1-0","5-0",16,6,2,1,1,1,0,0,4,4,13,7,5,8,20,"4-4","Y","Y","Y",2,0,8
"5419","SC2",2023-09-30,"Alloa","Edinburgh City",1,1,"D",0,0,"D",1.67,3.94,4.45,"0-0","1-1",14,6,6,3,2,2,0,0,7,5,11,8,2,12,19,"7-5","Y","N","N",4,0,8
"5420","SC2",2023-09-30,"Falkirk","Montrose",3,2,"H",0,0,"D",1.39,4.65,6.35,"0-0","3-2",21,7,10,3,2,3,0,0,13,5,12,8,5,18,20,"13-5","Y","Y","Y",5,0,8
"5421","SC2",2023-09-30,"Kelty Hearts","Queen of Sth",3,1,"H",1,1,"D",2.77,3.59,2.35,"1-1","3-1",8,3,14,4,3,2,0,0,5,6,18,14,4,11,32,"5-6","Y","Y","Y",5,0,8
"5422","SC2",2023-09-30,"Stirling","Cove Rangers",2,2,"D",1,0,"H",2.5,3.31,2.76,"1-0","2-2",11,7,9,4,2,0,0,1,2,4,8,7,4,6,15,"2-4","Y","Y","Y",2,1,8
"5423","SC2",2023-10-07,"Cove Rangers","Annan Athletic",3,2,"H",2,0,"H",1.63,3.97,4.41,"2-0","3-2",15,8,8,4,3,2,0,0,3,1,12,10,5,4,22,"3-1","Y","Y","Y",5,0,9
"5424","SC2",2023-10-07,"Edinburgh City","Kelty Hearts",1,4,"A",0,2,"A",3.13,3.59,2.14,"0-2","1-4",10,4,17,8,1,1,0,0,9,11,7,12,5,20,19,"9-11","Y","Y","Y",2,0,9
"5425","SC2",2023-10-07,"Montrose","Alloa",2,1,"H",1,0,"H",2.05,3.58,3.35,"1-0","2-1",7,5,12,5,1,3,0,0,4,7,11,16,3,11,27,"4-7","Y","Y","N",4,0,9
"5426","SC2",2023-10-07,"Queen of Sth","Stirling",0,1,"A",0,0,"D",1.93,3.77,3.55,"0-0","0-1",10,5,13,6,2,2,0,0,9,3,7,13,1,12,20,"9-3","N","N","N",4,0,9
"5427","SC2",2023-10-07,"Falkirk","Hamilton",0,0,"D",0,0,"D",1.96,3.56,3.64,"0-0","0-0",9,1,7,3,1,3,0,0,1,2,10,16,0,3,26,"1-2","N","N","N",4,0,9
"5428","SC2",2023-10-21,"Alloa","Kelty Hearts",3,1,"H",1,1,"D",2.3,3.66,2.8,"1-1","3-1",9,6,7,3,1,2,0,0,2,5,16,11,4,7,27,"2-5","Y","Y","Y",3,0,10
"5429","SC2",2023-10-21,"Annan Athletic","Queen of Sth",0,1,"A",0,1,"A",2.88,3.61,2.28,"0-1","0-1",16,4,9,4,3,4,0,0,5,2,12,10,1,7,22,"5-2","N","N","N",7,0,10
"5430","SC2",2023-10-21,"Hamilton","Edinburgh City",1,1,"D",1,0,"H",1.19,7.11,11.36,"1-0","1-1",16,5,7,1,3,2,0,0,13,0,6,8,2,13,14,"13-0","Y","N","N",5,0,10
"5431","SC2",2023-10-21,"Stirling","Falkirk",1,2,"A",1,1,"D",5.7,4.25,1.53,"1-1","1-2",2,1,16,7,6,5,0,0,2,6,16,16,3,8,32,"2-6","Y","Y","N",11,0,10
"5432","SC2",2023-10-28,"Edinburgh City","Annan Athletic",3,2,"H",2,1,"H",3.03,3.6,2.19,"2-1","3-2",5,4,12,6,2,2,0,0,4,2,13,13,5,6,26,"4-2","Y","Y","Y",4,0,10
"5433","SC2",2023-10-28,"Falkirk","Alloa",3,0,"H",3,0,"H",1.27,5.78,9.19,"3-0","3-0",21,8,3,0,1,3,0,0,12,1,9,12,3,13,21,"12-1","Y","Y","N",4,0,11
"5434","SC2",2023-10-28,"Kelty Hearts","Stirling",1,0,"H",0,0,"D",2.17,3.67,3.02,"0-0","1-0",7,3,6,2,1,1,0,1,9,8,8,8,1,17,16,"9-8","N","N","N",2,1,11
"5435","SC2",2023-10-28,"Queen of Sth","Cove Rangers",0,1,"A",0,0,"D",2.55,3.66,2.51,"0-0","0-1",7,2,13,5,1,0,0,0,2,4,13,8,1,6,21,"2-4","N","N","N",1,0,11
"5436","SC2",2023-10-28,"Montrose","Hamilton",0,3,"A",0,1,"A",4.48,4.09,1.68,"0-1","0-3",10,1,12,7,4,3,0,0,3,3,10,13,3,6,23,"3-3","Y","Y","N",7,0,11
"5437","SC2",2023-11-04,"Annan Athletic","Kelty Hearts",2,2,"D",1,1,"D",2.48,3.48,2.67,"1-1","2-2",7,3,8,4,3,2,0,0,4,17,13,5,4,21,18,"4-17","Y","Y","Y",5,0,11
"5438","SC2",2023-11-04,"Cove Rangers","Hamilton",1,0,"H",0,0,"D",3.4,3.63,2.02,"0-0","1-0",5,2,13,4,0,0,0,0,4,9,10,7,1,13,17,"4-9","N","N","N",0,0,12
"5439","SC2",2023-11-04,"Edinburgh City","Montrose",1,5,"A",1,2,"A",3.16,3.76,2.08,"1-2","1-5",4,1,13,8,5,2,0,0,5,7,17,15,6,12,32,"5-7","Y","Y","Y",7,0,12
"5440","SC2",2023-11-04,"Queen of Sth","Falkirk",1,1,"D",1,1,"D",6.89,4.68,1.42,"1-1","1-1",10,3,15,4,1,0,0,0,6,6,10,9,2,12,19,"6-6","Y","N","N",1,0,12
"5441","SC2",2023-11-04,"Stirling","Alloa",0,2,"A",0,1,"A",2.09,3.44,3.08,"0-1","0-2",8,2,14,6,2,1,0,0,5,6,12,7,2,11,19,"5-6","Y","N","N",3,0,12
"5442","SC2",2023-11-11,"Alloa","Queen of Sth",1,0,"H",0,0,"D",2.74,3.47,2.43,"0-0","1-0",8,4,7,2,1,3,0,0,3,7,6,7,1,10,13,"3-7","N","N","N",4,0,12
"5443","SC2",2023-11-11,"Falkirk","Edinburgh City",2,1,"H",1,1,"D",1.15,8.35,13.5,"1-1","2-1",18,7,6,1,1,7,0,0,5,2,15,14,3,7,29,"5-2","Y","Y","N",8,0,13
"5444","SC2",2023-11-11,"Hamilton","Stirling",5,0,"H",2,0,"H",1.4,4.79,7.01,"2-0","5-0",17,9,2,1,0,2,0,1,4,2,11,10,5,6,21,"4-2","Y","Y","Y",2,1,13
"5445","SC2",2023-11-11,"Kelty Hearts","Cove Rangers",0,1,"A",0,1,"A",2.7,3.54,2.43,"0-1","0-1",10,1,13,4,2,1,0,0,5,8,12,11,1,13,23,"5-8","N","N","N",3,0,13
"5446","SC2",2023-11-11,"Montrose","Annan Athletic",1,1,"D",0,1,"A",1.88,4.18,3.39,"0-1","1-1",15,2,12,4,4,3,0,0,4,4,9,10,2,8,19,"4-4","Y","N","N",7,0,13
"5447","SC2",2023-11-14,"Cove Rangers","Montrose",1,0,"H",1,0,"H",1.8,3.62,4.28,"1-0","1-0",7,4,6,3,1,3,0,0,5,7,6,12,1,12,18,"5-7","N","N","N",4,0,13
"5448","SC2",2023-11-18,"Cove Rangers","Stirling",3,1,"H",1,1,"D",1.58,4.11,5.33,"1-1","3-1",8,6,6,4,2,0,0,0,9,1,14,10,4,10,24,"9-1","Y","Y","Y",2,0,14
"5449","SC2",2023-11-18,"Edinburgh City","Alloa",3,0,"H",2,0,"H",3.89,3.83,1.83,"2-0","3-0",10,4,14,4,4,1,0,0,0,5,15,10,3,5,25,"0-5","Y","Y","N",5,0,14
"5450","SC2",2023-11-18,"Queen of Sth","Kelty Hearts",1,3,"A",1,1,"D",2.08,3.58,3.09,"1-1","1-3",11,6,11,4,2,1,0,0,7,5,9,10,4,12,19,"7-5","Y","Y","Y",3,0,14
"5451","SC2",2023-11-28,"Annan Athletic","Hamilton",1,2,"A",1,2,"A",5.24,4.3,1.56,"1-2","1-2",9,2,17,5,2,2,0,1,1,6,7,13,3,7,20,"1-6","Y","Y","N",4,1,14
"5452","SC2",2023-11-28,"Montrose","Falkirk",0,0,"D",0,0,"D",8.4,5.11,1.34,"0-0","0-0",5,1,10,3,2,4,0,0,5,7,13,16,0,12,29,"5-7","N","N","N",6,0,14
"5453","SC2",2023-12-02,"Hamilton","Queen of Sth",5,0,"H",3,0,"H",1.43,4.62,6.75,"3-0","5-0",20,11,5,1,1,3,0,1,12,2,2,8,5,14,10,"12-2","Y","Y","Y",4,1,15
"5454","SC2",2023-12-09,"Alloa","Hamilton",0,0,"D",0,0,"D",6.5,4.3,1.48,"0-0","0-0",8,3,10,3,1,3,0,0,7,5,12,9,0,12,21,"7-5","N","N","N",4,0,15
"5455","SC2",2023-12-09,"Annan Athletic","Cove Rangers",1,3,"A",1,2,"A",4.05,3.87,1.79,"1-2","1-3",11,5,8,5,1,2,0,1,4,2,17,5,4,6,22,"4-2","Y","Y","Y",3,1,15
"5456","SC2",2023-12-09,"Edinburgh City","Stirling",1,3,"A",1,2,"A",5.1,4.12,1.6,"1-2","1-3",7,5,18,8,2,3,0,0,3,9,8,8,4,12,16,"3-9","Y","Y","Y",5,0,15
"5457","SC2",2023-12-09,"Falkirk","Kelty Hearts",2,1,"H",1,0,"H",1.25,5.8,10.4,"1-0","2-1",21,11,3,2,5,2,0,0,11,0,22,10,3,11,32,"11-0","Y","Y","N",7,0,15
"5458","SC2",2023-12-09,"Montrose","Queen of Sth",1,4,"A",0,4,"A",1.93,3.76,3.59,"0-4","1-4",6,1,12,6,4,0,0,0,6,7,14,11,5,13,25,"6-7","Y","Y","Y",4,0,16
"5459","SC2",2023-12-16,"Cove Rangers","Alloa",1,2,"A",1,0,"H",1.77,3.72,4.36,"1-0","1-2",5,2,7,5,1,2,0,0,2,6,15,8,3,8,23,"2-6","Y","Y","N",3,0,16
"5460","SC2",2023-12-16,"Hamilton","Falkirk",1,3,"A",1,2,"A",2.44,3.19,2.93,"1-2","1-3",9,5,9,5,2,4,0,0,6,4,16,11,4,10,27,"6-4","Y","Y","Y",6,0,16
"5461","SC2",2023-12-16,"Kelty Hearts","Montrose",0,1,"A",0,1,"A",2.22,3.41,3.07,"0-1","0-1",6,3,7,4,1,1,0,0,2,2,9,17,1,4,26,"2-2","N","N","N",2,0,16
"5462","SC2",2023-12-16,"Queen of Sth","Edinburgh City",3,1,"H",1,0,"H",1.18,7.61,11.3,"1-0","3-1",16,6,4,2,1,3,0,0,2,3,10,14,4,5,24,"2-3","Y","Y","Y",4,0,16
"5463","SC2",2023-12-16,"Stirling","Annan Athletic",1,1,"D",1,1,"D",1.93,3.59,3.66,"1-1","1-1",12,4,8,1,2,3,0,0,3,7,17,11,2,10,28,"3-7","Y","N","N",5,0,17
"5464","SC2",2023-12-23,"Alloa","Montrose",2,2,"D",0,0,"D",2.26,3.51,2.97,"0-0","2-2",12,5,5,2,2,3,0,0,5,1,11,6,4,6,17,"5-1","Y","Y","Y",5,0,17
"5465","SC2",2023-12-23,"Annan Athletic","Falkirk",0,3,"A",0,1,"A",7.97,5.45,1.33,"0-1","0-3",2,2,16,8,3,3,0,0,1,12,7,14,3,13,21,"1-12","Y","Y","N",6,0,17
"5466","SC2",2023-12-23,"Hamilton","Kelty Hearts",1,1,"D",0,0,"D",1.34,5.2,8.11,"0-0","1-1",11,9,5,2,1,2,1,0,9,4,22,14,2,13,36,"9-4","Y","N","N",3,1,17
"5467","SC2",2023-12-23,"Stirling","Queen of Sth",1,1,"D",1,0,"H",2.37,3.41,2.86,"1-0","1-1",8,5,16,6,1,2,0,0,4,10,11,13,2,14,24,"4-10","Y","N","N",3,0,17
"5468","SC2",2023-12-23,"Cove Rangers","Edinburgh City",7,2,"H",2,1,"H",1.1,10.61,17.42,"2-1","7-2",21,13,7,5,1,0,0,1,12,1,9,12,9,13,21,"12-1","Y","Y","Y",1,1,18
"5469","SC2",2023-12-30,"Edinburgh City","Hamilton",2,5,"A",0,5,"A",NA,NA,NA,"0-5","2-5",5,3,23,9,3,0,0,0,1,13,7,10,7,14,17,"1-13","Y","Y","Y",3,0,18
"5470","SC2",2023-12-30,"Falkirk","Stirling",5,0,"H",4,0,"H",1.19,6.84,12.73,"4-0","5-0",14,8,2,2,0,1,0,0,12,2,6,6,5,14,12,"12-2","Y","Y","Y",1,0,18
"5471","SC2",2023-12-30,"Montrose","Cove Rangers",1,1,"D",1,1,"D",3.47,3.64,1.99,"1-1","1-1",9,4,11,5,1,2,0,0,10,5,5,5,2,15,10,"10-5","Y","N","N",3,0,18
"5472","SC2",2023-12-30,"Queen of Sth","Annan Athletic",2,1,"H",1,1,"D",1.68,3.99,4.54,"1-1","2-1",7,3,7,4,3,4,0,1,2,4,17,12,3,6,29,"2-4","Y","Y","N",7,1,18
"5473","SC2",2024-01-06,"Alloa","Edinburgh City",3,1,"H",1,0,"H",NA,NA,NA,"1-0","3-1",11,4,4,2,1,2,0,0,6,0,7,9,4,6,16,"6-0","Y","Y","Y",3,0,19
"5474","SC2",2024-01-06,"Annan Athletic","Montrose",2,2,"D",1,1,"D",2.45,3.62,2.63,"1-1","2-2",10,4,9,5,2,2,0,2,5,4,11,10,4,9,21,"5-4","Y","Y","Y",4,2,19
"5475","SC2",2024-01-06,"Cove Rangers","Kelty Hearts",2,2,"D",2,0,"H",1.51,4.3,5.64,"2-0","2-2",9,4,6,5,1,0,0,0,6,3,11,9,4,9,20,"6-3","Y","Y","Y",1,0,19
"5476","SC2",2024-01-06,"Falkirk","Queen of Sth",1,0,"H",0,0,"D",1.3,5.44,9.01,"0-0","1-0",15,3,1,0,2,1,0,0,3,0,7,9,1,3,16,"3-0","N","N","N",3,0,19
"5477","SC2",2024-01-09,"Falkirk","Cove Rangers",4,0,"H",1,0,"H",1.36,4.87,8.23,"1-0","4-0",16,10,2,0,1,1,0,0,9,0,12,5,4,9,17,"9-0","Y","Y","Y",2,0,19
"5478","SC2",2024-01-13,"Hamilton","Cove Rangers",2,0,"H",1,0,"H",1.56,4.17,5.46,"1-0","2-0",10,5,17,5,1,0,1,1,1,2,12,9,2,3,21,"1-2","Y","N","N",1,2,20
"5479","SC2",2024-01-13,"Kelty Hearts","Annan Athletic",1,1,"D",1,0,"H",1.92,4.06,3.36,"1-0","1-1",6,2,2,1,0,4,0,0,6,1,7,15,2,7,22,"6-1","Y","N","N",4,0,20
"5480","SC2",2024-01-13,"Montrose","Stirling",0,1,"A",0,0,"D",2.12,3.52,3.23,"0-0","0-1",9,3,9,3,2,1,0,1,8,2,6,15,1,10,21,"8-2","N","N","N",3,1,20
"5481","SC2",2024-01-13,"Queen of Sth","Alloa",1,1,"D",1,1,"D",2.34,3.57,2.8,"1-1","1-1",10,5,6,1,2,2,0,0,4,2,10,10,2,6,20,"4-2","Y","N","N",4,0,20
"5482","SC2",2024-01-13,"Edinburgh City","Falkirk",2,2,"D",2,0,"H",NA,NA,NA,"2-0","2-2",8,2,25,7,5,1,0,0,1,15,14,13,4,16,27,"1-15","Y","Y","Y",6,0,20
"5483","SC2",2024-01-27,"Alloa","Falkirk",0,5,"A",0,1,"A",6.74,4.71,1.42,"0-1","0-5",4,2,22,11,1,2,0,0,3,7,12,7,5,10,19,"3-7","Y","Y","Y",3,0,21
"5484","SC2",2024-01-27,"Annan Athletic","Edinburgh City",3,0,"H",1,0,"H",1.29,5.85,7.99,"1-0","3-0",16,9,6,4,0,3,0,0,6,5,6,16,3,11,22,"6-5","Y","Y","N",3,0,21
"5485","SC2",2024-01-27,"Cove Rangers","Queen of Sth",0,2,"A",0,1,"A",1.73,3.89,4.37,"0-1","0-2",4,2,6,4,1,2,0,0,4,6,9,12,2,10,21,"4-6","Y","N","N",3,0,21
"5486","SC2",2024-01-27,"Hamilton","Montrose",1,1,"D",1,0,"H",1.29,5.59,8.97,"1-0","1-1",5,3,3,2,0,2,0,0,8,3,1,11,2,11,12,"8-3","Y","N","N",2,0,21
"5487","SC2",2024-01-27,"Stirling","Kelty Hearts",5,0,"H",1,0,"H",2.4,3.35,2.86,"1-0","5-0",13,9,8,5,1,2,0,1,5,7,8,12,5,12,20,"5-7","Y","Y","Y",3,1,21
"5488","SC2",2024-02-03,"Annan Athletic","Alloa",2,3,"A",1,2,"A",2.78,3.68,2.31,"1-2","2-3",9,4,13,7,3,4,0,0,5,3,12,15,5,8,27,"5-3","Y","Y","Y",7,0,22
"5489","SC2",2024-02-03,"Edinburgh City","Kelty Hearts",0,3,"A",0,1,"A",9.67,6.62,1.23,"0-1","0-3",11,0,14,7,1,2,0,0,0,6,14,8,3,6,22,"0-6","Y","Y","N",3,0,22
"5490","SC2",2024-02-03,"Queen of Sth","Hamilton",0,2,"A",0,0,"D",6.01,4.3,1.5,"0-0","0-2",10,2,13,5,0,1,0,0,2,6,11,4,2,8,15,"2-6","Y","N","N",1,0,22
"5491","SC2",2024-02-03,"Stirling","Cove Rangers",2,2,"D",1,0,"H",3.61,3.55,1.97,"1-0","2-2",13,7,9,4,1,0,0,0,4,6,14,6,4,10,20,"4-6","Y","Y","Y",1,0,22
"5492","SC2",2024-02-06,"Stirling","Montrose",0,2,"A",0,1,"A",2.35,3.21,3.05,"0-1","0-2",4,1,11,5,2,2,0,0,1,3,4,9,2,4,13,"1-3","Y","N","N",4,0,22
"5493","SC2",2024-02-10,"Alloa","Stirling",1,0,"H",0,0,"D",2.35,3.45,2.86,"0-0","1-0",8,1,6,0,1,3,0,0,8,7,12,10,1,15,22,"8-7","N","N","N",4,0,23
"5494","SC2",2024-02-10,"Hamilton","Annan Athletic",2,3,"A",0,1,"A",1.23,6.18,10.75,"0-1","2-3",19,7,8,4,4,3,0,0,9,6,13,7,5,15,20,"9-6","Y","Y","Y",7,0,23
"5495","SC2",2024-02-10,"Kelty Hearts","Queen of Sth",0,0,"D",0,0,"D",2.52,3.41,2.67,"0-0","0-0",4,1,9,4,3,2,0,0,8,6,13,15,0,14,28,"8-6","N","N","N",5,0,23
"5496","SC2",2024-02-10,"Montrose","Edinburgh City",3,0,"H",3,0,"H",1.14,8.42,15.57,"3-0","3-0",15,6,13,2,1,1,0,0,8,1,12,3,3,9,15,"8-1","Y","Y","N",2,0,23
"5497","SC2",2024-02-13,"Alloa","Annan Athletic",2,1,"H",1,0,"H",1.95,3.89,3.38,"1-0","2-1",11,7,11,9,3,2,0,0,5,6,11,10,3,11,21,"5-6","Y","Y","N",5,0,23
"5498","SC2",2024-02-13,"Kelty Hearts","Edinburgh City",3,2,"H",1,1,"D",1.12,9.47,16.13,"1-1","3-2",15,5,14,4,2,4,0,0,6,2,10,17,5,8,27,"6-2","Y","Y","Y",6,0,24
"5499","SC2",2024-02-17,"Alloa","Cove Rangers",4,1,"H",1,0,"H",2.41,3.56,2.77,"1-0","4-1",7,4,8,1,0,1,1,0,8,6,2,5,5,14,7,"8-6","Y","Y","Y",1,1,24
"5500","SC2",2024-02-17,"Annan Athletic","Stirling",2,1,"H",1,1,"D",2.91,3.37,2.4,"1-1","2-1",12,5,5,3,1,0,0,0,8,5,9,12,3,13,21,"8-5","Y","Y","N",1,0,24
"5501","SC2",2024-02-17,"Edinburgh City","Queen of Sth",1,1,"D",0,0,"D",8.42,7.08,1.25,"0-0","1-1",6,3,12,4,2,3,0,0,4,4,10,15,2,8,25,"4-4","Y","N","N",5,0,24
"5502","SC2",2024-02-17,"Falkirk","Hamilton",3,2,"H",3,1,"H",1.74,3.75,4.61,"3-1","3-2",13,7,13,7,0,3,0,0,2,10,9,10,5,12,19,"2-10","Y","Y","Y",3,0,24
"5503","SC2",2024-02-17,"Montrose","Kelty Hearts",4,2,"H",2,0,"H",2.2,3.53,3.13,"2-0","4-2",13,5,11,4,1,1,0,0,7,3,14,7,6,10,21,"7-3","Y","Y","Y",2,0,25
"5504","SC2",2024-02-20,"Falkirk","Montrose",3,0,"H",2,0,"H",1.21,6.51,12.04,"2-0","3-0",16,8,5,1,2,1,0,0,5,4,13,13,3,9,26,"5-4","Y","Y","N",3,0,25
"5505","SC2",2024-02-24,"Cove Rangers","Annan Athletic",2,1,"H",1,0,"H",1.62,4.68,4.4,"1-0","2-1",10,4,6,3,1,2,0,0,3,9,6,8,3,12,14,"3-9","Y","Y","N",3,0,25
"5506","SC2",2024-02-24,"Hamilton","Alloa",1,2,"A",0,0,"D",1.35,5.03,8.47,"0-0","1-2",18,9,13,5,0,0,0,0,8,8,5,9,3,16,14,"8-8","Y","Y","N",0,0,25
"5507","SC2",2024-02-24,"Kelty Hearts","Falkirk",0,1,"A",0,1,"A",8.54,5.38,1.33,"0-1","0-1",4,2,12,7,3,2,1,0,5,16,13,14,1,21,27,"5-16","N","N","N",5,1,25
"5508","SC2",2024-02-24,"Stirling","Edinburgh City",4,0,"H",1,0,"H",1.14,8.82,15.1,"1-0","4-0",18,12,4,1,1,1,0,1,8,3,7,14,4,11,21,"8-3","Y","Y","Y",2,1,26
"5509","SC2",2024-02-24,"Queen of Sth","Montrose",2,3,"A",1,0,"H",2.08,3.74,3.23,"1-0","2-3",6,2,9,4,1,1,0,0,3,5,14,13,5,8,27,"3-5","Y","Y","Y",2,0,26
"5510","SC2",2024-02-27,"Stirling","Hamilton",0,0,"D",0,0,"D",5.72,4.32,1.54,"0-0","0-0",7,4,13,3,2,2,0,0,4,8,12,13,0,12,25,"4-8","N","N","N",4,0,26
"5511","SC2",2024-03-02,"Edinburgh City","Cove Rangers",0,2,"A",0,1,"A",8.63,5.77,1.3,"0-1","0-2",14,7,13,10,1,2,0,0,4,5,8,11,2,9,19,"4-5","Y","N","N",3,0,26
"5512","SC2",2024-03-02,"Falkirk","Annan Athletic",1,1,"D",0,0,"D",1.14,8.84,16.06,"0-0","1-1",19,6,5,3,1,2,0,0,13,1,11,10,2,14,21,"13-1","Y","N","N",3,0,26
"5513","SC2",2024-03-02,"Kelty Hearts","Hamilton",0,5,"A",0,3,"A",5.61,4.24,1.56,"0-3","0-5",6,3,13,8,1,0,0,0,4,6,9,10,5,10,19,"4-6","Y","Y","Y",1,0,27
"5514","SC2",2024-03-02,"Montrose","Alloa",4,3,"H",2,2,"D",2.32,3.42,3,"2-2","4-3",14,7,13,7,1,2,0,1,2,5,8,4,7,7,12,"2-5","Y","Y","Y",3,1,27
"5515","SC2",2024-03-02,"Queen of Sth","Stirling",2,2,"D",1,1,"D",2.36,3.43,2.93,"1-1","2-2",7,3,6,4,4,4,0,0,7,7,12,13,4,14,25,"7-7","Y","Y","Y",8,0,27
"5516","SC2",2024-03-05,"Cove Rangers","Falkirk",0,1,"A",0,0,"D",6.76,4.73,1.43,"0-0","0-1",2,1,13,6,2,2,0,0,1,10,8,10,1,11,18,"1-10","N","N","N",4,0,27
"5517","SC2",2024-03-09,"Alloa","Kelty Hearts",3,0,"H",1,0,"H",1.83,3.89,3.94,"1-0","3-0",17,9,5,1,0,2,0,0,9,2,3,7,3,11,10,"9-2","Y","Y","N",2,0,27
"5518","SC2",2024-03-09,"Annan Athletic","Queen of Sth",2,1,"H",2,0,"H",2.7,3.79,2.36,"2-0","2-1",10,6,9,5,0,2,0,0,10,5,5,9,3,15,14,"10-5","Y","Y","N",2,0,28
"5519","SC2",2024-03-09,"Cove Rangers","Montrose",1,4,"A",0,3,"A",1.97,3.92,3.39,"0-3","1-4",9,2,10,7,1,1,0,0,4,2,11,13,5,6,24,"4-2","Y","Y","Y",2,0,28
"5520","SC2",2024-03-09,"Hamilton","Edinburgh City",1,0,"H",1,0,"H",1.04,19.87,33.19,"1-0","1-0",10,4,9,5,1,2,0,0,6,4,11,15,1,10,26,"6-4","N","N","N",3,0,28
"5521","SC2",2024-03-09,"Stirling","Falkirk",1,2,"A",1,1,"D",8,5.01,1.37,"1-1","1-2",11,3,12,7,2,2,0,0,2,9,13,8,3,11,21,"2-9","Y","Y","N",4,0,28
"5522","SC2",2024-03-16,"Edinburgh City","Alloa",2,5,"A",2,1,"H",9.88,6.07,1.26,"2-1","2-5",11,7,12,6,2,0,0,0,4,6,13,6,7,10,19,"4-6","Y","Y","Y",2,0,28
"5523","SC2",2024-03-16,"Hamilton","Stirling",3,0,"H",1,0,"H",1.37,5.23,7.43,"1-0","3-0",13,6,8,3,0,0,0,0,4,3,8,10,3,7,18,"4-3","Y","Y","N",0,0,29
"5524","SC2",2024-03-16,"Kelty Hearts","Cove Rangers",0,1,"A",0,0,"D",3.04,3.56,2.24,"0-0","0-1",11,3,5,2,1,2,0,0,3,6,7,9,1,9,16,"3-6","N","N","N",3,0,29
"5525","SC2",2024-03-16,"Montrose","Annan Athletic",1,1,"D",0,1,"A",1.81,4.06,3.88,"0-1","1-1",10,4,9,4,3,4,0,0,5,8,13,6,2,13,19,"5-8","Y","N","N",7,0,29
"5526","SC2",2024-03-16,"Queen of Sth","Falkirk",1,4,"A",0,0,"D",8.48,5.1,1.35,"0-0","1-4",12,7,15,7,4,1,0,0,5,5,11,9,5,10,20,"5-5","Y","Y","Y",5,0,29
"5527","SC3",2023-08-05,"Bonnyrigg Rose","Dumbarton",1,1,"D",0,1,"A",2.53,3.26,2.77,"0-1","1-1",9,4,13,6,3,2,0,0,10,4,13,12,2,14,25,"10-4","Y","N","N",5,0,1
"5528","SC3",2023-08-05,"East Fife","Peterhead",0,3,"A",0,1,"A",1.78,3.66,4.39,"0-1","0-3",5,3,10,6,2,3,0,0,4,4,10,12,3,8,22,"4-4","Y","Y","N",5,0,1
"5529","SC3",2023-08-05,"Elgin","Stranraer",0,1,"A",0,1,"A",2.56,3.38,2.65,"0-1","0-1",10,3,6,2,0,1,0,0,5,6,12,18,1,11,30,"5-6","N","N","N",1,0,1
"5530","SC3",2023-08-05,"Spartans","Clyde",1,1,"D",0,1,"A",1.59,3.64,4.05,"0-1","1-1",6,2,7,3,1,1,0,0,6,2,3,7,2,8,10,"6-2","Y","N","N",2,0,1
"5531","SC3",2023-08-05,"Stenhousemuir","Forfar",0,0,"D",0,0,"D",2.2,3.55,3.04,"0-0","0-0",12,3,9,5,2,2,0,0,6,7,12,10,0,13,22,"6-7","N","N","N",4,0,1
"5532","SC3",2023-08-12,"Clyde","Bonnyrigg Rose",0,2,"A",0,1,"A",NA,NA,NA,"0-1","0-2",6,1,9,5,0,2,0,0,4,5,6,10,2,9,16,"4-5","Y","N","N",2,0,2
"5533","SC3",2023-08-12,"Dumbarton","Spartans",1,1,"D",0,0,"D",NA,NA,NA,"0-0","1-1",3,2,2,1,1,3,0,0,4,7,7,5,2,11,12,"4-7","Y","N","N",4,0,2
"5534","SC3",2023-08-12,"Forfar","Elgin",0,0,"D",0,0,"D",1.79,3.58,4.44,"0-0","0-0",11,3,7,3,1,3,0,0,4,6,15,14,0,10,29,"4-6","N","N","N",4,0,2
"5535","SC3",2023-08-12,"Peterhead","Stenhousemuir",0,0,"D",0,0,"D",NA,NA,NA,"0-0","0-0",9,2,8,1,1,2,1,0,4,6,10,14,0,10,24,"4-6","N","N","N",3,1,2
"5536","SC3",2023-08-12,"Stranraer","East Fife",1,1,"D",0,0,"D",2.44,3.29,2.85,"0-0","1-1",3,3,14,8,2,1,1,0,6,6,8,11,2,12,19,"6-6","Y","N","N",3,1,2
"5537","SC3",2023-08-19,"Bonnyrigg Rose","Stranraer",1,1,"D",1,0,"H",2.55,3.32,2.7,"1-0","1-1",5,3,5,2,2,1,0,0,2,4,12,8,2,6,20,"2-4","Y","N","N",3,0,3
"5538","SC3",2023-08-19,"Clyde","Peterhead",1,2,"A",1,2,"A",2.64,3.55,2.39,"1-2","1-2",3,3,11,5,2,1,1,1,2,1,13,4,3,3,17,"2-1","Y","Y","N",3,2,3
"5539","SC3",2023-08-19,"Dumbarton","Forfar",3,1,"H",0,1,"A",2.66,3.32,2.58,"0-1","3-1",14,4,6,3,0,1,0,0,9,5,7,9,4,14,16,"9-5","Y","Y","Y",1,0,3
"5540","SC3",2023-08-19,"East Fife","Stenhousemuir",0,2,"A",0,1,"A",2.31,3.36,2.77,"0-1","0-2",6,3,6,4,2,3,0,0,6,3,9,14,2,9,23,"6-3","Y","N","N",5,0,3
"5541","SC3",2023-08-19,"Spartans","Elgin",2,1,"H",0,0,"D",1.61,3.93,4.75,"0-0","2-1",11,6,8,3,0,0,0,0,5,3,11,8,3,8,19,"5-3","Y","Y","N",0,0,3
"5542","SC3",2023-08-26,"Elgin","East Fife",1,1,"D",1,0,"H",2.91,3.33,2.38,"1-0","1-1",8,3,10,4,4,2,0,0,2,5,12,7,2,7,19,"2-5","Y","N","N",6,0,4
"5543","SC3",2023-08-26,"Forfar","Bonnyrigg Rose",1,2,"A",0,1,"A",2.21,3.19,3.34,"0-1","1-2",9,4,8,3,2,1,1,0,3,4,21,20,3,7,41,"3-4","Y","Y","N",3,1,4
"5544","SC3",2023-08-26,"Peterhead","Spartans",0,1,"A",0,0,"D",2.29,3.34,3.04,"0-0","0-1",5,2,11,6,4,1,0,0,3,5,10,8,1,8,18,"3-5","N","N","N",5,0,4
"5545","SC3",2023-08-26,"Stenhousemuir","Dumbarton",2,4,"A",0,4,"A",2.46,3.26,2.85,"0-4","2-4",10,5,12,8,4,5,0,1,9,7,9,12,6,16,21,"9-7","Y","Y","Y",9,1,4
"5546","SC3",2023-08-26,"Stranraer","Clyde",1,0,"H",0,0,"D",1.93,3.59,3.76,"0-0","1-0",15,3,9,4,1,1,0,0,7,3,11,9,1,10,20,"7-3","N","N","N",2,0,4
"5547","SC3",2023-09-02,"Bonnyrigg Rose","Elgin",5,1,"H",2,0,"H",1.74,3.65,4.66,"2-0","5-1",13,6,11,3,1,1,0,0,6,3,22,11,6,9,33,"6-3","Y","Y","Y",2,0,5
"5548","SC3",2023-09-02,"Clyde","Forfar",0,0,"D",0,0,"D",2.66,3.25,2.63,"0-0","0-0",7,5,7,1,2,2,0,0,3,2,14,12,0,5,26,"3-2","N","N","N",4,0,5
"5549","SC3",2023-09-02,"Dumbarton","East Fife",1,0,"H",0,0,"D",1.8,3.69,4.19,"0-0","1-0",10,3,7,2,1,2,0,0,3,4,13,15,1,7,28,"3-4","N","N","N",3,0,5
"5550","SC3",2023-09-02,"Spartans","Stenhousemuir",0,1,"A",0,0,"D",1.85,3.82,3.84,"0-0","0-1",7,2,9,4,1,0,0,1,10,3,6,7,1,13,13,"10-3","N","N","N",1,1,5
"5551","SC3",2023-09-02,"Stranraer","Peterhead",2,1,"H",2,0,"H",2.18,3.42,3.19,"2-0","2-1",14,7,11,5,3,3,0,0,6,5,11,18,3,11,29,"6-5","Y","Y","N",6,0,5
"5552","SC3",2023-09-16,"East Fife","Clyde",2,0,"H",1,0,"H",1.9,3.49,3.53,"1-0","2-0",9,4,6,3,2,2,0,0,4,0,10,17,2,4,27,"4-0","Y","N","N",4,0,6
"5553","SC3",2023-09-16,"Elgin","Dumbarton",2,0,"H",1,0,"H",3.56,3.48,2.01,"1-0","2-0",11,4,11,2,1,0,0,0,7,7,9,11,2,14,20,"7-7","Y","N","N",1,0,6
"5554","SC3",2023-09-16,"Forfar","Spartans",2,2,"D",1,2,"A",2.42,3.2,2.73,"1-2","2-2",8,6,12,7,3,2,0,0,5,4,11,8,4,9,19,"5-4","Y","Y","Y",5,0,6
"5555","SC3",2023-09-16,"Peterhead","Bonnyrigg Rose",2,1,"H",0,0,"D",2.58,3.22,2.73,"0-0","2-1",10,4,8,2,5,2,0,0,2,3,21,12,3,5,33,"2-3","Y","Y","N",7,0,6
"5556","SC3",2023-09-16,"Stenhousemuir","Stranraer",5,0,"H",2,0,"H",2.24,3.34,3.13,"2-0","5-0",10,8,3,2,2,3,0,0,8,3,9,10,5,11,19,"8-3","Y","Y","Y",5,0,6
"5557","SC3",2023-09-23,"Bonnyrigg Rose","Stenhousemuir",0,1,"A",0,0,"D",2.37,3.43,2.85,"0-0","0-1",8,3,11,5,5,3,0,0,4,2,13,15,1,6,28,"4-2","N","N","N",8,0,7
"5558","SC3",2023-09-23,"Clyde","Elgin",2,1,"H",2,0,"H",2.35,3.39,2.91,"2-0","2-1",11,4,13,2,2,2,0,0,7,2,7,8,3,9,15,"7-2","Y","Y","N",4,0,7
"5559","SC3",2023-09-23,"Dumbarton","Peterhead",0,1,"A",0,0,"D",2.16,3.42,3.22,"0-0","0-1",11,3,16,5,2,2,1,0,11,7,14,9,1,18,23,"11-7","N","N","N",4,1,7
"5560","SC3",2023-09-23,"Spartans","East Fife",2,2,"D",1,0,"H",1.98,3.36,3.83,"1-0","2-2",7,2,10,8,2,2,0,0,5,2,8,10,4,7,18,"5-2","Y","Y","Y",4,0,7
"5561","SC3",2023-09-23,"Stranraer","Forfar",0,2,"A",0,2,"A",2.3,3.3,3,"0-2","0-2",9,5,11,6,1,2,0,0,9,8,7,18,2,17,25,"9-8","Y","N","N",3,0,7
"5562","SC3",2023-09-30,"Dumbarton","Stranraer",3,1,"H",2,1,"H",1.83,3.62,4.12,"2-1","3-1",10,5,6,1,2,3,0,0,8,3,11,10,4,11,21,"8-3","Y","Y","Y",5,0,8
"5563","SC3",2023-09-30,"East Fife","Forfar",1,1,"D",1,0,"H",2.33,3.26,3.05,"1-0","1-1",2,1,9,3,1,2,0,0,4,3,15,17,2,7,32,"4-3","Y","N","N",3,0,8
"5564","SC3",2023-09-30,"Peterhead","Elgin",6,0,"H",2,0,"H",1.7,3.79,4.68,"2-0","6-0",13,8,4,1,0,5,0,0,4,2,9,15,6,6,24,"4-2","Y","Y","Y",5,0,8
"5565","SC3",2023-09-30,"Spartans","Bonnyrigg Rose",2,2,"D",0,1,"A",2.17,3.37,3.25,"0-1","2-2",7,3,9,4,2,1,0,0,6,4,15,11,4,10,26,"6-4","Y","Y","Y",3,0,8
"5566","SC3",2023-09-30,"Stenhousemuir","Clyde",2,2,"D",1,0,"H",1.6,3.98,5.34,"1-0","2-2",13,8,12,4,2,4,0,0,5,4,7,12,4,9,19,"5-4","Y","Y","Y",6,0,8
"5567","SC3",2023-10-07,"Clyde","Dumbarton",0,4,"A",0,2,"A",3.98,3.55,1.88,"0-2","0-4",10,4,11,6,2,2,0,0,6,5,11,11,4,11,22,"6-5","Y","Y","Y",4,0,9
"5568","SC3",2023-10-07,"Forfar","Peterhead",1,3,"A",0,2,"A",2.52,3.2,2.82,"0-2","1-3",12,6,10,5,2,1,0,0,8,2,8,14,4,10,22,"8-2","Y","Y","Y",3,0,9
"5569","SC3",2023-10-07,"Stranraer","Spartans",3,4,"A",1,2,"A",2.78,3.37,2.45,"1-2","3-4",10,5,14,6,1,0,0,0,11,4,13,9,7,15,22,"11-4","Y","Y","Y",1,0,9
"5570","SC3",2023-10-21,"Bonnyrigg Rose","Clyde",3,2,"H",1,2,"A",1.81,3.61,4.28,"1-2","3-2",9,6,13,6,1,2,0,0,2,7,7,14,5,9,21,"2-7","Y","Y","Y",3,0,9
"5571","SC3",2023-10-21,"East Fife","Stranraer",4,0,"H",2,0,"H",1.93,3.56,3.76,"2-0","4-0",12,6,0,0,2,1,0,0,5,7,10,11,4,12,21,"5-7","Y","Y","Y",3,0,9
"5572","SC3",2023-10-21,"Spartans","Dumbarton",2,0,"H",0,0,"D",2.4,3.38,2.84,"0-0","2-0",8,3,7,1,1,1,0,0,4,11,8,8,2,15,16,"4-11","Y","N","N",2,0,10
"5573","SC3",2023-10-24,"Elgin","Stenhousemuir",1,1,"D",0,1,"A",4.77,3.87,1.68,"0-1","1-1",11,2,11,4,3,2,0,1,5,5,13,15,2,10,28,"5-5","Y","N","N",5,1,10
"5574","SC3",2023-11-04,"Clyde","Spartans",1,2,"A",0,2,"A",3.79,3.67,1.89,"0-2","1-2",10,3,7,2,3,1,0,0,5,3,13,8,3,8,21,"5-3","Y","Y","N",4,0,10
"5575","SC3",2023-11-04,"Dumbarton","Bonnyrigg Rose",4,0,"H",2,0,"H",1.89,3.71,3.73,"2-0","4-0",12,7,15,3,3,1,0,0,6,9,8,10,4,15,18,"6-9","Y","Y","Y",4,0,10
"5576","SC3",2023-11-04,"Forfar","Stenhousemuir",1,3,"A",1,1,"D",3.25,3.39,2.17,"1-1","1-3",4,2,12,7,2,1,0,0,4,5,11,8,4,9,19,"4-5","Y","Y","Y",3,0,10
"5577","SC3",2023-11-04,"Peterhead","East Fife",2,0,"H",1,0,"H",2.08,3.4,3.45,"1-0","2-0",11,6,5,2,1,3,0,0,7,6,11,14,2,13,25,"7-6","Y","N","N",4,0,11
"5578","SC3",2023-11-04,"Stranraer","Elgin",3,1,"H",2,0,"H",1.75,3.7,3.96,"2-0","3-1",8,6,6,3,2,2,0,0,8,4,12,12,4,12,24,"8-4","Y","Y","Y",4,0,11
"5579","SC3",2023-11-11,"East Fife","Dumbarton",0,1,"A",0,1,"A",2.96,3.36,2.33,"0-1","0-1",5,2,6,4,1,3,0,0,4,9,10,11,1,13,21,"4-9","N","N","N",4,0,11
"5580","SC3",2023-11-11,"Elgin","Bonnyrigg Rose",2,0,"H",0,0,"D",3.52,3.49,2.03,"0-0","2-0",12,6,9,6,5,4,0,0,1,6,12,9,2,7,21,"1-6","Y","N","N",9,0,11
"5581","SC3",2023-11-11,"Forfar","Clyde",1,1,"D",0,0,"D",1.81,3.74,4.11,"0-0","1-1",15,6,13,4,1,0,0,0,4,5,13,14,2,9,27,"4-5","Y","N","N",1,0,11
"5582","SC3",2023-11-11,"Peterhead","Stranraer",3,2,"H",2,1,"H",1.75,3.89,4.25,"2-1","3-2",9,5,8,6,4,3,0,0,3,7,14,14,5,10,28,"3-7","Y","Y","Y",7,0,12
"5583","SC3",2023-11-11,"Stenhousemuir","Spartans",3,2,"H",0,1,"A",1.97,3.58,3.61,"0-1","3-2",12,5,9,4,4,1,0,0,6,6,13,14,5,12,27,"6-6","Y","Y","Y",5,0,12
"5584","SC3",2023-11-14,"Stenhousemuir","Peterhead",2,0,"H",2,0,"H",2.12,3.48,3.27,"2-0","2-0",16,4,10,3,2,4,0,0,1,5,14,16,2,6,30,"1-5","Y","N","N",6,0,12
"5585","SC3",2023-11-18,"Bonnyrigg Rose","Forfar",0,2,"A",0,1,"A",2.29,3.37,3.02,"0-1","0-2",6,2,8,5,0,2,0,0,4,4,7,11,2,8,18,"4-4","Y","N","N",2,0,12
"5586","SC3",2023-11-18,"Clyde","East Fife",0,4,"A",0,2,"A",3.46,3.45,2.06,"0-2","0-4",7,2,10,7,1,3,0,0,5,2,8,7,4,7,15,"5-2","Y","Y","Y",4,0,12
"5587","SC3",2023-11-18,"Dumbarton","Elgin",1,0,"H",0,0,"D",1.31,5.27,9.25,"0-0","1-0",8,2,7,2,1,3,0,0,2,2,11,11,1,4,22,"2-2","N","N","N",4,0,13
"5588","SC3",2023-11-18,"Spartans","Peterhead",1,2,"A",0,1,"A",2.3,3.5,2.91,"0-1","1-2",9,5,10,4,2,4,0,0,3,1,7,17,3,4,24,"3-1","Y","Y","N",6,0,13
"5589","SC3",2023-11-18,"Stranraer","Stenhousemuir",0,3,"A",0,2,"A",3.37,3.61,2.03,"0-2","0-3",6,3,6,3,2,1,0,0,10,2,8,7,3,12,15,"10-2","Y","Y","N",3,0,13
"5590","SC3",2023-11-21,"Bonnyrigg Rose","East Fife",4,2,"H",1,1,"D",3.13,3.12,2.03,"1-1","4-2",15,10,5,2,3,2,0,0,5,4,9,18,6,9,27,"5-4","Y","Y","Y",5,0,13
"5591","SC3",2023-11-21,"Elgin","Forfar",1,0,"H",1,0,"H",3.05,3.18,2.37,"1-0","1-0",6,3,10,3,2,0,0,0,5,3,19,10,1,8,29,"5-3","N","N","N",2,0,13
"5592","SC3",2023-12-02,"Forfar","Stranraer",1,1,"D",1,0,"H",2.11,3.54,3.26,"1-0","1-1",16,5,4,1,2,3,0,0,9,3,16,12,2,12,28,"9-3","Y","N","N",5,0,14
"5593","SC3",2023-12-02,"Stenhousemuir","Bonnyrigg Rose",1,0,"H",1,0,"H",1.66,3.87,4.95,"1-0","1-0",12,6,7,2,2,2,1,1,5,3,11,17,1,8,28,"5-3","N","N","N",4,2,14
"5594","SC3",2023-12-09,"Bonnyrigg Rose","Peterhead",1,1,"D",1,0,"H",3.04,3.34,2.29,"1-0","1-1",7,3,9,2,2,3,0,0,9,4,19,15,2,13,34,"9-4","Y","N","N",5,0,14
"5595","SC3",2023-12-09,"Clyde","Stranraer",2,2,"D",2,1,"H",2.47,3.38,2.74,"2-1","2-2",5,4,5,2,2,1,0,0,4,6,6,7,4,10,13,"4-6","Y","Y","Y",3,0,14
"5596","SC3",2023-12-09,"Dumbarton","Stenhousemuir",0,1,"A",0,0,"D",2.25,3.32,3.08,"0-0","0-1",8,2,9,4,3,1,0,0,7,4,12,10,1,11,22,"7-4","N","N","N",4,0,14
"5597","SC3",2023-12-09,"East Fife","Elgin",4,0,"H",2,0,"H",1.8,3.89,3.87,"2-0","4-0",10,6,1,1,0,1,0,0,8,2,13,6,4,10,19,"8-2","Y","Y","Y",1,0,15
"5598","SC3",2023-12-09,"Spartans","Forfar",1,0,"H",0,0,"D",2.12,3.55,3.22,"0-0","1-0",5,2,7,1,5,3,0,0,2,3,15,10,1,5,25,"2-3","N","N","N",8,0,15
"5599","SC3",2023-12-16,"Elgin","Spartans",0,4,"A",0,3,"A",4.3,3.73,1.78,"0-3","0-4",13,4,9,7,1,4,0,0,3,4,12,19,4,7,31,"3-4","Y","Y","Y",5,0,15
"5600","SC3",2023-12-16,"Forfar","Dumbarton",2,4,"A",2,3,"A",3.06,3.27,2.32,"2-3","2-4",8,6,12,6,0,0,0,0,3,5,11,7,6,8,18,"3-5","Y","Y","Y",0,0,15
"5601","SC3",2023-12-16,"Peterhead","Clyde",2,1,"H",2,0,"H",1.61,4.04,5.08,"2-0","2-1",9,3,6,3,2,2,1,0,5,0,12,14,3,5,26,"5-0","Y","Y","N",4,1,15
"5602","SC3",2023-12-16,"Stenhousemuir","East Fife",2,1,"H",2,0,"H",1.93,3.52,3.8,"2-0","2-1",9,5,10,4,2,4,0,0,5,5,7,12,3,10,19,"5-5","Y","Y","N",6,0,16
"5603","SC3",2023-12-16,"Stranraer","Bonnyrigg Rose",3,1,"H",1,0,"H",2.36,3.27,2.99,"1-0","3-1",11,5,11,3,0,2,0,0,3,5,8,8,4,8,16,"3-5","Y","Y","Y",2,0,16
"5604","SC3",2023-12-22,"East Fife","Bonnyrigg Rose",0,3,"A",0,1,"A",1.88,3.66,3.76,"0-1","0-3",6,2,8,4,2,2,0,0,3,4,11,11,3,7,22,"3-4","Y","Y","N",4,0,16
"5605","SC3",2023-12-23,"Dumbarton","Clyde",4,4,"D",2,2,"D",1.41,4.68,7.08,"2-2","4-4",11,7,14,6,2,3,0,0,8,6,11,11,8,14,22,"8-6","Y","Y","Y",5,0,16
"5606","SC3",2023-12-23,"Peterhead","Forfar",1,2,"A",1,2,"A",1.93,3.4,3.97,"1-2","1-2",14,5,9,6,0,3,0,1,5,2,11,20,3,7,31,"5-2","Y","Y","N",3,1,16
"5607","SC3",2023-12-23,"Spartans","Stranraer",3,0,"H",1,0,"H",1.81,3.81,4.03,"1-0","3-0",8,3,4,0,2,0,0,0,6,3,14,7,3,9,21,"6-3","Y","Y","N",2,0,17
"5608","SC3",2023-12-23,"Stenhousemuir","Elgin",2,0,"H",1,0,"H",1.31,5.11,9.72,"1-0","2-0",8,3,5,2,0,1,0,0,6,3,13,16,2,9,29,"6-3","Y","N","N",1,0,17
"5609","SC3",2023-12-30,"Clyde","Stenhousemuir",1,2,"A",0,1,"A",5.26,3.87,1.62,"0-1","1-2",7,2,6,2,1,2,0,1,0,0,13,9,3,0,22,"0-0","Y","Y","N",3,1,17
"5610","SC3",2023-12-30,"Elgin","Peterhead",2,1,"H",1,0,"H",4.66,3.69,1.72,"1-0","2-1",11,6,13,5,6,3,0,0,1,6,18,16,3,7,34,"1-6","Y","Y","N",9,0,17
"5611","SC3",2023-12-30,"Forfar","East Fife",0,0,"D",0,0,"D",2.31,3.22,3.06,"0-0","0-0",7,2,6,4,1,2,1,0,2,5,9,13,0,7,22,"2-5","N","N","N",3,1,17
"5612","SC3",2024-01-06,"Clyde","Bonnyrigg Rose",3,2,"H",3,0,"H",3.05,3.3,2.31,"3-0","3-2",10,4,11,4,1,1,0,0,7,7,5,6,5,14,11,"7-7","Y","Y","Y",2,0,18
"5613","SC3",2024-01-06,"Dumbarton","East Fife",1,2,"A",0,1,"A",1.76,3.7,4.41,"0-1","1-2",9,3,9,3,3,3,0,0,8,5,8,9,3,13,17,"8-5","Y","Y","N",6,0,18
"5614","SC3",2024-01-06,"Elgin","Stranraer",2,1,"H",0,1,"A",2.91,3.29,2.4,"0-1","2-1",9,5,13,6,1,2,0,0,3,2,13,12,3,5,25,"3-2","Y","Y","N",3,0,18
"5615","SC3",2024-01-06,"Peterhead","Spartans",0,1,"A",0,0,"D",2.49,3.33,2.75,"0-0","0-1",4,3,4,2,3,1,0,0,5,2,11,13,1,7,24,"5-2","N","N","N",4,0,18
"5616","SC3",2024-01-06,"Stenhousemuir","Forfar",2,1,"H",1,0,"H",1.64,3.81,5.21,"1-0","2-1",7,4,4,2,2,0,0,0,8,3,10,11,3,11,21,"8-3","Y","Y","N",2,0,18
"5617","SC3",2024-01-09,"Peterhead","Dumbarton",3,1,"H",0,1,"A",2.39,3.59,2.72,"0-1","3-1",16,6,6,3,3,3,0,0,4,1,9,12,4,5,21,"4-1","Y","Y","Y",6,0,19
"5618","SC3",2024-01-13,"Bonnyrigg Rose","Dumbarton",1,1,"D",1,0,"H",2.88,3.4,2.36,"1-0","1-1",9,5,17,8,3,2,0,0,6,9,9,11,2,15,20,"6-9","Y","N","N",5,0,19
"5619","SC3",2024-01-13,"East Fife","Clyde",1,1,"D",1,1,"D",1.76,3.74,4.29,"1-1","1-1",5,1,9,5,0,2,0,0,3,4,12,9,2,7,21,"3-4","Y","N","N",2,0,19
"5620","SC3",2024-01-13,"Forfar","Elgin",2,1,"H",0,1,"A",1.76,3.61,4.54,"0-1","2-1",14,5,4,1,2,3,0,1,6,3,11,20,3,9,31,"6-3","Y","Y","N",5,1,19
"5621","SC3",2024-01-13,"Spartans","Stenhousemuir",0,2,"A",0,1,"A",2.84,3.27,2.46,"0-1","0-2",8,0,8,6,0,0,0,0,5,3,9,13,2,8,22,"5-3","Y","N","N",0,0,19
"5622","SC3",2024-01-13,"Stranraer","Peterhead",2,0,"H",1,0,"H",3.45,3.41,2.08,"1-0","2-0",7,4,6,1,2,2,0,1,3,4,13,10,2,7,23,"3-4","Y","N","N",4,1,20
"5623","SC3",2024-01-20,"East Fife","Peterhead",2,2,"D",2,0,"H",2.3,3.23,3.07,"2-0","2-2",7,3,9,4,2,3,0,0,7,6,18,12,4,13,30,"7-6","Y","Y","Y",5,0,20
"5624","SC3",2024-01-20,"Stenhousemuir","Stranraer",1,0,"H",1,0,"H",1.3,5.28,9.74,"1-0","1-0",7,4,9,1,3,0,1,0,4,6,12,9,1,10,21,"4-6","N","N","N",3,1,20
"5625","SC3",2024-01-27,"Elgin","Dumbarton",0,1,"A",0,1,"A",3.84,3.56,1.91,"0-1","0-1",12,3,11,5,1,0,0,0,5,4,13,13,1,9,26,"5-4","N","N","N",1,0,20
"5626","SC3",2024-01-27,"Forfar","Bonnyrigg Rose",0,0,"D",0,0,"D",2.38,3.17,3.05,"0-0","0-0",7,2,8,3,1,4,0,0,4,7,12,12,0,11,24,"4-7","N","N","N",5,0,20
"5627","SC3",2024-01-27,"Peterhead","Stenhousemuir",2,1,"H",1,1,"D",3.34,3.49,2.09,"1-1","2-1",12,5,6,2,3,4,0,0,3,6,9,17,3,9,26,"3-6","Y","Y","N",7,0,21
"5628","SC3",2024-01-27,"Spartans","Clyde",1,1,"D",1,1,"D",1.56,4.24,5.41,"1-1","1-1",6,1,8,4,2,0,0,0,0,10,11,11,2,10,22,"0-10","Y","N","N",2,0,21
"5629","SC3",2024-01-27,"Stranraer","East Fife",0,1,"A",0,1,"A",2.6,3.51,2.53,"0-1","0-1",7,1,8,4,2,0,0,0,9,2,11,7,1,11,18,"9-2","N","N","N",2,0,21
"5630","SC3",2024-01-30,"East Fife","Spartans",0,3,"A",0,0,"D",2.74,3.04,2.7,"0-0","0-3",5,3,8,4,0,1,0,0,2,3,7,11,3,5,18,"2-3","Y","Y","N",1,0,21
"5631","SC3",2024-01-30,"Elgin","Clyde",2,1,"H",1,1,"D",3.03,3.25,2.34,"1-1","2-1",11,5,7,4,0,2,0,0,8,4,10,13,3,12,23,"8-4","Y","Y","N",2,0,21
"5632","SC3",2024-02-03,"Bonnyrigg Rose","Stranraer",0,0,"D",0,0,"D",2.21,3.35,3.18,"0-0","0-0",9,1,9,5,5,1,0,0,7,6,12,10,0,13,22,"7-6","N","N","N",6,0,22
"5633","SC3",2024-02-03,"Clyde","Peterhead",1,1,"D",1,0,"H",3.14,3.5,2.17,"1-0","1-1",7,5,9,5,1,3,0,0,4,4,11,12,2,8,23,"4-4","Y","N","N",4,0,22
"5634","SC3",2024-02-03,"Elgin","East Fife",1,0,"H",1,0,"H",2.66,3.44,2.51,"1-0","1-0",12,5,4,1,1,1,0,0,8,6,12,11,1,14,23,"8-6","N","N","N",2,0,22
"5635","SC3",2024-02-03,"Forfar","Spartans",1,0,"H",1,0,"H",3.17,3.2,2.29,"1-0","1-0",7,5,5,2,2,0,0,0,2,5,9,7,1,7,16,"2-5","N","N","N",2,0,22
"5636","SC3",2024-02-03,"Stenhousemuir","Dumbarton",1,0,"H",0,0,"D",1.81,3.57,3.87,"0-0","1-0",11,3,8,4,3,4,0,1,5,12,8,13,1,17,21,"5-12","N","N","N",7,1,22
"5637","SC3",2024-02-06,"Bonnyrigg Rose","Elgin",2,0,"H",1,0,"H",1.76,3.75,4.37,"1-0","2-0",12,5,7,2,1,3,0,0,6,5,18,10,2,11,28,"6-5","Y","N","N",4,0,23
"5638","SC3",2024-02-10,"Dumbarton","Forfar",2,2,"D",2,1,"H",1.62,3.84,5.15,"2-1","2-2",12,7,10,3,2,3,0,0,3,5,15,13,4,8,28,"3-5","Y","Y","Y",5,0,23
"5639","SC3",2024-02-10,"East Fife","Stenhousemuir",1,1,"D",1,1,"D",3.86,3.55,1.91,"1-1","1-1",4,1,6,2,3,1,0,0,5,3,15,9,2,8,24,"5-3","Y","N","N",4,0,23
"5640","SC3",2024-02-10,"Spartans","Elgin",1,2,"A",0,0,"D",1.54,4.36,5.41,"0-0","1-2",7,1,7,5,2,1,0,0,5,5,11,11,3,10,22,"5-5","Y","Y","N",3,0,23
"5641","SC3",2024-02-10,"Stranraer","Clyde",2,0,"H",0,0,"D",2.43,3.36,2.82,"0-0","2-0",9,5,7,1,3,5,0,1,5,5,10,14,2,10,24,"5-5","Y","N","N",8,1,23
"5642","SC3",2024-02-13,"Dumbarton","Spartans",0,0,"D",0,0,"D",2.19,3.21,3.38,"0-0","0-0",13,4,6,2,4,2,0,0,7,3,10,8,0,10,18,"7-3","N","N","N",6,0,24
"5643","SC3",2024-02-17,"Bonnyrigg Rose","East Fife",0,2,"A",0,2,"A",2.31,3.27,3.11,"0-2","0-2",15,6,9,4,2,1,1,0,2,2,15,15,2,4,30,"2-2","Y","N","N",3,1,24
"5644","SC3",2024-02-17,"Clyde","Dumbarton",2,0,"H",1,0,"H",3.47,3.44,2.09,"1-0","2-0",14,4,8,1,3,3,1,0,5,5,10,12,2,10,22,"5-5","Y","N","N",6,1,24
"5645","SC3",2024-02-17,"Elgin","Stenhousemuir",2,2,"D",2,1,"H",4.16,3.48,1.88,"2-1","2-2",12,3,9,5,1,2,0,0,5,4,8,10,4,9,18,"5-4","Y","Y","Y",3,0,24
"5646","SC3",2024-02-17,"Forfar","Peterhead",3,3,"D",3,0,"H",2.59,3.36,2.67,"3-0","3-3",11,6,13,5,2,3,0,0,7,8,13,13,6,15,26,"7-8","Y","Y","Y",5,0,24
"5647","SC3",2024-02-17,"Stranraer","Spartans",1,2,"A",1,0,"H",2.68,3.35,2.6,"1-0","1-2",4,2,4,3,2,2,0,0,4,6,7,8,3,10,15,"4-6","Y","Y","N",4,0,25
"5648","SC3",2024-02-20,"Clyde","Forfar",0,2,"A",0,0,"D",2.88,3.22,2.5,"0-0","0-2",9,4,8,3,3,2,0,0,8,5,10,13,2,13,23,"8-5","Y","N","N",5,0,25
"5649","SC3",2024-02-20,"Peterhead","Bonnyrigg Rose",0,0,"D",0,0,"D",1.88,3.64,3.97,"0-0","0-0",11,6,6,1,1,1,1,0,4,3,9,10,0,7,19,"4-3","N","N","N",2,1,25
"5650","SC3",2024-02-24,"Dumbarton","Stranraer",2,1,"H",2,1,"H",1.74,3.78,4.62,"2-1","2-1",10,3,12,4,0,1,0,0,4,5,6,7,3,9,13,"4-5","Y","Y","N",1,0,25
"5651","SC3",2024-02-24,"East Fife","Forfar",1,1,"D",0,1,"A",2.33,3.22,3.14,"0-1","1-1",6,2,3,2,1,1,0,0,11,1,12,10,2,12,22,"11-1","Y","N","N",2,0,25
"5652","SC3",2024-02-24,"Peterhead","Elgin",1,1,"D",1,1,"D",1.66,3.9,5.02,"1-1","1-1",8,4,10,3,5,2,0,0,4,4,20,12,2,8,32,"4-4","Y","N","N",7,0,26
"5653","SC3",2024-02-24,"Spartans","Bonnyrigg Rose",2,1,"H",2,0,"H",2.05,3.43,3.58,"2-0","2-1",9,5,8,5,3,5,0,0,11,6,10,15,3,17,25,"11-6","Y","Y","N",8,0,26
"5654","SC3",2024-02-24,"Stenhousemuir","Clyde",1,6,"A",1,2,"A",1.51,4.3,6.22,"1-2","1-6",16,8,14,10,0,2,0,0,8,5,9,11,7,13,20,"8-5","Y","Y","Y",2,0,26
"5655","SC3",2024-03-02,"Bonnyrigg Rose","Stenhousemuir",0,1,"A",0,0,"D",3.05,3.26,2.37,"0-0","0-1",6,2,15,4,0,3,0,0,6,5,11,15,1,11,26,"6-5","N","N","N",3,0,26
"5656","SC3",2024-03-02,"Clyde","Elgin",2,1,"H",0,1,"A",2.16,3.36,3.36,"0-1","2-1",12,4,13,4,1,1,0,1,6,4,9,11,3,10,20,"6-4","Y","Y","N",2,1,26
"5657","SC3",2024-03-02,"Dumbarton","Peterhead",1,0,"H",0,0,"D",2.16,3.56,3.18,"0-0","1-0",14,5,6,1,2,3,0,0,7,2,10,16,1,9,26,"7-2","N","N","N",5,0,27
"5658","SC3",2024-03-02,"Spartans","East Fife",1,3,"A",1,1,"D",2.04,3.41,3.65,"1-1","1-3",4,3,7,3,2,2,0,0,6,3,9,11,4,9,20,"6-3","Y","Y","Y",4,0,27
"5659","SC3",2024-03-02,"Stranraer","Forfar",0,0,"D",0,0,"D",2.5,3.2,2.9,"0-0","0-0",9,5,8,6,1,1,0,1,6,6,8,14,0,12,22,"6-6","N","N","N",2,1,27
"5660","SC3",2024-03-05,"Bonnyrigg Rose","Spartans",2,2,"D",1,1,"D",2.83,3.16,2.57,"1-1","2-2",12,4,15,6,0,1,1,0,5,1,14,17,4,6,31,"5-1","Y","Y","Y",1,1,27
"5661","SC3",2024-03-05,"Stranraer","Dumbarton",5,0,"H",4,0,"H",3.2,3.28,2.27,"4-0","5-0",15,8,14,7,1,2,0,0,3,6,6,5,5,9,11,"3-6","Y","Y","Y",3,0,27
"5662","SC3",2024-03-09,"East Fife","Dumbarton",3,2,"H",1,0,"H",2.45,3.34,2.84,"1-0","3-2",8,5,7,3,1,2,0,0,8,3,7,13,5,11,20,"8-3","Y","Y","Y",3,0,28
"5663","SC3",2024-03-09,"Elgin","Bonnyrigg Rose",1,0,"H",0,0,"D",2.58,3.35,2.69,"0-0","1-0",14,6,3,2,2,1,0,0,2,5,15,17,1,7,32,"2-5","N","N","N",3,0,28
"5664","SC3",2024-03-09,"Forfar","Clyde",2,1,"H",0,1,"A",2.25,3.47,3.07,"0-1","2-1",11,5,10,4,0,0,0,0,7,3,9,13,3,10,22,"7-3","Y","Y","N",0,0,28
"5665","SC3",2024-03-09,"Peterhead","Stranraer",2,0,"H",2,0,"H",2,3.76,3.41,"2-0","2-0",8,6,8,3,1,3,0,0,5,7,14,8,2,12,22,"5-7","Y","N","N",4,0,28
"5666","SC3",2024-03-09,"Stenhousemuir","Spartans",0,0,"D",0,0,"D",2.04,3.42,3.62,"0-0","0-0",5,2,6,1,0,1,0,0,7,2,10,12,0,9,22,"7-2","N","N","N",1,0,28
"5667","SC3",2024-03-16,"Bonnyrigg Rose","Clyde",1,2,"A",1,0,"H",2.62,3.36,2.62,"1-0","1-2",11,4,14,5,0,0,0,0,2,7,8,12,3,9,20,"2-7","Y","Y","N",0,0,29
"5668","SC3",2024-03-16,"Forfar","Stenhousemuir",1,1,"D",0,1,"A",3.04,3.36,2.31,"0-1","1-1",6,1,12,3,2,4,0,0,3,3,15,22,2,6,37,"3-3","Y","N","N",6,0,29
"5669","SC3",2024-03-16,"Peterhead","East Fife",1,1,"D",1,0,"H",2.26,3.38,3.14,"1-0","1-1",8,4,5,1,0,2,0,0,2,3,7,13,2,5,20,"2-3","Y","N","N",2,0,29
"5670","SC3",2024-03-16,"Spartans","Dumbarton",2,6,"A",2,3,"A",2.36,3.35,2.99,"2-3","2-6",5,3,15,8,0,2,0,0,9,6,11,9,8,15,20,"9-6","Y","Y","Y",2,0,29
"5671","SC3",2024-03-16,"Stranraer","Elgin",1,2,"A",0,0,"D",2.08,3.47,3.47,"0-0","1-2",3,2,3,3,3,2,1,0,5,6,9,8,3,11,17,"5-6","Y","Y","N",5,1,29
"1657","SP1",2023-08-11,"Almeria","Vallecano",0,2,"A",0,2,"A",2.62,3.3,2.96,"0-2","0-2",19,5,10,4,1,3,0,0,8,3,16,25,2,11,41,"8-3","Y","N","N",4,0,1
"1658","SP1",2023-08-11,"Sevilla","Valencia",1,2,"A",0,0,"D",1.95,3.47,4.48,"0-0","1-2",9,3,10,3,3,2,1,0,8,1,15,17,3,9,32,"8-1","Y","Y","N",5,1,1
"1659","SP1",2023-08-12,"Sociedad","Girona",1,1,"D",1,0,"H",1.65,4.05,5.66,"1-0","1-1",15,2,6,1,2,5,0,0,4,1,22,9,2,5,31,"4-1","Y","N","N",7,0,1
"1660","SP1",2023-08-12,"Las Palmas","Mallorca",1,1,"D",1,0,"H",2.45,3.02,3.46,"1-0","1-1",5,2,12,2,3,2,0,0,3,6,11,21,2,9,32,"3-6","Y","N","N",5,0,1
"1661","SP1",2023-08-12,"Ath Bilbao","Real Madrid",0,2,"A",0,2,"A",3.43,3.58,2.19,"0-2","0-2",7,1,14,8,3,1,0,0,7,5,18,6,2,12,24,"7-5","Y","N","N",4,0,1
"1662","SP1",2023-08-13,"Celta","Osasuna",0,2,"A",0,1,"A",2.15,3.19,3.99,"0-1","0-2",11,1,11,5,1,1,0,0,7,2,11,15,2,9,26,"7-2","Y","N","N",2,0,1
"1663","SP1",2023-08-13,"Villarreal","Betis",1,2,"A",0,1,"A",1.81,3.98,4.43,"0-1","1-2",18,5,12,5,1,3,0,0,9,4,13,17,3,13,30,"9-4","Y","Y","N",4,0,1
"1664","SP1",2023-08-13,"Getafe","Barcelona",0,0,"D",0,0,"D",6.69,4.04,1.57,"0-0","0-0",5,2,14,4,8,2,1,1,3,4,20,11,0,7,31,"3-4","N","N","N",10,2,1
"1665","SP1",2023-08-14,"Cadiz","Alaves",1,0,"H",1,0,"H",2.25,3.08,3.86,"1-0","1-0",12,3,10,2,3,2,1,0,2,4,19,15,1,6,34,"2-4","N","N","N",5,1,1
"1666","SP1",2023-08-14,"Ath Madrid","Granada",3,1,"H",1,0,"H",1.31,5.76,10.3,"1-0","3-1",14,6,7,4,3,1,0,0,3,3,15,9,4,6,24,"3-3","Y","Y","Y",4,0,1
"1667","SP1",2023-08-18,"Mallorca","Villarreal",0,1,"A",0,0,"D",3.04,3.13,2.68,"0-0","0-1",8,1,15,3,2,4,0,0,6,5,12,11,1,11,23,"6-5","N","N","N",6,0,2
"1668","SP1",2023-08-18,"Valencia","Las Palmas",1,0,"H",0,0,"D",1.61,4.02,6.49,"0-0","1-0",9,4,7,1,0,0,0,0,6,4,12,6,1,10,18,"6-4","N","N","N",0,0,2
"1669","SP1",2023-08-19,"Sociedad","Celta",1,1,"D",1,0,"H",1.76,3.54,5.57,"1-0","1-1",11,2,17,6,2,1,0,0,9,7,12,12,2,16,24,"9-7","Y","N","N",3,0,2
"1670","SP1",2023-08-19,"Almeria","Real Madrid",1,3,"A",1,1,"D",8.15,5.11,1.4,"1-1","1-3",20,8,24,9,1,0,0,0,4,5,10,13,4,9,23,"4-5","Y","Y","Y",1,0,2
"1671","SP1",2023-08-19,"Osasuna","Ath Bilbao",0,2,"A",0,2,"A",2.89,3.1,2.79,"0-2","0-2",18,7,8,2,1,5,1,1,5,3,9,14,2,8,23,"5-3","Y","N","N",6,2,2
"1672","SP1",2023-08-20,"Girona","Getafe",3,0,"H",1,0,"H",2.06,3.22,4.31,"1-0","3-0",7,6,9,2,2,5,0,0,3,2,11,20,3,5,31,"3-2","Y","Y","N",7,0,2
"1673","SP1",2023-08-20,"Barcelona","Cadiz",2,0,"H",0,0,"D",1.21,6.9,14.96,"0-0","2-0",23,10,10,1,4,3,0,0,10,2,9,22,2,12,31,"10-2","Y","N","N",7,0,2
"1674","SP1",2023-08-20,"Betis","Ath Madrid",0,0,"D",0,0,"D",3.93,3.57,2.02,"0-0","0-0",14,0,5,1,2,1,0,0,2,7,10,8,0,9,18,"2-7","N","N","N",3,0,2
"1675","SP1",2023-08-21,"Alaves","Sevilla",4,3,"H",2,2,"D",3.45,3.1,2.41,"2-2","4-3",14,7,12,2,1,2,0,0,4,4,14,13,7,8,27,"4-4","Y","Y","Y",3,0,2
"1676","SP1",2023-08-21,"Granada","Vallecano",0,2,"A",0,0,"D",2.68,3.09,3.03,"0-0","0-2",14,7,17,9,2,1,1,0,5,6,14,11,2,11,25,"5-6","Y","N","N",3,1,2
"1677","SP1",2023-08-25,"Las Palmas","Sociedad",0,0,"D",0,0,"D",4.23,3.36,2.04,"0-0","0-0",11,5,8,1,1,4,0,0,5,7,7,29,0,12,36,"5-7","N","N","N",5,0,3
"1678","SP1",2023-08-25,"Celta","Real Madrid",0,1,"A",0,0,"D",4.93,3.97,1.75,"0-0","0-1",13,4,10,3,2,3,0,0,3,5,19,14,1,8,33,"3-5","N","N","N",5,0,3
"1679","SP1",2023-08-26,"Cadiz","Almeria",1,1,"D",0,0,"D",2.24,3.44,3.44,"0-0","1-1",11,3,5,2,0,5,1,1,7,3,16,22,2,10,38,"7-3","Y","N","N",5,2,3
"1680","SP1",2023-08-26,"Granada","Mallorca",3,2,"H",1,1,"D",2.71,3.03,3.05,"1-1","3-2",10,4,10,5,2,7,0,0,5,3,11,27,5,8,38,"5-3","Y","Y","Y",9,0,3
"1681","SP1",2023-08-26,"Sevilla","Girona",1,2,"A",1,1,"D",2.1,3.52,3.73,"1-1","1-2",21,4,8,3,2,1,0,0,6,6,11,18,3,12,29,"6-6","Y","Y","N",3,0,3
"1682","SP1",2023-08-27,"Villarreal","Barcelona",3,4,"A",2,2,"D",3.62,3.76,2.06,"2-2","3-4",13,6,21,11,3,3,0,0,2,6,12,14,7,8,26,"2-6","Y","Y","Y",6,0,3
"1683","SP1",2023-08-27,"Valencia","Osasuna",1,2,"A",0,1,"A",1.89,3.56,4.53,"0-1","1-2",16,4,7,2,3,4,0,0,6,3,13,12,3,9,25,"6-3","Y","Y","N",7,0,3
"1684","SP1",2023-08-27,"Ath Bilbao","Betis",4,2,"H",3,2,"H",1.96,3.7,4,"3-2","4-2",14,6,7,3,4,2,0,0,5,3,23,11,6,8,34,"5-3","Y","Y","Y",6,0,3
"1685","SP1",2023-08-28,"Getafe","Alaves",1,0,"H",0,0,"D",2.36,2.89,3.88,"0-0","1-0",15,4,16,2,1,2,0,0,4,5,13,15,1,9,28,"4-5","N","N","N",3,0,3
"1686","SP1",2023-08-28,"Vallecano","Ath Madrid",0,7,"A",0,3,"A",4.16,3.48,2,"0-3","0-7",12,3,17,10,4,3,0,0,8,3,19,17,7,11,36,"8-3","Y","Y","Y",7,0,3
"1687","SP1",2023-09-01,"Cadiz","Villarreal",3,1,"H",2,1,"H",3.43,3.59,2.21,"2-1","3-1",18,4,7,3,5,4,0,1,7,3,21,15,4,10,36,"7-3","Y","Y","Y",9,1,4
"1688","SP1",2023-09-01,"Almeria","Celta",2,3,"A",0,2,"A",3.04,3.33,2.55,"0-2","2-3",16,5,14,8,1,1,0,0,6,5,9,9,5,11,18,"6-5","Y","Y","Y",2,0,4
"1689","SP1",2023-09-02,"Sociedad","Granada",5,3,"H",2,1,"H",1.47,4.63,7.49,"2-1","5-3",15,6,8,5,1,5,0,0,2,5,15,14,8,7,29,"2-5","Y","Y","Y",6,0,4
"1690","SP1",2023-09-02,"Real Madrid","Getafe",2,1,"H",0,1,"A",1.34,5.13,10.76,"0-1","2-1",26,12,6,2,2,6,0,0,11,1,12,16,3,12,28,"11-1","Y","Y","N",8,0,4
"1691","SP1",2023-09-02,"Alaves","Valencia",1,0,"H",1,0,"H",2.96,2.99,2.82,"1-0","1-0",7,1,9,4,4,2,0,0,1,2,18,9,1,3,27,"1-2","N","N","N",6,0,4
"1692","SP1",2023-09-02,"Betis","Vallecano",1,0,"H",0,0,"D",1.98,3.55,4.14,"0-0","1-0",14,5,15,6,3,5,0,0,2,3,22,20,1,5,42,"2-3","N","N","N",8,0,4
"1693","SP1",2023-09-03,"Girona","Las Palmas",1,0,"H",0,0,"D",1.69,3.83,5.59,"0-0","1-0",11,6,10,5,3,3,0,0,3,5,15,10,1,8,25,"3-5","N","N","N",6,0,4
"1694","SP1",2023-09-03,"Mallorca","Ath Bilbao",0,0,"D",0,0,"D",3.3,3.11,2.49,"0-0","0-0",8,2,11,3,0,1,0,0,3,5,12,17,0,8,29,"3-5","N","N","N",1,0,4
"1695","SP1",2023-09-03,"Osasuna","Barcelona",1,2,"A",0,1,"A",5.37,4.17,1.65,"0-1","1-2",11,3,9,4,1,3,1,0,8,5,6,16,3,13,22,"8-5","Y","Y","N",4,1,4
"1696","SP1",2023-09-15,"Vallecano","Alaves",2,0,"H",1,0,"H",2.03,3.23,4.52,"1-0","2-0",20,11,9,1,2,3,0,0,5,3,15,14,2,8,29,"5-3","Y","N","N",5,0,4
"1697","SP1",2023-09-16,"Ath Bilbao","Cadiz",3,0,"H",0,0,"D",1.56,4.17,6.66,"0-0","3-0",20,9,5,4,1,4,0,0,5,4,10,20,3,9,30,"5-4","Y","Y","N",5,0,5
"1698","SP1",2023-09-16,"Valencia","Ath Madrid",3,0,"H",2,0,"H",3.93,3.41,2.08,"2-0","3-0",12,8,11,3,1,5,0,0,5,8,13,17,3,13,30,"5-8","Y","Y","N",6,0,5
"1699","SP1",2023-09-16,"Celta","Mallorca",0,1,"A",0,0,"D",2.08,3.13,4.4,"0-0","0-1",16,4,7,4,1,3,0,0,10,1,9,15,1,11,24,"10-1","N","N","N",4,0,5
"1700","SP1",2023-09-16,"Barcelona","Betis",5,0,"H",2,0,"H",1.38,5.4,8.04,"2-0","5-0",17,9,11,2,1,2,0,0,9,5,9,10,5,14,19,"9-5","Y","Y","Y",3,0,5
"1701","SP1",2023-09-17,"Getafe","Osasuna",3,2,"H",1,1,"D",2.65,2.93,3.24,"1-1","3-2",11,6,8,3,6,2,0,0,6,3,15,11,5,9,26,"6-3","Y","Y","Y",8,0,5
"1702","SP1",2023-09-17,"Villarreal","Almeria",2,1,"H",1,1,"D",1.48,4.98,6.38,"1-1","2-1",10,4,17,7,2,3,0,0,7,6,16,6,3,13,22,"7-6","Y","Y","N",5,0,5
"1703","SP1",2023-09-17,"Sevilla","Las Palmas",1,0,"H",0,0,"D",1.64,3.93,5.99,"0-0","1-0",26,9,12,2,3,5,0,0,7,3,13,12,1,10,25,"7-3","N","N","N",8,0,5
"1704","SP1",2023-09-17,"Real Madrid","Sociedad",2,1,"H",0,1,"A",1.69,3.97,5.31,"0-1","2-1",17,8,15,5,3,2,0,0,4,3,11,14,3,7,25,"4-3","Y","Y","N",5,0,5
"1705","SP1",2023-09-18,"Granada","Girona",2,4,"A",0,3,"A",2.78,3.44,2.65,"0-3","2-4",12,5,13,7,3,3,0,0,4,5,13,21,6,9,34,"4-5","Y","Y","Y",6,0,5
"1706","SP1",2023-09-22,"Alaves","Ath Bilbao",0,2,"A",0,1,"A",4.27,3.16,2.12,"0-1","0-2",15,5,11,3,2,2,0,0,3,4,13,9,2,7,22,"3-4","Y","N","N",4,0,5
"1707","SP1",2023-09-23,"Girona","Mallorca",5,3,"H",4,1,"H",1.94,3.39,4.54,"4-1","5-3",23,10,15,5,1,5,0,0,6,5,10,12,8,11,22,"6-5","Y","Y","Y",6,0,6
"1708","SP1",2023-09-23,"Osasuna","Sevilla",0,0,"D",0,0,"D",2.62,3.22,2.99,"0-0","0-0",16,2,15,3,2,3,0,0,7,4,11,7,0,11,18,"7-4","N","N","N",5,0,6
"1709","SP1",2023-09-23,"Barcelona","Celta",3,2,"H",0,1,"A",1.29,6.04,10.38,"0-1","3-2",15,6,13,7,2,1,0,0,2,3,10,11,5,5,21,"2-3","Y","Y","Y",3,0,6
"1710","SP1",2023-09-23,"Almeria","Valencia",2,2,"D",0,1,"A",3.11,3.53,2.36,"0-1","2-2",17,10,7,5,4,2,0,0,8,3,12,10,4,11,22,"8-3","Y","Y","Y",6,0,6
"1711","SP1",2023-09-24,"Sociedad","Getafe",4,3,"H",1,2,"A",1.56,3.82,7.76,"1-2","4-3",10,6,10,7,3,2,0,0,2,1,13,24,7,3,37,"2-1","Y","Y","Y",5,0,6
"1712","SP1",2023-09-24,"Vallecano","Villarreal",1,1,"D",1,1,"D",2.56,3.54,2.83,"1-1","1-1",11,6,13,6,2,3,0,1,2,8,20,18,2,10,38,"2-8","Y","N","N",5,1,6
"1713","SP1",2023-09-24,"Betis","Cadiz",1,1,"D",0,1,"A",1.86,3.62,4.64,"0-1","1-1",21,7,5,1,2,3,0,0,11,8,10,14,2,19,24,"11-8","Y","N","N",5,0,6
"1714","SP1",2023-09-24,"Las Palmas","Granada",1,0,"H",0,0,"D",2.05,3.56,3.87,"0-0","1-0",10,3,2,1,6,4,1,0,6,7,13,19,1,13,32,"6-7","N","N","N",10,1,6
"1715","SP1",2023-09-24,"Ath Madrid","Real Madrid",3,1,"H",2,1,"H",2.88,3.37,2.61,"2-1","3-1",10,4,20,5,1,3,0,0,6,11,13,10,4,17,23,"6-11","Y","Y","Y",4,0,6
"1716","SP1",2023-09-26,"Sevilla","Almeria",5,1,"H",3,0,"H",1.7,4.1,5.09,"3-0","5-1",18,9,10,1,3,2,0,0,9,4,15,16,6,13,31,"9-4","Y","Y","Y",5,0,6
"1717","SP1",2023-09-26,"Mallorca","Barcelona",2,2,"D",2,1,"H",6.98,4.53,1.51,"2-1","2-2",10,5,10,4,4,1,1,0,7,2,19,7,4,9,26,"7-2","Y","Y","Y",5,1,7
"1718","SP1",2023-09-27,"Ath Bilbao","Getafe",2,2,"D",1,0,"H",1.64,3.76,6.51,"1-0","2-2",9,4,13,5,5,6,1,0,5,4,9,19,4,9,28,"5-4","Y","Y","Y",11,1,7
"1719","SP1",2023-09-27,"Real Madrid","Las Palmas",2,0,"H",1,0,"H",1.21,7.24,13.67,"1-0","2-0",21,9,16,2,0,1,0,0,7,2,7,9,2,9,16,"7-2","Y","N","N",1,0,7
"1720","SP1",2023-09-27,"Villarreal","Girona",1,2,"A",0,0,"D",2.22,3.72,3.23,"0-0","1-2",14,3,17,5,3,2,0,0,5,6,9,11,3,11,20,"5-6","Y","Y","N",5,0,7
"1721","SP1",2023-09-27,"Cadiz","Vallecano",0,0,"D",0,0,"D",2.64,3.17,3,"0-0","0-0",9,2,9,4,5,6,0,1,1,2,16,13,0,3,29,"1-2","N","N","N",11,1,7
"1722","SP1",2023-09-27,"Valencia","Sociedad",0,1,"A",0,1,"A",2.68,3.18,2.94,"0-1","0-1",9,2,2,1,4,7,1,0,0,2,14,17,1,2,31,"0-2","N","N","N",11,1,7
"1723","SP1",2023-09-28,"Celta","Alaves",1,1,"D",1,0,"H",1.71,3.59,5.97,"1-0","1-1",8,0,21,11,5,3,1,0,2,8,9,11,2,10,20,"2-8","Y","N","N",8,1,7
"1724","SP1",2023-09-28,"Granada","Betis",1,1,"D",0,0,"D",3.11,3.53,2.36,"0-0","1-1",19,7,13,3,2,1,0,0,5,7,14,10,2,12,24,"5-7","Y","N","N",3,0,7
"1725","SP1",2023-09-28,"Osasuna","Ath Madrid",0,2,"A",0,1,"A",3.68,3.47,2.14,"0-1","0-2",13,2,4,3,3,3,1,1,7,2,14,4,2,9,18,"7-2","Y","N","N",6,2,7
"1726","SP1",2023-09-29,"Barcelona","Sevilla",1,0,"H",0,0,"D",1.39,5.36,7.97,"0-0","1-0",18,5,12,3,2,3,0,0,13,3,11,15,1,16,26,"13-3","N","N","N",5,0,7
"1727","SP1",2023-09-30,"Getafe","Villarreal",0,0,"D",0,0,"D",3,3.25,2.59,"0-0","0-0",22,9,3,0,2,4,0,1,6,4,19,11,0,10,30,"6-4","N","N","N",6,1,8
"1728","SP1",2023-09-30,"Vallecano","Mallorca",2,2,"D",1,1,"D",2.16,3.16,4.04,"1-1","2-2",19,5,9,4,2,5,0,0,5,0,12,20,4,5,32,"5-0","Y","Y","Y",7,0,8
"1729","SP1",2023-09-30,"Girona","Real Madrid",0,3,"A",0,2,"A",3.56,4.02,2,"0-2","0-3",13,3,14,7,2,2,0,1,1,4,13,14,3,5,27,"1-4","Y","Y","N",4,1,8
"1730","SP1",2023-09-30,"Sociedad","Ath Bilbao",3,0,"H",1,0,"H",2.26,3.3,3.53,"1-0","3-0",8,5,18,3,2,2,0,0,5,7,20,9,3,12,29,"5-7","Y","Y","N",4,0,8
"1731","SP1",2023-10-01,"Almeria","Granada",3,3,"D",3,0,"H",1.92,3.68,3.96,"3-0","3-3",17,5,19,4,2,1,0,0,1,5,18,14,6,6,32,"1-5","Y","Y","Y",3,0,8
"1732","SP1",2023-10-01,"Alaves","Osasuna",0,2,"A",0,1,"A",2.76,2.99,2.89,"0-1","0-2",17,3,10,3,2,3,1,0,4,2,13,13,2,6,26,"4-2","Y","N","N",5,1,8
"1733","SP1",2023-10-01,"Ath Madrid","Cadiz",3,2,"H",1,2,"A",1.35,4.99,8.91,"1-2","3-2",18,9,8,4,1,3,0,0,5,3,5,10,5,8,15,"5-3","Y","Y","Y",4,0,8
"1734","SP1",2023-10-01,"Betis","Valencia",3,0,"H",1,0,"H",2.31,3.29,3.26,"1-0","3-0",15,7,9,2,2,2,0,0,5,3,11,10,3,8,21,"5-3","Y","Y","N",4,0,8
"1735","SP1",2023-10-02,"Las Palmas","Celta",2,1,"H",0,0,"D",2.52,3.15,2.99,"0-0","2-1",16,5,11,3,2,1,0,0,4,5,13,14,3,9,27,"4-5","Y","Y","N",3,0,8
"1736","SP1",2023-10-06,"Ath Bilbao","Almeria",3,0,"H",1,0,"H",1.38,5.41,8.23,"1-0","3-0",23,9,4,1,2,0,0,0,6,2,11,7,3,8,18,"6-2","Y","Y","N",2,0,8
"1737","SP1",2023-10-07,"Cadiz","Girona",0,1,"A",0,0,"D",3.28,3.4,2.33,"0-0","0-1",8,2,20,5,1,3,1,0,5,5,12,13,1,10,25,"5-5","N","N","N",4,1,9
"1738","SP1",2023-10-07,"Real Madrid","Osasuna",4,0,"H",1,0,"H",1.3,5.95,10.38,"1-0","4-0",19,9,7,1,2,2,0,0,5,4,9,6,4,9,15,"5-4","Y","Y","Y",4,0,9
"1739","SP1",2023-10-07,"Mallorca","Valencia",1,1,"D",1,1,"D",2.54,3.05,3.26,"1-1","1-1",9,5,11,3,2,1,0,0,3,6,17,11,2,9,28,"3-6","Y","N","N",3,0,9
"1740","SP1",2023-10-07,"Sevilla","Vallecano",2,2,"D",0,2,"A",1.91,3.61,4.39,"0-2","2-2",22,6,7,4,5,2,0,0,12,2,16,19,4,14,35,"12-2","Y","Y","Y",7,0,9
"1741","SP1",2023-10-08,"Villarreal","Las Palmas",1,2,"A",0,1,"A",1.63,4.21,5.56,"0-1","1-2",9,4,8,5,4,4,0,0,7,2,17,7,3,9,24,"7-2","Y","Y","N",8,0,9
"1742","SP1",2023-10-08,"Ath Madrid","Sociedad",2,1,"H",1,0,"H",1.93,3.39,4.59,"1-0","2-1",14,5,13,4,3,3,0,0,1,4,9,12,3,5,21,"1-4","Y","Y","N",6,0,9
"1743","SP1",2023-10-08,"Alaves","Betis",1,1,"D",1,1,"D",2.93,3.2,2.68,"1-1","1-1",15,5,6,2,3,3,0,1,5,3,13,9,2,8,22,"5-3","Y","N","N",6,1,9
"1744","SP1",2023-10-08,"Celta","Getafe",2,2,"D",2,2,"D",2.07,3.23,4.23,"2-2","2-2",26,11,3,2,1,8,0,1,13,1,14,20,4,14,34,"13-1","Y","Y","Y",9,1,9
"1745","SP1",2023-10-08,"Granada","Barcelona",2,2,"D",2,1,"H",6.89,5.36,1.43,"2-1","2-2",7,2,22,10,4,1,0,0,1,11,12,7,4,12,19,"1-11","Y","Y","Y",5,0,9
"1746","SP1",2023-10-20,"Osasuna","Granada",2,0,"H",1,0,"H",1.72,3.99,5.13,"1-0","2-0",12,6,13,3,3,4,0,1,1,7,19,13,2,8,32,"1-7","Y","N","N",7,1,9
"1747","SP1",2023-10-21,"Sociedad","Mallorca",1,0,"H",0,0,"D",1.57,3.91,7.23,"0-0","1-0",14,6,18,7,3,3,0,0,2,5,14,16,1,7,30,"2-5","N","N","N",6,0,10
"1748","SP1",2023-10-21,"Getafe","Betis",1,1,"D",1,1,"D",2.51,3.11,3.25,"1-1","1-1",14,4,13,3,5,2,0,0,4,8,17,11,2,12,28,"4-8","Y","N","N",7,0,10
"1749","SP1",2023-10-21,"Sevilla","Real Madrid",1,1,"D",0,0,"D",4.18,3.91,1.87,"0-0","1-1",17,7,14,5,5,2,0,0,4,6,13,6,2,10,19,"4-6","Y","N","N",7,0,10
"1750","SP1",2023-10-21,"Celta","Ath Madrid",0,3,"A",0,1,"A",3.65,3.53,2.12,"0-1","0-3",16,3,12,7,3,2,1,0,7,5,10,10,3,12,20,"7-5","Y","Y","N",5,1,10
"1751","SP1",2023-10-22,"Las Palmas","Vallecano",0,1,"A",0,0,"D",2.71,3.12,2.96,"0-0","0-1",12,6,12,4,4,3,0,1,10,5,13,11,1,15,24,"10-5","N","N","N",7,1,10
"1752","SP1",2023-10-22,"Girona","Almeria",5,2,"H",3,2,"H",1.47,4.89,6.71,"3-2","5-2",19,8,9,5,1,2,0,0,9,6,11,14,7,15,25,"9-6","Y","Y","Y",3,0,10
"1753","SP1",2023-10-22,"Villarreal","Alaves",1,1,"D",0,0,"D",1.74,3.98,4.95,"0-0","1-1",12,3,16,7,4,3,0,0,9,3,15,10,2,12,25,"9-3","Y","N","N",7,0,10
"1754","SP1",2023-10-22,"Barcelona","Ath Bilbao",1,0,"H",0,0,"D",1.68,4.14,5.16,"0-0","1-0",12,7,10,3,3,3,0,0,4,7,11,18,1,11,29,"4-7","N","N","N",6,0,10
"1755","SP1",2023-10-23,"Valencia","Cadiz",2,0,"H",2,0,"H",1.78,3.6,5.29,"2-0","2-0",12,4,5,4,0,3,0,1,4,6,16,16,2,10,32,"4-6","Y","N","N",3,1,10
"1756","SP1",2023-10-27,"Girona","Celta",1,0,"H",0,0,"D",1.69,4.27,4.84,"0-0","1-0",12,2,4,2,3,2,0,0,10,1,15,12,1,11,27,"10-1","N","N","N",5,0,10
"1757","SP1",2023-10-28,"Almeria","Las Palmas",1,2,"A",0,1,"A",2.37,3.46,3.15,"0-1","1-2",10,4,10,3,3,1,0,0,3,2,13,19,3,5,32,"3-2","Y","Y","N",4,0,11
"1758","SP1",2023-10-28,"Barcelona","Real Madrid",1,2,"A",1,0,"H",2.55,3.66,2.76,"1-0","1-2",15,3,13,4,2,1,0,0,6,3,15,15,3,9,30,"6-3","Y","Y","N",3,0,11
"1759","SP1",2023-10-28,"Mallorca","Getafe",0,0,"D",0,0,"D",2.35,3.03,3.67,"0-0","0-0",15,4,8,0,0,1,0,0,8,3,10,25,0,11,35,"8-3","N","N","N",1,0,11
"1760","SP1",2023-10-28,"Cadiz","Sevilla",2,2,"D",2,1,"H",3.39,3.37,2.29,"2-1","2-2",10,5,20,10,6,4,0,0,2,4,17,12,4,6,29,"2-4","Y","Y","Y",10,0,11
"1761","SP1",2023-10-29,"Betis","Osasuna",2,1,"H",1,0,"H",2.1,3.4,3.89,"1-0","2-1",9,2,7,1,3,4,0,0,6,3,10,25,3,9,35,"6-3","Y","Y","N",7,0,11
"1762","SP1",2023-10-29,"Vallecano","Sociedad",2,2,"D",1,1,"D",3.34,3.11,2.46,"1-1","2-2",16,7,15,3,3,2,0,0,4,5,17,16,4,9,33,"4-5","Y","Y","Y",5,0,11
"1763","SP1",2023-10-29,"Ath Bilbao","Valencia",2,2,"D",1,0,"H",1.64,3.96,5.95,"1-0","2-2",12,7,11,5,3,1,0,0,10,4,11,10,4,14,21,"10-4","Y","Y","Y",4,0,11
"1764","SP1",2023-10-29,"Ath Madrid","Alaves",2,1,"H",2,0,"H",1.4,4.96,8.74,"2-0","2-1",11,7,8,1,3,2,0,0,4,4,10,11,3,8,21,"4-4","Y","Y","N",5,0,11
"1765","SP1",2023-10-30,"Granada","Villarreal",2,3,"A",2,3,"A",3.16,3.62,2.29,"2-3","2-3",18,8,6,5,0,4,0,0,4,1,14,15,5,5,29,"4-1","Y","Y","Y",4,0,11
"1766","SP1",2023-11-03,"Las Palmas","Ath Madrid",2,1,"H",0,0,"D",5.74,3.85,1.68,"0-0","2-1",9,3,13,5,0,3,0,0,3,4,12,9,3,7,21,"3-4","Y","Y","N",3,0,11
"1767","SP1",2023-11-04,"Osasuna","Girona",2,4,"A",1,1,"D",2.88,3.47,2.51,"1-1","2-4",15,3,11,4,5,3,0,0,2,7,14,10,6,9,24,"2-7","Y","Y","Y",8,0,12
"1768","SP1",2023-11-04,"Betis","Mallorca",2,0,"H",1,0,"H",1.93,3.37,4.52,"1-0","2-0",22,3,8,1,1,4,0,1,6,1,13,16,2,7,29,"6-1","Y","N","N",5,1,12
"1769","SP1",2023-11-04,"Celta","Sevilla",1,1,"D",1,0,"H",2.58,3.49,2.79,"1-0","1-1",15,3,13,5,2,5,1,0,4,6,14,10,2,10,24,"4-6","Y","N","N",7,1,12
"1770","SP1",2023-11-04,"Sociedad","Barcelona",0,1,"A",0,0,"D",3.37,3.55,2.2,"0-0","0-1",13,6,12,4,3,3,0,0,8,3,16,8,1,11,24,"8-3","N","N","N",6,0,12
"1771","SP1",2023-11-05,"Alaves","Almeria",1,0,"H",0,0,"D",1.78,3.8,4.75,"0-0","1-0",23,3,9,3,2,3,0,0,12,6,13,14,1,18,27,"12-6","N","N","N",5,0,12
"1772","SP1",2023-11-05,"Valencia","Granada",1,0,"H",1,0,"H",1.66,4.13,5.24,"1-0","1-0",11,2,6,1,3,5,0,0,0,4,20,15,1,4,35,"0-4","N","N","N",8,0,12
"1773","SP1",2023-11-05,"Villarreal","Ath Bilbao",2,3,"A",0,3,"A",3.06,3.58,2.34,"0-3","2-3",17,6,17,7,4,4,0,0,9,3,11,18,5,12,29,"9-3","Y","Y","Y",8,0,12
"1774","SP1",2023-11-05,"Real Madrid","Vallecano",0,0,"D",0,0,"D",1.27,6.24,10.53,"0-0","0-0",22,5,4,0,3,5,0,0,11,1,12,15,0,12,27,"11-1","N","N","N",8,0,12
"1775","SP1",2023-11-06,"Getafe","Cadiz",1,0,"H",0,0,"D",1.93,3.19,4.88,"0-0","1-0",13,3,6,2,7,1,1,0,6,3,18,12,1,9,30,"6-3","N","N","N",8,1,12
"1776","SP1",2023-11-10,"Ath Bilbao","Celta",4,3,"H",2,2,"D",1.69,4.17,5.04,"2-2","4-3",21,12,13,5,2,2,0,0,7,2,15,13,7,9,28,"7-2","Y","Y","Y",4,0,12
"1777","SP1",2023-11-11,"Vallecano","Girona",1,2,"A",1,1,"D",2.92,3.48,2.48,"1-1","1-2",22,9,19,7,1,2,0,0,8,3,15,13,3,11,28,"8-3","Y","Y","N",3,0,13
"1778","SP1",2023-11-11,"Almeria","Sociedad",1,3,"A",0,0,"D",4.83,4.01,1.72,"0-0","1-3",7,2,18,6,2,2,0,0,5,5,18,19,4,10,37,"5-5","Y","Y","Y",4,0,13
"1779","SP1",2023-11-11,"Granada","Getafe",1,1,"D",1,1,"D",2.58,3.16,3.04,"1-1","1-1",12,6,10,6,4,2,0,0,3,5,14,9,2,8,23,"3-5","Y","N","N",6,0,13
"1780","SP1",2023-11-11,"Osasuna","Las Palmas",1,1,"D",0,0,"D",2,3.25,4.42,"0-0","1-1",11,3,6,1,1,1,0,0,8,3,25,10,2,11,35,"8-3","Y","N","N",2,0,13
"1781","SP1",2023-11-11,"Real Madrid","Valencia",5,1,"H",2,0,"H",1.32,5.6,9.7,"2-0","5-1",16,7,10,4,1,3,0,0,4,4,7,26,6,8,33,"4-4","Y","Y","Y",4,0,13
"1782","SP1",2023-11-12,"Barcelona","Alaves",2,1,"H",0,1,"A",1.24,6.51,11.82,"0-1","2-1",11,6,8,1,2,1,0,0,2,1,11,10,3,3,21,"2-1","Y","Y","N",3,0,13
"1783","SP1",2023-11-12,"Sevilla","Betis",1,1,"D",0,0,"D",2.17,3.52,3.46,"0-0","1-1",13,4,14,6,1,1,0,0,9,5,18,14,2,14,32,"9-5","Y","N","N",2,0,13
"1784","SP1",2023-11-12,"Ath Madrid","Villarreal",3,1,"H",1,1,"D",1.38,5.43,7.71,"1-1","3-1",25,10,11,7,0,2,0,0,6,3,8,8,4,9,16,"6-3","Y","Y","Y",2,0,13
"1785","SP1",2023-11-24,"Alaves","Granada",3,1,"H",2,0,"H",1.76,3.74,5.15,"2-0","3-1",8,5,11,4,1,3,0,0,6,2,10,13,4,8,23,"6-2","Y","Y","Y",4,0,13
"1786","SP1",2023-11-25,"Vallecano","Barcelona",1,1,"D",1,0,"H",5.39,4.09,1.65,"1-0","1-1",10,4,15,4,3,4,0,0,1,4,23,13,2,5,36,"1-4","Y","N","N",7,0,13
"1787","SP1",2023-11-25,"Valencia","Celta",0,0,"D",0,0,"D",2.19,3.43,3.51,"0-0","0-0",8,0,13,1,3,2,0,0,5,7,13,7,0,12,20,"5-7","N","N","N",5,0,14
"1788","SP1",2023-11-25,"Getafe","Almeria",2,1,"H",2,1,"H",1.68,3.86,5.46,"2-1","2-1",18,5,13,4,2,4,0,0,3,6,12,8,3,9,20,"3-6","Y","Y","N",6,0,14
"1789","SP1",2023-11-25,"Ath Madrid","Mallorca",1,0,"H",0,0,"D",1.37,4.89,9.37,"0-0","1-0",20,3,8,1,0,0,0,0,7,3,8,19,1,10,27,"7-3","N","N","N",0,0,14
"1790","SP1",2023-11-26,"Villarreal","Osasuna",3,1,"H",0,0,"D",2.17,3.49,3.5,"0-0","3-1",10,3,15,7,0,0,0,0,2,4,9,14,4,6,23,"2-4","Y","Y","Y",0,0,14
"1791","SP1",2023-11-26,"Sociedad","Sevilla",2,1,"H",2,0,"H",1.76,3.76,4.92,"2-0","2-1",11,8,8,2,2,1,0,2,4,4,22,8,3,8,30,"4-4","Y","Y","N",3,2,14
"1792","SP1",2023-11-26,"Cadiz","Real Madrid",0,3,"A",0,1,"A",6.67,4.68,1.48,"0-1","0-3",13,4,14,5,3,3,0,0,4,4,16,16,3,8,32,"4-4","Y","Y","N",6,0,14
"1793","SP1",2023-11-26,"Betis","Las Palmas",1,0,"H",1,0,"H",1.65,3.91,5.66,"1-0","1-0",12,6,15,4,1,2,0,0,7,6,7,12,1,13,19,"7-6","N","N","N",3,0,14
"1794","SP1",2023-11-27,"Girona","Ath Bilbao",1,1,"D",0,0,"D",2.32,3.69,3.01,"0-0","1-1",12,2,13,6,1,1,0,0,2,6,8,16,2,8,24,"2-6","Y","N","N",2,0,14
"1795","SP1",2023-11-29,"Mallorca","Cadiz",1,1,"D",1,1,"D",1.99,3.21,4.56,"1-1","1-1",16,3,6,3,2,3,0,0,7,0,14,18,2,7,32,"7-0","Y","N","N",5,0,14
"1796","SP1",2023-12-01,"Las Palmas","Getafe",2,0,"H",1,0,"H",2.49,2.95,3.48,"1-0","2-0",11,6,12,4,0,5,0,1,4,4,11,9,2,8,20,"4-4","Y","N","N",5,1,14
"1797","SP1",2023-12-02,"Girona","Valencia",2,1,"H",0,0,"D",1.71,3.97,5,"0-0","2-1",9,5,9,3,2,3,0,0,3,2,6,7,3,5,13,"3-2","Y","Y","N",5,0,15
"1798","SP1",2023-12-02,"Ath Bilbao","Vallecano",4,0,"H",1,0,"H",1.57,4.32,5.92,"1-0","4-0",9,4,11,3,1,2,0,0,7,2,15,11,4,9,26,"7-2","Y","Y","Y",3,0,15
"1799","SP1",2023-12-02,"Real Madrid","Granada",2,0,"H",1,0,"H",1.16,8.84,14.66,"1-0","2-0",11,4,1,0,2,1,0,0,6,0,10,12,2,6,22,"6-0","Y","N","N",3,0,15
"1800","SP1",2023-12-02,"Osasuna","Sociedad",1,1,"D",1,1,"D",3.75,3.24,2.18,"1-1","1-1",9,3,17,5,3,3,0,0,1,8,12,10,2,9,22,"1-8","Y","N","N",6,0,15
"1801","SP1",2023-12-03,"Mallorca","Alaves",0,0,"D",0,0,"D",2.47,2.99,3.41,"0-0","0-0",7,3,7,4,4,2,0,0,5,4,16,15,0,9,31,"5-4","N","N","N",6,0,15
"1802","SP1",2023-12-03,"Almeria","Betis",0,0,"D",0,0,"D",3.36,3.66,2.16,"0-0","0-0",20,8,6,2,0,3,0,1,4,6,12,8,0,10,20,"4-6","N","N","N",3,1,15
"1803","SP1",2023-12-03,"Sevilla","Villarreal",1,1,"D",0,0,"D",2.05,3.73,3.58,"0-0","1-1",18,4,5,4,3,2,0,0,8,4,6,16,2,12,22,"8-4","Y","N","N",5,0,15
"1804","SP1",2023-12-03,"Barcelona","Ath Madrid",1,0,"H",1,0,"H",2.05,3.76,3.57,"1-0","1-0",13,2,9,4,5,4,0,0,7,2,17,12,1,9,29,"7-2","N","N","N",9,0,15
"1805","SP1",2023-12-04,"Celta","Cadiz",1,1,"D",0,1,"A",1.61,4.13,5.8,"0-1","1-1",26,7,2,1,1,6,0,1,12,1,14,18,2,13,32,"12-1","Y","N","N",7,1,15
"1806","SP1",2023-12-08,"Getafe","Valencia",1,0,"H",0,0,"D",2.76,2.88,3.14,"0-0","1-0",8,6,3,0,2,4,1,2,7,0,15,14,1,7,29,"7-0","N","N","N",6,3,15
"1807","SP1",2023-12-09,"Alaves","Las Palmas",0,1,"A",0,1,"A",2.08,3.16,4.2,"0-1","0-1",19,5,9,2,3,4,0,0,12,3,13,13,1,15,26,"12-3","N","N","N",7,0,16
"1808","SP1",2023-12-09,"Betis","Real Madrid",1,1,"D",0,0,"D",4.39,3.92,1.81,"0-0","1-1",14,6,12,2,2,1,0,0,8,6,14,7,2,14,21,"8-6","Y","N","N",3,0,16
"1809","SP1",2023-12-09,"Villarreal","Sociedad",0,3,"A",0,3,"A",3.45,3.55,2.16,"0-3","0-3",20,4,16,5,2,1,0,0,5,3,10,22,3,8,32,"5-3","Y","Y","N",3,0,16
"1810","SP1",2023-12-09,"Mallorca","Sevilla",1,0,"H",1,0,"H",2.69,3.16,2.9,"1-0","1-0",6,3,19,5,2,2,0,0,4,12,15,6,1,16,21,"4-12","N","N","N",4,0,16
"1811","SP1",2023-12-10,"Ath Madrid","Almeria",2,1,"H",2,0,"H",1.19,7.63,13.51,"2-0","2-1",13,4,19,5,1,0,0,0,3,15,13,11,3,18,24,"3-15","Y","Y","N",1,0,16
"1812","SP1",2023-12-10,"Cadiz","Osasuna",1,1,"D",1,0,"H",2.99,3.14,2.63,"1-0","1-1",12,5,13,5,1,2,0,0,2,4,15,16,2,6,31,"2-4","Y","N","N",3,0,16
"1813","SP1",2023-12-10,"Barcelona","Girona",2,4,"A",1,2,"A",1.52,4.9,5.7,"1-2","2-4",31,11,15,7,1,2,0,0,8,3,7,10,6,11,17,"8-3","Y","Y","Y",3,0,16
"1814","SP1",2023-12-11,"Granada","Ath Bilbao",1,1,"D",0,1,"A",4.85,4.16,1.69,"0-1","1-1",7,4,19,4,0,2,0,0,1,8,9,11,2,9,20,"1-8","Y","N","N",2,0,16
"1815","SP1",2023-12-11,"Vallecano","Celta",0,0,"D",0,0,"D",2.51,3.31,3.02,"0-0","0-0",17,4,4,2,3,0,0,0,8,1,15,10,0,9,25,"8-1","N","N","N",3,0,16
"1816","SP1",2023-12-15,"Osasuna","Vallecano",1,0,"H",0,0,"D",2.29,3.16,3.63,"0-0","1-0",10,4,9,3,2,3,0,0,9,1,20,13,1,10,33,"9-1","N","N","N",5,0,16
"1817","SP1",2023-12-16,"Celta","Granada",1,0,"H",1,0,"H",1.67,4.1,5.13,"1-0","1-0",11,4,7,2,6,2,1,0,7,1,20,18,1,8,38,"7-1","N","N","N",8,1,17
"1818","SP1",2023-12-16,"Ath Bilbao","Ath Madrid",2,0,"H",0,0,"D",2.45,3.52,2.94,"0-0","2-0",16,7,7,3,0,1,0,0,3,7,7,10,2,10,17,"3-7","Y","N","N",1,0,17
"1819","SP1",2023-12-16,"Sevilla","Getafe",0,3,"A",0,2,"A",1.97,3.39,4.32,"0-2","0-3",12,4,14,7,3,3,0,0,4,2,18,18,3,6,36,"4-2","Y","Y","N",6,0,17
"1820","SP1",2023-12-16,"Valencia","Barcelona",1,1,"D",0,0,"D",5.2,4.06,1.67,"0-0","1-1",11,4,16,8,1,2,0,0,4,6,9,11,2,10,20,"4-6","Y","N","N",3,0,17
"1821","SP1",2023-12-17,"Almeria","Mallorca",0,0,"D",0,0,"D",2.66,3.3,2.83,"0-0","0-0",7,1,20,2,2,1,0,0,4,4,12,9,0,8,21,"4-4","N","N","N",3,0,17
"1822","SP1",2023-12-17,"Sociedad","Betis",0,0,"D",0,0,"D",1.7,3.9,5.17,"0-0","0-0",12,4,12,3,3,4,0,0,3,7,12,12,0,10,24,"3-7","N","N","N",7,0,17
"1823","SP1",2023-12-17,"Las Palmas","Cadiz",1,1,"D",1,0,"H",1.96,3.31,4.49,"1-0","1-1",7,2,13,5,1,3,0,0,4,6,9,12,2,10,21,"4-6","Y","N","N",4,0,17
"1824","SP1",2023-12-17,"Real Madrid","Villarreal",4,1,"H",2,0,"H",1.29,6.3,9.21,"2-0","4-1",22,9,3,1,2,3,0,0,11,0,14,12,5,11,26,"11-0","Y","Y","Y",5,0,17
"1825","SP1",2023-12-18,"Girona","Alaves",3,0,"H",2,0,"H",1.57,4.38,5.79,"2-0","3-0",9,4,12,2,0,1,0,0,3,2,9,7,3,5,16,"3-2","Y","Y","N",1,0,17
"1826","SP1",2023-12-19,"Vallecano","Valencia",0,1,"A",0,0,"D",2.24,3.18,3.74,"0-0","0-1",7,1,8,3,1,5,0,1,8,1,16,18,1,9,34,"8-1","N","N","N",6,1,17
"1827","SP1",2023-12-19,"Ath Madrid","Getafe",3,3,"D",1,0,"H",1.48,4.45,7.67,"1-0","3-3",8,4,29,9,3,3,1,0,1,12,7,14,6,13,21,"1-12","Y","Y","Y",6,1,18
"1828","SP1",2023-12-19,"Granada","Sevilla",0,3,"A",0,2,"A",2.96,3.3,2.59,"0-2","0-3",12,3,12,5,2,1,0,0,6,4,10,18,3,10,28,"6-4","Y","Y","N",3,0,18
"1829","SP1",2023-12-20,"Barcelona","Almeria",3,2,"H",1,1,"D",1.13,10.49,16.19,"1-1","3-2",30,11,10,5,3,3,0,0,12,0,16,9,5,12,25,"12-0","Y","Y","Y",6,0,18
"1830","SP1",2023-12-20,"Ath Bilbao","Las Palmas",1,0,"H",0,0,"D",1.39,4.99,8.41,"0-0","1-0",19,10,5,1,1,3,0,0,5,2,12,11,1,7,23,"5-2","N","N","N",4,0,18
"1831","SP1",2023-12-20,"Villarreal","Celta",3,2,"H",2,0,"H",2.42,3.52,2.98,"2-0","3-2",12,8,15,5,2,4,0,0,4,7,16,15,5,11,31,"4-7","Y","Y","Y",6,0,18
"1832","SP1",2023-12-21,"Betis","Girona",1,1,"D",0,1,"A",2.87,3.69,2.42,"0-1","1-1",21,4,12,4,2,2,0,0,7,6,6,9,2,13,15,"7-6","Y","N","N",4,0,18
"1833","SP1",2023-12-21,"Cadiz","Sociedad",0,0,"D",0,0,"D",4.8,3.42,1.87,"0-0","0-0",10,2,8,1,3,1,0,0,7,5,16,15,0,12,31,"7-5","N","N","N",4,0,18
"1834","SP1",2023-12-21,"Alaves","Real Madrid",0,1,"A",0,0,"D",5.93,4.26,1.58,"0-0","0-1",8,2,9,4,3,1,0,1,3,3,18,13,1,6,31,"3-3","N","N","N",4,1,18
"1835","SP1",2023-12-21,"Mallorca","Osasuna",3,2,"H",1,1,"D",2.42,2.98,3.51,"1-1","3-2",15,8,12,7,3,1,0,0,6,0,11,12,5,6,23,"6-0","Y","Y","Y",4,0,18
"1836","SP1",2023-12-23,"Ath Madrid","Sevilla",1,0,"H",0,0,"D",1.54,4.51,6.05,"0-0","1-0",12,4,8,2,7,3,1,0,6,5,12,19,1,11,31,"6-5","N","N","N",10,1,18
"1837","SP1",2024-01-02,"Getafe","Vallecano",0,2,"A",0,1,"A",2.42,3,3.5,"0-1","0-2",5,0,12,8,6,3,2,0,2,3,16,16,2,5,32,"2-3","Y","N","N",9,2,19
"1838","SP1",2024-01-02,"Sociedad","Alaves",1,1,"D",0,0,"D",1.59,3.9,6.58,"0-0","1-1",16,6,7,2,4,4,1,0,6,4,9,17,2,10,26,"6-4","Y","N","N",8,1,19
"1839","SP1",2024-01-02,"Valencia","Villarreal",3,1,"H",2,0,"H",2.04,3.49,3.9,"2-0","3-1",11,8,8,4,2,5,0,0,4,3,12,15,4,7,27,"4-3","Y","Y","Y",7,0,19
"1840","SP1",2024-01-03,"Granada","Cadiz",2,0,"H",1,0,"H",2.26,3.19,3.59,"1-0","2-0",15,8,15,2,3,4,0,1,5,6,17,16,2,11,33,"5-6","Y","N","N",7,1,19
"1841","SP1",2024-01-03,"Celta","Betis",2,1,"H",1,1,"D",2.47,3.33,3.05,"1-1","2-1",19,6,14,3,0,2,0,0,8,7,10,12,3,15,22,"8-7","Y","Y","N",2,0,19
"1842","SP1",2024-01-03,"Real Madrid","Mallorca",1,0,"H",0,0,"D",1.23,6.68,12.58,"0-0","1-0",17,5,7,0,2,3,0,0,5,4,5,15,1,9,20,"5-4","N","N","N",5,0,19
"1843","SP1",2024-01-03,"Girona","Ath Madrid",4,3,"H",3,2,"H",2.61,3.55,2.71,"3-2","4-3",17,9,18,12,0,1,0,0,7,8,8,10,7,15,18,"7-8","Y","Y","Y",1,0,19
"1844","SP1",2024-01-04,"Osasuna","Almeria",1,0,"H",1,0,"H",1.71,3.94,5.03,"1-0","1-0",14,2,4,0,1,2,0,0,5,4,14,5,1,9,19,"5-4","N","N","N",3,0,19
"1845","SP1",2024-01-04,"Sevilla","Ath Bilbao",0,2,"A",0,1,"A",3.17,3.24,2.45,"0-1","0-2",11,2,15,6,3,1,0,0,5,4,9,19,2,9,28,"5-4","Y","N","N",4,0,19
"1846","SP1",2024-01-04,"Las Palmas","Barcelona",1,2,"A",1,0,"H",5.82,4.39,1.57,"1-0","1-2",12,3,15,5,5,2,1,0,5,10,14,5,3,15,19,"5-10","Y","Y","N",7,1,19
"1847","SP1",2024-01-12,"Sevilla","Alaves",2,3,"A",0,2,"A",1.95,3.4,4.52,"0-2","2-3",19,4,16,8,4,3,0,0,5,4,12,13,5,9,25,"5-4","Y","Y","Y",7,0,20
"1848","SP1",2024-01-13,"Las Palmas","Villarreal",3,0,"H",1,0,"H",2.52,3.39,2.94,"1-0","3-0",8,3,17,3,4,3,0,0,4,6,13,11,3,10,24,"4-6","Y","Y","N",7,0,20
"1849","SP1",2024-01-13,"Mallorca","Celta",1,1,"D",1,1,"D",2.57,3.02,3.2,"1-1","1-1",17,6,6,2,4,1,0,0,10,1,18,18,2,11,36,"10-1","Y","N","N",5,0,20
"1850","SP1",2024-01-13,"Ath Bilbao","Sociedad",2,1,"H",2,0,"H",2.02,3.47,4,"2-0","2-1",10,3,9,1,1,4,0,0,5,5,16,21,3,10,37,"5-5","Y","Y","N",5,0,20
"1851","SP1",2024-01-13,"Betis","Granada",1,0,"H",0,0,"D",1.65,4.04,5.49,"0-0","1-0",25,6,6,2,3,4,0,0,13,1,11,17,1,14,28,"13-1","N","N","N",7,0,20
"1852","SP1",2024-01-14,"Almeria","Girona",0,0,"D",0,0,"D",4.71,4.42,1.67,"0-0","0-0",20,3,5,1,4,4,0,1,4,3,13,8,0,7,21,"4-3","N","N","N",8,1,20
"1853","SP1",2024-01-14,"Cadiz","Valencia",1,4,"A",1,1,"D",3.02,2.96,2.75,"1-1","1-4",10,2,9,5,4,2,0,0,3,1,15,15,5,4,30,"3-1","Y","Y","Y",6,0,20
"1854","SP1",2024-01-19,"Alaves","Cadiz",1,0,"H",0,0,"D",1.73,3.51,6,"0-0","1-0",13,3,9,1,0,4,0,0,4,4,15,18,1,8,33,"4-4","N","N","N",4,0,20
"1855","SP1",2024-01-20,"Vallecano","Las Palmas",0,2,"A",0,1,"A",1.93,3.42,4.5,"0-1","0-2",16,3,10,5,3,1,1,0,12,0,19,8,2,12,27,"12-0","Y","N","N",4,1,20
"1856","SP1",2024-01-20,"Villarreal","Mallorca",1,1,"D",1,0,"H",2.1,3.5,3.68,"1-0","1-1",18,5,8,2,2,2,1,0,4,6,13,11,2,10,24,"4-6","Y","N","N",4,1,20
"1857","SP1",2024-01-20,"Valencia","Ath Bilbao",1,0,"H",0,0,"D",3.47,3.46,2.19,"0-0","1-0",6,1,6,3,0,3,0,0,4,2,11,14,1,6,25,"4-2","N","N","N",3,0,21
"1858","SP1",2024-01-20,"Celta","Sociedad",0,1,"A",0,1,"A",3.21,3.08,2.52,"0-1","0-1",6,2,6,2,1,2,0,0,6,3,12,18,1,9,30,"6-3","N","N","N",3,0,21
"1859","SP1",2024-01-21,"Osasuna","Getafe",3,2,"H",2,0,"H",2.21,3.11,3.87,"2-0","3-2",13,7,10,7,4,4,0,0,1,4,14,16,5,5,30,"1-4","Y","Y","Y",8,0,21
"1860","SP1",2024-01-21,"Real Madrid","Almeria",3,2,"H",0,2,"A",1.15,9.58,15.8,"0-2","3-2",18,6,10,2,3,5,0,0,6,3,9,17,5,9,26,"6-3","Y","Y","Y",8,0,21
"1861","SP1",2024-01-21,"Betis","Barcelona",2,4,"A",0,1,"A",4.29,4.01,1.81,"0-1","2-4",14,5,11,4,1,2,0,0,3,4,12,9,6,7,21,"3-4","Y","Y","Y",3,0,21
"1862","SP1",2024-01-21,"Girona","Sevilla",5,1,"H",3,1,"H",1.74,3.93,4.81,"3-1","5-1",12,8,9,3,0,2,0,0,4,5,9,11,6,9,20,"4-5","Y","Y","Y",2,0,21
"1863","SP1",2024-01-22,"Granada","Ath Madrid",0,1,"A",0,0,"D",5.03,4,1.7,"0-0","0-1",17,2,10,5,2,2,1,0,6,2,11,16,1,8,27,"6-2","N","N","N",4,1,21
"1864","SP1",2024-01-26,"Almeria","Alaves",0,3,"A",0,1,"A",2.64,3.24,2.9,"0-1","0-3",19,7,11,3,1,2,0,0,11,3,17,12,3,14,29,"11-3","Y","Y","N",3,0,21
"1865","SP1",2024-01-27,"Sociedad","Vallecano",0,0,"D",0,0,"D",1.67,3.73,5.86,"0-0","0-0",6,3,5,0,2,4,0,0,2,2,16,14,0,4,30,"2-2","N","N","N",6,0,21
"1866","SP1",2024-01-27,"Las Palmas","Real Madrid",1,2,"A",0,0,"D",7.18,4.74,1.45,"0-0","1-2",7,2,13,5,3,3,0,0,1,6,17,14,3,7,31,"1-6","Y","Y","N",6,0,21
"1867","SP1",2024-01-27,"Barcelona","Villarreal",3,5,"A",0,1,"A",1.35,5.9,7.75,"0-1","3-5",22,10,9,6,3,4,0,0,10,0,8,13,8,10,21,"10-0","Y","Y","Y",7,0,22
"1868","SP1",2024-01-27,"Mallorca","Betis",0,1,"A",0,1,"A",2.39,3.13,3.37,"0-1","0-1",14,1,8,2,2,1,0,0,5,4,14,6,1,9,20,"5-4","N","N","N",3,0,22
"1869","SP1",2024-01-28,"Celta","Girona",0,1,"A",0,1,"A",2.8,3.52,2.55,"0-1","0-1",10,5,15,6,1,1,0,0,5,7,13,11,1,12,24,"5-7","N","N","N",2,0,22
"1870","SP1",2024-01-28,"Cadiz","Ath Bilbao",0,0,"D",0,0,"D",5.11,3.68,1.76,"0-0","0-0",9,2,8,0,4,2,0,0,6,8,13,14,0,14,27,"6-8","N","N","N",6,0,22
"1871","SP1",2024-01-28,"Sevilla","Osasuna",1,1,"D",1,0,"H",2.1,3.37,3.84,"1-0","1-1",10,5,11,4,3,0,1,0,2,4,19,13,2,6,32,"2-4","Y","N","N",3,1,22
"1872","SP1",2024-01-28,"Ath Madrid","Valencia",2,0,"H",1,0,"H",1.51,4.47,6.63,"1-0","2-0",12,8,10,3,2,0,0,0,3,6,9,9,2,9,18,"3-6","Y","N","N",2,0,22
"1873","SP1",2024-01-29,"Getafe","Granada",2,0,"H",2,0,"H",1.82,3.5,5.01,"2-0","2-0",7,4,16,3,2,1,0,0,4,3,17,11,2,7,28,"4-3","Y","N","N",3,0,22
"1874","SP1",2024-01-31,"Barcelona","Osasuna",1,0,"H",0,0,"D",1.32,5.82,9.33,"0-0","1-0",16,4,9,1,1,2,0,1,6,6,9,12,1,12,21,"6-6","N","N","N",3,1,22
"1875","SP1",2024-01-31,"Ath Madrid","Vallecano",2,1,"H",1,1,"D",1.5,4.48,6.83,"1-1","2-1",8,3,10,2,0,3,0,0,5,6,11,13,3,11,24,"5-6","Y","Y","N",3,0,22
"1876","SP1",2024-02-01,"Getafe","Real Madrid",0,2,"A",0,1,"A",6.44,4.18,1.56,"0-1","0-2",10,2,16,9,1,2,0,0,2,6,16,5,2,8,21,"2-6","Y","N","N",3,0,22
"1877","SP1",2024-02-02,"Ath Bilbao","Mallorca",4,0,"H",2,0,"H",1.56,4,7.13,"2-0","4-0",13,6,6,2,0,1,0,0,6,2,17,15,4,8,32,"6-2","Y","Y","Y",1,0,23
"1878","SP1",2024-02-03,"Valencia","Almeria",2,1,"H",2,0,"H",1.67,3.97,5.35,"2-0","2-1",7,2,15,5,4,5,0,0,0,6,17,16,3,6,33,"0-6","Y","Y","N",9,0,23
"1879","SP1",2024-02-03,"Granada","Las Palmas",1,1,"D",1,0,"H",2.32,3.23,3.41,"1-0","1-1",3,1,16,6,4,3,1,1,2,9,6,16,2,11,22,"2-9","Y","N","N",7,2,23
"1880","SP1",2024-02-03,"Alaves","Barcelona",1,3,"A",0,1,"A",4.31,3.71,1.87,"0-1","1-3",13,2,8,5,2,2,0,1,14,5,15,10,4,19,25,"14-5","Y","Y","Y",4,1,23
"1881","SP1",2024-02-03,"Girona","Sociedad",0,0,"D",0,0,"D",2.19,3.42,3.52,"0-0","0-0",11,3,11,2,2,3,0,0,3,4,8,19,0,7,27,"3-4","N","N","N",5,0,23
"1882","SP1",2024-02-04,"Villarreal","Cadiz",0,0,"D",0,0,"D",1.66,4.02,5.4,"0-0","0-0",19,4,8,2,3,1,0,0,13,2,14,14,0,15,28,"13-2","N","N","N",4,0,23
"1883","SP1",2024-02-04,"Osasuna","Celta",0,3,"A",0,2,"A",2.38,3.16,3.36,"0-2","0-3",18,1,6,5,2,0,0,0,9,1,10,10,3,10,20,"9-1","Y","Y","N",2,0,23
"1884","SP1",2024-02-04,"Betis","Getafe",1,1,"D",1,1,"D",1.9,3.45,4.57,"1-1","1-1",9,3,11,2,7,4,0,0,3,5,9,19,2,8,28,"3-5","Y","N","N",11,0,23
"1885","SP1",2024-02-04,"Real Madrid","Ath Madrid",1,1,"D",1,0,"H",1.78,4.06,4.36,"1-0","1-1",17,4,10,5,0,5,0,0,2,8,6,15,2,10,21,"2-8","Y","N","N",5,0,23
"1886","SP1",2024-02-05,"Vallecano","Sevilla",1,2,"A",1,2,"A",2.18,3.36,3.61,"1-2","1-2",22,5,10,6,2,2,0,0,6,0,8,10,3,6,18,"6-0","Y","Y","N",4,0,23
"1887","SP1",2024-02-09,"Cadiz","Betis",0,2,"A",0,1,"A",3.12,2.97,2.7,"0-1","0-2",14,5,13,5,1,1,0,0,5,3,12,10,2,8,22,"5-3","Y","N","N",2,0,24
"1888","SP1",2024-02-10,"Alaves","Villarreal",1,1,"D",1,1,"D",2.24,3.42,3.4,"1-1","1-1",17,4,12,4,0,2,0,0,10,9,7,11,2,19,18,"10-9","Y","N","N",2,0,24
"1889","SP1",2024-02-10,"Sociedad","Osasuna",0,1,"A",0,0,"D",1.89,3.21,5.12,"0-0","0-1",21,3,9,2,0,0,0,0,7,4,11,11,1,11,22,"7-4","N","N","N",0,0,24
"1890","SP1",2024-02-10,"Real Madrid","Girona",4,0,"H",2,0,"H",1.45,5.12,6.54,"2-0","4-0",16,6,5,0,1,2,0,0,0,2,9,12,4,2,21,"0-2","Y","Y","Y",3,0,24
"1891","SP1",2024-02-10,"Las Palmas","Valencia",2,0,"H",0,0,"D",2.84,2.91,2.97,"0-0","2-0",8,3,7,1,2,0,0,0,5,0,9,9,2,5,18,"5-0","Y","N","N",2,0,24
"1892","SP1",2024-02-11,"Getafe","Celta",3,2,"H",2,0,"H",2.24,3.14,3.71,"2-0","3-2",11,4,9,4,1,2,0,0,0,4,16,13,5,4,29,"0-4","Y","Y","Y",3,0,24
"1893","SP1",2024-02-11,"Mallorca","Vallecano",2,1,"H",0,0,"D",2.42,2.97,3.54,"0-0","2-1",8,5,11,4,4,0,0,0,5,1,17,11,3,6,28,"5-1","Y","Y","N",4,0,24
"1894","SP1",2024-02-11,"Sevilla","Ath Madrid",1,0,"H",1,0,"H",3.6,3.64,2.08,"1-0","1-0",10,6,16,5,2,1,0,0,2,7,8,5,1,9,13,"2-7","N","N","N",3,0,24
"1895","SP1",2024-02-11,"Barcelona","Granada",3,3,"D",1,1,"D",1.2,7.83,12.33,"1-1","3-3",11,6,11,5,1,2,0,0,6,2,13,9,6,8,22,"6-2","Y","Y","Y",3,0,24
"1896","SP1",2024-02-12,"Almeria","Ath Bilbao",0,0,"D",0,0,"D",4.64,3.99,1.76,"0-0","0-0",10,4,12,4,4,1,1,0,4,10,17,15,0,14,32,"4-10","N","N","N",5,1,24
"1897","SP1",2024-02-16,"Villarreal","Getafe",1,1,"D",0,1,"A",2.02,3.58,3.93,"0-1","1-1",20,7,11,2,0,1,0,0,8,3,13,13,2,11,26,"8-3","Y","N","N",1,0,25
"1898","SP1",2024-02-17,"Ath Madrid","Las Palmas",5,0,"H",2,0,"H",1.48,4.58,6.96,"2-0","5-0",13,7,11,2,2,2,0,0,3,5,19,9,5,8,28,"3-5","Y","Y","Y",4,0,25
"1899","SP1",2024-02-17,"Osasuna","Cadiz",2,0,"H",0,0,"D",1.8,3.41,5.36,"0-0","2-0",11,4,5,1,4,2,0,0,5,4,20,12,2,9,32,"5-4","Y","N","N",6,0,25
"1900","SP1",2024-02-17,"Celta","Barcelona",1,2,"A",0,1,"A",4.09,3.88,1.88,"0-1","1-2",13,4,14,4,2,4,0,0,2,5,11,13,3,7,24,"2-5","Y","Y","N",6,0,25
"1901","SP1",2024-02-17,"Valencia","Sevilla",0,0,"D",0,0,"D",2.29,3.28,3.44,"0-0","0-0",14,4,1,1,0,1,0,0,7,2,5,8,0,9,13,"7-2","N","N","N",1,0,25
"1902","SP1",2024-02-18,"Vallecano","Real Madrid",1,1,"D",1,1,"D",5.43,4.12,1.64,"1-1","1-1",8,3,11,4,4,3,0,1,4,10,17,7,2,14,24,"4-10","Y","N","N",7,1,25
"1903","SP1",2024-02-18,"Granada","Almeria",1,1,"D",0,1,"A",2.19,3.51,3.43,"0-1","1-1",19,7,13,3,2,3,0,0,10,4,13,22,2,14,35,"10-4","Y","N","N",5,0,25
"1904","SP1",2024-02-18,"Mallorca","Sociedad",1,2,"A",1,1,"D",3.4,2.83,2.6,"1-1","1-2",4,1,19,5,7,5,1,0,3,9,12,18,3,12,30,"3-9","Y","Y","N",12,1,25
"1905","SP1",2024-02-18,"Betis","Alaves",0,0,"D",0,0,"D",2.15,3.31,3.75,"0-0","0-0",13,2,13,4,5,2,0,0,6,8,13,9,0,14,22,"6-8","N","N","N",7,0,25
"1906","SP1",2024-02-19,"Ath Bilbao","Girona",3,2,"H",1,0,"H",1.94,3.79,3.88,"1-0","3-2",14,7,12,6,1,2,0,0,3,4,16,13,5,7,29,"3-4","Y","Y","Y",3,0,25
"1907","SP1",2024-02-23,"Sociedad","Villarreal",1,3,"A",0,1,"A",1.72,3.84,5.25,"0-1","1-3",21,8,6,4,3,4,0,0,13,2,15,14,4,15,29,"13-2","Y","Y","Y",7,0,26
"1908","SP1",2024-02-24,"Barcelona","Getafe",4,0,"H",1,0,"H",1.42,5.11,7.29,"1-0","4-0",17,9,10,4,1,4,0,0,5,8,12,18,4,13,30,"5-8","Y","Y","Y",5,0,26
"1909","SP1",2024-02-24,"Alaves","Mallorca",1,1,"D",0,0,"D",1.96,3.09,4.98,"0-0","1-1",9,1,15,8,0,2,0,0,3,3,7,15,2,6,22,"3-3","Y","N","N",2,0,26
"1910","SP1",2024-02-24,"Almeria","Ath Madrid",2,2,"D",1,1,"D",4.55,4.02,1.76,"1-1","2-2",9,4,18,9,1,1,0,0,2,7,13,12,4,9,25,"2-7","Y","Y","Y",2,0,26
"1911","SP1",2024-02-25,"Cadiz","Celta",2,2,"D",0,1,"A",3.15,3.04,2.58,"0-1","2-2",19,6,7,3,2,3,0,0,9,1,13,20,4,10,33,"9-1","Y","Y","Y",5,0,26
"1912","SP1",2024-02-25,"Betis","Ath Bilbao",3,1,"H",2,1,"H",3.63,3.27,2.21,"2-1","3-1",13,5,3,1,1,6,0,1,5,3,14,12,4,8,26,"5-3","Y","Y","Y",7,1,26
"1913","SP1",2024-02-25,"Las Palmas","Osasuna",1,1,"D",0,0,"D",2.44,3.03,3.42,"0-0","1-1",9,3,6,2,2,1,0,0,6,7,6,15,2,13,21,"6-7","Y","N","N",3,0,26
"1914","SP1",2024-02-25,"Real Madrid","Sevilla",1,0,"H",0,0,"D",1.32,6.02,8.92,"0-0","1-0",16,6,4,1,1,3,0,0,7,2,10,13,1,9,23,"7-2","N","N","N",4,0,26
"1915","SP1",2024-02-26,"Girona","Vallecano",3,0,"H",0,0,"D",1.68,4.15,5.01,"0-0","3-0",14,8,7,1,3,5,0,1,2,2,13,16,3,4,29,"2-2","Y","Y","N",8,1,26
"1916","SP1",2024-03-01,"Celta","Almeria",1,0,"H",0,0,"D",1.88,3.78,4.29,"0-0","1-0",15,6,3,0,1,2,0,1,7,0,8,14,1,7,22,"7-0","N","N","N",3,1,26
"1917","SP1",2024-03-02,"Sevilla","Sociedad",3,2,"H",2,1,"H",2.64,3.02,3.09,"2-1","3-2",12,5,13,4,1,2,0,0,2,5,12,15,5,7,27,"2-5","Y","Y","Y",3,0,27
"1918","SP1",2024-03-02,"Vallecano","Cadiz",1,1,"D",0,0,"D",1.84,3.32,5.25,"0-0","1-1",9,5,16,5,1,1,0,0,4,9,14,17,2,13,31,"4-9","Y","N","N",2,0,27
"1919","SP1",2024-03-02,"Getafe","Las Palmas",3,3,"D",3,1,"H",2.05,3.2,4.27,"3-1","3-3",16,5,14,5,4,1,0,0,4,4,28,9,6,8,37,"4-4","Y","Y","Y",5,0,27
"1920","SP1",2024-03-02,"Valencia","Real Madrid",2,2,"D",2,1,"H",5.48,3.96,1.66,"2-1","2-2",12,5,10,5,2,3,0,1,2,2,18,11,4,4,29,"2-2","Y","Y","Y",5,1,27
"1921","SP1",2024-03-03,"Villarreal","Granada",5,1,"H",3,0,"H",1.65,4.33,5.04,"3-0","5-1",16,10,9,3,1,2,0,0,6,4,12,15,6,10,27,"6-4","Y","Y","Y",3,0,27
"1922","SP1",2024-03-03,"Ath Madrid","Betis",2,1,"H",2,0,"H",1.58,4.36,5.73,"2-0","2-1",17,12,12,6,1,2,0,0,4,6,9,12,3,10,21,"4-6","Y","Y","N",3,0,27
"1923","SP1",2024-03-03,"Mallorca","Girona",1,0,"H",1,0,"H",3.27,3.3,2.35,"1-0","1-0",16,2,15,4,5,0,0,0,8,5,19,9,1,13,28,"8-5","N","N","N",5,0,27
"1924","SP1",2024-03-03,"Ath Bilbao","Barcelona",0,0,"D",0,0,"D",2.94,3.54,2.43,"0-0","0-0",8,2,8,2,3,3,0,0,4,4,14,11,0,8,25,"4-4","N","N","N",6,0,27
"1925","SP1",2024-03-04,"Osasuna","Alaves",1,0,"H",0,0,"D",2.44,3.05,3.38,"0-0","1-0",15,4,10,4,2,1,0,0,5,5,15,11,1,10,26,"5-5","N","N","N",3,0,27
"1926","SP1",2024-03-08,"Barcelona","Mallorca",1,0,"H",0,0,"D",1.47,4.68,7.38,"0-0","1-0",20,6,9,3,1,1,0,0,4,1,9,14,1,5,23,"4-1","N","N","N",2,0,27
"1927","SP1",2024-03-09,"Valencia","Getafe",1,0,"H",1,0,"H",2,3.15,4.62,"1-0","1-0",10,3,15,5,2,3,0,0,5,5,10,19,1,10,29,"5-5","N","N","N",5,0,28
"1928","SP1",2024-03-09,"Cadiz","Ath Madrid",2,0,"H",1,0,"H",4.96,3.76,1.76,"1-0","2-0",7,3,8,4,4,5,0,0,3,1,20,15,2,4,35,"3-1","Y","N","N",9,0,28
"1929","SP1",2024-03-09,"Granada","Sociedad",2,3,"A",2,1,"H",4.45,3.5,1.91,"2-1","2-3",13,6,11,8,1,2,0,0,4,6,17,11,5,10,28,"4-6","Y","Y","Y",3,0,28
"1930","SP1",2024-03-09,"Girona","Osasuna",2,0,"H",1,0,"H",1.62,4.2,5.54,"1-0","2-0",11,6,7,1,3,3,0,0,5,7,10,16,2,12,26,"5-7","Y","N","N",6,0,28
"1931","SP1",2024-03-10,"Alaves","Vallecano",1,0,"H",1,0,"H",2.2,3.1,3.89,"1-0","1-0",12,4,9,3,2,2,0,0,7,5,13,10,1,12,23,"7-5","N","N","N",4,0,28
"1932","SP1",2024-03-10,"Las Palmas","Ath Bilbao",0,2,"A",0,1,"A",4.14,3.38,2.01,"0-1","0-2",14,2,7,2,3,3,0,0,10,3,8,14,2,13,22,"10-3","Y","N","N",6,0,28
"1933","SP1",2024-03-10,"Real Madrid","Celta",4,0,"H",1,0,"H",1.29,6.13,10.04,"1-0","4-0",24,13,11,1,2,3,0,0,12,1,8,13,4,13,21,"12-1","Y","Y","Y",5,0,28
"1934","SP1",2024-03-10,"Betis","Villarreal",2,3,"A",2,1,"H",2.08,3.66,3.59,"2-1","2-3",13,4,6,4,3,4,1,1,11,4,12,17,5,15,29,"11-4","Y","Y","Y",7,2,28
"1935","SP1",2024-03-11,"Almeria","Sevilla",2,2,"D",1,0,"H",3.11,3.36,2.42,"1-0","2-2",14,4,19,6,2,2,0,0,1,8,6,11,4,9,17,"1-8","Y","Y","Y",4,0,28
"1936","SP1",2024-03-15,"Sociedad","Cadiz",2,0,"H",1,0,"H",1.48,4.15,8.55,"1-0","2-0",14,6,13,2,3,1,0,0,8,2,15,6,2,10,21,"8-2","Y","N","N",4,0,28
"1937","SP1",2024-03-16,"Mallorca","Granada",1,0,"H",0,0,"D",1.84,3.43,5,"0-0","1-0",18,8,8,3,2,0,0,0,10,2,17,9,1,12,26,"10-2","N","N","N",2,0,29
"1938","SP1",2024-03-16,"Osasuna","Real Madrid",2,4,"A",1,2,"A",6.12,4.36,1.55,"1-2","2-4",9,4,17,9,3,2,0,0,5,7,18,9,6,12,27,"5-7","Y","Y","Y",5,0,29
"1939","SP1",2024-03-16,"Getafe","Girona",1,0,"H",1,0,"H",3.13,3.56,2.31,"1-0","1-0",11,3,13,3,4,4,0,0,2,5,16,13,1,7,29,"2-5","N","N","N",8,0,29
"1940","SP1",2024-03-16,"Ath Bilbao","Alaves",2,0,"H",2,0,"H",1.55,4.08,6.75,"2-0","2-0",16,4,7,3,1,3,0,0,5,4,7,13,2,9,20,"5-4","Y","N","N",4,0,29
"1941","SP1",2024-03-17,"Sevilla","Celta",1,2,"A",1,0,"H",2.03,3.45,4.05,"1-0","1-2",11,4,18,5,4,0,0,0,3,8,13,6,3,11,19,"3-8","Y","Y","N",4,0,29
"1942","SP1",2024-03-17,"Las Palmas","Almeria",0,1,"A",0,1,"A",1.92,3.65,4.18,"0-1","0-1",21,6,3,2,2,2,0,0,11,3,8,17,1,14,25,"11-3","N","N","N",4,0,29
"1943","SP1",2024-03-17,"Villarreal","Valencia",1,0,"H",0,0,"D",2.13,3.49,3.61,"0-0","1-0",13,7,14,7,5,1,0,0,6,2,12,12,1,8,24,"6-2","N","N","N",6,0,29
"1944","SP1",2024-03-17,"Vallecano","Betis",2,0,"H",1,0,"H",2.51,3.31,3,"1-0","2-0",8,4,11,1,4,4,0,0,4,8,22,16,2,12,38,"4-8","Y","N","N",8,0,29
"1945","SP1",2024-03-17,"Ath Madrid","Barcelona",0,3,"A",0,1,"A",2.42,3.66,2.89,"0-1","0-3",12,3,9,5,3,1,1,0,7,3,15,9,3,10,24,"7-3","Y","Y","N",4,1,29
"1946","SP2",2023-08-11,"Amorebieta","Levante",1,1,"D",0,1,"A",3.32,3.1,2.48,"0-1","1-1",11,3,7,2,0,3,0,0,8,2,20,18,2,10,38,"8-2","Y","N","N",3,0,1
"1947","SP2",2023-08-11,"Valladolid","Sp Gijon",2,0,"H",1,0,"H",1.93,3.36,4.67,"1-0","2-0",17,5,11,4,5,5,0,0,8,2,12,15,2,10,27,"8-2","Y","N","N",10,0,1
"1948","SP2",2023-08-12,"Santander","Eibar",4,0,"H",3,0,"H",3.05,2.98,2.74,"3-0","4-0",11,8,14,3,2,3,0,0,4,6,10,14,4,10,24,"4-6","Y","Y","Y",5,0,1
"1949","SP2",2023-08-12,"Zaragoza","Villarreal B",2,0,"H",0,0,"D",1.71,3.54,6.06,"0-0","2-0",16,7,11,2,2,4,0,0,4,0,9,8,2,4,17,"4-0","Y","N","N",6,0,1
"1950","SP2",2023-08-12,"Elche","Ferrol",0,1,"A",0,0,"D",NA,NA,NA,"0-0","0-1",14,1,10,2,0,2,0,0,4,4,13,15,1,8,28,"4-4","N","N","N",2,0,1
"1951","SP2",2023-08-13,"Burgos","Huesca",1,1,"D",1,1,"D",2.39,2.94,3.7,"1-1","1-1",19,5,4,2,2,4,0,0,6,5,5,14,2,11,19,"6-5","Y","N","N",6,0,1
"1952","SP2",2023-08-13,"Albacete","Espanol",1,1,"D",0,1,"A",3.09,3.26,2.52,"0-1","1-1",17,6,8,3,3,3,0,0,7,4,14,19,2,11,33,"7-4","Y","N","N",6,0,1
"1953","SP2",2023-08-13,"Cartagena","Eldense",0,1,"A",0,1,"A",2.2,3.11,3.96,"0-1","0-1",12,2,8,2,1,1,0,0,6,6,9,18,1,12,27,"6-6","N","N","N",2,0,1
"1954","SP2",2023-08-13,"Leganes","Andorra",0,1,"A",0,1,"A",2.38,2.97,3.69,"0-1","0-1",12,4,13,3,5,1,0,0,2,2,25,12,1,4,37,"2-2","N","N","N",6,0,1
"1955","SP2",2023-08-14,"Mirandes","Alcorcon",4,0,"H",2,0,"H",2.66,2.96,3.13,"2-0","4-0",17,6,18,6,1,1,0,0,2,5,14,6,4,7,20,"2-5","Y","Y","Y",2,0,1
"1956","SP2",2023-08-14,"Tenerife","Oviedo",1,0,"H",1,0,"H",2.15,2.99,4.28,"1-0","1-0",10,3,7,0,6,0,0,0,6,4,17,7,1,10,24,"6-4","N","N","N",6,0,1
"1957","SP2",2023-08-18,"Andorra","Cartagena",3,2,"H",0,0,"D",1.92,3.42,4.65,"0-0","3-2",17,5,5,3,2,4,0,0,6,0,14,11,5,6,25,"6-0","Y","Y","Y",6,0,2
"1958","SP2",2023-08-18,"Zaragoza","Valladolid",1,0,"H",1,0,"H",2.39,3.08,3.51,"1-0","1-0",12,5,11,5,3,2,0,0,5,0,10,14,1,5,24,"5-0","N","N","N",5,0,2
"1959","SP2",2023-08-19,"Eibar","Elche",2,1,"H",1,0,"H",2.25,3.06,3.89,"1-0","2-1",11,5,13,3,1,2,0,0,6,4,13,8,3,10,21,"6-4","Y","Y","N",3,0,2
"1960","SP2",2023-08-19,"Espanol","Santander",2,0,"H",1,0,"H",1.85,3.35,5.22,"1-0","2-0",20,6,12,2,1,2,0,0,6,7,23,17,2,13,40,"6-7","Y","N","N",3,0,2
"1961","SP2",2023-08-19,"Levante","Burgos",3,2,"H",2,1,"H",1.72,3.47,6.13,"2-1","3-2",18,11,16,8,4,3,0,0,4,4,19,7,5,8,26,"4-4","Y","Y","Y",7,0,2
"1962","SP2",2023-08-19,"Alcorcon","Leganes",0,2,"A",0,0,"D",2.61,2.92,3.31,"0-0","0-2",15,2,7,4,3,4,0,0,8,5,12,16,2,13,28,"8-5","Y","N","N",7,0,2
"1963","SP2",2023-08-20,"Oviedo","Ferrol",1,1,"D",0,1,"A",2.08,2.96,4.75,"0-1","1-1",16,3,5,1,2,1,0,1,6,3,8,12,2,9,20,"6-3","Y","N","N",3,1,2
"1964","SP2",2023-08-20,"Sp Gijon","Mirandes",3,0,"H",3,0,"H",1.88,3.37,4.94,"3-0","3-0",12,7,22,11,2,2,0,0,7,11,11,12,3,18,23,"7-11","Y","Y","N",4,0,2
"1965","SP2",2023-08-20,"Albacete","Amorebieta",2,2,"D",1,2,"A",1.64,3.56,6.99,"1-2","2-2",18,8,13,3,3,0,0,0,4,7,11,8,4,11,19,"4-7","Y","Y","Y",3,0,2
"1966","SP2",2023-08-21,"Villarreal B","Eldense",3,1,"H",2,1,"H",2.31,3.34,3.32,"2-1","3-1",13,6,11,3,2,1,0,0,2,5,17,17,4,7,34,"2-5","Y","Y","Y",3,0,2
"1967","SP2",2023-08-21,"Huesca","Tenerife",0,2,"A",0,1,"A",2.96,2.87,2.89,"0-1","0-2",12,4,11,5,0,4,0,0,4,2,7,18,2,6,25,"4-2","Y","N","N",4,0,2
"1968","SP2",2023-08-25,"Cartagena","Levante",0,1,"A",0,1,"A",2.98,3.13,2.69,"0-1","0-1",9,3,13,5,4,6,0,0,2,12,14,15,1,14,29,"2-12","N","N","N",10,0,3
"1969","SP2",2023-08-26,"Burgos","Oviedo",1,0,"H",1,0,"H",2.74,2.8,3.28,"1-0","1-0",16,5,9,3,4,4,0,1,4,3,13,16,1,7,29,"4-3","N","N","N",8,1,3
"1970","SP2",2023-08-26,"Tenerife","Zaragoza",0,1,"A",0,0,"D",2.23,2.89,4.27,"0-0","0-1",14,2,7,4,3,3,1,0,11,3,19,10,1,14,29,"11-3","N","N","N",6,1,3
"1971","SP2",2023-08-26,"Elche","Villarreal B",1,0,"H",1,0,"H",1.63,3.86,6.33,"1-0","1-0",19,8,12,3,2,0,0,0,4,4,14,8,1,8,22,"4-4","N","N","N",2,0,3
"1972","SP2",2023-08-26,"Valladolid","Alcorcon",0,2,"A",0,1,"A",1.79,3.44,5.49,"0-1","0-2",28,2,12,5,1,4,0,0,10,3,10,20,2,13,30,"10-3","Y","N","N",5,0,3
"1973","SP2",2023-08-27,"Ferrol","Sp Gijon",2,0,"H",0,0,"D",2.53,3.04,3.29,"0-0","2-0",13,3,6,1,0,2,0,0,4,4,12,16,2,8,28,"4-4","Y","N","N",2,0,3
"1974","SP2",2023-08-27,"Amorebieta","Andorra",3,0,"H",1,0,"H",3.35,3.1,2.46,"1-0","3-0",9,4,15,5,2,1,0,0,3,7,14,8,3,10,22,"3-7","Y","Y","N",3,0,3
"1975","SP2",2023-08-27,"Mirandes","Espanol",0,1,"A",0,0,"D",3.58,3.22,2.28,"0-0","0-1",5,1,17,4,4,2,0,0,4,7,12,13,1,11,25,"4-7","N","N","N",6,0,3
"1976","SP2",2023-08-27,"Leganes","Albacete",2,0,"H",1,0,"H",2.47,3.12,3.28,"1-0","2-0",11,2,12,3,3,2,0,0,2,5,9,15,2,7,24,"2-5","Y","N","N",5,0,3
"1977","SP2",2023-08-28,"Eldense","Eibar",2,1,"H",2,0,"H",2.96,3.04,2.73,"2-0","2-1",7,4,12,2,1,4,0,0,6,4,8,11,3,10,19,"6-4","Y","Y","N",5,0,3
"1978","SP2",2023-08-28,"Santander","Huesca",0,0,"D",0,0,"D",2.12,3.13,4.12,"0-0","0-0",10,0,14,0,5,5,0,0,12,6,16,16,0,18,32,"12-6","N","N","N",10,0,3
"1979","SP2",2023-09-01,"Alcorcon","Ferrol",1,1,"D",0,0,"D",2.34,2.99,3.77,"0-0","1-1",12,3,7,2,3,1,0,0,3,1,11,9,2,4,20,"3-1","Y","N","N",4,0,4
"1980","SP2",2023-09-01,"Albacete","Valladolid",2,0,"H",1,0,"H",2.11,3.31,3.97,"1-0","2-0",9,3,7,1,1,5,0,0,5,4,19,12,2,9,31,"5-4","Y","N","N",6,0,4
"1981","SP2",2023-09-02,"Sp Gijon","Burgos",2,1,"H",1,0,"H",2.1,3.12,4.32,"1-0","2-1",17,2,5,2,1,1,0,0,10,2,12,15,3,12,27,"10-2","Y","Y","N",2,0,4
"1982","SP2",2023-09-02,"Levante","Oviedo",1,1,"D",0,0,"D",1.86,3.39,5.06,"0-0","1-1",17,4,11,2,3,3,0,1,4,2,18,11,2,6,29,"4-2","Y","N","N",6,1,4
"1983","SP2",2023-09-02,"Elche","Santander",1,1,"D",1,0,"H",1.84,3.53,4.82,"1-0","1-1",22,6,12,6,0,3,1,0,8,1,11,16,2,9,27,"8-1","Y","N","N",3,1,4
"1984","SP2",2023-09-02,"Villarreal B","Cartagena",1,2,"A",1,0,"H",2.24,3.38,3.5,"1-0","1-2",17,6,12,5,2,3,0,0,3,7,9,14,3,10,23,"3-7","Y","Y","N",5,0,4
"1985","SP2",2023-09-03,"Andorra","Tenerife",0,1,"A",0,0,"D",2.29,3.07,3.73,"0-0","0-1",16,2,10,4,0,3,0,0,8,4,7,18,1,12,25,"8-4","N","N","N",3,0,4
"1986","SP2",2023-09-03,"Eibar","Leganes",0,1,"A",0,1,"A",2.07,3.15,4.39,"0-1","0-1",20,2,2,1,2,3,0,0,8,1,11,14,1,9,25,"8-1","N","N","N",5,0,4
"1987","SP2",2023-09-03,"Espanol","Amorebieta",3,2,"H",0,2,"A",1.62,3.76,6.71,"0-2","3-2",21,7,7,4,3,1,0,0,4,3,6,15,5,7,21,"4-3","Y","Y","Y",4,0,4
"1988","SP2",2023-09-03,"Zaragoza","Eldense",2,0,"H",1,0,"H",1.77,3.45,5.68,"1-0","2-0",13,1,8,3,2,1,0,0,1,3,6,13,2,4,19,"1-3","Y","N","N",3,0,4
"1989","SP2",2023-09-03,"Huesca","Mirandes",1,1,"D",0,0,"D",2.09,3.28,4.07,"0-0","1-1",15,3,13,3,5,5,1,0,9,5,15,10,2,14,25,"9-5","Y","N","N",10,1,4
"1990","SP2",2023-09-08,"Levante","Espanol",1,4,"A",1,2,"A",2.67,3.19,2.95,"1-2","1-4",15,3,17,10,0,0,1,0,5,3,13,13,5,8,26,"5-3","Y","Y","Y",0,1,5
"1991","SP2",2023-09-09,"Burgos","Eibar",1,0,"H",0,0,"D",3.13,2.99,2.68,"0-0","1-0",6,3,14,2,2,4,0,1,5,10,10,13,1,15,23,"5-10","N","N","N",6,1,5
"1992","SP2",2023-09-09,"Oviedo","Sp Gijon",0,0,"D",0,0,"D",2.36,2.96,3.77,"0-0","0-0",6,0,7,1,2,3,0,0,7,1,12,17,0,8,29,"7-1","N","N","N",5,0,5
"1993","SP2",2023-09-09,"Leganes","Huesca",2,0,"H",1,0,"H",2.04,3.09,4.65,"1-0","2-0",11,7,8,3,0,2,0,0,2,3,18,12,2,5,30,"2-3","Y","N","N",2,0,5
"1994","SP2",2023-09-09,"Tenerife","Albacete",2,0,"H",2,0,"H",2.18,3.08,4.09,"2-0","2-0",10,4,14,4,2,1,0,0,1,7,19,9,2,8,28,"1-7","Y","N","N",3,0,5
"1995","SP2",2023-09-10,"Ferrol","Villarreal B",2,2,"D",0,1,"A",1.97,3.33,4.54,"0-1","2-2",24,8,6,3,3,2,0,0,13,0,11,12,4,13,23,"13-0","Y","Y","Y",5,0,5
"1996","SP2",2023-09-10,"Santander","Amorebieta",1,0,"H",1,0,"H",1.85,3.58,4.73,"1-0","1-0",7,4,7,2,4,2,0,0,4,4,12,17,1,8,29,"4-4","N","N","N",6,0,5
"1997","SP2",2023-09-10,"Cartagena","Zaragoza",1,3,"A",1,2,"A",3.25,2.93,2.64,"1-2","1-3",19,5,9,5,2,2,0,0,6,4,11,6,4,10,17,"6-4","Y","Y","Y",4,0,5
"1998","SP2",2023-09-10,"Mirandes","Andorra",4,3,"H",2,0,"H",3.24,3.21,2.46,"2-0","4-3",17,6,25,7,1,3,0,0,3,3,9,11,7,6,20,"3-3","Y","Y","Y",4,0,5
"1999","SP2",2023-09-10,"Valladolid","Elche",1,1,"D",1,0,"H",2.33,3.03,3.71,"1-0","1-1",14,5,8,3,6,2,1,1,7,6,15,13,2,13,28,"7-6","Y","N","N",8,2,5
"2000","SP2",2023-09-11,"Eldense","Alcorcon",2,2,"D",0,0,"D",2.4,2.99,3.53,"0-0","2-2",17,3,13,4,0,3,0,1,5,2,14,7,4,7,21,"5-2","Y","Y","Y",3,1,5
"2001","SP2",2023-09-15,"Zaragoza","Santander",1,1,"D",1,1,"D",2.06,3.11,4.5,"1-1","1-1",6,2,12,4,2,5,0,0,6,6,21,16,2,12,37,"6-6","Y","N","N",7,0,6
"2002","SP2",2023-09-16,"Huesca","Villarreal B",2,2,"D",0,2,"A",2.07,3.23,4.24,"0-2","2-2",8,2,7,3,5,3,0,0,7,0,14,14,4,7,28,"7-0","Y","Y","Y",8,0,6
"2003","SP2",2023-09-16,"Alcorcon","Levante",0,2,"A",0,1,"A",2.96,3.08,2.74,"0-1","0-2",10,1,21,5,6,3,1,0,3,6,10,16,2,9,26,"3-6","Y","N","N",9,1,6
"2004","SP2",2023-09-16,"Valladolid","Cartagena",1,0,"H",0,0,"D",1.87,3.62,4.58,"0-0","1-0",22,8,9,4,3,1,0,0,9,3,14,14,1,12,28,"9-3","N","N","N",4,0,6
"2005","SP2",2023-09-16,"Albacete","Burgos",2,1,"H",1,0,"H",1.81,3.42,5.44,"1-0","2-1",19,5,12,3,1,2,0,0,3,6,16,8,3,9,24,"3-6","Y","Y","N",3,0,6
"2006","SP2",2023-09-17,"Amorebieta","Mirandes",2,0,"H",2,0,"H",2.31,3.31,3.41,"2-0","2-0",7,2,10,2,3,2,0,0,9,4,24,10,2,13,34,"9-4","Y","N","N",5,0,6
"2007","SP2",2023-09-17,"Eibar","Ferrol",2,0,"H",1,0,"H",1.82,3.42,5.31,"1-0","2-0",13,6,8,1,0,2,0,0,4,6,10,10,2,10,20,"4-6","Y","N","N",2,0,6
"2008","SP2",2023-09-17,"Elche","Leganes",1,0,"H",1,0,"H",1.85,3.37,5.22,"1-0","1-0",18,5,9,3,5,3,0,0,8,4,14,10,1,12,24,"8-4","N","N","N",8,0,6
"2009","SP2",2023-09-17,"Espanol","Eldense",3,3,"D",0,2,"A",1.49,4.29,7.86,"0-2","3-3",23,5,6,3,3,4,0,1,12,0,14,13,6,12,27,"12-0","Y","Y","Y",7,1,6
"2010","SP2",2023-09-17,"Sp Gijon","Tenerife",2,1,"H",1,1,"D",2.81,2.95,3.01,"1-1","2-1",10,4,8,1,2,5,0,0,6,4,12,16,3,10,28,"6-4","Y","Y","N",7,0,6
"2011","SP2",2023-09-18,"Andorra","Oviedo",1,0,"H",0,0,"D",2.22,3.08,3.85,"0-0","1-0",5,1,6,2,1,4,1,1,4,3,15,16,1,7,31,"4-3","N","N","N",5,2,6
"2012","SP2",2023-09-22,"Cartagena","Eibar",1,2,"A",0,1,"A",3.53,3.19,2.32,"0-1","1-2",7,4,11,5,2,5,1,0,5,6,10,23,3,11,33,"5-6","Y","Y","N",7,1,7
"2013","SP2",2023-09-23,"Andorra","Sp Gijon",0,0,"D",0,0,"D",2.27,2.99,3.94,"0-0","0-0",13,5,6,2,0,1,0,0,4,2,10,10,0,6,20,"4-2","N","N","N",1,0,7
"2014","SP2",2023-09-23,"Levante","Eldense",2,0,"H",1,0,"H",1.83,3.53,5.02,"1-0","2-0",17,7,10,2,1,2,0,0,5,2,11,15,2,7,26,"5-2","Y","N","N",3,0,7
"2015","SP2",2023-09-23,"Burgos","Elche",4,0,"H",2,0,"H",3.15,3.19,2.52,"2-0","4-0",16,9,12,1,3,1,0,0,4,1,11,12,4,5,23,"4-1","Y","Y","Y",4,0,7
"2016","SP2",2023-09-23,"Alcorcon","Huesca",0,2,"A",0,2,"A",2.29,3.1,3.72,"0-2","0-2",19,3,6,2,2,1,0,0,4,2,15,7,2,6,22,"4-2","Y","N","N",3,0,7
"2017","SP2",2023-09-23,"Santander","Albacete",2,1,"H",2,0,"H",2.36,3.26,3.37,"2-0","2-1",8,3,18,4,2,3,0,0,0,6,13,13,3,6,26,"0-6","Y","Y","N",5,0,7
"2018","SP2",2023-09-24,"Villarreal B","Amorebieta",3,1,"H",1,0,"H",2.04,3.56,3.9,"1-0","3-1",19,8,14,4,2,4,0,0,3,6,12,18,4,9,30,"3-6","Y","Y","Y",6,0,7
"2019","SP2",2023-09-24,"Oviedo","Valladolid",0,1,"A",0,0,"D",2.68,2.89,3.24,"0-0","0-1",10,3,16,5,1,3,0,0,6,6,14,13,1,12,27,"6-6","N","N","N",4,0,7
"2020","SP2",2023-09-24,"Mirandes","Leganes",1,3,"A",1,1,"D",2.78,2.83,3.19,"1-1","1-3",12,6,10,5,1,1,0,0,0,4,11,12,4,4,23,"0-4","Y","Y","Y",2,0,7
"2021","SP2",2023-09-25,"Ferrol","Zaragoza",1,0,"H",0,0,"D",2.9,3,2.82,"0-0","1-0",7,3,6,2,1,0,0,0,4,4,7,9,1,8,16,"4-4","N","N","N",1,0,7
"2022","SP2",2023-09-25,"Tenerife","Espanol",1,0,"H",1,0,"H",NA,NA,NA,"1-0","1-0",14,6,18,2,3,3,0,0,6,10,22,9,1,16,31,"6-10","N","N","N",6,0,7
"2023","SP2",2023-09-29,"Leganes","Santander",2,1,"H",1,0,"H",2.44,2.96,3.57,"1-0","2-1",9,4,16,2,4,3,0,0,4,11,14,5,3,15,19,"4-11","Y","Y","N",7,0,8
"2024","SP2",2023-09-30,"Eibar","Tenerife",3,0,"H",0,0,"D",2.06,3.13,4.45,"0-0","3-0",14,5,8,2,3,1,0,0,4,3,16,9,3,7,25,"4-3","Y","Y","N",4,0,8
"2025","SP2",2023-09-30,"Elche","Levante",0,0,"D",0,0,"D",2.47,3.31,3.12,"0-0","0-0",28,4,10,2,1,1,0,0,8,7,8,12,0,15,20,"8-7","N","N","N",2,0,8
"2026","SP2",2023-09-30,"Albacete","Andorra",3,1,"H",2,0,"H",2.25,3.27,3.62,"2-0","3-1",12,7,11,2,2,2,0,0,4,3,12,15,4,7,27,"4-3","Y","Y","Y",4,0,8
"2027","SP2",2023-09-30,"Villarreal B","Alcorcon",2,2,"D",1,2,"A",2.51,3.26,3.1,"1-2","2-2",25,8,10,5,2,3,0,0,7,5,16,13,4,12,29,"7-5","Y","Y","Y",5,0,8
"2028","SP2",2023-10-01,"Eldense","Oviedo",1,3,"A",0,3,"A",2.85,2.95,2.97,"0-3","1-3",10,4,10,4,1,0,0,0,6,4,18,10,4,10,28,"6-4","Y","Y","Y",1,0,8
"2029","SP2",2023-10-01,"Amorebieta","Cartagena",0,0,"D",0,0,"D",2.37,3.28,3.33,"0-0","0-0",5,2,8,1,2,2,0,0,3,2,14,10,0,5,24,"3-2","N","N","N",4,0,8
"2030","SP2",2023-10-01,"Valladolid","Burgos",3,0,"H",2,0,"H",1.79,3.6,5.2,"2-0","3-0",11,6,11,2,2,2,0,0,3,6,14,10,3,9,24,"3-6","Y","Y","N",4,0,8
"2031","SP2",2023-10-01,"Zaragoza","Mirandes",0,1,"A",0,0,"D",1.79,3.56,5.19,"0-0","0-1",8,2,8,0,2,4,1,0,6,2,10,11,1,8,21,"6-2","N","N","N",6,1,8
"2032","SP2",2023-10-01,"Huesca","Sp Gijon",0,1,"A",0,0,"D",2.35,3.05,3.64,"0-0","0-1",6,2,13,6,6,5,0,0,9,8,11,15,1,17,26,"9-8","N","N","N",11,0,8
"2033","SP2",2023-10-02,"Espanol","Ferrol",3,0,"H",1,0,"H",1.63,4.01,5.76,"1-0","3-0",10,3,6,2,2,2,0,1,6,0,22,13,3,6,35,"6-0","Y","Y","N",4,1,8
"2034","SP2",2023-10-03,"Alcorcon","Albacete",1,2,"A",0,1,"A",3.16,3.11,2.57,"0-1","1-2",23,6,9,4,0,6,0,0,6,1,10,11,3,7,21,"6-1","Y","Y","N",6,0,9
"2035","SP2",2023-10-03,"Levante","Villarreal B",1,1,"D",0,0,"D",1.72,3.99,5.06,"0-0","1-1",15,4,7,1,2,2,0,0,8,2,18,9,2,10,27,"8-2","Y","N","N",4,0,9
"2036","SP2",2023-10-03,"Tenerife","Santander",2,0,"H",0,0,"D",1.93,3.34,4.69,"0-0","2-0",21,6,9,3,1,4,0,0,7,4,18,7,2,11,25,"7-4","Y","N","N",5,0,9
"2037","SP2",2023-10-04,"Eldense","Valladolid",0,1,"A",0,1,"A",3.17,3.2,2.5,"0-1","0-1",4,0,8,2,1,4,0,0,3,2,16,18,1,5,34,"3-2","N","N","N",5,0,9
"2038","SP2",2023-10-04,"Oviedo","Huesca",1,0,"H",0,0,"D",1.99,3.15,4.8,"0-0","1-0",9,6,9,3,2,2,0,0,5,4,14,18,1,9,32,"5-4","N","N","N",4,0,9
"2039","SP2",2023-10-04,"Burgos","Leganes",1,0,"H",1,0,"H",2.36,3.01,3.66,"1-0","1-0",5,3,12,2,5,3,0,1,0,8,14,11,1,8,25,"0-8","N","N","N",8,1,9
"2040","SP2",2023-10-04,"Sp Gijon","Elche",2,0,"H",2,0,"H",2.54,3.18,3.12,"2-0","2-0",20,8,10,1,0,0,0,0,6,3,9,15,2,9,24,"6-3","Y","N","N",0,0,9
"2041","SP2",2023-10-05,"Andorra","Zaragoza",0,1,"A",0,1,"A",2.3,3.13,3.67,"0-1","0-1",5,0,5,3,2,4,1,0,4,0,9,16,1,4,25,"4-0","N","N","N",6,1,9
"2042","SP2",2023-10-05,"Mirandes","Eibar",1,3,"A",1,1,"D",3.59,3.1,2.35,"1-1","1-3",7,3,13,3,2,2,0,0,0,6,8,14,4,6,22,"0-6","Y","Y","Y",4,0,9
"2043","SP2",2023-10-05,"Cartagena","Espanol",0,2,"A",0,1,"A",3.81,3.63,2.04,"0-1","0-2",10,1,8,4,4,3,0,0,6,2,17,14,2,8,31,"6-2","Y","N","N",7,0,9
"2044","SP2",2023-10-05,"Ferrol","Amorebieta",1,0,"H",1,0,"H",1.85,3.5,4.75,"1-0","1-0",11,3,4,2,1,1,0,0,5,3,12,9,1,8,21,"5-3","N","N","N",2,0,9
"2045","SP2",2023-10-06,"Albacete","Levante",0,2,"A",0,1,"A",2.2,3.12,3.96,"0-1","0-2",14,4,10,7,0,1,0,0,6,3,11,11,2,9,22,"6-3","Y","N","N",1,0,10
"2046","SP2",2023-10-07,"Huesca","Eldense",0,1,"A",0,0,"D",2.28,3.03,3.87,"0-0","0-1",17,1,15,3,1,6,1,0,4,8,8,17,1,12,25,"4-8","N","N","N",7,1,10
"2047","SP2",2023-10-07,"Santander","Sp Gijon",3,2,"H",1,1,"D",2.33,3.15,3.56,"1-1","3-2",20,7,21,8,4,4,0,0,5,7,13,7,5,12,20,"5-7","Y","Y","Y",8,0,10
"2048","SP2",2023-10-07,"Leganes","Oviedo",0,0,"D",0,0,"D",2.48,2.85,3.67,"0-0","0-0",9,3,6,2,3,1,0,0,1,4,11,13,0,5,24,"1-4","N","N","N",4,0,10
"2049","SP2",2023-10-08,"Amorebieta","Eibar",1,2,"A",1,1,"D",4.27,3.27,2.05,"1-1","1-2",10,7,12,7,3,1,0,0,5,5,12,12,3,10,24,"5-5","Y","Y","N",4,0,10
"2050","SP2",2023-10-08,"Valladolid","Mirandes",3,2,"H",0,0,"D",1.65,3.83,6.14,"0-0","3-2",23,9,6,3,2,3,0,0,7,1,10,11,5,8,21,"7-1","Y","Y","Y",5,0,10
"2051","SP2",2023-10-08,"Ferrol","Cartagena",1,1,"D",0,1,"A",1.97,3.4,4.41,"0-1","1-1",12,5,11,4,0,5,0,0,4,6,11,19,2,10,30,"4-6","Y","N","N",5,0,10
"2052","SP2",2023-10-08,"Tenerife","Burgos",2,1,"H",0,0,"D",1.84,3.29,5.45,"0-0","2-1",8,2,14,6,3,4,1,0,4,6,12,15,3,10,27,"4-6","Y","Y","N",7,1,10
"2053","SP2",2023-10-08,"Zaragoza","Alcorcon",0,2,"A",0,1,"A",1.87,3.4,4.97,"0-1","0-2",15,5,11,2,5,4,0,0,7,1,12,18,2,8,30,"7-1","Y","N","N",9,0,10
"2054","SP2",2023-10-09,"Elche","Andorra",2,1,"H",1,0,"H",1.94,3.54,4.22,"1-0","2-1",24,9,4,1,0,0,0,0,10,4,13,15,3,14,28,"10-4","Y","Y","N",0,0,10
"2055","SP2",2023-10-09,"Villarreal B","Espanol",3,1,"H",2,1,"H",4.38,3.84,1.83,"2-1","3-1",17,7,16,4,1,4,0,0,7,9,17,12,4,16,29,"7-9","Y","Y","Y",5,0,10
"2056","SP2",2023-10-13,"Oviedo","Albacete",3,0,"H",0,0,"D",2.52,3.02,3.35,"0-0","3-0",9,3,12,2,1,4,0,1,6,2,10,14,3,8,24,"6-2","Y","Y","N",5,1,11
"2057","SP2",2023-10-14,"Mirandes","Tenerife",1,1,"D",1,1,"D",3.33,2.94,2.58,"1-1","1-1",9,3,9,4,3,3,0,0,5,2,10,14,2,7,24,"5-2","Y","N","N",6,0,11
"2058","SP2",2023-10-14,"Cartagena","Santander",2,3,"A",2,2,"D",2.43,3.12,3.37,"2-2","2-3",22,6,20,10,2,4,0,0,6,4,10,18,5,10,28,"6-4","Y","Y","Y",6,0,11
"2059","SP2",2023-10-14,"Sp Gijon","Zaragoza",2,2,"D",0,1,"A",2.25,3,4,"0-1","2-2",13,4,13,3,3,2,0,0,5,3,12,10,4,8,22,"5-3","Y","Y","Y",5,0,11
"2060","SP2",2023-10-14,"Espanol","Valladolid",2,0,"H",2,0,"H",1.99,3.58,4.04,"2-0","2-0",5,3,11,3,3,3,0,0,0,5,15,14,2,5,29,"0-5","Y","N","N",6,0,11
"2061","SP2",2023-10-15,"Burgos","Villarreal B",3,2,"H",0,0,"D",2.06,3.36,4.06,"0-0","3-2",11,4,12,3,0,4,0,0,9,2,13,8,5,11,21,"9-2","Y","Y","Y",4,0,11
"2062","SP2",2023-10-15,"Andorra","Alcorcon",2,0,"H",0,0,"D",2.15,3.09,4.17,"0-0","2-0",12,3,12,3,0,1,0,0,3,2,6,15,2,5,21,"3-2","Y","N","N",1,0,11
"2063","SP2",2023-10-15,"Eldense","Elche",1,1,"D",1,0,"H",3.46,3.27,2.31,"1-0","1-1",9,2,6,2,4,3,0,0,6,5,20,16,2,11,36,"6-5","Y","N","N",7,0,11
"2064","SP2",2023-10-15,"Eibar","Huesca",1,1,"D",0,1,"A",1.54,3.92,7.94,"0-1","1-1",14,2,5,2,1,3,0,0,6,1,8,14,2,7,22,"6-1","Y","N","N",4,0,11
"2065","SP2",2023-10-15,"Leganes","Amorebieta",6,0,"H",2,0,"H",1.96,3.25,4.73,"2-0","6-0",17,10,8,1,1,2,0,0,2,5,13,11,6,7,24,"2-5","Y","Y","Y",3,0,11
"2066","SP2",2023-10-16,"Levante","Ferrol",1,0,"H",0,0,"D",1.83,3.64,4.62,"0-0","1-0",9,4,13,1,4,1,0,0,3,3,13,11,1,6,24,"3-3","N","N","N",5,0,11
"2067","SP2",2023-10-20,"Espanol","Leganes",0,1,"A",0,0,"D",1.72,3.76,5.42,"0-0","0-1",12,3,13,4,2,4,0,0,4,1,12,13,1,5,25,"4-1","N","N","N",6,0,12
"2068","SP2",2023-10-21,"Amorebieta","Oviedo",0,0,"D",0,0,"D",3.44,2.98,2.49,"0-0","0-0",9,1,15,2,3,4,1,0,2,6,17,7,0,8,24,"2-6","N","N","N",7,1,12
"2069","SP2",2023-10-21,"Villarreal B","Mirandes",0,3,"A",0,1,"A",2.14,3.64,3.5,"0-1","0-3",15,3,7,3,1,1,0,0,8,1,8,13,3,9,21,"8-1","Y","Y","N",2,0,12
"2070","SP2",2023-10-21,"Tenerife","Levante",0,0,"D",0,0,"D",2.13,3.17,4.09,"0-0","0-0",17,4,8,1,3,2,0,0,3,3,14,13,0,6,27,"3-3","N","N","N",5,0,12
"2071","SP2",2023-10-21,"Zaragoza","Eibar",2,3,"A",2,0,"H",2.82,3.02,2.92,"2-0","2-3",13,5,10,6,4,3,0,0,3,5,9,14,5,8,23,"3-5","Y","Y","Y",7,0,12
"2072","SP2",2023-10-22,"Ferrol","Eldense",1,1,"D",0,0,"D",1.9,3.33,4.9,"0-0","1-1",14,3,11,3,0,2,0,0,8,4,12,16,2,12,28,"8-4","Y","N","N",2,0,12
"2073","SP2",2023-10-22,"Huesca","Elche",0,1,"A",0,1,"A",3.39,3.1,2.44,"0-1","0-1",7,1,4,3,3,3,0,0,4,1,16,20,1,5,36,"4-1","N","N","N",6,0,12
"2074","SP2",2023-10-22,"Albacete","Sp Gijon",1,3,"A",0,1,"A",2.21,3.28,3.69,"0-1","1-3",25,6,8,4,3,3,0,0,11,0,10,11,4,11,21,"11-0","Y","Y","Y",6,0,12
"2075","SP2",2023-10-22,"Santander","Burgos",3,0,"H",1,0,"H",2.31,3.22,3.53,"1-0","3-0",17,5,12,2,1,3,0,0,4,4,8,11,3,8,19,"4-4","Y","Y","N",4,0,12
"2076","SP2",2023-10-22,"Valladolid","Andorra",2,0,"H",2,0,"H",1.77,3.73,5.11,"2-0","2-0",10,4,16,4,5,2,0,0,6,6,16,10,2,12,26,"6-6","Y","N","N",7,0,12
"2077","SP2",2023-10-23,"Alcorcon","Cartagena",1,1,"D",1,0,"H",2.28,3.28,3.44,"1-0","1-1",18,2,16,6,1,3,0,0,6,7,7,9,2,13,16,"6-7","Y","N","N",4,0,12
"2078","SP2",2023-10-27,"Eibar","Valladolid",5,1,"H",2,0,"H",2.09,3.16,4.27,"2-0","5-1",23,13,10,2,1,0,0,0,2,1,13,12,6,3,25,"2-1","Y","Y","Y",1,0,13
"2079","SP2",2023-10-28,"Eldense","Amorebieta",2,0,"H",1,0,"H",2.04,3.36,4.17,"1-0","2-0",12,4,11,3,1,2,0,0,2,7,13,14,2,9,27,"2-7","Y","N","N",3,0,13
"2080","SP2",2023-10-28,"Andorra","Levante",2,0,"H",0,0,"D",2.73,3.12,2.93,"0-0","2-0",21,10,7,1,2,3,0,0,7,6,11,8,2,13,19,"7-6","Y","N","N",5,0,13
"2081","SP2",2023-10-28,"Sp Gijon","Espanol",2,0,"H",1,0,"H",2.56,3.29,3,"1-0","2-0",9,3,17,4,6,3,0,0,4,7,13,8,2,11,21,"4-7","Y","N","N",9,0,13
"2082","SP2",2023-10-28,"Elche","Tenerife",2,1,"H",0,0,"D",2.21,3.13,3.9,"0-0","2-1",9,4,8,1,0,6,0,0,4,4,11,16,3,8,27,"4-4","Y","Y","N",6,0,13
"2083","SP2",2023-10-29,"Mirandes","Cartagena",2,1,"H",0,0,"D",2.37,3.37,3.23,"0-0","2-1",13,4,14,5,0,3,0,0,4,5,9,14,3,9,23,"4-5","Y","Y","N",3,0,13
"2084","SP2",2023-10-29,"Huesca","Albacete",0,0,"D",0,0,"D",2.96,2.96,2.85,"0-0","0-0",8,1,8,5,1,1,0,0,6,1,11,13,0,7,24,"6-1","N","N","N",2,0,13
"2085","SP2",2023-10-29,"Leganes","Villarreal B",1,0,"H",0,0,"D",1.76,3.86,4.94,"0-0","1-0",10,5,8,3,2,2,0,1,7,0,11,16,1,7,27,"7-0","N","N","N",4,1,13
"2086","SP2",2023-10-29,"Oviedo","Alcorcon",2,0,"H",1,0,"H",1.97,3.31,4.58,"1-0","2-0",12,4,6,3,1,5,0,0,6,2,9,14,2,8,23,"6-2","Y","N","N",6,0,13
"2087","SP2",2023-10-29,"Santander","Ferrol",1,3,"A",1,2,"A",2.23,3.14,3.83,"1-2","1-3",11,5,17,8,1,5,0,0,5,4,12,22,4,9,34,"5-4","Y","Y","Y",6,0,13
"2088","SP2",2023-10-30,"Burgos","Zaragoza",1,1,"D",0,1,"A",2.55,2.99,3.26,"0-1","1-1",10,2,8,5,2,2,0,0,4,1,17,16,2,5,33,"4-1","Y","N","N",4,0,13
"2089","SP2",2023-11-03,"Espanol","Eibar",2,2,"D",1,1,"D",2.42,3.26,3.25,"1-1","2-2",13,5,13,4,1,1,0,0,4,4,9,7,4,8,16,"4-4","Y","Y","Y",2,0,14
"2090","SP2",2023-11-04,"Villarreal B","Sp Gijon",0,3,"A",0,1,"A",2.82,3.41,2.63,"0-1","0-3",22,6,10,6,0,0,0,0,9,4,15,9,3,13,24,"9-4","Y","Y","N",0,0,14
"2091","SP2",2023-11-04,"Levante","Mirandes",2,2,"D",1,1,"D",1.83,3.7,4.7,"1-1","2-2",10,5,10,4,4,3,2,0,2,6,19,11,4,8,30,"2-6","Y","Y","Y",7,2,14
"2092","SP2",2023-11-04,"Valladolid","Tenerife",2,0,"H",0,0,"D",1.99,3.27,4.53,"0-0","2-0",16,6,6,1,1,3,0,0,9,4,10,13,2,13,23,"9-4","Y","N","N",4,0,14
"2093","SP2",2023-11-04,"Albacete","Elche",1,1,"D",0,0,"D",2.28,3.38,3.4,"0-0","1-1",14,5,5,3,4,6,0,1,6,3,17,17,2,9,34,"6-3","Y","N","N",10,1,14
"2094","SP2",2023-11-05,"Ferrol","Andorra",1,0,"H",1,0,"H",2.37,3.2,3.42,"1-0","1-0",11,4,12,5,4,3,0,0,3,3,19,18,1,6,37,"3-3","N","N","N",7,0,14
"2095","SP2",2023-11-05,"Amorebieta","Huesca",0,1,"A",0,0,"D",2.59,2.94,3.32,"0-0","0-1",7,0,8,3,3,2,1,0,2,4,13,12,1,6,25,"2-4","N","N","N",5,1,14
"2096","SP2",2023-11-05,"Alcorcon","Santander",3,1,"H",1,0,"H",2.27,3.35,3.45,"1-0","3-1",17,6,10,3,3,1,0,0,3,3,18,7,4,6,25,"3-3","Y","Y","Y",4,0,14
"2097","SP2",2023-11-05,"Cartagena","Leganes",0,3,"A",0,0,"D",2.72,3.25,2.84,"0-0","0-3",11,1,8,5,1,2,0,0,3,5,15,10,3,8,25,"3-5","Y","Y","N",3,0,14
"2098","SP2",2023-11-05,"Eldense","Burgos",2,0,"H",1,0,"H",2.42,2.97,3.6,"1-0","2-0",15,5,9,2,2,2,0,0,7,7,11,8,2,14,19,"7-7","Y","N","N",4,0,14
"2099","SP2",2023-11-06,"Zaragoza","Oviedo",0,0,"D",0,0,"D",2.52,2.92,3.4,"0-0","0-0",19,5,13,2,1,1,0,0,7,4,17,13,0,11,30,"7-4","N","N","N",2,0,14
"2100","SP2",2023-11-10,"Leganes","Levante",2,1,"H",0,1,"A",2.01,3.24,4.47,"0-1","2-1",10,5,9,3,2,1,0,0,8,7,20,8,3,15,28,"8-7","Y","Y","N",3,0,15
"2101","SP2",2023-11-11,"Santander","Valladolid",2,3,"A",0,1,"A",2.63,3.28,2.92,"0-1","2-3",14,6,19,9,0,2,0,0,3,3,13,11,5,6,24,"3-3","Y","Y","Y",2,0,15
"2102","SP2",2023-11-11,"Elche","Zaragoza",2,0,"H",0,0,"D",1.96,3.4,4.44,"0-0","2-0",13,4,8,3,4,2,0,0,7,5,18,12,2,12,30,"7-5","Y","N","N",6,0,15
"2103","SP2",2023-11-11,"Mirandes","Ferrol",1,2,"A",0,2,"A",2.53,3.04,3.3,"0-2","1-2",17,7,10,3,1,1,0,0,6,2,4,12,3,8,16,"6-2","Y","Y","N",2,0,15
"2104","SP2",2023-11-11,"Sp Gijon","Amorebieta",1,1,"D",0,0,"D",1.42,4.6,9.06,"0-0","1-1",16,8,10,4,1,5,0,0,4,3,12,8,2,7,20,"4-3","Y","N","N",6,0,15
"2105","SP2",2023-11-12,"Burgos","Alcorcon",4,2,"H",0,2,"A",2.14,3.16,4.1,"0-2","4-2",15,7,9,3,1,0,0,0,5,2,14,7,6,7,21,"5-2","Y","Y","Y",1,0,15
"2106","SP2",2023-11-12,"Andorra","Eldense",1,3,"A",1,1,"D",1.87,3.59,4.64,"1-1","1-3",23,6,9,5,2,3,0,0,8,1,9,12,4,9,21,"8-1","Y","Y","Y",5,0,15
"2107","SP2",2023-11-12,"Huesca","Espanol",1,1,"D",0,0,"D",3.88,3.21,2.18,"0-0","1-1",19,5,6,1,2,4,0,0,7,1,8,18,2,8,26,"7-1","Y","N","N",6,0,15
"2108","SP2",2023-11-12,"Tenerife","Villarreal B",0,1,"A",0,1,"A",1.63,3.96,5.93,"0-1","0-1",20,5,13,6,3,5,0,1,8,4,15,14,1,12,29,"8-4","N","N","N",8,1,15
"2109","SP2",2023-11-12,"Eibar","Albacete",1,1,"D",1,0,"H",1.89,3.36,4.92,"1-0","1-1",12,6,16,6,1,1,0,0,3,7,15,15,2,10,30,"3-7","Y","N","N",2,0,15
"2110","SP2",2023-11-13,"Oviedo","Cartagena",1,1,"D",0,1,"A",1.78,3.39,5.56,"0-1","1-1",18,3,2,1,4,8,0,0,4,2,11,15,2,6,26,"4-2","Y","N","N",12,0,15
"2111","SP2",2023-11-17,"Valladolid","Leganes",1,1,"D",1,0,"H",2.25,2.95,4.09,"1-0","1-1",21,3,11,3,1,3,0,0,3,6,13,12,2,9,25,"3-6","Y","N","N",4,0,16
"2112","SP2",2023-11-18,"Alcorcon","Sp Gijon",0,0,"D",0,0,"D",3.33,3.17,2.43,"0-0","0-0",15,2,16,2,2,2,0,0,5,7,14,10,0,12,24,"5-7","N","N","N",4,0,16
"2113","SP2",2023-11-18,"Amorebieta","Tenerife",2,0,"H",1,0,"H",3.75,3.15,2.25,"1-0","2-0",5,3,23,6,1,4,1,1,3,14,8,9,2,17,17,"3-14","Y","N","N",5,2,16
"2114","SP2",2023-11-18,"Zaragoza","Huesca",0,2,"A",0,1,"A",2.06,3.01,4.71,"0-1","0-2",11,3,7,3,2,3,0,0,9,4,16,21,2,13,37,"9-4","Y","N","N",5,0,16
"2115","SP2",2023-11-18,"Espanol","Elche",2,0,"H",2,0,"H",2.12,3.44,3.76,"2-0","2-0",12,5,15,3,3,2,0,0,8,5,25,11,2,13,36,"8-5","Y","N","N",5,0,16
"2116","SP2",2023-11-19,"Ferrol","Burgos",1,1,"D",0,0,"D",2.13,3.09,3.79,"0-0","1-1",13,5,9,2,1,5,0,0,3,4,13,11,2,7,24,"3-4","Y","N","N",6,0,16
"2117","SP2",2023-11-19,"Eldense","Mirandes",2,2,"D",1,1,"D",2.2,3.19,3.48,"1-1","2-2",20,6,7,3,1,1,0,0,7,1,21,14,4,8,35,"7-1","Y","Y","Y",2,0,16
"2118","SP2",2023-11-19,"Oviedo","Eibar",2,1,"H",0,1,"A",3.17,2.84,2.58,"0-1","2-1",9,3,7,2,4,3,0,0,4,4,11,15,3,8,26,"4-4","Y","Y","N",7,0,16
"2119","SP2",2023-11-19,"Cartagena","Albacete",1,1,"D",1,0,"H",2.82,3.19,2.59,"1-0","1-1",9,2,18,2,1,2,0,0,2,9,9,20,2,11,29,"2-9","Y","N","N",3,0,16
"2120","SP2",2023-11-19,"Villarreal B","Andorra",0,0,"D",0,0,"D",2.54,3.46,2.9,"0-0","0-0",12,2,15,5,2,1,0,0,2,7,12,7,0,9,19,"2-7","N","N","N",3,0,16
"2121","SP2",2023-11-20,"Levante","Santander",2,4,"A",2,1,"H",2.02,3.36,3.71,"2-1","2-4",26,5,9,5,2,1,0,0,8,5,15,11,6,13,26,"8-5","Y","Y","Y",3,0,16
"2122","SP2",2023-11-24,"Huesca","Valladolid",0,1,"A",0,0,"D",3.34,2.93,2.59,"0-0","0-1",10,2,11,5,4,4,0,0,3,4,12,15,1,7,27,"3-4","N","N","N",8,0,17
"2123","SP2",2023-11-25,"Burgos","Andorra",0,0,"D",0,0,"D",2.21,3.29,3.68,"0-0","0-0",11,2,7,1,1,1,0,0,3,3,7,13,0,6,20,"3-3","N","N","N",2,0,17
"2124","SP2",2023-11-25,"Santander","Villarreal B",2,0,"H",1,0,"H",1.75,4.03,4.77,"1-0","2-0",10,4,7,0,3,4,0,0,4,3,17,20,2,7,37,"4-3","Y","N","N",7,0,17
"2125","SP2",2023-11-25,"Albacete","Zaragoza",1,0,"H",0,0,"D",1.92,3.41,4.68,"0-0","1-0",18,5,5,2,2,2,0,0,4,5,19,5,1,9,24,"4-5","N","N","N",4,0,17
"2126","SP2",2023-11-25,"Eibar","Levante",3,1,"H",1,1,"D",1.72,3.81,5.23,"1-1","3-1",20,7,12,7,3,1,0,0,10,3,12,12,4,13,24,"10-3","Y","Y","Y",4,0,17
"2127","SP2",2023-11-26,"Leganes","Ferrol",2,2,"D",2,2,"D",1.99,3.21,4.67,"2-2","2-2",22,5,3,3,1,2,0,1,5,2,13,4,4,7,17,"5-2","Y","Y","Y",3,1,17
"2128","SP2",2023-11-26,"Elche","Amorebieta",2,0,"H",0,0,"D",1.43,4.47,9.03,"0-0","2-0",11,4,11,4,2,2,0,0,4,9,11,18,2,13,29,"4-9","Y","N","N",4,0,17
"2129","SP2",2023-11-26,"Mirandes","Oviedo",2,1,"H",1,0,"H",3.33,2.98,2.55,"1-0","2-1",10,6,8,2,3,3,0,0,5,2,7,15,3,7,22,"5-2","Y","Y","N",6,0,17
"2130","SP2",2023-11-26,"Tenerife","Cartagena",1,1,"D",0,1,"A",1.88,3.32,5.04,"0-1","1-1",15,5,7,3,3,4,0,0,6,1,14,12,2,7,26,"6-1","Y","N","N",7,0,17
"2131","SP2",2023-11-26,"Espanol","Alcorcon",2,0,"H",1,0,"H",1.48,4.55,7.34,"1-0","2-0",24,9,6,2,2,2,0,1,8,2,16,11,2,10,27,"8-2","Y","N","N",4,1,17
"2132","SP2",2023-11-27,"Sp Gijon","Eldense",2,0,"H",1,0,"H",1.67,3.82,5.73,"1-0","2-0",17,7,13,3,1,2,0,0,5,2,13,16,2,7,29,"5-2","Y","N","N",3,0,17
"2133","SP2",2023-12-01,"Oviedo","Espanol",2,0,"H",1,0,"H",2.83,2.84,3.11,"1-0","2-0",16,5,7,2,5,3,0,0,7,4,16,24,2,11,40,"7-4","Y","N","N",8,0,18
"2134","SP2",2023-12-02,"Cartagena","Sp Gijon",1,0,"H",0,0,"D",3.19,3.09,2.39,"0-0","1-0",19,10,6,1,1,3,0,0,6,3,11,11,1,9,22,"6-3","N","N","N",4,0,18
"2135","SP2",2023-12-02,"Eldense","Tenerife",0,3,"A",0,1,"A",2.51,2.95,3.15,"0-1","0-3",13,1,4,3,1,1,0,0,9,1,14,14,3,10,28,"9-1","Y","Y","N",2,0,18
"2136","SP2",2023-12-02,"Zaragoza","Leganes",1,0,"H",1,0,"H",2.72,2.86,2.98,"1-0","1-0",10,2,5,0,2,1,0,0,4,4,17,11,1,8,28,"4-4","N","N","N",3,0,18
"2137","SP2",2023-12-02,"Levante","Valladolid",2,1,"H",2,1,"H",2.59,3.19,3.05,"2-1","2-1",19,7,11,3,4,3,0,0,12,6,16,13,3,18,29,"12-6","Y","Y","N",7,0,18
"2138","SP2",2023-12-03,"Andorra","Huesca",1,0,"H",0,0,"D",2.16,3.07,4.17,"0-0","1-0",8,4,8,1,2,2,0,0,6,3,11,12,1,9,23,"6-3","N","N","N",4,0,18
"2139","SP2",2023-12-03,"Alcorcon","Elche",0,2,"A",0,1,"A",3.21,3.1,2.54,"0-1","0-2",10,2,22,9,3,1,1,0,4,4,12,11,2,8,23,"4-4","Y","N","N",4,1,18
"2140","SP2",2023-12-03,"Ferrol","Albacete",5,4,"H",1,1,"D",2.51,2.94,3.17,"1-1","5-4",17,6,18,7,2,3,0,1,2,5,12,16,9,7,28,"2-5","Y","Y","Y",5,1,18
"2141","SP2",2023-12-03,"Mirandes","Santander",0,0,"D",0,0,"D",2.53,3.33,3.02,"0-0","0-0",13,5,12,3,4,4,0,0,9,10,14,17,0,19,31,"9-10","N","N","N",8,0,18
"2142","SP2",2023-12-03,"Amorebieta","Burgos",0,1,"A",0,1,"A",2.73,2.96,2.86,"0-1","0-1",14,3,6,4,2,0,0,0,7,6,10,7,1,13,17,"7-6","N","N","N",2,0,18
"2143","SP2",2023-12-04,"Villarreal B","Eibar",1,0,"H",0,0,"D",3.86,3.69,1.98,"0-0","1-0",26,8,6,0,1,0,0,1,9,0,10,6,1,9,16,"9-0","N","N","N",1,1,18
"2144","SP2",2023-12-08,"Albacete","Villarreal B",2,0,"H",0,0,"D",1.54,4.27,6.68,"0-0","2-0",18,5,7,1,2,2,0,0,4,0,10,9,2,4,19,"4-0","Y","N","N",4,0,19
"2145","SP2",2023-12-08,"Espanol","Zaragoza",1,1,"D",0,0,"D",1.84,3.55,4.89,"0-0","1-1",8,1,10,2,2,3,1,0,4,6,15,17,2,10,32,"4-6","Y","N","N",5,1,19
"2146","SP2",2023-12-09,"Valladolid","Amorebieta",2,1,"H",0,1,"A",1.41,4.75,8.89,"0-1","2-1",12,6,7,3,1,3,0,0,4,4,7,18,3,8,25,"4-4","Y","Y","N",4,0,19
"2147","SP2",2023-12-09,"Sp Gijon","Levante",0,0,"D",0,0,"D",1.98,3.53,4.15,"0-0","0-0",12,3,8,2,7,4,1,0,5,3,9,14,0,8,23,"5-3","N","N","N",11,1,19
"2148","SP2",2023-12-09,"Burgos","Mirandes",0,0,"D",0,0,"D",2.15,3.2,4.01,"0-0","0-0",11,2,5,1,3,4,0,0,3,8,10,10,0,11,20,"3-8","N","N","N",7,0,19
"2149","SP2",2023-12-10,"Elche","Cartagena",1,2,"A",1,0,"H",1.74,3.7,5.38,"1-0","1-2",12,2,7,4,3,4,0,0,8,5,10,18,3,13,28,"8-5","Y","Y","N",7,0,19
"2150","SP2",2023-12-10,"Santander","Oviedo",2,2,"D",1,2,"A",2.5,3.1,3.29,"1-2","2-2",10,5,16,3,4,3,0,0,6,8,18,14,4,14,32,"6-8","Y","Y","Y",7,0,19
"2151","SP2",2023-12-10,"Eibar","Andorra",2,2,"D",2,1,"H",1.75,3.69,5.34,"2-1","2-2",15,4,16,5,5,3,1,0,5,1,14,13,4,6,27,"5-1","Y","Y","Y",8,1,19
"2152","SP2",2023-12-10,"Leganes","Eldense",1,1,"D",1,1,"D",1.87,3.38,5.01,"1-1","1-1",12,3,6,1,4,3,0,0,8,2,16,22,2,10,38,"8-2","Y","N","N",7,0,19
"2153","SP2",2023-12-10,"Huesca","Ferrol",1,0,"H",1,0,"H",2.34,2.99,3.74,"1-0","1-0",11,5,11,0,1,3,0,0,3,4,10,14,1,7,24,"3-4","N","N","N",4,0,19
"2154","SP2",2023-12-11,"Tenerife","Alcorcon",1,0,"H",0,0,"D",1.66,3.63,6.27,"0-0","1-0",14,5,11,2,1,5,0,0,3,3,13,19,1,6,32,"3-3","N","N","N",6,0,19
"2155","SP2",2023-12-15,"Oviedo","Elche",3,2,"H",1,2,"A",2.27,3.01,3.92,"1-2","3-2",11,6,18,5,2,4,0,0,5,2,11,16,5,7,27,"5-2","Y","Y","Y",6,0,20
"2156","SP2",2023-12-16,"Eldense","Santander",3,3,"D",0,2,"A",2.36,3.22,3.12,"0-2","3-3",13,6,8,4,2,2,0,0,8,3,11,7,6,11,18,"8-3","Y","Y","Y",4,0,20
"2157","SP2",2023-12-16,"Andorra","Espanol",1,1,"D",0,0,"D",3.21,3.13,2.52,"0-0","1-1",14,3,6,1,1,4,0,0,6,2,10,19,2,8,29,"6-2","Y","N","N",5,0,20
"2158","SP2",2023-12-16,"Cartagena","Burgos",0,3,"A",0,1,"A",2.37,3.03,3.31,"0-1","0-3",9,1,10,5,5,1,0,0,2,2,14,9,3,4,23,"2-2","Y","Y","N",6,0,20
"2159","SP2",2023-12-16,"Sp Gijon","Leganes",1,1,"D",0,1,"A",2.14,2.96,3.99,"0-1","1-1",17,3,8,2,3,3,0,0,9,4,13,8,2,13,21,"9-4","Y","N","N",6,0,20
"2160","SP2",2023-12-16,"Mirandes","Albacete",2,0,"H",1,0,"H",3.46,3.29,2.3,"1-0","2-0",12,3,11,3,2,2,0,0,2,7,9,15,2,9,24,"2-7","Y","N","N",4,0,20
"2161","SP2",2023-12-17,"Alcorcon","Eibar",1,0,"H",1,0,"H",4.04,3.35,2.07,"1-0","1-0",6,3,18,7,1,2,0,0,2,13,18,9,1,15,27,"2-13","N","N","N",3,0,20
"2162","SP2",2023-12-17,"Levante","Huesca",2,1,"H",2,0,"H",2.14,3.18,4.05,"2-0","2-1",12,6,5,1,2,3,0,1,10,0,21,14,3,10,35,"10-0","Y","Y","N",5,1,20
"2163","SP2",2023-12-17,"Amorebieta","Zaragoza",1,1,"D",1,1,"D",3.69,2.98,2.38,"1-1","1-1",18,7,10,6,5,1,0,0,3,7,9,12,2,10,21,"3-7","Y","N","N",6,0,20
"2164","SP2",2023-12-17,"Ferrol","Tenerife",3,1,"H",1,0,"H",2.46,2.92,3.59,"1-0","3-1",18,7,5,2,2,2,0,0,8,0,9,9,4,8,18,"8-0","Y","Y","Y",4,0,20
"2165","SP2",2023-12-18,"Villarreal B","Valladolid",1,0,"H",1,0,"H",3.61,3.45,2.14,"1-0","1-0",11,3,17,5,1,4,0,0,3,5,20,10,1,8,30,"3-5","N","N","N",5,0,20
"2166","SP2",2023-12-19,"Albacete","Eldense",1,1,"D",0,0,"D",1.63,3.81,6.51,"0-0","1-1",9,1,12,2,1,4,0,1,5,3,12,15,2,8,27,"5-3","Y","N","N",5,1,21
"2167","SP2",2023-12-19,"Santander","Andorra",2,0,"H",1,0,"H",2.44,3.21,3.27,"1-0","2-0",17,12,9,3,5,4,0,1,6,4,16,14,2,10,30,"6-4","Y","N","N",9,1,21
"2168","SP2",2023-12-19,"Elche","Mirandes",0,0,"D",0,0,"D",1.82,3.63,4.87,"0-0","0-0",17,1,4,0,2,3,0,0,6,1,13,12,0,7,25,"6-1","N","N","N",5,0,21
"2169","SP2",2023-12-19,"Espanol","Burgos",3,3,"D",1,2,"A",1.73,3.65,5.61,"1-2","3-3",14,7,12,6,3,2,0,0,6,6,8,12,6,12,20,"6-6","Y","Y","Y",5,0,21
"2170","SP2",2023-12-20,"Zaragoza","Levante",2,2,"D",2,0,"H",2.25,3.14,3.77,"2-0","2-2",16,4,9,5,2,2,0,0,5,2,12,9,4,7,21,"5-2","Y","Y","Y",4,0,21
"2171","SP2",2023-12-20,"Eibar","Sp Gijon",1,1,"D",0,1,"A",1.93,3.43,4.58,"0-1","1-1",15,4,7,4,3,3,0,0,6,3,8,8,2,9,16,"6-3","Y","N","N",6,0,21
"2172","SP2",2023-12-20,"Leganes","Tenerife",1,1,"D",0,0,"D",2.38,2.93,3.76,"0-0","1-1",5,3,6,3,2,3,0,0,5,5,12,12,2,10,24,"5-5","Y","N","N",5,0,21
"2173","SP2",2023-12-21,"Huesca","Cartagena",3,0,"H",3,0,"H",2.21,3.08,3.98,"3-0","3-0",7,6,12,4,0,1,0,0,4,8,11,9,3,12,20,"4-8","Y","Y","N",1,0,21
"2174","SP2",2023-12-21,"Villarreal B","Oviedo",1,1,"D",1,0,"H",3.1,3.12,2.6,"1-0","1-1",15,6,12,2,1,4,0,1,1,7,16,16,2,8,32,"1-7","Y","N","N",5,1,21
"2175","SP2",2023-12-21,"Amorebieta","Alcorcon",1,2,"A",1,1,"D",2.21,3.18,3.84,"1-1","1-2",7,2,12,5,3,4,0,0,9,3,12,19,3,12,31,"9-3","Y","Y","N",7,0,21
"2176","SP2",2023-12-21,"Valladolid","Ferrol",0,1,"A",0,1,"A",2.06,3.33,4.11,"0-1","0-1",15,3,10,2,1,3,0,0,7,4,12,12,1,11,24,"7-4","N","N","N",4,0,21
"2177","SP2",2024-01-12,"Eibar","Santander",2,0,"H",1,0,"H",1.74,3.87,5.04,"1-0","2-0",14,6,9,2,2,1,0,0,2,6,18,14,2,8,32,"2-6","Y","N","N",3,0,22
"2178","SP2",2024-01-13,"Alcorcon","Mirandes",0,0,"D",0,0,"D",2.72,3.12,2.95,"0-0","0-0",14,2,12,2,0,1,0,0,3,3,10,7,0,6,17,"3-3","N","N","N",1,0,22
"2179","SP2",2024-01-13,"Levante","Albacete",3,2,"H",2,0,"H",2.48,3.21,3.2,"2-0","3-2",13,8,11,4,1,0,0,0,5,3,19,18,5,8,37,"5-3","Y","Y","Y",1,0,22
"2180","SP2",2024-01-13,"Oviedo","Amorebieta",1,1,"D",1,1,"D",1.62,3.77,6.79,"1-1","1-1",15,3,14,4,0,1,0,0,10,5,9,11,2,15,20,"10-5","Y","N","N",1,0,22
"2181","SP2",2024-01-13,"Tenerife","Elche",0,1,"A",0,1,"A",2.29,2.96,3.92,"0-1","0-1",10,2,7,3,4,2,0,0,4,2,12,15,1,6,27,"4-2","N","N","N",6,0,22
"2182","SP2",2024-01-13,"Burgos","Valladolid",1,0,"H",1,0,"H",2.7,3.1,3,"1-0","1-0",7,2,20,2,5,2,0,0,5,9,13,10,1,14,23,"5-9","N","N","N",7,0,22
"2183","SP2",2024-01-13,"Ferrol","Espanol",0,0,"D",0,0,"D",2.55,3.22,3.08,"0-0","0-0",6,1,8,1,2,3,0,0,5,8,11,14,0,13,25,"5-8","N","N","N",5,0,22
"2184","SP2",2024-01-14,"Andorra","Leganes",2,3,"A",0,0,"D",2.54,3.02,3.31,"0-0","2-3",18,6,6,4,4,1,0,0,6,1,10,13,5,7,23,"6-1","Y","Y","Y",5,0,22
"2185","SP2",2024-01-14,"Cartagena","Villarreal B",4,1,"H",0,1,"A",2.21,3.36,3.59,"0-1","4-1",19,6,11,2,3,2,0,0,10,6,14,12,5,16,26,"10-6","Y","Y","Y",5,0,22
"2186","SP2",2024-01-14,"Sp Gijon","Huesca",0,0,"D",0,0,"D",1.93,3.09,5.28,"0-0","0-0",11,2,9,4,2,2,0,0,7,1,9,11,0,8,20,"7-1","N","N","N",4,0,22
"2187","SP2",2024-01-15,"Eldense","Zaragoza",1,1,"D",1,1,"D",2.65,2.9,3.21,"1-1","1-1",14,4,4,2,3,4,0,0,10,1,13,9,2,11,22,"10-1","Y","N","N",7,0,22
"2188","SP2",2024-01-20,"Albacete","Alcorcon",0,1,"A",0,0,"D",1.58,4.11,6.49,"0-0","0-1",16,2,15,3,2,4,0,0,3,2,19,12,1,5,31,"3-2","N","N","N",6,0,23
"2189","SP2",2024-01-20,"Amorebieta","Eldense",0,2,"A",0,1,"A",2.87,3,2.9,"0-1","0-2",10,1,12,7,1,2,0,0,7,2,10,12,2,9,22,"7-2","Y","N","N",3,0,23
"2190","SP2",2024-01-20,"Zaragoza","Andorra",2,0,"H",1,0,"H",2.26,2.93,4.1,"1-0","2-0",11,6,8,3,2,1,0,0,3,2,20,9,2,5,29,"3-2","Y","N","N",3,0,23
"2191","SP2",2024-01-20,"Espanol","Villarreal B",2,1,"H",2,1,"H",1.53,4.44,6.49,"2-1","2-1",9,4,11,3,2,2,0,0,5,8,13,11,3,13,24,"5-8","Y","Y","N",4,0,23
"2192","SP2",2024-01-20,"Tenerife","Sp Gijon",1,2,"A",1,1,"D",2.38,2.89,3.82,"1-1","1-2",11,2,11,6,2,3,0,0,2,6,14,14,3,8,28,"2-6","Y","Y","N",5,0,23
"2193","SP2",2024-01-20,"Ferrol","Oviedo",1,3,"A",0,0,"D",2.48,2.94,3.53,"0-0","1-3",9,3,17,9,2,2,0,0,7,7,18,10,4,14,28,"7-7","Y","Y","Y",4,0,23
"2194","SP2",2024-01-21,"Santander","Cartagena",0,2,"A",0,1,"A",1.86,3.65,4.56,"0-1","0-2",14,3,8,4,3,3,2,0,8,1,13,20,2,9,33,"8-1","Y","N","N",6,2,23
"2195","SP2",2024-01-21,"Mirandes","Levante",1,1,"D",0,1,"A",2.6,3.15,3.07,"0-1","1-1",15,3,9,2,2,3,0,0,6,3,11,18,2,9,29,"6-3","Y","N","N",5,0,23
"2196","SP2",2024-01-21,"Huesca","Eibar",2,3,"A",0,2,"A",3.24,2.92,2.66,"0-2","2-3",19,8,14,6,1,2,0,0,7,7,7,10,5,14,17,"7-7","Y","Y","Y",3,0,23
"2197","SP2",2024-01-21,"Elche","Valladolid",0,0,"D",0,0,"D",2.37,3.22,3.38,"0-0","0-0",18,2,3,1,2,2,0,0,3,2,14,10,0,5,24,"3-2","N","N","N",4,0,23
"2198","SP2",2024-01-22,"Leganes","Burgos",2,0,"H",2,0,"H",2.04,3.01,4.71,"2-0","2-0",11,5,13,5,0,2,0,0,7,4,12,9,2,11,21,"7-4","Y","N","N",2,0,23
"2199","SP2",2024-01-26,"Eibar","Mirandes",1,0,"H",0,0,"D",1.65,3.91,5.97,"0-0","1-0",20,7,11,3,1,2,0,0,6,4,12,10,1,10,22,"6-4","N","N","N",3,0,24
"2200","SP2",2024-01-27,"Alcorcon","Zaragoza",0,0,"D",0,0,"D",3.16,2.88,2.75,"0-0","0-0",9,2,5,1,0,1,0,0,4,0,12,8,0,4,20,"4-0","N","N","N",1,0,24
"2201","SP2",2024-01-27,"Cartagena","Amorebieta",1,0,"H",0,0,"D",1.95,3.33,4.6,"0-0","1-0",10,4,9,3,3,4,0,0,3,1,16,15,1,4,31,"3-1","N","N","N",7,0,24
"2202","SP2",2024-01-27,"Oviedo","Leganes",1,0,"H",0,0,"D",2.22,2.89,4.32,"0-0","1-0",12,6,5,2,4,2,0,0,9,3,12,15,1,12,27,"9-3","N","N","N",6,0,24
"2203","SP2",2024-01-27,"Levante","Tenerife",0,0,"D",0,0,"D",2.3,3.08,3.73,"0-0","0-0",8,3,8,0,1,3,0,1,2,4,15,18,0,6,33,"2-4","N","N","N",4,1,24
"2204","SP2",2024-01-28,"Eldense","Espanol",3,2,"H",2,2,"D",3.11,3.11,2.6,"2-2","3-2",14,5,5,1,2,2,0,0,7,3,15,15,5,10,30,"7-3","Y","Y","Y",4,0,24
"2205","SP2",2024-01-28,"Andorra","Elche",0,1,"A",0,0,"D",2.56,3,3.31,"0-0","0-1",10,5,14,6,3,3,0,0,4,5,13,14,1,9,27,"4-5","N","N","N",6,0,24
"2206","SP2",2024-01-28,"Villarreal B","Huesca",1,1,"D",0,1,"A",2.52,3.04,3.31,"0-1","1-1",16,5,6,2,3,3,0,0,7,1,13,11,2,8,24,"7-1","Y","N","N",6,0,24
"2207","SP2",2024-01-28,"Burgos","Albacete",2,1,"H",1,1,"D",2.64,2.95,3.24,"1-1","2-1",20,5,9,4,1,1,0,0,6,3,8,19,3,9,27,"6-3","Y","Y","N",2,0,24
"2208","SP2",2024-01-28,"Sp Gijon","Ferrol",1,2,"A",0,0,"D",1.9,3.41,4.75,"0-0","1-2",13,3,12,4,1,4,0,0,2,3,11,18,3,5,29,"2-3","Y","Y","N",5,0,24
"2209","SP2",2024-01-29,"Valladolid","Santander",3,1,"H",1,0,"H",1.89,3.47,4.58,"1-0","3-1",12,7,8,4,2,2,1,0,3,2,17,13,4,5,30,"3-2","Y","Y","Y",4,1,24
"2210","SP2",2024-02-02,"Elche","Burgos",2,0,"H",0,0,"D",1.92,3.21,5.09,"0-0","2-0",16,8,6,2,2,0,0,0,5,6,14,8,2,11,22,"5-6","Y","N","N",2,0,25
"2211","SP2",2024-02-03,"Albacete","Cartagena",1,1,"D",1,0,"H",1.78,3.52,5.39,"1-0","1-1",5,2,11,2,3,1,0,0,3,4,16,10,2,7,26,"3-4","Y","N","N",4,0,25
"2212","SP2",2024-02-03,"Huesca","Alcorcon",1,0,"H",0,0,"D",1.95,3.14,5.02,"0-0","1-0",11,3,8,4,1,2,0,0,4,5,8,15,1,9,23,"4-5","N","N","N",3,0,25
"2213","SP2",2024-02-03,"Mirandes","Villarreal B",3,0,"H",1,0,"H",2.13,3.27,3.96,"1-0","3-0",13,6,4,0,1,1,0,0,5,1,9,13,3,6,22,"5-1","Y","Y","N",2,0,25
"2214","SP2",2024-02-03,"Leganes","Valladolid",0,0,"D",0,0,"D",2.69,2.89,3.23,"0-0","0-0",9,1,10,0,2,3,0,0,3,4,10,16,0,7,26,"3-4","N","N","N",5,0,25
"2215","SP2",2024-02-03,"Tenerife","Andorra",0,0,"D",0,0,"D",1.96,3.28,4.69,"0-0","0-0",12,1,9,3,5,2,0,0,6,3,22,15,0,9,37,"6-3","N","N","N",7,0,25
"2216","SP2",2024-02-04,"Ferrol","Eibar",1,1,"D",0,0,"D",3.19,2.93,2.69,"0-0","1-1",10,3,6,3,5,2,0,0,2,2,7,19,2,4,26,"2-2","Y","N","N",7,0,25
"2217","SP2",2024-02-04,"Amorebieta","Santander",0,1,"A",0,1,"A",2.96,3.14,2.7,"0-1","0-1",10,3,8,1,3,3,0,0,4,0,17,17,1,4,34,"4-0","N","N","N",6,0,25
"2218","SP2",2024-02-04,"Oviedo","Eldense",1,1,"D",0,1,"A",1.99,3.2,4.68,"0-1","1-1",27,9,7,2,1,5,0,1,16,5,5,15,2,21,20,"16-5","Y","N","N",6,1,25
"2219","SP2",2024-02-04,"Espanol","Levante",2,1,"H",1,0,"H",1.91,3.43,4.7,"1-0","2-1",9,3,16,5,3,3,0,0,5,6,19,16,3,11,35,"5-6","Y","Y","N",6,0,25
"2220","SP2",2024-02-05,"Zaragoza","Sp Gijon",3,0,"H",1,0,"H",2.51,2.98,3.33,"1-0","3-0",13,5,8,2,1,3,0,0,4,4,15,6,3,8,21,"4-4","Y","Y","N",4,0,25
"2221","SP2",2024-02-09,"Levante","Leganes",0,0,"D",0,0,"D",2.28,2.96,3.96,"0-0","0-0",12,3,11,2,1,6,0,0,6,3,13,15,0,9,28,"6-3","N","N","N",7,0,26
"2222","SP2",2024-02-10,"Amorebieta","Elche",1,0,"H",0,0,"D",4.25,3.13,2.11,"0-0","1-0",8,2,19,4,0,0,0,0,0,5,11,11,1,5,22,"0-5","N","N","N",0,0,26
"2223","SP2",2024-02-10,"Eldense","Huesca",0,0,"D",0,0,"D",2.21,2.95,4.21,"0-0","0-0",8,0,9,4,2,1,0,0,4,7,21,10,0,11,31,"4-7","N","N","N",3,0,26
"2224","SP2",2024-02-10,"Sp Gijon","Oviedo",1,0,"H",1,0,"H",2.44,2.98,3.54,"1-0","1-0",12,5,13,3,3,3,0,0,4,5,11,9,1,9,20,"4-5","N","N","N",6,0,26
"2225","SP2",2024-02-10,"Santander","Espanol",2,0,"H",2,0,"H",2.64,3.17,3,"2-0","2-0",10,5,10,1,1,0,0,0,7,3,17,14,2,10,31,"7-3","Y","N","N",1,0,26
"2226","SP2",2024-02-11,"Villarreal B","Tenerife",1,0,"H",0,0,"D",3.05,3.04,2.7,"0-0","1-0",10,3,4,0,3,6,0,1,4,1,12,16,1,5,28,"4-1","N","N","N",9,1,26
"2227","SP2",2024-02-11,"Alcorcon","Andorra",1,0,"H",1,0,"H",2.6,3,3.23,"1-0","1-0",7,1,13,3,3,1,0,0,4,6,17,3,1,10,20,"4-6","N","N","N",4,0,26
"2228","SP2",2024-02-11,"Cartagena","Mirandes",1,0,"H",1,0,"H",2.28,3.14,3.7,"1-0","1-0",6,2,18,4,6,1,0,0,4,5,14,7,1,9,21,"4-5","N","N","N",7,0,26
"2229","SP2",2024-02-11,"Eibar","Zaragoza",1,0,"H",1,0,"H",1.87,3.37,5.04,"1-0","1-0",10,4,13,1,2,0,0,0,3,5,7,6,1,8,13,"3-5","N","N","N",2,0,26
"2230","SP2",2024-02-11,"Burgos","Ferrol",2,0,"H",2,0,"H",2.11,3.18,4.15,"2-0","2-0",8,5,16,6,0,1,0,0,2,8,11,8,2,10,19,"2-8","Y","N","N",1,0,26
"2231","SP2",2024-02-12,"Valladolid","Albacete",0,0,"D",0,0,"D",2.08,3.34,3.93,"0-0","0-0",18,2,8,3,3,3,0,0,6,1,14,18,0,7,32,"6-1","N","N","N",6,0,26
"2232","SP2",2024-02-16,"Zaragoza","Cartagena",1,2,"A",0,1,"A",1.85,3.18,5.64,"0-1","1-2",20,6,6,4,4,5,0,1,8,3,13,12,3,11,25,"8-3","Y","Y","N",9,1,27
"2233","SP2",2024-02-17,"Andorra","Villarreal B",1,1,"D",0,0,"D",1.84,3.53,4.92,"0-0","1-1",10,4,5,2,4,2,0,0,8,1,16,11,2,9,27,"8-1","Y","N","N",6,0,27
"2234","SP2",2024-02-17,"Oviedo","Burgos",5,0,"H",3,0,"H",2.06,3.05,4.62,"3-0","5-0",20,11,15,4,2,0,0,0,5,7,14,5,5,12,19,"5-7","Y","Y","Y",2,0,27
"2235","SP2",2024-02-17,"Sp Gijon","Valladolid",1,1,"D",0,1,"A",2.63,2.92,3.28,"0-1","1-1",11,4,12,5,3,2,0,0,6,9,9,12,2,15,21,"6-9","Y","N","N",5,0,27
"2236","SP2",2024-02-17,"Espanol","Mirandes",3,0,"H",1,0,"H",1.81,3.53,5.19,"1-0","3-0",18,7,4,0,2,3,0,0,7,3,18,13,3,10,31,"7-3","Y","Y","N",5,0,27
"2237","SP2",2024-02-18,"Albacete","Santander",2,0,"H",0,0,"D",2.04,3.58,3.85,"0-0","2-0",15,6,8,1,2,4,0,0,8,5,12,14,2,13,26,"8-5","Y","N","N",6,0,27
"2238","SP2",2024-02-18,"Ferrol","Levante",0,0,"D",0,0,"D",2.52,3.12,3.22,"0-0","0-0",6,1,14,3,1,3,1,0,1,4,11,18,0,5,29,"1-4","N","N","N",4,1,27
"2239","SP2",2024-02-18,"Leganes","Alcorcon",3,0,"H",1,0,"H",1.77,3.3,6.15,"1-0","3-0",12,6,16,5,4,4,0,0,5,3,23,15,3,8,38,"5-3","Y","Y","N",8,0,27
"2240","SP2",2024-02-18,"Huesca","Amorebieta",0,0,"D",0,0,"D",1.94,3.01,5.51,"0-0","0-0",15,5,7,2,2,1,0,0,9,0,10,10,0,9,20,"9-0","N","N","N",3,0,27
"2241","SP2",2024-02-18,"Elche","Eibar",0,0,"D",0,0,"D",2.43,3.12,3.38,"0-0","0-0",30,5,8,3,4,4,0,0,9,3,11,13,0,12,24,"9-3","N","N","N",8,0,27
"2242","SP2",2024-02-19,"Tenerife","Eldense",1,0,"H",1,0,"H",1.93,3.19,4.96,"1-0","1-0",16,5,6,0,3,1,0,0,3,3,13,14,1,6,27,"3-3","N","N","N",4,0,27
"2243","SP2",2024-02-23,"Valladolid","Oviedo",3,0,"H",1,0,"H",2.27,3.01,3.93,"1-0","3-0",13,4,11,3,1,1,0,0,6,5,20,9,3,11,29,"6-5","Y","Y","N",2,0,28
"2244","SP2",2024-02-24,"Santander","Leganes",2,1,"H",1,1,"D",2.47,2.99,3.47,"1-1","2-1",10,3,9,5,1,4,0,0,5,5,14,17,3,10,31,"5-5","Y","Y","N",5,0,28
"2245","SP2",2024-02-24,"Eibar","Espanol",2,3,"A",1,0,"H",2.08,3.2,4.25,"1-0","2-3",12,4,6,4,1,2,0,0,6,3,14,13,5,9,27,"6-3","Y","Y","Y",3,0,28
"2246","SP2",2024-02-24,"Villarreal B","Zaragoza",0,0,"D",0,0,"D",3.31,2.94,2.6,"0-0","0-0",13,4,6,1,1,2,0,0,3,6,15,7,0,9,22,"3-6","N","N","N",3,0,28
"2247","SP2",2024-02-25,"Eldense","Ferrol",2,0,"H",2,0,"H",2.29,3.1,3.72,"2-0","2-0",10,3,10,2,3,1,0,0,4,1,14,13,2,5,27,"4-1","Y","N","N",4,0,28
"2248","SP2",2024-02-25,"Alcorcon","Tenerife",1,1,"D",0,0,"D",3.17,2.82,2.81,"0-0","1-1",6,2,12,4,2,3,0,0,3,4,13,9,2,7,22,"3-4","Y","N","N",5,0,28
"2249","SP2",2024-02-25,"Burgos","Sp Gijon",1,0,"H",1,0,"H",2.48,3.06,3.36,"1-0","1-0",11,2,7,4,6,2,0,0,3,5,17,7,1,8,24,"3-5","N","N","N",8,0,28
"2250","SP2",2024-02-25,"Cartagena","Elche",0,1,"A",0,0,"D",3.26,2.98,2.59,"0-0","0-1",5,3,25,6,2,0,0,0,4,13,9,18,1,17,27,"4-13","N","N","N",2,0,28
"2251","SP2",2024-02-25,"Amorebieta","Albacete",1,1,"D",0,1,"A",3.56,3.2,2.3,"0-1","1-1",21,5,10,0,3,6,0,0,6,4,12,17,2,10,29,"6-4","Y","N","N",9,0,28
"2252","SP2",2024-02-26,"Mirandes","Huesca",0,3,"A",0,0,"D",2.33,2.9,3.85,"0-0","0-3",8,0,10,6,3,5,0,0,4,5,8,19,3,9,27,"4-5","Y","Y","N",8,0,28
"2253","SP2",2024-03-01,"Sp Gijon","Albacete",2,1,"H",1,1,"D",2.26,3.04,3.92,"1-1","2-1",20,6,6,3,3,1,0,1,10,1,8,12,3,11,20,"10-1","Y","Y","N",4,1,28
"2254","SP2",2024-03-02,"Eldense","Villarreal B",2,0,"H",1,0,"H",2.09,3.29,4.06,"1-0","2-0",18,7,9,1,3,1,0,0,2,4,14,13,2,6,27,"2-4","Y","N","N",4,0,29
"2255","SP2",2024-03-02,"Espanol","Huesca",0,0,"D",0,0,"D",1.78,3.39,5.75,"0-0","0-0",12,3,2,1,2,5,0,0,4,1,19,16,0,5,35,"4-1","N","N","N",7,0,29
"2256","SP2",2024-03-02,"Ferrol","Santander",2,2,"D",1,1,"D",2.31,3.16,3.59,"1-1","2-2",13,7,8,3,3,6,0,1,7,4,19,18,4,11,37,"7-4","Y","Y","Y",9,1,29
"2257","SP2",2024-03-02,"Oviedo","Levante",3,2,"H",0,1,"A",2.05,3.24,4.31,"0-1","3-2",18,6,12,3,0,0,0,0,13,5,12,15,5,18,27,"13-5","Y","Y","Y",0,0,29
"2258","SP2",2024-03-02,"Burgos","Cartagena",3,0,"H",1,0,"H",1.98,3.24,4.64,"1-0","3-0",18,7,8,1,3,1,1,0,6,1,13,8,3,7,21,"6-1","Y","Y","N",4,1,29
"2259","SP2",2024-03-03,"Andorra","Valladolid",2,1,"H",0,1,"A",2.91,3.05,2.82,"0-1","2-1",15,6,10,2,2,3,0,0,8,7,13,16,3,15,29,"8-7","Y","Y","N",5,0,29
"2260","SP2",2024-03-03,"Tenerife","Mirandes",2,1,"H",2,0,"H",1.95,3.23,4.82,"2-0","2-1",17,5,8,3,4,4,0,0,9,4,15,11,3,13,26,"9-4","Y","Y","N",8,0,29
"2261","SP2",2024-03-03,"Zaragoza","Amorebieta",0,1,"A",0,0,"D",1.64,3.62,7.03,"0-0","0-1",8,4,7,3,3,1,0,0,4,1,15,12,1,5,27,"4-1","N","N","N",4,0,29
"2262","SP2",2024-03-03,"Leganes","Eibar",0,2,"A",0,2,"A",2.78,2.83,3.18,"0-2","0-2",26,2,9,3,2,5,0,1,7,4,10,14,2,11,24,"7-4","Y","N","N",7,1,29
"2263","SP2",2024-03-04,"Elche","Alcorcon",3,0,"H",3,0,"H",1.55,3.92,7.27,"3-0","3-0",17,6,7,1,1,3,0,0,5,0,14,15,3,5,29,"5-0","Y","Y","N",4,0,29
"2264","SP2",2024-03-08,"Huesca","Andorra",2,0,"H",1,0,"H",2.45,2.8,3.8,"1-0","2-0",18,9,8,1,4,0,0,1,8,4,16,4,2,12,20,"8-4","Y","N","N",4,1,29
"2265","SP2",2024-03-09,"Albacete","Oviedo",1,2,"A",0,0,"D",2.47,3.12,3.31,"0-0","1-2",11,3,18,8,6,0,0,0,7,6,20,10,3,13,30,"7-6","Y","Y","N",6,0,30
"2266","SP2",2024-03-09,"Mirandes","Eldense",3,1,"H",1,0,"H",2.44,2.89,3.35,"1-0","3-1",8,4,11,3,2,0,0,0,2,6,12,13,4,8,25,"2-6","Y","Y","Y",2,0,30
"2267","SP2",2024-03-09,"Valladolid","Zaragoza",2,0,"H",1,0,"H",1.99,3.18,4.71,"1-0","2-0",12,3,5,3,1,4,0,0,4,3,9,16,2,7,25,"4-3","Y","N","N",5,0,30
"2268","SP2",2024-03-09,"Cartagena","Ferrol",2,1,"H",1,1,"D",2.53,2.96,3.39,"1-1","2-1",12,5,11,4,2,4,0,0,5,5,10,12,3,10,22,"5-5","Y","Y","N",6,0,30
"2269","SP2",2024-03-10,"Santander","Tenerife",4,2,"H",0,1,"A",2.5,2.97,3.43,"0-1","4-2",19,8,6,3,3,5,0,1,8,3,14,16,6,11,30,"8-3","Y","Y","Y",8,1,30
"2270","SP2",2024-03-10,"Levante","Sp Gijon",1,0,"H",0,0,"D",2.11,3.41,3.82,"0-0","1-0",19,3,10,2,2,1,1,0,7,4,7,5,1,11,12,"7-4","N","N","N",3,1,30
"2271","SP2",2024-03-10,"Villarreal B","Elche",0,1,"A",0,1,"A",3.3,3.01,2.38,"0-1","0-1",14,6,13,3,2,5,0,0,8,4,13,17,1,12,30,"8-4","N","N","N",7,0,30
"2272","SP2",2024-03-10,"Eibar","Burgos",0,1,"A",0,0,"D",1.77,3.52,5.56,"0-0","0-1",12,3,9,2,2,4,0,0,9,2,12,10,1,11,22,"9-2","N","N","N",6,0,30
"2273","SP2",2024-03-10,"Alcorcon","Espanol",1,1,"D",0,0,"D",3.91,3.06,2.12,"0-0","1-1",15,5,13,2,2,4,1,1,4,6,11,13,2,10,24,"4-6","Y","N","N",6,2,30
"2274","SP2",2024-03-11,"Amorebieta","Leganes",0,1,"A",0,0,"D",3.36,2.93,2.54,"0-0","0-1",13,1,4,2,2,1,0,1,8,1,9,8,1,9,17,"8-1","N","N","N",3,1,30
"2275","SP2",2024-03-13,"Levante","Andorra",0,0,"D",0,0,"D",1.96,3.29,4.65,"0-0","0-0",6,2,11,3,2,1,0,0,7,4,17,11,0,11,28,"7-4","N","N","N",3,0,30
"2276","SP2",2024-03-15,"Eldense","Cartagena",0,0,"D",0,0,"D",2.04,2.95,5.01,"0-0","0-0",16,4,8,2,4,0,0,0,9,1,19,8,0,10,27,"9-1","N","N","N",4,0,31
"2277","SP2",2024-03-16,"Burgos","Levante",1,1,"D",1,0,"H",2.38,3.13,3.48,"1-0","1-1",18,11,11,2,4,3,0,0,7,8,8,12,2,15,20,"7-8","Y","N","N",7,0,31
"2278","SP2",2024-03-16,"Eibar","Villarreal B",2,0,"H",1,0,"H",1.46,4.56,7.88,"1-0","2-0",13,9,11,3,1,3,0,0,7,4,11,13,2,11,24,"7-4","Y","N","N",4,0,31
"2279","SP2",2024-03-16,"Oviedo","Santander",1,1,"D",0,1,"A",1.75,3.77,5.16,"0-1","1-1",14,6,16,5,2,3,1,1,8,6,6,15,2,14,21,"8-6","Y","N","N",5,2,31
"2280","SP2",2024-03-16,"Tenerife","Huesca",0,0,"D",0,0,"D",2.02,2.87,5.36,"0-0","0-0",20,2,6,2,2,2,0,0,8,5,10,7,0,13,17,"8-5","N","N","N",4,0,31
"2281","SP2",2024-03-16,"Sp Gijon","Alcorcon",1,0,"H",1,0,"H",1.74,3.58,5.72,"1-0","1-0",11,3,11,2,2,2,0,0,12,4,12,11,1,16,23,"12-4","N","N","N",4,0,31
"2282","SP2",2024-03-17,"Leganes","Mirandes",4,0,"H",3,0,"H",1.78,3.3,6.08,"3-0","4-0",12,7,9,3,0,2,0,0,8,3,3,9,4,11,12,"8-3","Y","Y","Y",2,0,31
"2283","SP2",2024-03-17,"Ferrol","Valladolid",2,0,"H",1,0,"H",3.24,3.07,2.54,"1-0","2-0",17,6,7,1,1,3,0,1,8,4,20,15,2,12,35,"8-4","Y","N","N",4,1,31
"2284","SP2",2024-03-17,"Elche","Albacete",3,2,"H",1,1,"D",1.72,3.61,5.75,"1-1","3-2",22,7,7,2,2,2,0,0,9,3,11,19,5,12,30,"9-3","Y","Y","Y",4,0,31
"2285","SP2",2024-03-17,"Zaragoza","Espanol",0,1,"A",0,1,"A",2.73,2.88,2.93,"0-1","0-1",14,2,6,1,0,4,0,0,8,3,13,22,1,11,35,"8-3","N","N","N",4,0,31
"4574","T1",2023-08-11,"Trabzonspor","Antalyaspor",1,0,"H",1,0,"H",1.92,3.81,4.06,"1-0","1-0",13,5,11,2,0,1,0,0,6,9,18,11,1,15,29,"6-9","N","N","N",1,0,1
"4575","T1",2023-08-12,"Kasimpasa","Ankaragucu",3,2,"H",1,0,"H",2.36,3.73,2.98,"1-0","3-2",15,5,9,3,1,0,0,0,3,5,8,15,5,8,23,"3-5","Y","Y","Y",1,0,1
"4576","T1",2023-08-12,"Konyaspor","Istanbulspor",1,1,"D",0,1,"A",1.8,3.93,4.55,"0-1","1-1",15,2,4,2,3,5,1,2,10,2,13,10,2,12,23,"10-2","Y","N","N",8,3,1
"4577","T1",2023-08-12,"Kayserispor","Galatasaray",0,0,"D",0,0,"D",5.15,4.41,1.64,"0-0","0-0",12,3,17,3,2,2,0,0,3,9,11,6,0,12,17,"3-9","N","N","N",4,0,1
"4578","T1",2023-08-12,"Pendikspor","Hatayspor",1,5,"A",0,2,"A",2.27,3.48,3.33,"0-2","1-5",6,4,15,9,0,1,0,0,4,2,10,18,6,6,28,"4-2","Y","Y","Y",1,0,1
"4579","T1",2023-08-13,"Sivasspor","Samsunspor",1,1,"D",1,0,"H",2.33,3.6,3.12,"1-0","1-1",6,2,11,3,2,1,0,0,4,5,11,11,2,9,22,"4-5","Y","N","N",3,0,1
"4580","T1",2023-08-13,"Ad. Demirspor","Rizespor",2,1,"H",1,0,"H",1.6,4.61,5.34,"1-0","2-1",9,6,13,4,6,6,0,0,4,5,15,14,3,9,29,"4-5","Y","Y","N",12,0,1
"4581","T1",2023-08-13,"Fenerbahce","Gaziantep",2,1,"H",2,1,"H",1.33,6.04,8.69,"2-1","2-1",21,5,4,1,0,6,0,1,3,1,13,12,3,4,25,"3-1","Y","Y","N",6,1,1
"4582","T1",2023-08-14,"Alanyaspor","Buyuksehyr",2,0,"H",1,0,"H",2.83,3.58,2.49,"1-0","2-0",11,4,8,3,5,4,0,1,4,5,15,14,2,9,29,"4-5","Y","N","N",9,1,1
"4583","T1",2023-08-14,"Karagumruk","Besiktas",0,1,"A",0,0,"D",4.53,4.58,1.67,"0-0","0-1",2,0,9,6,4,1,0,0,4,4,13,14,1,8,27,"4-4","N","N","N",5,0,1
"4584","T1",2023-08-18,"Antalyaspor","Konyaspor",1,1,"D",0,0,"D",2.3,3.61,3.16,"0-0","1-1",14,3,7,3,2,2,0,0,5,5,14,12,2,10,26,"5-5","Y","N","N",4,0,2
"4585","T1",2023-08-18,"Istanbulspor","Kayserispor",1,1,"D",0,0,"D",2.67,3.55,2.69,"0-0","1-1",7,3,9,4,1,0,0,0,4,6,11,11,2,10,22,"4-6","Y","N","N",1,0,2
"4586","T1",2023-08-19,"Rizespor","Alanyaspor",0,0,"D",0,0,"D",2.48,3.61,2.86,"0-0","0-0",10,3,8,2,3,3,0,1,3,3,12,13,0,6,25,"3-3","N","N","N",6,1,2
"4587","T1",2023-08-19,"Galatasaray","Trabzonspor",2,0,"H",1,0,"H",1.64,4.55,4.98,"1-0","2-0",15,5,5,1,4,3,0,0,7,1,21,3,2,8,24,"7-1","Y","N","N",7,0,2
"4588","T1",2023-08-19,"Hatayspor","Kasimpasa",0,0,"D",0,0,"D",2.49,3.6,2.87,"0-0","0-0",8,2,11,2,0,0,0,0,3,1,7,6,0,4,13,"3-1","N","N","N",0,0,2
"4589","T1",2023-08-20,"Buyuksehyr","Karagumruk",0,2,"A",0,2,"A",1.68,4.31,4.95,"0-2","0-2",15,5,9,2,3,4,0,0,5,4,11,14,2,9,25,"5-4","Y","N","N",7,0,2
"4590","T1",2023-08-20,"Besiktas","Pendikspor",1,1,"D",1,0,"H",1.24,6.75,11.71,"1-0","1-1",15,6,11,1,4,2,0,0,6,4,11,9,2,10,20,"6-4","Y","N","N",6,0,2
"4591","T1",2023-08-20,"Gaziantep","Sivasspor",1,3,"A",0,2,"A",2.71,3.73,2.56,"0-2","1-3",11,2,13,7,6,4,0,0,7,4,19,16,4,11,35,"7-4","Y","Y","Y",10,0,2
"4592","T1",2023-08-21,"Ankaragucu","Ad. Demirspor",1,1,"D",1,1,"D",2.72,3.63,2.56,"1-1","1-1",18,5,12,4,1,1,0,0,3,4,9,10,2,7,19,"3-4","Y","N","N",2,0,2
"4593","T1",2023-08-21,"Samsunspor","Fenerbahce",0,2,"A",0,0,"D",5.53,4.5,1.57,"0-0","0-2",5,1,13,6,1,1,0,0,2,5,11,10,2,7,21,"2-5","Y","N","N",2,0,2
"4594","T1",2023-08-25,"Konyaspor","Gaziantep",2,0,"H",0,0,"D",1.8,4.01,4.46,"0-0","2-0",17,8,8,3,1,2,0,0,10,2,9,8,2,12,17,"10-2","Y","N","N",3,0,3
"4595","T1",2023-08-26,"Kasimpasa","Pendikspor",1,1,"D",0,1,"A",1.79,3.85,4.71,"0-1","1-1",7,3,16,6,3,2,0,1,9,2,10,19,2,11,29,"9-2","Y","N","N",5,1,3
"4596","T1",2023-08-26,"Trabzonspor","Rizespor",2,3,"A",0,2,"A",1.51,4.72,6.34,"0-2","2-3",20,7,12,7,1,2,0,0,9,2,10,17,5,11,27,"9-2","Y","Y","Y",3,0,3
"4597","T1",2023-08-26,"Sivasspor","Antalyaspor",1,1,"D",1,1,"D",2.36,3.31,3.31,"1-1","1-1",6,2,8,4,3,3,0,0,3,4,11,15,2,7,26,"3-4","Y","N","N",6,0,3
"4598","T1",2023-08-27,"Karagumruk","Ankaragucu",1,1,"D",1,0,"H",2.38,3.47,3.13,"1-0","1-1",6,2,7,5,1,1,0,0,3,5,15,12,2,8,27,"3-5","Y","N","N",2,0,3
"4599","T1",2023-08-27,"Kayserispor","Samsunspor",2,1,"H",2,1,"H",2.53,3.53,2.87,"2-1","2-1",11,4,6,1,0,0,0,0,3,2,7,8,3,5,15,"3-2","Y","Y","N",0,0,3
"4600","T1",2023-08-27,"Alanyaspor","Hatayspor",0,0,"D",0,0,"D",1.99,3.84,3.77,"0-0","0-0",15,5,5,0,4,3,0,0,9,1,9,17,0,10,26,"9-1","N","N","N",7,0,3
"4601","T1",2023-09-01,"Kasimpasa","Trabzonspor",1,5,"A",0,3,"A",3.03,3.6,2.38,"0-3","1-5",19,6,7,6,3,3,0,0,9,3,10,16,6,12,26,"9-3","Y","Y","Y",6,0,3
"4602","T1",2023-09-01,"Rizespor","Karagumruk",1,0,"H",1,0,"H",1.76,4.1,3.34,"1-0","1-0",13,4,17,3,3,2,0,0,1,6,12,17,1,7,29,"1-6","N","N","N",5,0,3
"4603","T1",2023-09-02,"Buyuksehyr","Konyaspor",0,1,"A",0,0,"D",2.4,3.53,3.05,"0-0","0-1",11,2,13,5,4,2,1,0,2,4,13,13,1,6,26,"2-4","N","N","N",6,1,3
"4604","T1",2023-09-02,"Pendikspor","Alanyaspor",1,1,"D",0,0,"D",2.38,3.63,3.02,"0-0","1-1",10,3,8,4,2,2,0,0,8,4,9,14,2,12,23,"8-4","Y","N","N",4,0,4
"4605","T1",2023-09-02,"Antalyaspor","Kayserispor",1,1,"D",1,1,"D",1.94,3.87,3.91,"1-1","1-1",20,7,7,3,2,3,0,0,9,3,14,11,2,12,25,"9-3","Y","N","N",5,0,4
"4606","T1",2023-09-02,"Gaziantep","Galatasaray",0,3,"A",0,1,"A",7.45,5.13,1.42,"0-1","0-3",15,7,15,4,2,0,0,0,4,7,12,13,3,11,25,"4-7","Y","Y","N",2,0,4
"4607","T1",2023-09-03,"Besiktas","Sivasspor",2,0,"H",2,0,"H",1.45,4.72,7.56,"2-0","2-0",17,8,5,1,2,4,0,0,7,2,17,17,2,9,34,"7-2","Y","N","N",6,0,4
"4608","T1",2023-09-03,"Ankaragucu","Fenerbahce",0,1,"A",0,0,"D",5.03,4.08,1.7,"0-0","0-1",14,2,14,2,2,3,0,1,4,2,15,14,1,6,29,"4-2","N","N","N",5,1,4
"4609","T1",2023-09-03,"Hatayspor","Ad. Demirspor",3,3,"D",0,1,"A",3.45,3.62,2.16,"0-1","3-3",14,7,11,6,6,2,0,0,3,7,19,9,6,10,28,"3-7","Y","Y","Y",8,0,4
"4610","T1",2023-09-16,"Kayserispor","Gaziantep",2,0,"H",1,0,"H",1.89,3.79,4.21,"1-0","2-0",10,4,16,5,0,1,0,0,3,7,11,8,2,10,19,"3-7","Y","N","N",1,0,4
"4611","T1",2023-09-16,"Konyaspor","Rizespor",1,2,"A",1,0,"H",1.99,3.69,3.92,"1-0","1-2",6,4,11,2,2,1,0,0,2,4,12,14,3,6,26,"2-4","Y","Y","N",3,0,4
"4612","T1",2023-09-16,"Ad. Demirspor","Pendikspor",3,0,"H",2,0,"H",1.52,4.93,5.92,"2-0","3-0",18,7,15,5,0,3,0,0,6,6,8,6,3,12,14,"6-6","Y","Y","N",3,0,4
"4613","T1",2023-09-16,"Galatasaray","Samsunspor",4,2,"H",3,0,"H",1.34,5.78,8.87,"3-0","4-2",9,5,9,4,1,3,0,0,2,6,17,15,6,8,32,"2-6","Y","Y","Y",4,0,4
"4614","T1",2023-09-17,"Fenerbahce","Antalyaspor",3,2,"H",1,1,"D",1.4,5.41,7.66,"1-1","3-2",17,10,14,6,3,4,0,0,7,5,13,11,5,12,24,"7-5","Y","Y","Y",7,0,5
"4615","T1",2023-09-17,"Istanbulspor","Buyuksehyr",0,2,"A",0,0,"D",3.34,3.48,2.27,"0-0","0-2",5,0,20,8,4,0,0,0,0,7,15,9,2,7,24,"0-7","Y","N","N",4,0,5
"4616","T1",2023-09-17,"Alanyaspor","Kasimpasa",3,3,"D",2,1,"H",2.09,3.67,3.56,"2-1","3-3",13,6,17,3,0,0,0,0,5,7,9,11,6,12,20,"5-7","Y","Y","Y",0,0,5
"4617","T1",2023-09-17,"Trabzonspor","Besiktas",3,0,"H",2,0,"H",3.12,3.47,2.39,"2-0","3-0",8,5,7,1,4,1,0,0,2,7,15,11,3,9,26,"2-7","Y","Y","N",5,0,5
"4618","T1",2023-09-18,"Karagumruk","Hatayspor",0,0,"D",0,0,"D",1.99,3.63,3.89,"0-0","0-0",5,2,18,5,3,2,0,0,3,3,14,9,0,6,23,"3-3","N","N","N",5,0,5
"4619","T1",2023-09-18,"Sivasspor","Ankaragucu",1,3,"A",1,1,"D",2.42,3.4,3.08,"1-1","1-3",15,9,15,5,3,2,1,0,5,3,7,12,4,8,19,"5-3","Y","Y","Y",5,1,5
"4620","T1",2023-09-22,"Gaziantep","Istanbulspor",2,0,"H",0,0,"D",1.88,3.91,4.12,"0-0","2-0",13,2,5,0,1,5,0,0,8,4,11,13,2,12,24,"8-4","Y","N","N",6,0,5
"4621","T1",2023-09-23,"Pendikspor","Karagumruk",1,1,"D",1,0,"H",2.56,3.44,2.89,"1-0","1-1",8,4,10,4,0,1,0,0,5,4,13,10,2,9,23,"5-4","Y","N","N",1,0,5
"4622","T1",2023-09-23,"Rizespor","Sivasspor",1,1,"D",1,1,"D",2.29,3.39,3.37,"1-1","1-1",14,4,14,4,7,3,0,0,5,4,12,17,2,9,29,"5-4","Y","N","N",10,0,5
"4623","T1",2023-09-23,"Antalyaspor","Samsunspor",2,0,"H",2,0,"H",2.12,3.75,3.46,"2-0","2-0",7,3,9,1,2,1,0,0,1,4,22,11,2,5,33,"1-4","Y","N","N",3,0,5
"4624","T1",2023-09-23,"Buyuksehyr","Galatasaray",1,2,"A",0,1,"A",4.44,3.86,1.83,"0-1","1-2",6,2,17,4,3,2,0,0,2,4,18,15,3,6,33,"2-4","Y","Y","N",5,0,6
"4625","T1",2023-09-24,"Ankaragucu","Konyaspor",1,1,"D",1,1,"D",2.4,3.58,3.01,"1-1","1-1",15,1,7,1,1,1,0,0,4,2,15,8,2,6,23,"4-2","Y","N","N",2,0,6
"4626","T1",2023-09-24,"Besiktas","Kayserispor",2,1,"H",0,0,"D",1.4,5.2,8.13,"0-0","2-1",23,10,5,1,1,0,0,0,7,2,13,10,3,9,23,"7-2","Y","Y","N",1,0,6
"4627","T1",2023-09-24,"Alanyaspor","Fenerbahce",0,1,"A",0,1,"A",5.11,4.35,1.65,"0-1","0-1",2,1,14,7,2,6,0,0,4,5,15,14,1,9,29,"4-5","N","N","N",8,0,6
"4628","T1",2023-09-24,"Kasimpasa","Ad. Demirspor",2,1,"H",1,0,"H",3.2,3.83,2.2,"1-0","2-1",13,7,19,6,4,2,0,3,6,11,21,7,3,17,28,"6-11","Y","Y","N",6,3,6
"4629","T1",2023-09-25,"Hatayspor","Trabzonspor",3,2,"H",0,1,"A",3.05,3.68,2.3,"0-1","3-2",9,3,6,3,6,2,0,0,9,1,22,13,5,10,35,"9-1","Y","Y","Y",8,0,6
"4630","T1",2023-09-26,"Istanbulspor","Galatasaray",0,1,"A",0,1,"A",9.13,5.73,1.34,"0-1","0-1",4,3,17,7,1,2,0,0,3,4,12,16,1,7,28,"3-4","N","N","N",3,0,6
"4631","T1",2023-09-27,"Ad. Demirspor","Besiktas",4,2,"H",2,0,"H",3.37,3.93,2.09,"2-0","4-2",14,7,16,5,2,1,0,0,1,5,16,15,6,6,31,"1-5","Y","Y","Y",3,0,6
"4632","T1",2023-09-28,"Fenerbahce","Buyuksehyr",4,0,"H",3,0,"H",1.44,5.07,7.13,"3-0","4-0",16,8,6,0,4,1,0,0,14,2,22,9,4,16,31,"14-2","Y","Y","Y",5,0,6
"4633","T1",2023-09-29,"Samsunspor","Gaziantep",1,2,"A",0,2,"A",1.93,3.76,4.11,"0-2","1-2",18,2,4,3,2,3,0,0,9,2,13,12,3,11,25,"9-2","Y","Y","N",5,0,6
"4634","T1",2023-09-30,"Sivasspor","Hatayspor",0,0,"D",0,0,"D",2.08,3.57,3.74,"0-0","0-0",12,4,4,1,3,3,0,0,6,7,9,20,0,13,29,"6-7","N","N","N",6,0,7
"4635","T1",2023-09-30,"Istanbulspor","Antalyaspor",1,2,"A",1,0,"H",3.23,3.77,2.21,"1-0","1-2",4,3,17,5,2,3,0,0,4,8,8,17,3,12,25,"4-8","Y","Y","N",5,0,7
"4636","T1",2023-09-30,"Trabzonspor","Pendikspor",2,1,"H",2,1,"H",1.55,4.62,5.91,"2-1","2-1",11,3,9,4,2,1,1,0,4,2,19,8,3,6,27,"4-2","Y","Y","N",3,1,7
"4637","T1",2023-09-30,"Galatasaray","Ankaragucu",2,1,"H",0,0,"D",1.31,6.12,9.34,"0-0","2-1",34,13,7,2,0,3,0,0,12,3,11,10,3,15,21,"12-3","Y","Y","N",3,0,7
"4638","T1",2023-10-01,"Karagumruk","Kasimpasa",2,3,"A",1,3,"A",2.34,3.63,3.08,"1-3","2-3",13,4,4,3,3,3,0,0,8,0,9,14,5,8,23,"8-0","Y","Y","Y",6,0,7
"4639","T1",2023-10-01,"Fenerbahce","Rizespor",5,0,"H",1,0,"H",1.34,5.83,8.54,"1-0","5-0",23,11,5,1,1,3,0,0,8,2,10,15,5,10,25,"8-2","Y","Y","Y",4,0,7
"4640","T1",2023-10-01,"Ad. Demirspor","Alanyaspor",4,0,"H",1,0,"H",1.74,4.3,4.43,"1-0","4-0",15,7,9,1,2,3,0,0,7,3,11,14,4,10,25,"7-3","Y","Y","Y",5,0,7
"4641","T1",2023-10-01,"Konyaspor","Besiktas",0,2,"A",0,1,"A",3.51,3.7,2.11,"0-1","0-2",5,3,6,1,2,3,1,0,2,6,13,20,2,8,33,"2-6","Y","N","N",5,1,7
"4642","T1",2023-10-02,"Kayserispor","Buyuksehyr",0,0,"D",0,0,"D",2.6,3.39,2.83,"0-0","0-0",14,1,8,4,2,2,0,0,10,5,6,15,0,15,21,"10-5","N","N","N",4,0,7
"4643","T1",2023-10-06,"Ad. Demirspor","Trabzonspor",1,0,"H",1,0,"H",2.06,3.94,3.46,"1-0","1-0",13,8,18,3,5,3,0,0,3,3,17,9,1,6,26,"3-3","N","N","N",8,0,7
"4644","T1",2023-10-06,"Alanyaspor","Karagumruk",2,1,"H",1,0,"H",2.31,3.37,3.35,"1-0","2-1",6,3,10,4,4,1,0,0,3,6,16,16,3,9,32,"3-6","Y","Y","N",5,0,8
"4645","T1",2023-10-07,"Pendikspor","Sivasspor",2,3,"A",0,1,"A",2.74,3.47,2.67,"0-1","2-3",15,6,15,7,5,2,0,0,9,4,14,13,5,13,27,"9-4","Y","Y","Y",7,0,8
"4646","T1",2023-10-07,"Ankaragucu","Kayserispor",3,0,"H",0,0,"D",2.15,3.67,3.44,"0-0","3-0",12,8,4,1,0,0,0,0,1,3,1,10,3,4,11,"1-3","Y","Y","N",0,0,8
"4647","T1",2023-10-07,"Antalyaspor","Galatasaray",0,2,"A",0,0,"D",4.94,4.21,1.69,"0-0","0-2",12,4,11,7,1,3,0,0,3,7,15,21,2,10,36,"3-7","Y","N","N",4,0,8
"4648","T1",2023-10-07,"Buyuksehyr","Gaziantep",2,0,"H",2,0,"H",1.88,3.71,4.42,"2-0","2-0",8,3,12,1,0,0,0,0,5,7,12,10,2,12,22,"5-7","Y","N","N",0,0,8
"4649","T1",2023-10-08,"Rizespor","Samsunspor",1,0,"H",0,0,"D",2.17,3.68,3.34,"0-0","1-0",8,4,12,3,3,3,1,0,4,8,9,15,1,12,24,"4-8","N","N","N",6,1,8
"4650","T1",2023-10-08,"Besiktas","Istanbulspor",2,0,"H",1,0,"H",1.24,6.6,12.33,"1-0","2-0",17,5,4,2,2,2,0,0,4,4,12,10,2,8,22,"4-4","Y","N","N",4,0,8
"4651","T1",2023-10-08,"Hatayspor","Konyaspor",3,1,"H",1,1,"D",2.77,3.17,2.85,"1-1","3-1",10,5,8,5,2,0,0,0,3,2,19,10,4,5,29,"3-2","Y","Y","Y",2,0,8
"4652","T1",2023-10-08,"Kasimpasa","Fenerbahce",0,2,"A",0,2,"A",6.76,5.01,1.46,"0-2","0-2",6,1,20,7,5,0,0,0,1,8,13,12,2,9,25,"1-8","Y","N","N",5,0,8
"4653","T1",2023-10-21,"Kayserispor","Rizespor",3,1,"H",1,0,"H",2.28,3.33,3.17,"1-0","3-1",20,7,12,3,5,2,0,0,5,2,13,12,4,7,25,"5-2","Y","Y","Y",7,0,8
"4654","T1",2023-10-21,"Gaziantep","Antalyaspor",1,0,"H",0,0,"D",2.84,3.23,2.74,"0-0","1-0",10,2,8,2,1,2,0,0,6,4,16,14,1,10,30,"6-4","N","N","N",3,0,9
"4655","T1",2023-10-21,"Konyaspor","Pendikspor",1,2,"A",0,0,"D",1.78,3.82,4.82,"0-0","1-2",16,8,8,3,1,3,0,0,5,2,4,12,3,7,16,"5-2","Y","Y","N",4,0,9
"4656","T1",2023-10-21,"Galatasaray","Besiktas",2,1,"H",1,0,"H",1.64,4.44,5.11,"1-0","2-1",25,10,2,2,3,5,0,1,6,2,12,19,3,8,31,"6-2","Y","Y","N",8,1,9
"4657","T1",2023-10-22,"Sivasspor","Kasimpasa",0,1,"A",0,0,"D",2.28,3.57,3.24,"0-0","0-1",17,8,17,6,0,2,0,0,7,8,10,9,1,15,19,"7-8","N","N","N",2,0,9
"4658","T1",2023-10-22,"Istanbulspor","Ankaragucu",2,1,"H",1,1,"D",3.32,3.59,2.22,"1-1","2-1",7,3,9,1,0,3,0,0,2,5,14,14,3,7,28,"2-5","Y","Y","N",3,0,9
"4659","T1",2023-10-22,"Fenerbahce","Hatayspor",4,2,"H",3,0,"H",1.22,7.29,12.61,"3-0","4-2",17,6,8,5,1,4,0,0,7,5,10,14,6,12,24,"7-5","Y","Y","Y",5,0,9
"4660","T1",2023-10-22,"Samsunspor","Buyuksehyr",0,0,"D",0,0,"D",2.48,3.44,2.99,"0-0","0-0",20,5,7,0,2,2,0,0,8,0,17,8,0,8,25,"8-0","N","N","N",4,0,9
"4661","T1",2023-10-23,"Karagumruk","Ad. Demirspor",2,0,"H",0,0,"D",3.49,3.88,2.04,"0-0","2-0",10,6,11,5,0,1,0,0,5,4,18,8,2,9,26,"5-4","Y","N","N",1,0,9
"4662","T1",2023-10-23,"Trabzonspor","Alanyaspor",1,0,"H",0,0,"D",1.65,4.24,5.08,"0-0","1-0",14,3,15,3,1,2,0,0,7,5,15,4,1,12,19,"7-5","N","N","N",3,0,9
"4663","T1",2023-10-27,"Hatayspor","Kayserispor",1,2,"A",0,1,"A",2.29,3.46,3.3,"0-1","1-2",18,9,8,2,5,0,0,0,12,1,10,15,3,13,25,"12-1","Y","Y","N",5,0,9
"4664","T1",2023-10-27,"Kasimpasa","Istanbulspor",3,1,"H",1,0,"H",1.81,4.08,4.29,"1-0","3-1",19,11,17,6,2,2,0,0,8,5,13,11,4,13,24,"8-5","Y","Y","Y",4,0,10
"4665","T1",2023-10-28,"Alanyaspor","Sivasspor",1,2,"A",0,0,"D",2.17,3.63,3.43,"0-0","1-2",12,5,15,4,3,1,0,0,7,2,13,12,3,9,25,"7-2","Y","Y","N",4,0,10
"4666","T1",2023-10-28,"Ad. Demirspor","Konyaspor",3,0,"H",0,0,"D",1.7,4.34,4.69,"0-0","3-0",15,5,13,4,1,1,0,0,4,5,12,10,3,9,22,"4-5","Y","Y","N",2,0,10
"4667","T1",2023-10-28,"Rizespor","Galatasaray",0,1,"A",0,0,"D",5.88,4.68,1.54,"0-0","0-1",11,3,20,5,2,2,0,0,6,5,14,11,1,11,25,"6-5","N","N","N",4,0,10
"4668","T1",2023-10-29,"Karagumruk","Trabzonspor",0,0,"D",0,0,"D",3.07,3.51,2.4,"0-0","0-0",6,3,12,0,2,1,0,0,6,3,8,11,0,9,19,"6-3","N","N","N",3,0,10
"4669","T1",2023-10-29,"Ankaragucu","Samsunspor",2,0,"H",0,0,"D",2.39,3.51,3.07,"0-0","2-0",12,5,3,2,0,2,0,0,4,6,8,14,2,10,22,"4-6","Y","N","N",2,0,10
"4670","T1",2023-10-29,"Antalyaspor","Buyuksehyr",1,0,"H",1,0,"H",2.25,3.35,3.47,"1-0","1-0",11,1,8,3,3,5,0,0,7,5,20,19,1,12,39,"7-5","N","N","N",8,0,10
"4671","T1",2023-10-29,"Pendikspor","Fenerbahce",0,5,"A",0,2,"A",9.36,6.08,1.32,"0-2","0-5",2,0,19,10,1,2,0,0,0,7,7,11,5,7,18,"0-7","Y","Y","Y",3,0,10
"4672","T1",2023-10-30,"Besiktas","Gaziantep",2,0,"H",0,0,"D",1.38,5.21,8.18,"0-0","2-0",13,6,12,6,2,5,1,1,7,3,15,16,2,10,31,"7-3","Y","N","N",7,2,10
"4673","T1",2023-11-03,"Galatasaray","Kasimpasa",2,1,"H",1,0,"H",1.21,7.89,11.86,"1-0","2-1",13,3,12,5,2,3,0,0,5,3,11,12,3,8,23,"5-3","Y","Y","N",5,0,10
"4674","T1",2023-11-04,"Istanbulspor","Pendikspor",2,4,"A",1,2,"A",2.46,3.58,2.93,"1-2","2-4",15,4,22,11,2,3,0,0,4,7,14,8,6,11,22,"4-7","Y","Y","Y",5,0,11
"4675","T1",2023-11-04,"Samsunspor","Hatayspor",2,1,"H",0,1,"A",2.21,3.41,3.54,"0-1","2-1",15,6,10,3,3,7,0,1,12,4,7,16,3,16,23,"12-4","Y","Y","N",10,1,11
"4676","T1",2023-11-04,"Fenerbahce","Trabzonspor",2,3,"A",0,1,"A",1.35,5.58,9.05,"0-1","2-3",12,4,6,4,5,4,1,0,10,4,14,27,5,14,41,"10-4","Y","Y","Y",9,1,11
"4677","T1",2023-11-05,"Sivasspor","Ad. Demirspor",1,1,"D",1,0,"H",3.04,3.75,2.31,"1-0","1-1",19,10,14,4,1,3,0,0,5,6,14,15,2,11,29,"5-6","Y","N","N",4,0,11
"4678","T1",2023-11-05,"Buyuksehyr","Ankaragucu",3,3,"D",2,2,"D",2.2,3.41,3.58,"2-2","3-3",9,4,10,5,2,0,0,0,1,3,7,12,6,4,19,"1-3","Y","Y","Y",2,0,11
"4679","T1",2023-11-05,"Konyaspor","Karagumruk",1,1,"D",0,0,"D",2.15,3.53,3.58,"0-0","1-1",10,3,9,2,2,4,0,0,2,8,13,19,2,10,32,"2-8","Y","N","N",6,0,11
"4680","T1",2023-11-05,"Antalyaspor","Besiktas",3,2,"H",0,1,"A",3.26,3.56,2.27,"0-1","3-2",5,3,17,5,1,3,0,0,3,6,13,13,5,9,26,"3-6","Y","Y","Y",4,0,11
"4681","T1",2023-11-06,"Gaziantep","Rizespor",2,0,"H",1,0,"H",2.31,3.47,3.2,"1-0","2-0",9,5,14,2,3,1,0,0,3,5,8,8,2,8,16,"3-5","Y","N","N",4,0,11
"4682","T1",2023-11-06,"Kayserispor","Alanyaspor",1,0,"H",0,0,"D",2.16,3.49,3.52,"0-0","1-0",12,4,9,6,1,3,0,0,8,5,17,9,1,13,26,"8-5","N","N","N",4,0,11
"4683","T1",2023-11-08,"Samsunspor","Istanbulspor",2,1,"H",0,1,"A",1.9,3.81,4.1,"0-1","2-1",12,4,6,3,3,5,0,0,7,2,16,12,3,9,28,"7-2","Y","Y","N",8,0,11
"4684","T1",2023-11-10,"Ankaragucu","Antalyaspor",0,4,"A",0,2,"A",2.54,3.36,2.98,"0-2","0-4",10,2,21,9,3,0,0,0,2,5,9,11,4,7,20,"2-5","Y","Y","Y",3,0,12
"4685","T1",2023-11-10,"Trabzonspor","Konyaspor",2,1,"H",0,0,"D",1.68,3.99,5.48,"0-0","2-1",13,5,13,3,1,3,0,0,6,4,16,14,3,10,30,"6-4","Y","Y","N",4,0,12
"4686","T1",2023-11-11,"Kasimpasa","Kayserispor",3,4,"A",1,3,"A",2.32,3.66,3.09,"1-3","3-4",19,9,8,5,0,1,0,0,6,4,4,15,7,10,19,"6-4","Y","Y","Y",1,0,12
"4687","T1",2023-11-11,"Alanyaspor","Gaziantep",0,3,"A",0,2,"A",2.29,3.55,3.24,"0-2","0-3",13,3,9,5,3,1,0,0,8,1,12,10,3,9,22,"8-1","Y","Y","N",4,0,12
"4688","T1",2023-11-11,"Karagumruk","Sivasspor",3,0,"H",1,0,"H",2.25,3.4,3.44,"1-0","3-0",13,7,11,3,2,2,0,0,5,4,16,4,3,9,20,"5-4","Y","Y","N",4,0,12
"4689","T1",2023-11-11,"Hatayspor","Galatasaray",2,1,"H",1,1,"D",6.95,5.17,1.44,"1-1","2-1",6,4,18,6,2,1,0,0,2,9,16,11,3,11,27,"2-9","Y","Y","N",3,0,12
"4690","T1",2023-11-12,"Pendikspor","Samsunspor",1,0,"H",0,0,"D",3.1,3.51,2.38,"0-0","1-0",10,4,16,8,1,3,0,0,4,3,10,18,1,7,28,"4-3","N","N","N",4,0,12
"4691","T1",2023-11-12,"Besiktas","Buyuksehyr",1,0,"H",0,0,"D",1.79,3.93,4.58,"0-0","1-0",12,4,7,2,2,3,0,0,5,6,18,17,1,11,35,"5-6","N","N","N",5,0,12
"4692","T1",2023-11-12,"Rizespor","Istanbulspor",1,0,"H",1,0,"H",1.76,3.99,4.72,"1-0","1-0",8,3,7,0,1,0,0,0,6,6,17,7,1,12,24,"6-6","N","N","N",1,0,12
"4693","T1",2023-11-12,"Ad. Demirspor","Fenerbahce",0,0,"D",0,0,"D",3.6,4.21,1.94,"0-0","0-0",4,0,18,9,3,3,0,0,3,5,13,15,0,8,28,"3-5","N","N","N",6,0,12
"4694","T1",2023-11-25,"Istanbulspor","Hatayspor",2,1,"H",1,0,"H",3.26,3.61,2.25,"1-0","2-1",15,10,10,3,2,3,0,0,8,6,9,14,3,14,23,"8-6","Y","Y","N",5,0,13
"4695","T1",2023-11-25,"Gaziantep","Ankaragucu",0,1,"A",0,1,"A",2.19,3.39,3.6,"0-1","0-1",9,2,12,5,4,5,0,0,2,4,8,19,1,6,27,"2-4","N","N","N",9,0,13
"4696","T1",2023-11-25,"Konyaspor","Kasimpasa",2,0,"H",0,0,"D",2.01,3.71,3.82,"0-0","2-0",17,7,8,1,0,1,0,0,2,9,11,12,2,11,23,"2-9","Y","N","N",1,0,13
"4697","T1",2023-11-25,"Galatasaray","Alanyaspor",4,0,"H",2,0,"H",1.15,7.14,11.19,"2-0","4-0",26,11,4,1,1,1,0,0,9,3,12,8,4,12,20,"9-3","Y","Y","Y",2,0,13
"4698","T1",2023-11-26,"Kayserispor","Ad. Demirspor",1,1,"D",0,1,"A",2.67,4.03,2.47,"0-1","1-1",14,4,9,3,3,3,0,0,9,4,23,8,2,13,31,"9-4","Y","N","N",6,0,13
"4699","T1",2023-11-26,"Antalyaspor","Rizespor",0,0,"D",0,0,"D",1.86,3.7,4.5,"0-0","0-0",16,10,8,3,1,5,0,0,6,4,12,17,0,10,29,"6-4","N","N","N",6,0,13
"4700","T1",2023-11-26,"Samsunspor","Besiktas",1,2,"A",1,1,"D",3.41,3.56,2.19,"1-1","1-2",13,5,16,5,2,1,0,0,9,5,17,9,3,14,26,"9-5","Y","Y","N",3,0,13
"4701","T1",2023-11-26,"Fenerbahce","Karagumruk",2,1,"H",0,1,"A",1.24,6.94,11.63,"0-1","2-1",9,3,9,2,5,4,0,0,1,2,20,17,3,3,37,"1-2","Y","Y","N",9,0,13
"4702","T1",2023-11-27,"Buyuksehyr","Pendikspor",4,1,"H",1,1,"D",1.8,3.78,4.62,"1-1","4-1",10,5,12,3,1,2,0,0,7,4,13,14,5,11,27,"7-4","Y","Y","Y",3,0,13
"4703","T1",2023-11-27,"Sivasspor","Trabzonspor",3,3,"D",2,2,"D",3.51,3.35,2.18,"2-2","3-3",17,9,13,6,1,1,0,0,5,2,11,10,6,7,21,"5-2","Y","Y","Y",2,0,13
"4704","T1",2023-12-01,"Hatayspor","Antalyaspor",3,3,"D",1,1,"D",3.08,3.4,2.44,"1-1","3-3",14,8,13,7,2,2,0,0,6,5,14,5,6,11,19,"6-5","Y","Y","Y",4,0,14
"4705","T1",2023-12-01,"Karagumruk","Istanbulspor",3,0,"H",1,0,"H",1.7,3.89,5.36,"1-0","3-0",15,5,6,0,3,1,0,0,3,5,12,9,3,8,21,"3-5","Y","Y","N",4,0,14
"4706","T1",2023-12-02,"Alanyaspor","Konyaspor",2,2,"D",2,1,"H",2.27,3.36,3.15,"2-1","2-2",19,5,13,6,2,2,0,0,4,6,10,20,4,10,30,"4-6","Y","Y","Y",4,0,14
"4707","T1",2023-12-02,"Rizespor","Buyuksehyr",3,2,"H",2,2,"D",2.5,3.34,3.05,"2-2","3-2",19,7,16,9,2,3,0,0,6,5,10,13,5,11,23,"6-5","Y","Y","Y",5,0,14
"4708","T1",2023-12-02,"Ad. Demirspor","Samsunspor",2,3,"A",1,2,"A",1.74,4.44,4.34,"1-2","2-3",11,4,11,6,2,2,0,0,7,4,9,13,5,11,22,"7-4","Y","Y","Y",4,0,14
"4709","T1",2023-12-02,"Pendikspor","Galatasaray",0,2,"A",0,0,"D",9.28,6.01,1.32,"0-0","0-2",9,0,18,6,2,3,0,0,2,6,8,11,2,8,19,"2-6","Y","N","N",5,0,14
"4710","T1",2023-12-03,"Kasimpasa","Gaziantep",4,2,"H",3,0,"H",2.31,3.53,3.22,"3-0","4-2",24,7,15,4,5,5,1,0,5,6,19,13,6,11,32,"5-6","Y","Y","Y",10,1,14
"4711","T1",2023-12-03,"Trabzonspor","Kayserispor",0,1,"A",0,0,"D",1.79,3.92,4.58,"0-0","0-1",15,2,9,4,3,2,0,0,4,2,7,15,1,6,22,"4-2","N","N","N",5,0,14
"4712","T1",2023-12-03,"Ankaragucu","Besiktas",1,1,"D",1,0,"H",3.47,3.61,2.16,"1-0","1-1",11,4,9,4,1,1,0,0,1,5,19,10,2,6,29,"1-5","Y","N","N",2,0,14
"4713","T1",2023-12-04,"Fenerbahce","Sivasspor",4,1,"H",2,0,"H",1.23,6.95,11.81,"2-0","4-1",8,5,9,3,1,1,0,0,4,2,18,12,5,6,30,"4-2","Y","Y","Y",2,0,14
"4714","T1",2023-12-08,"Galatasaray","Ad. Demirspor",3,1,"H",2,1,"H",1.27,6.64,9.99,"2-1","3-1",22,7,13,5,2,0,0,0,7,4,15,9,4,11,24,"7-4","Y","Y","Y",2,0,15
"4715","T1",2023-12-09,"Antalyaspor","Karagumruk",2,1,"H",2,1,"H",1.85,3.81,4.4,"2-1","2-1",2,2,11,2,4,7,1,0,2,4,15,17,3,6,32,"2-4","Y","Y","N",11,1,15
"4716","T1",2023-12-09,"Samsunspor","Kasimpasa",4,2,"H",2,0,"H",2.1,3.71,3.23,"2-0","4-2",12,7,13,6,1,0,0,0,3,4,15,9,6,7,24,"3-4","Y","Y","Y",1,0,15
"4717","T1",2023-12-09,"Besiktas","Fenerbahce",1,3,"A",1,1,"D",3.95,3.61,1.89,"1-1","1-3",4,1,23,10,5,4,0,0,1,6,18,13,4,7,31,"1-6","Y","Y","Y",9,0,15
"4718","T1",2023-12-10,"Istanbulspor","Alanyaspor",0,1,"A",0,0,"D",2.76,3.5,2.63,"0-0","0-1",11,2,18,7,1,2,0,0,1,9,23,10,1,10,33,"1-9","N","N","N",3,0,15
"4719","T1",2023-12-10,"Buyuksehyr","Hatayspor",1,0,"H",1,0,"H",1.99,3.56,4.06,"1-0","1-0",9,4,16,3,3,3,1,0,1,7,19,18,1,8,37,"1-7","N","N","N",6,1,15
"4720","T1",2023-12-10,"Kayserispor","Pendikspor",2,0,"H",0,0,"D",1.89,3.93,4.05,"0-0","2-0",11,5,11,4,0,1,0,0,4,5,9,9,2,9,18,"4-5","Y","N","N",1,0,15
"4721","T1",2023-12-10,"Gaziantep","Trabzonspor",1,3,"A",0,0,"D",3.23,3.34,2.39,"0-0","1-3",8,4,20,11,1,2,0,0,2,3,6,11,4,5,17,"2-3","Y","Y","Y",3,0,15
"4722","T1",2023-12-11,"Ankaragucu","Rizespor",1,1,"D",1,0,"H",2.12,3.41,3.71,"1-0","1-1",15,7,13,2,4,6,1,1,2,1,11,19,2,3,30,"2-1","Y","N","N",10,2,15
"4723","T1",2023-12-11,"Konyaspor","Sivasspor",0,1,"A",0,1,"A",2.14,3.43,3.64,"0-1","0-1",13,1,10,3,3,4,0,0,7,2,8,13,1,9,21,"7-2","N","N","N",7,0,15
"4724","T1",2023-12-19,"Buyuksehyr","Sivasspor",3,1,"H",1,1,"D",2.29,3.48,3.29,"1-1","3-1",15,6,7,4,1,2,0,0,3,1,22,11,4,4,33,"3-1","Y","Y","Y",3,0,16
"4725","T1",2023-12-19,"Gaziantep","Ad. Demirspor",2,2,"D",1,0,"H",2.78,3.79,2.47,"1-0","2-2",15,5,15,7,0,1,0,0,5,5,15,9,4,10,24,"5-5","Y","Y","Y",1,0,16
"4726","T1",2023-12-20,"Kayserispor","Fenerbahce",3,4,"A",1,2,"A",6.76,4.95,1.47,"1-2","3-4",16,6,13,6,2,5,0,2,5,3,22,11,7,8,33,"5-3","Y","Y","Y",7,2,16
"4727","T1",2023-12-20,"Antalyaspor","Kasimpasa",0,0,"D",0,0,"D",1.77,4.07,4.57,"0-0","0-0",9,1,6,3,2,2,0,0,5,11,10,11,0,16,21,"5-11","N","N","N",4,0,16
"4728","T1",2023-12-20,"Galatasaray","Karagumruk",1,0,"H",1,0,"H",1.24,7.01,11.7,"1-0","1-0",18,8,7,3,3,3,0,0,7,4,11,11,1,11,22,"7-4","N","N","N",6,0,16
"4729","T1",2023-12-21,"Rizespor","Pendikspor",5,1,"H",3,1,"H",1.93,3.8,4.05,"3-1","5-1",8,5,12,5,2,3,0,1,5,6,9,11,6,11,20,"5-6","Y","Y","Y",5,1,16
"4730","T1",2023-12-21,"Samsunspor","Konyaspor",1,1,"D",0,1,"A",2.05,3.65,3.74,"0-1","1-1",8,3,12,2,3,0,0,0,4,8,18,11,2,12,29,"4-8","Y","N","N",3,0,16
"4731","T1",2023-12-21,"Ankaragucu","Hatayspor",0,0,"D",0,0,"D",2,3.75,3.81,"0-0","0-0",13,4,11,5,0,2,0,0,6,5,9,15,0,11,24,"6-5","N","N","N",2,0,16
"4732","T1",2023-12-21,"Besiktas","Alanyaspor",1,3,"A",1,1,"D",1.53,4.67,6.02,"1-1","1-3",16,3,10,3,3,2,0,0,10,3,16,7,4,13,23,"10-3","Y","Y","Y",5,0,16
"4733","T1",2023-12-23,"Sivasspor","Istanbulspor",1,0,"H",0,0,"D",1.68,4.22,4.99,"0-0","1-0",16,6,6,0,0,2,0,0,9,7,7,12,1,16,19,"9-7","N","N","N",2,0,16
"4734","T1",2023-12-23,"Karagumruk","Gaziantep",0,3,"A",0,1,"A",2.08,3.4,3.92,"0-1","0-3",9,3,7,3,3,1,0,0,2,3,15,9,3,5,24,"2-3","Y","Y","N",4,0,17
"4735","T1",2023-12-23,"Trabzonspor","Buyuksehyr",1,1,"D",1,1,"D",1.69,3.93,5.39,"1-1","1-1",18,4,6,1,0,2,0,0,5,6,13,18,2,11,31,"5-6","Y","N","N",2,0,17
"4736","T1",2023-12-24,"Konyaspor","Kayserispor",2,0,"H",0,0,"D",2.44,3.57,2.95,"0-0","2-0",11,4,13,4,1,4,0,0,2,5,6,19,2,7,25,"2-5","Y","N","N",5,0,17
"4737","T1",2023-12-24,"Ad. Demirspor","Antalyaspor",2,1,"H",2,0,"H",2.09,4.02,3.31,"2-0","2-1",6,2,22,3,4,2,0,0,1,10,17,10,3,11,27,"1-10","Y","Y","N",6,0,17
"4738","T1",2023-12-24,"Fenerbahce","Galatasaray",0,0,"D",0,0,"D",2.25,3.71,3.19,"0-0","0-0",6,0,8,1,3,4,0,0,2,6,19,26,0,8,45,"2-6","N","N","N",7,0,17
"4739","T1",2023-12-25,"Alanyaspor","Samsunspor",3,1,"H",2,0,"H",2.43,3.39,3.06,"2-0","3-1",15,7,17,3,1,4,0,0,3,4,9,19,4,7,28,"3-4","Y","Y","Y",5,0,17
"4740","T1",2023-12-25,"Kasimpasa","Rizespor",2,2,"D",1,1,"D",2.06,3.63,3.66,"1-1","2-2",21,9,11,3,0,1,0,0,3,4,9,16,4,7,25,"3-4","Y","Y","Y",1,0,17
"4741","T1",2023-12-25,"Hatayspor","Besiktas",1,2,"A",0,1,"A",3.18,3.67,2.24,"0-1","1-2",7,2,15,7,1,1,0,0,5,8,11,9,3,13,20,"5-8","Y","Y","N",2,0,17
"4742","T1",2023-12-25,"Pendikspor","Ankaragucu",1,1,"D",0,1,"A",3.01,3.52,2.4,"0-1","1-1",14,4,8,1,0,3,0,0,5,3,10,12,2,8,22,"5-3","Y","N","N",3,0,17
"4743","T1",2024-01-05,"Gaziantep","Pendikspor",2,2,"D",1,0,"H",2.03,3.63,3.82,"1-0","2-2",9,2,8,4,2,6,0,0,1,5,7,16,4,6,23,"1-5","Y","Y","Y",8,0,17
"4744","T1",2024-01-05,"Antalyaspor","Alanyaspor",0,0,"D",0,0,"D",2.16,3.42,3.67,"0-0","0-0",11,2,8,2,2,0,0,0,9,5,15,12,0,14,27,"9-5","N","N","N",2,0,18
"4745","T1",2024-01-05,"Besiktas","Kasimpasa",1,3,"A",1,1,"D",1.58,4.66,5.47,"1-1","1-3",10,3,14,7,2,2,0,0,4,3,20,13,4,7,33,"4-3","Y","Y","Y",4,0,18
"4746","T1",2024-01-06,"Rizespor","Hatayspor",2,0,"H",1,0,"H",2.12,3.57,3.62,"1-0","2-0",10,3,16,0,0,2,0,0,3,4,11,10,2,7,21,"3-4","Y","N","N",2,0,18
"4747","T1",2024-01-06,"Buyuksehyr","Ad. Demirspor",0,0,"D",0,0,"D",2.03,3.8,3.66,"0-0","0-0",8,1,11,4,3,0,0,0,6,6,11,12,0,12,23,"6-6","N","N","N",3,0,18
"4748","T1",2024-01-06,"Ankaragucu","Trabzonspor",0,1,"A",0,1,"A",3.4,3.5,2.23,"0-1","0-1",16,2,10,2,1,1,0,0,4,3,18,8,1,7,26,"4-3","N","N","N",2,0,18
"4749","T1",2024-01-06,"Samsunspor","Karagumruk",1,0,"H",0,0,"D",2.13,3.54,3.61,"0-0","1-0",12,4,7,1,2,3,0,0,3,5,22,14,1,8,36,"3-5","N","N","N",5,0,18
"4750","T1",2024-01-07,"Kayserispor","Sivasspor",1,3,"A",1,1,"D",2.02,3.61,3.91,"1-1","1-3",15,3,10,5,4,3,0,0,7,7,8,11,4,14,19,"7-7","Y","Y","Y",7,0,18
"4751","T1",2024-01-07,"Istanbulspor","Fenerbahce",1,5,"A",1,4,"A",12.53,7.23,1.22,"1-4","1-5",15,8,23,15,3,1,0,0,4,8,12,13,6,12,25,"4-8","Y","Y","Y",4,0,18
"4752","T1",2024-01-07,"Galatasaray","Konyaspor",3,0,"H",0,0,"D",1.26,6.42,11.68,"0-0","3-0",27,9,7,4,3,3,0,0,13,3,20,14,3,16,34,"13-3","Y","Y","N",6,0,18
"4753","T1",2024-01-09,"Alanyaspor","Ankaragucu",1,1,"D",0,0,"D",2.26,3.39,3.45,"0-0","1-1",8,3,11,3,3,2,1,1,3,3,10,10,2,6,20,"3-3","Y","N","N",5,2,18
"4754","T1",2024-01-09,"Pendikspor","Antalyaspor",0,1,"A",0,1,"A",3.02,3.54,2.42,"0-1","0-1",14,3,12,2,2,4,0,0,5,7,10,16,1,12,26,"5-7","N","N","N",6,0,19
"4755","T1",2024-01-09,"Kasimpasa","Buyuksehyr",0,3,"A",0,1,"A",2.4,3.58,3.02,"0-1","0-3",15,1,7,5,2,1,0,0,6,3,16,12,3,9,28,"6-3","Y","Y","N",3,0,19
"4756","T1",2024-01-09,"Rizespor","Besiktas",0,4,"A",0,2,"A",2.38,3.59,3.04,"0-2","0-4",28,7,15,7,3,1,0,0,10,5,10,15,4,15,25,"10-5","Y","Y","Y",4,0,19
"4757","T1",2024-01-10,"Hatayspor","Gaziantep",0,0,"D",0,0,"D",2.06,3.59,3.78,"0-0","0-0",14,7,7,2,3,0,0,0,5,5,14,4,0,10,18,"5-5","N","N","N",3,0,19
"4758","T1",2024-01-10,"Karagumruk","Kayserispor",4,1,"H",3,1,"H",2.16,3.65,3.44,"3-1","4-1",15,10,14,6,0,2,0,0,5,3,9,6,5,8,15,"5-3","Y","Y","Y",2,0,19
"4759","T1",2024-01-10,"Ad. Demirspor","Istanbulspor",2,2,"D",1,0,"H",1.35,5.8,8.56,"1-0","2-2",18,7,13,5,0,3,0,0,7,7,6,15,4,14,21,"7-7","Y","Y","Y",3,0,19
"4760","T1",2024-01-10,"Fenerbahce","Konyaspor",7,1,"H",5,0,"H",1.23,6.8,13.26,"5-0","7-1",17,11,6,1,1,2,0,0,7,0,14,8,8,7,22,"7-0","Y","Y","Y",3,0,19
"4761","T1",2024-01-11,"Sivasspor","Galatasaray",1,1,"D",0,1,"A",6.91,4.64,1.49,"0-1","1-1",14,5,21,8,0,3,0,1,4,8,9,21,2,12,30,"4-8","Y","N","N",3,1,19
"4762","T1",2024-01-11,"Trabzonspor","Samsunspor",2,1,"H",2,0,"H",1.72,3.97,5.06,"2-0","2-1",13,7,19,8,3,1,0,0,5,1,12,19,3,6,31,"5-1","Y","Y","N",4,0,19
"4763","T1",2024-01-13,"Ankaragucu","Kasimpasa",3,1,"H",1,1,"D",2.16,3.74,3.36,"1-1","3-1",12,8,16,2,1,1,0,0,2,5,14,15,4,7,29,"2-5","Y","Y","Y",2,0,19
"4764","T1",2024-01-13,"Hatayspor","Pendikspor",1,1,"D",0,0,"D",2.2,3.56,3.42,"0-0","1-1",8,4,12,2,4,1,0,0,4,6,8,10,2,10,18,"4-6","Y","N","N",5,0,20
"4765","T1",2024-01-13,"Buyuksehyr","Alanyaspor",3,2,"H",2,1,"H",1.96,3.46,4.35,"2-1","3-2",11,6,13,3,1,1,0,0,4,3,19,12,5,7,31,"4-3","Y","Y","Y",2,0,20
"4766","T1",2024-01-13,"Besiktas","Karagumruk",3,0,"H",0,0,"D",1.66,4.17,5.28,"0-0","3-0",19,6,7,3,3,0,0,0,6,4,17,9,3,10,26,"6-4","Y","Y","N",3,0,20
"4767","T1",2024-01-13,"Rizespor","Ad. Demirspor",1,0,"H",0,0,"D",2.22,3.92,3.1,"0-0","1-0",15,6,15,3,1,0,0,0,9,4,19,11,1,13,30,"9-4","N","N","N",1,0,20
"4768","T1",2024-01-14,"Istanbulspor","Konyaspor",0,0,"D",0,0,"D",3.47,3.67,2.14,"0-0","0-0",19,7,8,1,2,1,0,0,8,3,14,7,0,11,21,"8-3","N","N","N",3,0,20
"4769","T1",2024-01-14,"Antalyaspor","Trabzonspor",1,1,"D",0,1,"A",3.02,3.5,2.43,"0-1","1-1",14,3,4,2,1,0,0,0,6,2,17,9,2,8,26,"6-2","Y","N","N",1,0,20
"4770","T1",2024-01-14,"Samsunspor","Sivasspor",2,0,"H",2,0,"H",2.24,3.34,3.54,"2-0","2-0",16,10,6,2,5,0,1,1,5,2,22,10,2,7,32,"5-2","Y","N","N",5,2,20
"4771","T1",2024-01-14,"Gaziantep","Fenerbahce",0,1,"A",0,0,"D",8.7,5.57,1.36,"0-0","0-1",5,4,17,6,3,2,0,0,4,10,14,8,1,14,22,"4-10","N","N","N",5,0,20
"4772","T1",2024-01-15,"Galatasaray","Kayserispor",2,1,"H",1,0,"H",1.28,6.67,8.88,"1-0","2-1",29,8,10,3,1,6,0,0,8,5,7,17,3,13,24,"8-5","Y","Y","N",7,0,20
"4773","T1",2024-01-20,"Kasimpasa","Hatayspor",3,0,"H",0,0,"D",1.99,3.77,3.82,"0-0","3-0",16,4,5,2,1,2,0,0,5,7,5,10,3,12,15,"5-7","Y","Y","N",3,0,20
"4774","T1",2024-01-20,"Alanyaspor","Rizespor",2,1,"H",0,0,"D",2.33,3.55,3.16,"0-0","2-1",23,5,17,3,4,0,0,0,8,4,9,9,3,12,18,"8-4","Y","Y","N",4,0,21
"4775","T1",2024-01-20,"Karagumruk","Buyuksehyr",1,1,"D",0,1,"A",2.34,3.48,3.19,"0-1","1-1",14,5,16,6,3,2,1,0,4,3,16,13,2,7,29,"4-3","Y","N","N",5,1,21
"4776","T1",2024-01-20,"Ad. Demirspor","Ankaragucu",1,1,"D",0,0,"D",2.18,3.45,3.58,"0-0","1-1",12,4,9,3,0,1,0,0,6,5,11,13,2,11,24,"6-5","Y","N","N",1,0,21
"4777","T1",2024-01-20,"Pendikspor","Besiktas",4,0,"H",1,0,"H",3.99,3.94,1.91,"1-0","4-0",9,5,17,4,1,2,0,0,1,6,10,11,4,7,21,"1-6","Y","Y","Y",3,0,21
"4778","T1",2024-01-21,"Sivasspor","Gaziantep",2,2,"D",2,2,"D",2.02,3.38,4.21,"2-2","2-2",14,5,15,7,3,5,0,1,3,5,9,15,4,8,24,"3-5","Y","Y","Y",8,1,21
"4779","T1",2024-01-21,"Fenerbahce","Samsunspor",1,1,"D",1,0,"H",1.22,7.08,13.56,"1-0","1-1",21,7,6,4,1,3,0,0,8,1,7,14,2,9,21,"8-1","Y","N","N",4,0,21
"4780","T1",2024-01-21,"Konyaspor","Antalyaspor",1,1,"D",1,0,"H",2.75,3.35,2.73,"1-0","1-1",8,2,12,1,2,3,0,0,5,4,8,11,2,9,19,"5-4","Y","N","N",5,0,21
"4781","T1",2024-01-21,"Trabzonspor","Galatasaray",1,5,"A",0,1,"A",3.58,4.14,1.97,"0-1","1-5",16,1,16,10,1,4,0,0,11,6,14,17,6,17,31,"11-6","Y","Y","Y",5,0,21
"4782","T1",2024-01-22,"Kayserispor","Istanbulspor",0,1,"A",0,0,"D",1.6,4.49,5.24,"0-0","0-1",10,4,16,8,2,3,0,0,5,7,15,11,1,12,26,"5-7","N","N","N",5,0,21
"4783","T1",2024-01-23,"Hatayspor","Alanyaspor",1,1,"D",1,0,"H",2.35,3.38,3.27,"1-0","1-1",4,1,18,3,4,2,0,0,3,5,17,4,2,8,21,"3-5","Y","N","N",6,0,21
"4784","T1",2024-01-23,"Besiktas","Ad. Demirspor",0,0,"D",0,0,"D",1.81,4.01,4.39,"0-0","0-0",20,7,6,0,4,4,0,1,8,2,13,10,0,10,23,"8-2","N","N","N",8,1,22
"4785","T1",2024-01-23,"Pendikspor","Kasimpasa",3,2,"H",2,2,"D",2.58,3.71,2.7,"2-2","3-2",11,5,8,3,2,2,0,0,6,2,12,10,5,8,22,"6-2","Y","Y","Y",4,0,22
"4786","T1",2024-01-24,"Ankaragucu","Karagumruk",2,0,"H",1,0,"H",2.33,3.18,3.51,"1-0","2-0",8,5,11,4,1,3,0,0,2,9,14,9,2,11,23,"2-9","Y","N","N",4,0,22
"4787","T1",2024-01-24,"Gaziantep","Konyaspor",1,1,"D",1,1,"D",2.2,3.51,3.47,"1-1","1-1",8,1,7,4,2,2,0,0,3,5,19,13,2,8,32,"3-5","Y","N","N",4,0,22
"4788","T1",2024-01-24,"Antalyaspor","Sivasspor",2,1,"H",2,1,"H",1.75,3.8,5.09,"2-1","2-1",24,12,8,4,2,1,0,0,8,6,10,15,3,14,25,"8-6","Y","Y","N",3,0,22
"4789","T1",2024-01-24,"Buyuksehyr","Fenerbahce",0,1,"A",0,0,"D",6,4.3,1.58,"0-0","0-1",4,1,31,9,9,4,2,0,1,7,16,14,1,8,30,"1-7","N","N","N",13,2,22
"4790","T1",2024-01-25,"Samsunspor","Kayserispor",2,0,"H",1,0,"H",2.01,3.87,3.69,"1-0","2-0",11,5,8,2,0,0,0,0,3,5,3,12,2,8,15,"3-5","Y","N","N",0,0,22
"4791","T1",2024-01-25,"Galatasaray","Istanbulspor",3,1,"H",1,1,"D",1.13,10.76,18.1,"1-1","3-1",16,4,6,2,2,5,0,1,3,2,11,22,4,5,33,"3-2","Y","Y","Y",7,1,22
"4792","T1",2024-01-25,"Rizespor","Trabzonspor",1,0,"H",0,0,"D",2.82,3.51,2.58,"0-0","1-0",15,5,10,3,3,1,0,0,3,3,21,12,1,6,33,"3-3","N","N","N",4,0,22
"4793","T1",2024-01-27,"Alanyaspor","Pendikspor",1,1,"D",0,0,"D",1.88,3.84,4.22,"0-0","1-1",8,2,10,3,2,1,0,0,5,5,9,15,2,10,24,"5-5","Y","N","N",3,0,22
"4794","T1",2024-01-27,"Ad. Demirspor","Hatayspor",0,1,"A",0,1,"A",1.97,3.77,3.91,"0-1","0-1",13,0,4,2,5,4,1,0,5,3,12,24,1,8,36,"5-3","N","N","N",9,1,23
"4795","T1",2024-01-28,"Konyaspor","Buyuksehyr",2,3,"A",2,0,"H",2.51,3.27,3.09,"2-0","2-3",12,3,15,5,3,2,0,0,1,4,6,12,5,5,18,"1-4","Y","Y","Y",5,0,23
"4796","T1",2024-01-28,"Karagumruk","Rizespor",4,0,"H",1,0,"H",2.43,3.55,2.99,"1-0","4-0",17,5,5,3,2,2,0,0,5,7,13,15,4,12,28,"5-7","Y","Y","Y",4,0,23
"4797","T1",2024-01-28,"Sivasspor","Besiktas",1,0,"H",1,0,"H",3.74,3.89,1.98,"1-0","1-0",8,4,14,3,6,4,0,0,3,10,22,9,1,13,31,"3-10","N","N","N",10,0,23
"4798","T1",2024-01-28,"Fenerbahce","Ankaragucu",2,1,"H",2,1,"H",1.18,7.9,15.93,"2-1","2-1",22,10,4,2,0,0,0,0,9,0,17,13,3,9,30,"9-0","Y","Y","N",0,0,23
"4799","T1",2024-01-29,"Istanbulspor","Samsunspor",1,1,"D",0,0,"D",3.47,3.63,2.13,"0-0","1-1",9,5,12,3,3,1,0,0,4,4,15,13,2,8,28,"4-4","Y","N","N",4,0,23
"4800","T1",2024-01-29,"Kayserispor","Antalyaspor",1,1,"D",0,1,"A",3.02,3.53,2.39,"0-1","1-1",15,5,13,3,2,1,0,0,6,7,13,12,2,13,25,"6-7","Y","N","N",3,0,23
"4801","T1",2024-01-29,"Galatasaray","Gaziantep",2,1,"H",0,1,"A",1.19,7.78,14.1,"0-1","2-1",33,9,6,4,1,5,0,0,13,2,7,10,3,15,17,"13-2","Y","Y","N",6,0,23
"4802","T1",2024-01-29,"Trabzonspor","Kasimpasa",2,3,"A",1,0,"H",1.71,4.21,4.68,"1-0","2-3",21,8,15,6,1,2,0,0,7,3,15,11,5,10,26,"7-3","Y","Y","Y",3,0,23
"4803","T1",2024-02-02,"Ankaragucu","Sivasspor",0,0,"D",0,0,"D",1.97,3.43,4.35,"0-0","0-0",10,2,9,5,2,2,0,0,7,1,7,10,0,8,17,"7-1","N","N","N",4,0,23
"4804","T1",2024-02-02,"Hatayspor","Karagumruk",3,1,"H",1,0,"H",3.04,3.12,2.65,"1-0","3-1",5,3,18,4,0,2,0,0,4,5,14,7,4,9,21,"4-5","Y","Y","Y",2,0,24
"4805","T1",2024-02-02,"Samsunspor","Galatasaray",0,2,"A",0,2,"A",5.08,4.12,1.69,"0-2","0-2",17,5,16,5,2,1,0,0,4,4,14,5,2,8,19,"4-4","Y","N","N",3,0,24
"4806","T1",2024-02-03,"Rizespor","Konyaspor",0,0,"D",0,0,"D",1.95,3.5,4.32,"0-0","0-0",24,3,19,6,1,1,0,0,12,4,9,10,0,16,19,"12-4","N","N","N",2,0,24
"4807","T1",2024-02-03,"Buyuksehyr","Istanbulspor",2,0,"H",1,0,"H",1.57,4.41,6,"1-0","2-0",22,9,7,3,1,1,0,0,8,3,8,9,2,11,17,"8-3","Y","N","N",2,0,24
"4808","T1",2024-02-03,"Antalyaspor","Fenerbahce",0,2,"A",0,1,"A",5.82,4.22,1.61,"0-1","0-2",16,5,14,7,1,0,0,0,6,7,13,17,2,13,30,"6-7","Y","N","N",1,0,24
"4809","T1",2024-02-03,"Gaziantep","Kayserispor",1,1,"D",0,1,"A",2.24,3.46,3.41,"0-1","1-1",12,3,15,4,2,4,0,0,9,4,10,12,2,13,22,"9-4","Y","N","N",6,0,24
"4810","T1",2024-02-04,"Pendikspor","Ad. Demirspor",2,1,"H",2,0,"H",2.28,3.68,3.15,"2-0","2-1",16,5,16,6,3,1,1,0,7,6,20,7,3,13,27,"7-6","Y","Y","N",4,1,24
"4811","T1",2024-02-04,"Kasimpasa","Alanyaspor",2,1,"H",1,1,"D",2.33,3.81,2.98,"1-1","2-1",19,7,7,3,0,4,0,0,7,9,10,8,3,16,18,"7-9","Y","Y","N",4,0,24
"4812","T1",2024-02-04,"Besiktas","Trabzonspor",2,0,"H",1,0,"H",2,3.49,4.11,"1-0","2-0",9,3,13,2,3,0,0,0,6,6,22,11,2,12,33,"6-6","Y","N","N",3,0,24
"4813","T1",2024-02-09,"Ad. Demirspor","Kasimpasa",1,3,"A",0,2,"A",2.31,3.7,3.07,"0-2","1-3",23,4,13,7,5,3,0,0,7,4,15,11,4,11,26,"7-4","Y","Y","Y",8,0,24
"4814","T1",2024-02-10,"Karagumruk","Pendikspor",2,0,"H",1,0,"H",2.27,3.55,3.28,"1-0","2-0",12,6,8,1,1,0,0,0,6,9,11,17,2,15,28,"6-9","Y","N","N",1,0,25
"4815","T1",2024-02-10,"Galatasaray","Buyuksehyr",2,0,"H",2,0,"H",1.31,5.86,10.36,"2-0","2-0",18,7,9,1,2,2,0,0,7,3,13,11,2,10,24,"7-3","Y","N","N",4,0,25
"4816","T1",2024-02-11,"Sivasspor","Rizespor",1,0,"H",1,0,"H",2.39,3.53,3.07,"1-0","1-0",7,2,17,5,1,1,0,0,0,6,15,10,1,6,25,"0-6","N","N","N",2,0,25
"4817","T1",2024-02-11,"Istanbulspor","Gaziantep",1,3,"A",1,1,"D",2.88,3.41,2.58,"1-1","1-3",3,1,8,5,4,2,1,0,3,3,14,12,4,6,26,"3-3","Y","Y","Y",6,1,25
"4818","T1",2024-02-11,"Konyaspor","Ankaragucu",1,0,"H",1,0,"H",2.67,3.15,2.98,"1-0","1-0",14,1,9,1,3,1,0,0,4,2,15,6,1,6,21,"4-2","N","N","N",4,0,25
"4819","T1",2024-02-11,"Fenerbahce","Alanyaspor",2,2,"D",0,1,"A",1.21,7.5,12.98,"0-1","2-2",21,8,5,3,3,5,0,0,9,0,10,20,4,9,30,"9-0","Y","Y","Y",8,0,25
"4820","T1",2024-02-12,"Trabzonspor","Hatayspor",2,0,"H",0,0,"D",1.79,3.63,4.91,"0-0","2-0",23,11,11,2,2,1,0,0,10,5,10,9,2,15,19,"10-5","Y","N","N",3,0,25
"4821","T1",2024-02-12,"Kayserispor","Besiktas",0,0,"D",0,0,"D",3.76,3.78,1.98,"0-0","0-0",14,4,6,1,3,0,0,0,7,3,17,9,0,10,26,"7-3","N","N","N",3,0,25
"4822","T1",2024-02-12,"Samsunspor","Antalyaspor",2,0,"H",0,0,"D",2.42,3.29,3.16,"0-0","2-0",11,6,11,2,2,2,0,0,3,2,18,8,2,5,26,"3-2","Y","N","N",4,0,25
"4823","T1",2024-02-16,"Kasimpasa","Karagumruk",1,1,"D",1,1,"D",2.63,3.72,2.64,"1-1","1-1",7,4,16,5,2,1,0,0,3,11,17,12,2,14,29,"3-11","Y","N","N",3,0,25
"4824","T1",2024-02-17,"Antalyaspor","Istanbulspor",2,2,"D",2,0,"H",1.51,4.48,6.89,"2-0","2-2",14,5,12,8,2,2,0,0,6,6,11,16,4,12,27,"6-6","Y","Y","Y",4,0,26
"4825","T1",2024-02-17,"Hatayspor","Sivasspor",1,1,"D",0,1,"A",2.38,3.32,3.26,"0-1","1-1",15,6,4,2,1,1,0,0,6,2,14,10,2,8,24,"6-2","Y","N","N",2,0,26
"4826","T1",2024-02-17,"Rizespor","Fenerbahce",1,3,"A",1,0,"H",6.91,4.78,1.48,"1-0","1-3",8,4,13,5,4,2,0,0,3,6,16,18,4,9,34,"3-6","Y","Y","Y",6,0,26
"4827","T1",2024-02-18,"Alanyaspor","Ad. Demirspor",3,3,"D",2,0,"H",2.04,3.73,3.71,"2-0","3-3",8,6,19,9,4,1,0,0,3,6,12,15,6,9,27,"3-6","Y","Y","Y",5,0,26
"4828","T1",2024-02-18,"Gaziantep","Samsunspor",1,1,"D",0,0,"D",2.56,3.32,2.98,"0-0","1-1",12,2,10,5,3,3,0,0,2,4,13,17,2,6,30,"2-4","Y","N","N",6,0,26
"4829","T1",2024-02-18,"Pendikspor","Trabzonspor",0,2,"A",0,0,"D",3.3,3.68,2.21,"0-0","0-2",7,1,11,3,0,1,0,0,4,6,12,12,2,10,24,"4-6","Y","N","N",1,0,26
"4830","T1",2024-02-18,"Ankaragucu","Galatasaray",0,3,"A",0,3,"A",6.74,4.51,1.51,"0-3","0-3",8,3,24,10,1,1,0,0,3,16,6,14,3,19,20,"3-16","Y","Y","N",2,0,26
"4831","T1",2024-02-19,"Besiktas","Konyaspor",2,0,"H",0,0,"D",1.56,4.38,5.93,"0-0","2-0",19,6,4,2,2,0,0,0,6,4,8,8,2,10,16,"6-4","Y","N","N",2,0,26
"4832","T1",2024-02-19,"Buyuksehyr","Kayserispor",2,3,"A",0,2,"A",1.75,3.63,5.26,"0-2","2-3",18,8,14,7,2,4,0,0,7,3,7,26,5,10,33,"7-3","Y","Y","Y",6,0,26
"4833","T1",2024-02-23,"Samsunspor","Rizespor",3,0,"H",1,0,"H",1.96,3.53,4.24,"1-0","3-0",15,3,11,4,2,1,0,0,2,8,19,8,3,10,27,"2-8","Y","Y","N",3,0,26
"4834","T1",2024-02-24,"Kayserispor","Ankaragucu",3,2,"H",0,2,"A",2.26,3.47,3.37,"0-2","3-2",10,4,9,5,4,3,0,0,4,3,10,13,5,7,23,"4-3","Y","Y","Y",7,0,27
"4835","T1",2024-02-24,"Gaziantep","Buyuksehyr",0,2,"A",0,0,"D",2.81,3.23,2.76,"0-0","0-2",13,6,4,4,1,3,0,0,5,0,13,12,2,5,25,"5-0","Y","N","N",4,0,27
"4836","T1",2024-02-24,"Fenerbahce","Kasimpasa",2,1,"H",0,0,"D",1.21,7.95,12.05,"0-0","2-1",18,5,10,2,2,3,0,0,4,3,10,23,3,7,33,"4-3","Y","Y","N",5,0,27
"4837","T1",2024-02-24,"Konyaspor","Hatayspor",2,0,"H",0,0,"D",2.34,3.23,3.43,"0-0","2-0",13,4,7,4,6,3,0,0,4,3,8,15,2,7,23,"4-3","Y","N","N",9,0,27
"4838","T1",2024-02-25,"Sivasspor","Pendikspor",4,1,"H",1,1,"D",2.21,3.44,3.51,"1-1","4-1",12,5,12,6,2,4,0,0,3,3,10,14,5,6,24,"3-3","Y","Y","Y",6,0,27
"4839","T1",2024-02-25,"Karagumruk","Alanyaspor",1,1,"D",1,0,"H",1.95,3.47,4.38,"1-0","1-1",6,1,19,3,3,2,1,0,1,11,10,14,2,12,24,"1-11","Y","N","N",5,1,27
"4840","T1",2024-02-25,"Trabzonspor","Ad. Demirspor",1,0,"H",1,0,"H",1.79,3.88,4.65,"1-0","1-0",19,7,12,3,2,3,0,1,4,5,16,16,1,9,32,"4-5","N","N","N",5,1,27
"4841","T1",2024-02-25,"Istanbulspor","Besiktas",0,2,"A",0,1,"A",6.04,4.41,1.56,"0-1","0-2",14,6,15,6,1,3,0,0,4,7,9,16,2,11,25,"4-7","Y","N","N",4,0,27
"4842","T1",2024-02-26,"Galatasaray","Antalyaspor",2,1,"H",2,1,"H",1.32,5.91,9.18,"2-1","2-1",14,8,15,4,2,4,0,0,5,6,14,14,3,11,28,"5-6","Y","Y","N",6,0,27
"4843","T1",2024-03-01,"Kasimpasa","Sivasspor",0,0,"D",0,0,"D",2.18,3.55,3.48,"0-0","0-0",17,3,7,3,2,1,0,0,5,1,16,10,0,6,26,"5-1","N","N","N",3,0,27
"4844","T1",2024-03-02,"Ankaragucu","Istanbulspor",1,1,"D",0,1,"A",1.47,4.55,7.58,"0-1","1-1",15,5,14,6,3,4,1,1,10,2,4,12,2,12,16,"10-2","Y","N","N",7,2,28
"4845","T1",2024-03-02,"Rizespor","Kayserispor",3,0,"H",0,0,"D",2.01,3.57,3.97,"0-0","3-0",21,8,14,6,1,3,0,0,3,2,11,13,3,5,24,"3-2","Y","Y","N",4,0,28
"4846","T1",2024-03-02,"Hatayspor","Fenerbahce",0,2,"A",0,2,"A",10.4,5.7,1.32,"0-2","0-2",10,1,14,6,1,5,0,0,3,4,14,14,2,7,28,"3-4","Y","N","N",6,0,28
"4847","T1",2024-03-03,"Buyuksehyr","Samsunspor",1,0,"H",0,0,"D",2.27,3.54,3.28,"0-0","1-0",10,6,8,2,0,3,0,1,5,5,6,13,1,10,19,"5-5","N","N","N",3,1,28
"4848","T1",2024-03-03,"Pendikspor","Konyaspor",0,2,"A",0,1,"A",2.23,3.57,3.34,"0-1","0-2",9,0,13,5,5,5,0,0,4,4,16,20,2,8,36,"4-4","Y","N","N",10,0,28
"4849","T1",2024-03-03,"Besiktas","Galatasaray",0,1,"A",0,1,"A",3.65,3.85,2.02,"0-1","0-1",12,3,13,3,2,0,1,0,4,11,7,14,1,15,21,"4-11","N","N","N",2,1,28
"4850","T1",2024-03-04,"Ad. Demirspor","Karagumruk",1,0,"H",1,0,"H",2.32,3.5,3.21,"1-0","1-0",13,5,12,1,4,4,0,1,7,7,17,12,1,14,29,"7-7","N","N","N",8,1,28
"4851","T1",2024-03-04,"Alanyaspor","Trabzonspor",3,1,"H",2,0,"H",3,3.53,2.4,"2-0","3-1",11,5,24,7,3,0,0,0,1,9,17,8,4,10,25,"1-9","Y","Y","Y",3,0,28
"4852","T1",2024-03-04,"Antalyaspor","Gaziantep",1,0,"H",1,0,"H",1.86,3.82,4.24,"1-0","1-0",20,10,8,3,1,2,0,0,11,5,12,11,1,16,23,"11-5","N","N","N",3,0,28
"4853","T1",2024-03-08,"Galatasaray","Rizespor",6,2,"H",4,1,"H",1.26,6.65,10.98,"4-1","6-2",14,10,10,4,1,1,0,0,3,3,18,13,8,6,31,"3-3","Y","Y","Y",2,0,28
"4854","T1",2024-03-09,"Sivasspor","Alanyaspor",1,2,"A",0,0,"D",2.57,3.36,2.93,"0-0","1-2",16,5,5,4,3,2,0,0,5,4,9,17,3,9,26,"5-4","Y","Y","N",5,0,29
"4855","T1",2024-03-09,"Konyaspor","Ad. Demirspor",2,2,"D",2,1,"H",2.49,3.34,3.06,"2-1","2-2",13,5,13,3,0,3,0,0,3,6,12,12,4,9,24,"3-6","Y","Y","Y",3,0,29
"4856","T1",2024-03-09,"Buyuksehyr","Antalyaspor",1,0,"H",0,0,"D",2.3,3.37,3.38,"0-0","1-0",12,4,9,0,1,1,0,0,10,3,11,10,1,13,21,"10-3","N","N","N",2,0,29
"4857","T1",2024-03-09,"Trabzonspor","Karagumruk",5,1,"H",1,1,"D",1.78,3.56,4.67,"1-1","5-1",27,12,6,2,0,3,0,0,8,2,10,13,6,10,23,"8-2","Y","Y","Y",3,0,29
"4858","T1",2024-03-10,"Kayserispor","Hatayspor",1,1,"D",1,1,"D",1.97,3.52,3.75,"1-1","1-1",18,3,5,1,3,3,1,0,3,2,10,13,2,5,23,"3-2","Y","N","N",6,1,29
"4859","T1",2024-03-10,"Istanbulspor","Kasimpasa",1,2,"A",1,0,"H",4.36,3.97,1.83,"1-0","1-2",8,2,24,9,2,0,0,0,4,9,10,6,3,13,16,"4-9","Y","Y","N",2,0,29
"4860","T1",2024-03-10,"Samsunspor","Ankaragucu",2,1,"H",1,1,"D",2.05,3.22,4.35,"1-1","2-1",22,4,7,2,1,3,0,0,2,2,13,14,3,4,27,"2-2","Y","Y","N",4,0,29
"4861","T1",2024-03-10,"Fenerbahce","Pendikspor",4,1,"H",0,1,"A",1.18,8.58,14.14,"0-1","4-1",20,7,4,1,7,8,0,2,8,1,15,29,5,9,44,"8-1","Y","Y","Y",15,2,29
"4862","T1",2024-03-11,"Gaziantep","Besiktas",2,0,"H",1,0,"H",3.91,3.6,2,"1-0","2-0",8,4,13,5,3,3,0,0,2,3,10,12,2,5,22,"2-3","Y","N","N",6,0,29
"4863","T1",2024-03-15,"Karagumruk","Konyaspor",1,1,"D",0,1,"A",2.03,3.3,4.32,"0-1","1-1",11,5,11,4,2,0,0,0,9,4,12,11,2,13,23,"9-4","Y","N","N",2,0,29
"4864","T1",2024-03-15,"Pendikspor","Istanbulspor",1,0,"H",0,0,"D",1.6,4.43,5.5,"0-0","1-0",19,5,3,1,1,6,0,1,6,2,12,20,1,8,32,"6-2","N","N","N",7,1,30
"4865","T1",2024-03-16,"Alanyaspor","Kayserispor",1,0,"H",0,0,"D",2.19,3.44,3.57,"0-0","1-0",8,3,13,3,1,3,0,0,0,3,11,18,1,3,29,"0-3","N","N","N",4,0,30
"4866","T1",2024-03-16,"Ankaragucu","Buyuksehyr",2,1,"H",0,0,"D",2.57,3.19,3.08,"0-0","2-1",13,6,12,4,0,2,0,0,1,2,10,10,3,3,20,"1-2","Y","Y","N",2,0,30
"4867","T1",2024-03-16,"Ad. Demirspor","Sivasspor",4,1,"H",1,0,"H",1.84,3.51,4.96,"1-0","4-1",13,7,6,2,3,2,1,0,3,6,11,13,5,9,24,"3-6","Y","Y","Y",5,1,30
"4868","T1",2024-03-16,"Besiktas","Antalyaspor",1,2,"A",0,2,"A",1.97,3.56,4.15,"0-2","1-2",20,7,10,2,2,3,0,0,8,5,11,14,3,13,25,"8-5","Y","Y","N",5,0,30
"4869","T1",2024-03-17,"Rizespor","Gaziantep",3,1,"H",0,0,"D",1.85,3.61,4.73,"0-0","3-1",10,6,14,8,1,2,0,0,6,8,14,10,4,14,24,"6-8","Y","Y","Y",3,0,30
"4870","T1",2024-03-17,"Hatayspor","Samsunspor",3,0,"H",1,0,"H",3.1,3.27,2.51,"1-0","3-0",9,3,12,2,4,1,0,0,0,7,13,9,3,7,22,"0-7","Y","Y","N",5,0,30
"4871","T1",2024-03-17,"Kasimpasa","Galatasaray",3,4,"A",1,1,"D",6.32,5.22,1.47,"1-1","3-4",16,5,12,6,4,1,1,0,2,4,12,8,7,6,20,"2-4","Y","Y","Y",5,1,30
"4872","T1",2024-03-17,"Trabzonspor","Fenerbahce",2,3,"A",0,2,"A",4.74,4.12,1.74,"0-2","2-3",7,3,7,5,5,3,0,0,10,2,13,18,5,12,31,"10-2","Y","Y","Y",8,0,30
