"","Div","Date","HomeTeam","AwayTeam","FTHG","FTAG","FTR","HTHG","HTAG","HTR","PSH","PSD","PSA","HTCS","CS","HS","HST","AS","AST","HY","AY","HR","AR","HCO","ACO","HF","AF","TG","TC","TF","COSC","OV15","OV25","OV35","TY","TR","all_matchday"
"1338","B1",2023-07-28,"St. Gilloise","Anderlecht",2,0,"H",1,0,"H",2.22,3.63,3.24,"1-0","2-0",10,3,5,2,5,3,0,0,3,3,16,13,2,6,29,"3-3","Y","N","N",8,0,1
"1339","B1",2023-07-29,"Eupen","Westerlo",2,2,"D",1,0,"H",3.56,3.56,2.12,"1-0","2-2",13,6,22,5,1,0,0,0,1,4,14,7,4,5,21,"1-4","Y","Y","Y",1,0,1
"1340","B1",2023-07-29,"Charleroi","Oud-Heverlee Leuven",1,1,"D",1,0,"H",2.03,3.73,3.65,"1-0","1-1",4,2,19,5,3,1,1,0,2,6,7,12,2,8,19,"2-6","Y","N","N",4,1,1
"1341","B1",2023-07-29,"RWD Molenbeek","Genk",0,4,"A",0,3,"A",3.67,3.9,1.98,"0-3","0-4",10,4,28,10,1,0,0,0,2,6,11,11,4,8,22,"2-6","Y","Y","Y",1,0,1
"1342","B1",2023-07-30,"Antwerp","Cercle Brugge",1,0,"H",1,0,"H",1.85,3.6,4.36,"1-0","1-0",15,4,8,1,0,2,0,0,7,7,15,13,1,14,28,"7-7","N","N","N",2,0,1
"1343","B1",2023-07-30,"Gent","Kortrijk",3,2,"H",2,1,"H",1.33,5.51,8.63,"2-1","3-2",17,4,10,3,1,4,0,0,7,5,5,9,5,12,14,"7-5","Y","Y","Y",5,0,1
"1344","B1",2023-07-30,"Club Brugge","Mechelen",1,1,"D",0,1,"A",1.47,4.68,6.33,"0-1","1-1",21,5,9,2,2,2,1,0,4,3,8,9,2,7,17,"4-3","Y","N","N",4,1,1
"1345","B1",2023-07-30,"St Truiden","Standard",1,0,"H",0,0,"D",2.71,3.27,2.71,"0-0","1-0",11,3,7,3,1,1,0,0,3,2,13,11,1,5,24,"3-2","N","N","N",2,0,1
"1346","B1",2023-08-04,"Standard","St. Gilloise",0,1,"A",0,1,"A",3.87,3.67,1.98,"0-1","0-1",8,3,24,8,4,1,1,0,2,13,9,12,1,15,21,"2-13","N","N","N",5,1,2
"1347","B1",2023-08-05,"Genk","Eupen",0,1,"A",0,1,"A",1.29,6.28,9.53,"0-1","0-1",28,3,5,2,1,2,0,0,7,2,11,11,1,9,22,"7-2","N","N","N",3,0,2
"1348","B1",2023-08-05,"Cercle Brugge","Charleroi",2,0,"H",2,0,"H",1.92,3.8,3.98,"2-0","2-0",19,3,8,3,0,3,0,0,4,5,11,13,2,9,24,"4-5","Y","N","N",3,0,2
"1349","B1",2023-08-05,"Oud-Heverlee Leuven","RWD Molenbeek",1,2,"A",1,1,"D",1.82,4.01,4.23,"1-1","1-2",18,5,15,4,4,1,0,0,15,6,14,18,3,21,32,"15-6","Y","Y","N",5,0,2
"1350","B1",2023-08-06,"Anderlecht","Antwerp",1,0,"H",1,0,"H",2.65,3.7,2.55,"1-0","1-0",9,2,5,3,1,1,0,0,3,6,9,19,1,9,28,"3-6","N","N","N",2,0,2
"1351","B1",2023-08-06,"Mechelen","Gent",0,1,"A",0,0,"D",3.78,4.04,1.87,"0-0","0-1",14,2,12,3,2,3,0,0,7,3,14,14,1,10,28,"7-3","N","N","N",5,0,2
"1352","B1",2023-08-06,"Westerlo","Club Brugge",0,1,"A",0,1,"A",3.69,3.7,1.98,"0-1","0-1",11,3,20,8,1,0,0,0,4,5,7,9,1,9,16,"4-5","N","N","N",1,0,2
"1353","B1",2023-08-06,"Kortrijk","St Truiden",0,1,"A",0,0,"D",2.85,3.35,2.53,"0-0","0-1",8,1,14,4,1,2,0,0,0,14,10,12,1,14,22,"0-14","N","N","N",3,0,2
"1354","B1",2023-08-11,"Antwerp","Kortrijk",6,0,"H",4,0,"H",1.26,6.31,11.17,"4-0","6-0",25,9,4,1,0,2,0,0,4,1,8,11,6,5,19,"4-1","Y","Y","Y",2,0,3
"1355","B1",2023-08-12,"RWD Molenbeek","Mechelen",1,0,"H",0,0,"D",2.25,3.89,3.01,"0-0","1-0",18,8,9,4,3,1,0,0,7,4,12,11,1,11,23,"7-4","N","N","N",4,0,3
"1356","B1",2023-08-12,"St. Gilloise","Oud-Heverlee Leuven",5,1,"H",2,1,"H",1.51,4.42,6.74,"2-1","5-1",16,9,4,1,1,4,0,0,0,3,10,15,6,3,25,"0-3","Y","Y","Y",5,0,3
"1357","B1",2023-08-13,"St Truiden","Anderlecht",0,1,"A",0,0,"D",3.46,3.45,2.15,"0-0","0-1",14,5,9,3,4,5,0,1,6,1,13,15,1,7,28,"6-1","N","N","N",9,1,3
"1358","B1",2023-08-13,"Cercle Brugge","Genk",0,1,"A",0,0,"D",2.72,3.73,2.45,"0-0","0-1",13,2,10,3,2,3,0,0,5,3,8,20,1,8,28,"5-3","N","N","N",5,0,3
"1359","B1",2023-08-13,"Eupen","Club Brugge",0,5,"A",0,3,"A",5.62,4.33,1.56,"0-3","0-5",9,1,13,7,0,2,0,0,4,6,9,13,5,10,22,"4-6","Y","Y","Y",2,0,3
"1360","B1",2023-08-13,"Charleroi","Standard",1,1,"D",0,1,"A",2.07,3.64,3.47,"0-1","1-1",18,3,7,2,3,2,1,1,13,2,11,12,2,15,23,"13-2","Y","N","N",5,2,3
"1361","B1",2023-08-13,"Westerlo","Gent",1,3,"A",1,1,"D",3.56,3.96,1.95,"1-1","1-3",14,4,18,9,1,1,0,0,4,10,10,14,4,14,24,"4-10","Y","Y","Y",2,0,3
"1362","B1",2023-08-18,"Oud-Heverlee Leuven","Antwerp",1,1,"D",0,1,"A",4.93,4.24,1.67,"0-1","1-1",10,2,13,4,4,2,1,0,7,7,16,10,2,14,26,"7-7","Y","N","N",6,1,4
"1363","B1",2023-08-19,"Standard","Cercle Brugge",0,1,"A",0,0,"D",2.94,3.55,2.43,"0-0","0-1",7,3,16,4,2,2,0,0,3,2,10,11,1,5,21,"3-2","N","N","N",4,0,4
"1364","B1",2023-08-19,"Mechelen","St. Gilloise",4,0,"H",1,0,"H",4.29,4.01,1.81,"1-0","4-0",10,7,14,1,0,2,0,0,4,6,9,10,4,10,19,"4-6","Y","Y","Y",2,0,4
"1365","B1",2023-08-20,"Anderlecht","Westerlo",2,1,"H",1,0,"H",1.92,3.59,4.13,"1-0","2-1",24,7,18,3,1,3,0,0,6,2,7,13,3,8,20,"6-2","Y","Y","N",4,0,4
"1366","B1",2023-08-20,"Genk","Charleroi",0,0,"D",0,0,"D",1.59,4.53,5.02,"0-0","0-0",23,7,7,3,0,0,0,0,11,4,11,13,0,15,24,"11-4","N","N","N",0,0,4
"1367","B1",2023-08-20,"Gent","St Truiden",2,2,"D",1,2,"A",1.44,4.89,6.52,"1-2","2-2",19,5,14,3,2,2,0,0,7,2,11,9,4,9,20,"7-2","Y","Y","Y",4,0,4
"1368","B1",2023-08-20,"Club Brugge","RWD Molenbeek",7,1,"H",2,1,"H",1.29,5.77,9.29,"2-1","7-1",23,9,9,3,0,1,0,0,8,3,10,12,8,11,22,"8-3","Y","Y","Y",1,0,4
"1369","B1",2023-08-20,"Kortrijk","Eupen",1,3,"A",0,0,"D",2.33,3.77,2.85,"0-0","1-3",13,4,15,8,5,4,1,0,5,9,15,15,4,14,30,"5-9","Y","Y","Y",9,1,4
"1370","B1",2023-08-26,"Westerlo","Mechelen",2,3,"A",2,0,"H",2.25,3.83,3.04,"2-0","2-3",11,4,17,5,0,3,0,0,5,4,8,9,5,9,17,"5-4","Y","Y","Y",3,0,5
"1371","B1",2023-08-26,"Eupen","Oud-Heverlee Leuven",3,1,"H",1,0,"H",3.02,3.81,2.27,"1-0","3-1",17,4,22,5,1,2,0,0,3,5,15,9,4,8,24,"3-5","Y","Y","Y",3,0,5
"1372","B1",2023-08-26,"Kortrijk","Standard",1,1,"D",1,0,"H",3,3.65,2.35,"1-0","1-1",19,6,23,6,0,2,0,0,7,10,7,12,2,17,19,"7-10","Y","N","N",2,0,5
"1373","B1",2023-08-27,"St Truiden","Cercle Brugge",0,2,"A",0,0,"D",3.19,3.38,2.3,"0-0","0-2",20,4,25,8,1,1,0,0,8,8,8,18,2,16,26,"8-8","Y","N","N",2,0,5
"1374","B1",2023-08-27,"Anderlecht","Charleroi",2,1,"H",1,0,"H",1.72,4.11,4.43,"1-0","2-1",15,8,18,5,0,2,0,0,4,7,12,16,3,11,28,"4-7","Y","Y","N",2,0,5
"1375","B1",2023-09-01,"Oud-Heverlee Leuven","Kortrijk",3,0,"H",1,0,"H",1.63,4.61,4.83,"1-0","3-0",20,9,13,7,1,3,0,0,4,1,10,14,3,5,24,"4-1","Y","Y","N",4,0,5
"1376","B1",2023-09-02,"Cercle Brugge","Westerlo",2,1,"H",1,0,"H",1.58,4.43,5.54,"1-0","2-1",21,6,7,1,0,1,0,0,14,1,16,16,3,15,32,"14-1","Y","Y","N",1,0,5
"1377","B1",2023-09-02,"Mechelen","Eupen",1,0,"H",0,0,"D",1.78,4.13,4.21,"0-0","1-0",22,6,9,1,0,1,0,0,6,4,10,13,1,10,23,"6-4","N","N","N",1,0,5
"1378","B1",2023-09-02,"Standard","RWD Molenbeek",1,1,"D",1,1,"D",2.07,3.56,3.7,"1-1","1-1",11,4,8,3,1,3,0,0,5,0,9,22,2,5,31,"5-0","Y","N","N",4,0,6
"1379","B1",2023-09-03,"Gent","Club Brugge",2,1,"H",1,1,"D",2.41,3.77,2.79,"1-1","2-1",14,4,14,7,2,0,1,0,5,6,14,12,3,11,26,"5-6","Y","Y","N",2,1,6
"1380","B1",2023-09-03,"St. Gilloise","Antwerp",2,2,"D",1,2,"A",2.34,3.22,3.27,"1-2","2-2",24,7,8,5,1,2,0,0,8,4,9,12,4,12,21,"8-4","Y","Y","Y",3,0,6
"1381","B1",2023-09-03,"Genk","Anderlecht",1,1,"D",0,0,"D",1.97,3.56,3.87,"0-0","1-1",12,4,8,4,5,6,1,0,7,7,6,15,2,14,21,"7-7","Y","N","N",11,1,6
"1382","B1",2023-09-03,"Charleroi","St Truiden",1,1,"D",0,0,"D",2.23,3.43,3.28,"0-0","1-1",18,5,8,5,2,0,0,1,3,5,12,6,2,8,18,"3-5","Y","N","N",2,1,6
"1383","B1",2023-09-15,"Westerlo","Antwerp",0,3,"A",0,1,"A",5.39,4.45,1.6,"0-1","0-3",9,2,15,4,3,0,0,0,4,5,13,9,3,9,22,"4-5","Y","Y","N",3,0,6
"1384","B1",2023-09-16,"RWD Molenbeek","Cercle Brugge",2,1,"H",1,1,"D",4.18,4.22,1.79,"1-1","2-1",10,5,15,4,3,3,0,0,5,4,18,12,3,9,30,"5-4","Y","Y","N",6,0,6
"1385","B1",2023-09-16,"St. Gilloise","Genk",0,2,"A",0,1,"A",2,3.85,3.63,"0-1","0-2",25,4,7,2,1,6,0,0,7,3,15,15,2,10,30,"7-3","Y","N","N",7,0,6
"1386","B1",2023-09-16,"Club Brugge","Charleroi",4,2,"H",2,2,"D",1.41,5.26,7.15,"2-2","4-2",25,10,14,8,2,3,0,0,5,5,8,6,6,10,14,"5-5","Y","Y","Y",5,0,7
"1387","B1",2023-09-17,"Eupen","Standard",1,3,"A",0,2,"A",3.08,3.37,2.36,"0-2","1-3",13,3,16,6,1,4,0,1,6,6,5,12,4,12,17,"6-6","Y","Y","Y",5,1,7
"1388","B1",2023-09-17,"Kortrijk","Anderlecht",2,2,"D",1,1,"D",4.66,4.22,1.68,"1-1","2-2",9,4,18,6,5,1,1,1,3,11,13,6,4,14,19,"3-11","Y","Y","Y",6,2,7
"1389","B1",2023-09-17,"Oud-Heverlee Leuven","Gent",1,1,"D",1,1,"D",4.4,4.13,1.73,"1-1","1-1",9,2,22,4,4,3,0,0,3,16,7,11,2,19,18,"3-16","Y","N","N",7,0,7
"1390","B1",2023-09-17,"St Truiden","Mechelen",2,0,"H",1,0,"H",2.45,3.44,2.9,"1-0","2-0",16,4,13,7,1,2,0,0,1,7,8,12,2,8,20,"1-7","Y","N","N",3,0,7
"1391","B1",2023-09-22,"Standard","Westerlo",0,0,"D",0,0,"D",1.83,4.25,3.92,"0-0","0-0",14,5,3,2,0,3,0,0,5,2,6,23,0,7,29,"5-2","N","N","N",3,0,7
"1392","B1",2023-09-23,"Charleroi","Kortrijk",1,0,"H",1,0,"H",1.65,4.34,5.05,"1-0","1-0",14,5,13,3,2,1,0,0,8,7,16,13,1,15,29,"8-7","N","N","N",3,0,7
"1393","B1",2023-09-23,"Mechelen","Oud-Heverlee Leuven",1,2,"A",0,2,"A",1.93,3.81,3.9,"0-2","1-2",16,4,15,8,5,3,0,0,6,6,12,7,3,12,19,"6-6","Y","Y","N",8,0,7
"1394","B1",2023-09-23,"Antwerp","RWD Molenbeek",0,0,"D",0,0,"D",1.33,5.63,8.62,"0-0","0-0",14,3,5,1,0,1,0,0,9,1,4,14,0,10,18,"9-1","N","N","N",1,0,8
"1395","B1",2023-09-24,"Genk","St Truiden",3,3,"D",0,3,"A",1.58,4.34,5.35,"0-3","3-3",20,7,16,6,2,4,0,0,5,1,17,11,6,6,28,"5-1","Y","Y","Y",6,0,8
"1396","B1",2023-09-24,"Cercle Brugge","St. Gilloise",0,2,"A",0,1,"A",2.88,3.53,2.42,"0-1","0-2",6,1,15,7,3,3,1,0,3,2,8,17,2,5,25,"3-2","Y","N","N",6,1,8
"1397","B1",2023-09-24,"Anderlecht","Club Brugge",1,1,"D",1,0,"H",2.91,3.74,2.31,"1-0","1-1",8,1,9,3,1,1,0,0,3,3,12,11,2,6,23,"3-3","Y","N","N",2,0,8
"1398","B1",2023-09-24,"Gent","Eupen",2,1,"H",0,1,"A",1.28,5.94,9.23,"0-1","2-1",13,6,14,3,1,4,1,0,3,7,9,16,3,10,25,"3-7","Y","Y","N",5,1,8
"1399","B1",2023-09-27,"Antwerp","Gent",0,0,"D",0,0,"D",2.12,3.7,3.42,"0-0","0-0",14,4,6,2,3,1,0,0,6,0,10,4,0,6,14,"6-0","N","N","N",4,0,8
"1400","B1",2023-09-28,"RWD Molenbeek","St. Gilloise",2,3,"A",2,2,"D",4.79,4.22,1.66,"2-2","2-3",10,7,16,8,2,3,0,0,3,8,8,14,5,11,22,"3-8","Y","Y","Y",5,0,8
"1401","B1",2023-09-28,"Club Brugge","Genk",1,1,"D",0,1,"A",1.79,4.03,4.16,"0-1","1-1",18,3,15,5,4,1,0,0,10,3,16,7,2,13,23,"10-3","Y","N","N",5,0,8
"1402","B1",2023-09-29,"Kortrijk","Cercle Brugge",2,1,"H",0,0,"D",4.68,4.39,1.68,"0-0","2-1",10,4,10,2,3,1,0,0,3,7,13,19,3,10,32,"3-7","Y","Y","N",4,0,9
"1403","B1",2023-09-30,"Eupen","Anderlecht",1,3,"A",1,1,"D",4.48,3.99,1.78,"1-1","1-3",9,3,20,6,1,0,0,0,2,4,11,15,4,6,26,"2-4","Y","Y","Y",1,0,9
"1404","B1",2023-09-30,"Oud-Heverlee Leuven","Standard",1,2,"A",0,1,"A",2.38,3.69,2.92,"0-1","1-2",11,5,14,3,2,1,0,0,6,3,10,11,3,9,21,"6-3","Y","Y","N",3,0,9
"1405","B1",2023-09-30,"Mechelen","Antwerp",0,0,"D",0,0,"D",3.93,3.8,1.93,"0-0","0-0",14,3,22,4,0,1,0,0,5,13,3,5,0,18,8,"5-13","N","N","N",1,0,9
"1406","B1",2023-10-01,"St. Gilloise","Charleroi",3,1,"H",3,1,"H",1.57,4.43,5.34,"3-1","3-1",17,7,4,3,1,2,0,0,8,7,13,13,4,15,26,"8-7","Y","Y","Y",3,0,9
"1407","B1",2023-10-01,"Genk","Westerlo",3,3,"D",2,1,"H",1.45,4.87,6.35,"2-1","3-3",18,6,10,7,2,2,1,0,4,7,7,12,6,11,19,"4-7","Y","Y","Y",4,1,9
"1408","B1",2023-10-01,"Club Brugge","St Truiden",1,1,"D",0,0,"D",1.38,5.12,7.61,"0-0","1-1",20,7,12,3,3,1,0,0,11,4,12,8,2,15,20,"11-4","Y","N","N",4,0,9
"1409","B1",2023-10-01,"RWD Molenbeek","Gent",1,1,"D",1,1,"D",4.5,4.23,1.69,"1-1","1-1",9,3,19,9,3,1,0,0,4,4,9,10,2,8,19,"4-4","Y","N","N",4,0,9
"791","D1",2023-08-18,"Werder Bremen","Bayern Munich",0,4,"A",0,1,"A",8.59,6.36,1.33,"0-1","0-4",6,1,25,10,2,1,0,0,0,6,16,11,4,6,27,"0-6","Y","Y","Y",3,0,1
"792","D1",2023-08-19,"Augsburg","Mgladbach",4,4,"D",3,3,"D",2.74,3.78,2.51,"3-3","4-4",20,8,9,6,1,2,0,0,8,7,9,14,8,15,23,"8-7","Y","Y","Y",3,0,1
"793","D1",2023-08-19,"Hoffenheim","Freiburg",1,2,"A",0,2,"A",2.43,3.67,2.92,"0-2","1-2",24,5,17,8,0,1,0,0,4,2,9,9,3,6,18,"4-2","Y","Y","N",1,0,1
"794","D1",2023-08-19,"Leverkusen","RB Leipzig",3,2,"H",2,1,"H",2.5,3.61,2.85,"2-1","3-2",11,7,13,6,1,2,0,0,4,5,13,10,5,9,23,"4-5","Y","Y","Y",3,0,1
"795","D1",2023-08-19,"Stuttgart","Bochum",5,0,"H",2,0,"H",1.7,4.25,4.78,"2-0","5-0",19,9,4,1,1,1,0,0,7,0,5,12,5,7,17,"7-0","Y","Y","Y",2,0,1
"796","D1",2023-08-19,"Wolfsburg","Heidenheim",2,0,"H",2,0,"H",1.62,4.49,5.24,"2-0","2-0",18,8,13,1,3,0,0,0,1,7,10,9,2,8,19,"1-7","Y","N","N",3,0,1
"797","D1",2023-08-19,"Dortmund","FC Koln",1,0,"H",0,0,"D",1.41,5.42,7.25,"0-0","1-0",12,2,11,4,1,0,0,0,6,3,13,11,1,9,24,"6-3","N","N","N",1,0,1
"798","D1",2023-08-20,"Union Berlin","Mainz",4,1,"H",2,0,"H",2.02,3.5,4.02,"2-0","4-1",12,7,9,3,1,5,0,0,3,1,15,16,5,4,31,"3-1","Y","Y","Y",6,0,1
"799","D1",2023-08-20,"Ein Frankfurt","Darmstadt",1,0,"H",1,0,"H",1.4,5.42,7.44,"1-0","1-0",10,4,11,2,2,3,0,0,7,3,9,14,1,10,23,"7-3","N","N","N",5,0,1
"800","D1",2023-08-25,"RB Leipzig","Stuttgart",5,1,"H",0,1,"A",1.53,4.69,6.14,"0-1","5-1",20,11,8,3,1,1,0,0,4,4,12,10,6,8,22,"4-4","Y","Y","Y",2,0,2
"801","D1",2023-08-26,"Bochum","Dortmund",1,1,"D",1,0,"H",6.63,5.36,1.44,"1-0","1-1",17,6,13,3,2,1,0,0,5,4,21,7,2,9,28,"5-4","Y","N","N",3,0,2
"802","D1",2023-08-26,"Darmstadt","Union Berlin",1,4,"A",1,3,"A",3.94,3.42,2.08,"1-3","1-4",18,6,12,6,2,2,0,1,3,5,15,12,5,8,27,"3-5","Y","Y","Y",4,1,2
"803","D1",2023-08-26,"FC Koln","Wolfsburg",1,2,"A",0,0,"D",2.41,3.53,3.04,"0-0","1-2",14,2,9,6,1,5,0,0,6,1,6,10,3,7,16,"6-1","Y","Y","N",6,0,2
"804","D1",2023-08-26,"Freiburg","Werder Bremen",1,0,"H",0,0,"D",1.72,4.15,4.76,"0-0","1-0",23,6,16,2,2,2,0,0,5,5,9,8,1,10,17,"5-5","N","N","N",4,0,2
"805","D1",2023-08-26,"Heidenheim","Hoffenheim",2,3,"A",1,0,"H",2.96,3.81,2.34,"1-0","2-3",19,9,16,6,1,5,0,0,10,6,13,9,5,16,22,"10-6","Y","Y","Y",6,0,2
"806","D1",2023-08-26,"Mgladbach","Leverkusen",0,3,"A",0,2,"A",3.73,4.2,1.91,"0-2","0-3",13,2,24,10,2,3,0,0,5,8,7,8,3,13,15,"5-8","Y","Y","N",5,0,2
"807","D1",2023-08-27,"Mainz","Ein Frankfurt",1,1,"D",1,0,"H",2.39,3.74,2.92,"1-0","1-1",13,7,8,2,3,4,0,1,5,4,23,12,2,9,35,"5-4","Y","N","N",7,1,2
"808","D1",2023-08-27,"Bayern Munich","Augsburg",3,1,"H",2,0,"H",1.09,14.24,22.48,"2-0","3-1",19,6,11,2,1,2,0,0,10,4,13,8,4,14,21,"10-4","Y","Y","Y",3,0,2
"809","D1",2023-09-01,"Dortmund","Heidenheim",2,2,"D",2,0,"H",1.26,7.07,10.23,"2-0","2-2",20,9,15,6,3,3,0,0,3,6,9,22,4,9,31,"3-6","Y","Y","Y",6,0,3
"810","D1",2023-09-02,"Augsburg","Bochum",2,2,"D",1,1,"D",2.09,3.67,3.61,"1-1","2-2",11,3,22,9,2,2,0,0,3,5,15,13,4,8,28,"3-5","Y","Y","Y",4,0,3
"811","D1",2023-09-02,"Hoffenheim","Wolfsburg",3,1,"H",1,1,"D",2.48,3.86,2.73,"1-1","3-1",11,5,14,7,2,2,0,0,3,3,12,15,4,6,27,"3-3","Y","Y","Y",4,0,3
"812","D1",2023-09-02,"Leverkusen","Darmstadt",5,1,"H",1,1,"D",1.2,7.79,13.72,"1-1","5-1",24,13,5,1,3,2,0,0,4,2,8,11,6,6,19,"4-2","Y","Y","Y",5,0,3
"813","D1",2023-09-02,"Stuttgart","Freiburg",5,0,"H",3,0,"H",2.18,3.79,3.28,"3-0","5-0",13,6,11,5,1,1,0,0,2,4,9,10,5,6,19,"2-4","Y","Y","Y",2,0,3
"814","D1",2023-09-02,"Werder Bremen","Mainz",4,0,"H",1,0,"H",2.76,3.55,2.61,"1-0","4-0",12,6,12,3,2,2,0,0,1,7,18,14,4,8,32,"1-7","Y","Y","Y",4,0,3
"815","D1",2023-09-02,"Mgladbach","Bayern Munich",1,2,"A",1,0,"H",7.93,6.61,1.31,"1-0","1-2",8,3,25,9,0,2,0,0,1,15,5,20,3,16,25,"1-15","Y","Y","N",2,0,3
"816","D1",2023-09-03,"Ein Frankfurt","FC Koln",1,1,"D",0,1,"A",2.18,3.49,3.54,"0-1","1-1",12,4,6,2,1,3,0,0,8,1,10,10,2,9,20,"8-1","Y","N","N",4,0,3
"817","D1",2023-09-03,"Union Berlin","RB Leipzig",0,3,"A",0,0,"D",3.24,3.48,2.31,"0-0","0-3",4,1,15,8,3,1,1,0,3,7,16,9,3,10,25,"3-7","Y","Y","N",4,1,3
"818","D1",2023-09-15,"Bayern Munich","Leverkusen",2,2,"D",1,1,"D",1.65,4.7,4.78,"1-1","2-2",15,9,12,5,0,3,0,0,7,4,6,6,4,11,12,"7-4","Y","Y","Y",3,0,4
"819","D1",2023-09-16,"FC Koln","Hoffenheim",1,3,"A",0,2,"A",2.26,3.87,3.06,"0-2","1-3",17,7,17,5,4,4,1,0,13,4,15,14,4,17,29,"13-4","Y","Y","Y",8,1,4
"820","D1",2023-09-16,"Freiburg","Dortmund",2,4,"A",2,1,"H",3.16,3.86,2.21,"2-1","2-4",14,4,14,6,2,3,1,0,6,8,12,16,6,14,28,"6-8","Y","Y","Y",5,1,4
"821","D1",2023-09-16,"Mainz","Stuttgart",1,3,"A",0,0,"D",2.57,3.71,2.71,"0-0","1-3",15,3,16,6,1,2,0,0,6,4,12,9,4,10,21,"6-4","Y","Y","Y",3,0,4
"822","D1",2023-09-16,"RB Leipzig","Augsburg",3,0,"H",3,0,"H",1.24,7.19,11.19,"3-0","3-0",9,6,16,4,0,0,0,0,1,6,16,12,3,7,28,"1-6","Y","Y","N",0,0,4
"823","D1",2023-09-16,"Wolfsburg","Union Berlin",2,1,"H",2,1,"H",2.27,3.55,3.27,"2-1","2-1",8,3,17,5,1,0,0,0,3,7,6,8,3,10,14,"3-7","Y","Y","N",1,0,4
"824","D1",2023-09-16,"Bochum","Ein Frankfurt",1,1,"D",0,0,"D",2.95,3.63,2.42,"0-0","1-1",24,10,8,6,3,2,0,0,8,2,13,14,2,10,27,"8-2","Y","N","N",5,0,4
"825","D1",2023-09-17,"Heidenheim","Werder Bremen",4,2,"H",2,0,"H",2.39,3.88,2.85,"2-0","4-2",19,4,11,4,1,1,0,0,10,1,21,9,6,11,30,"10-1","Y","Y","Y",2,0,4
"826","D1",2023-09-17,"Darmstadt","Mgladbach",3,3,"D",3,0,"H",3.01,3.74,2.34,"3-0","3-3",15,8,21,10,1,1,1,0,6,6,12,8,6,12,20,"6-6","Y","Y","Y",2,1,4
"827","D1",2023-09-22,"Stuttgart","Darmstadt",3,1,"H",2,1,"H",1.4,5.24,8.18,"2-1","3-1",18,11,3,0,1,6,0,0,5,4,7,12,4,9,19,"5-4","Y","Y","Y",7,0,5
"828","D1",2023-09-23,"Augsburg","Mainz",2,1,"H",2,1,"H",2.61,3.7,2.68,"2-1","2-1",6,3,13,3,2,3,1,0,3,4,16,14,3,7,30,"3-4","Y","Y","N",5,1,5
"829","D1",2023-09-23,"Bayern Munich","Bochum",7,0,"H",4,0,"H",1.1,12.85,20.11,"4-0","7-0",26,16,4,1,0,1,0,0,8,1,8,10,7,9,18,"8-1","Y","Y","Y",1,0,5
"830","D1",2023-09-23,"Dortmund","Wolfsburg",1,0,"H",0,0,"D",1.71,4.47,4.48,"0-0","1-0",18,4,8,2,0,1,0,0,5,3,9,14,1,8,23,"5-3","N","N","N",1,0,5
"831","D1",2023-09-23,"Mgladbach","RB Leipzig",0,1,"A",0,0,"D",5.26,4.74,1.59,"0-0","0-1",13,1,8,4,1,1,0,0,11,6,14,7,1,17,21,"11-6","N","N","N",2,0,5
"832","D1",2023-09-23,"Union Berlin","Hoffenheim",0,2,"A",0,2,"A",2.15,3.72,3.39,"0-2","0-2",22,6,11,4,1,3,0,0,11,6,11,13,2,17,24,"11-6","Y","N","N",4,0,5
"833","D1",2023-09-23,"Werder Bremen","FC Koln",2,1,"H",1,1,"D",2.56,3.69,2.74,"1-1","2-1",17,6,13,5,2,1,0,0,9,8,18,16,3,17,34,"9-8","Y","Y","N",3,0,5
"834","D1",2023-09-24,"Leverkusen","Heidenheim",4,1,"H",1,0,"H",1.23,7.35,11.42,"1-0","4-1",20,10,1,1,1,1,0,0,7,2,9,10,5,9,19,"7-2","Y","Y","Y",2,0,5
"835","D1",2023-09-24,"Ein Frankfurt","Freiburg",0,0,"D",0,0,"D",2.16,3.66,3.42,"0-0","0-0",13,5,9,2,4,2,0,0,7,3,12,5,0,10,17,"7-3","N","N","N",6,0,5
"836","D1",2023-09-29,"Hoffenheim","Dortmund",1,3,"A",1,2,"A",3.15,4.16,2.12,"1-2","1-3",15,5,6,5,3,4,0,1,4,3,14,16,4,7,30,"4-3","Y","Y","Y",7,1,6
"837","D1",2023-09-30,"Bochum","Mgladbach",1,3,"A",0,3,"A",2.32,3.88,2.96,"0-3","1-3",23,5,25,9,2,3,0,0,5,10,12,12,4,15,24,"5-10","Y","Y","Y",5,0,6
"838","D1",2023-09-30,"FC Koln","Stuttgart",0,2,"A",0,0,"D",2.89,3.64,2.46,"0-0","0-2",14,5,18,4,2,1,0,0,8,4,16,8,2,12,24,"8-4","Y","N","N",3,0,6
"839","D1",2023-09-30,"Heidenheim","Union Berlin",1,0,"H",0,0,"D",3.05,3.72,2.32,"0-0","1-0",9,4,19,8,1,2,0,0,5,7,11,14,1,12,25,"5-7","N","N","N",3,0,6
"840","D1",2023-09-30,"Mainz","Leverkusen",0,3,"A",0,1,"A",5.85,4.72,1.54,"0-1","0-3",10,3,6,3,4,1,0,0,3,1,13,11,3,4,24,"3-1","Y","Y","N",5,0,6
"841","D1",2023-09-30,"Wolfsburg","Ein Frankfurt",2,0,"H",1,0,"H",2.11,3.53,3.68,"1-0","2-0",19,7,7,3,1,6,0,1,7,4,11,18,2,11,29,"7-4","Y","N","N",7,1,6
"842","D1",2023-09-30,"RB Leipzig","Bayern Munich",2,2,"D",2,0,"H",3.73,4.2,1.91,"2-0","2-2",7,2,11,5,2,5,0,0,5,1,10,11,4,6,21,"5-1","Y","Y","Y",7,0,6
"843","D1",2023-10-01,"Darmstadt","Werder Bremen",4,2,"H",2,0,"H",2.82,3.74,2.47,"2-0","4-2",14,5,10,7,3,2,0,0,2,4,19,19,6,6,38,"2-4","Y","Y","Y",5,0,6
"844","D1",2023-10-01,"Freiburg","Augsburg",2,0,"H",1,0,"H",1.73,4.19,4.68,"1-0","2-0",7,3,13,4,2,2,0,0,2,3,13,17,2,5,30,"2-3","Y","N","N",4,0,6
"845","D2",2023-07-28,"Hamburg","Schalke 04",5,3,"H",1,2,"A",2.43,3.81,2.83,"1-2","5-3",31,14,11,6,3,3,0,1,9,3,10,13,8,12,23,"9-3","Y","Y","Y",6,1,1
"846","D2",2023-07-29,"Hannover","Elversberg",2,2,"D",1,2,"A",2.12,3.88,3.34,"1-2","2-2",10,4,23,9,3,4,0,0,3,6,5,18,4,9,23,"3-6","Y","Y","Y",7,0,1
"847","D2",2023-07-29,"Kaiserslautern","St Pauli",1,2,"A",0,0,"D",3.19,3.5,2.33,"0-0","1-2",10,3,14,5,2,1,0,0,3,5,11,10,3,8,21,"3-5","Y","Y","N",3,0,1
"848","D2",2023-07-29,"Osnabruck","Karlsruhe",2,3,"A",1,2,"A",2.94,3.75,2.38,"1-2","2-3",18,7,14,8,3,2,1,0,4,9,11,9,5,13,20,"4-9","Y","Y","Y",5,1,1
"849","D2",2023-07-29,"Wehen","Magdeburg",1,1,"D",0,1,"A",2.91,3.8,2.37,"0-1","1-1",9,1,11,3,2,3,1,0,3,2,10,18,2,5,28,"3-2","Y","N","N",5,1,1
"850","D2",2023-07-29,"Fortuna Dusseldorf","Hertha",1,0,"H",0,0,"D",2.32,3.59,3.13,"0-0","1-0",9,2,12,4,3,2,0,0,7,8,13,11,1,15,24,"7-8","N","N","N",5,0,1
"851","D2",2023-07-30,"Braunschweig","Holstein Kiel",0,1,"A",0,0,"D",2.66,3.83,2.56,"0-0","0-1",9,2,15,4,3,1,1,0,4,10,10,13,1,14,23,"4-10","N","N","N",4,1,1
"852","D2",2023-07-30,"Greuther Furth","Paderborn",5,0,"H",3,0,"H",2.46,3.71,2.85,"3-0","5-0",24,11,7,0,1,1,0,1,5,2,9,5,5,7,14,"5-2","Y","Y","Y",2,1,1
"853","D2",2023-07-30,"Hansa Rostock","Nurnberg",2,0,"H",1,0,"H",2.62,3.23,2.97,"1-0","2-0",14,4,18,7,3,4,0,0,6,6,15,13,2,12,28,"6-6","Y","N","N",7,0,1
"854","D2",2023-08-04,"Hertha","Wehen",0,1,"A",0,0,"D",1.57,4.43,5.89,"0-0","0-1",21,8,12,5,2,3,0,0,6,4,9,9,1,10,18,"6-4","N","N","N",5,0,2
"855","D2",2023-08-04,"Paderborn","Osnabruck",1,1,"D",0,0,"D",1.6,4.38,5.68,"0-0","1-1",15,5,15,5,1,0,0,0,7,7,11,12,2,14,23,"7-7","Y","N","N",1,0,2
"856","D2",2023-08-05,"Elversberg","Hansa Rostock",1,2,"A",0,0,"D",2.15,3.72,3.4,"0-0","1-2",13,4,17,5,3,4,0,0,7,2,12,15,3,9,27,"7-2","Y","Y","N",7,0,2
"857","D2",2023-08-05,"Holstein Kiel","Greuther Furth",2,1,"H",0,0,"D",2.47,3.85,2.75,"0-0","2-1",9,4,15,2,2,2,0,0,8,5,14,16,3,13,30,"8-5","Y","Y","N",4,0,2
"858","D2",2023-08-05,"St Pauli","Fortuna Dusseldorf",0,0,"D",0,0,"D",1.97,3.73,3.96,"0-0","0-0",13,5,10,3,2,1,1,0,4,8,11,8,0,12,19,"4-8","N","N","N",3,1,2
"859","D2",2023-08-05,"Schalke 04","Kaiserslautern",3,0,"H",1,0,"H",1.69,4.07,5.12,"1-0","3-0",16,8,10,4,1,3,0,2,8,7,14,12,3,15,26,"8-7","Y","Y","N",4,2,2
"860","D2",2023-08-06,"Karlsruhe","Hamburg",2,2,"D",1,0,"H",2.87,4.16,2.28,"1-0","2-2",17,4,13,7,3,2,0,0,7,3,6,14,4,10,20,"7-3","Y","Y","Y",5,0,2
"861","D2",2023-08-06,"Magdeburg","Braunschweig",2,1,"H",2,0,"H",1.81,4.06,4.35,"2-0","2-1",14,5,9,4,1,3,0,0,1,5,7,20,3,6,27,"1-5","Y","Y","N",4,0,2
"862","D2",2023-08-06,"Nurnberg","Hannover",2,2,"D",0,2,"A",2.39,3.64,2.99,"0-2","2-2",8,3,19,6,6,2,0,0,5,7,20,14,4,12,34,"5-7","Y","Y","Y",8,0,2
"863","D2",2023-08-18,"Kaiserslautern","Elversberg",3,2,"H",1,0,"H",2.32,3.65,3.09,"1-0","3-2",20,8,21,9,3,1,0,0,4,6,11,12,5,10,23,"4-6","Y","Y","Y",4,0,3
"864","D2",2023-08-18,"Wehen","Karlsruhe",1,0,"H",1,0,"H",3.07,3.82,2.27,"1-0","1-0",11,4,15,7,3,1,0,0,2,7,14,2,1,9,16,"2-7","N","N","N",4,0,3
"865","D2",2023-08-19,"Fortuna Dusseldorf","Paderborn",1,2,"A",0,1,"A",2.11,3.94,3.32,"0-1","1-2",26,6,10,6,0,3,0,0,12,1,6,20,3,13,26,"12-1","Y","Y","N",3,0,3
"866","D2",2023-08-19,"Greuther Furth","St Pauli",0,0,"D",0,0,"D",2.66,3.59,2.68,"0-0","0-0",16,2,6,1,1,5,0,0,2,1,11,17,0,3,28,"2-1","N","N","N",6,0,3
"867","D2",2023-08-19,"Hansa Rostock","Hannover",1,2,"A",0,1,"A",2.63,3.63,2.69,"0-1","1-2",10,2,8,2,3,1,0,0,4,5,13,11,3,9,24,"4-5","Y","Y","N",4,0,3
"868","D2",2023-08-19,"Hamburg","Hertha",3,0,"H",2,0,"H",1.9,4.17,3.79,"2-0","3-0",27,7,11,2,2,2,0,0,4,2,10,7,3,6,17,"4-2","Y","Y","N",4,0,3
"869","D2",2023-08-20,"Braunschweig","Schalke 04",1,0,"H",1,0,"H",3.61,3.87,2.03,"1-0","1-0",17,6,11,3,3,0,1,0,6,4,15,12,1,10,27,"6-4","N","N","N",3,1,3
"870","D2",2023-08-20,"Holstein Kiel","Magdeburg",2,4,"A",1,2,"A",2.45,3.82,2.8,"1-2","2-4",17,8,18,10,1,2,0,0,6,3,23,12,6,9,35,"6-3","Y","Y","Y",3,0,3
"871","D2",2023-08-20,"Osnabruck","Nurnberg",2,3,"A",0,1,"A",2.6,3.4,2.86,"0-1","2-3",15,3,20,7,2,2,0,0,3,12,13,8,5,15,21,"3-12","Y","Y","Y",4,0,3
"872","D2",2023-08-25,"Paderborn","Kaiserslautern",1,2,"A",0,0,"D",2.21,3.84,3.17,"0-0","1-2",15,5,12,3,2,5,0,0,1,2,17,12,3,3,29,"1-2","Y","Y","N",7,0,4
"873","D2",2023-08-25,"Schalke 04","Holstein Kiel",0,2,"A",0,1,"A",1.95,4.19,3.61,"0-1","0-2",13,4,14,5,1,1,1,0,3,7,11,13,2,10,24,"3-7","Y","N","N",2,1,4
"874","D2",2023-08-26,"Elversberg","Fortuna Dusseldorf",0,5,"A",0,3,"A",2.86,3.87,2.38,"0-3","0-5",13,4,15,8,1,3,0,0,8,6,6,9,5,14,15,"8-6","Y","Y","Y",4,0,4
"875","D2",2023-08-26,"Hansa Rostock","Osnabruck",2,1,"H",1,1,"D",2.12,3.7,3.49,"1-1","2-1",12,5,13,3,3,0,0,0,4,5,17,10,3,9,27,"4-5","Y","Y","N",3,0,4
"876","D2",2023-08-26,"Hertha","Greuther Furth",5,0,"H",2,0,"H",2.55,3.71,2.73,"2-0","5-0",14,7,17,6,1,1,0,0,5,8,18,9,5,13,27,"5-8","Y","Y","Y",2,0,4
"877","D2",2023-08-26,"Hannover","Hamburg",0,1,"A",0,0,"D",3.42,4.12,2.03,"0-0","0-1",19,5,11,4,1,4,0,1,3,3,13,13,1,6,26,"3-3","N","N","N",5,1,4
"878","D2",2023-08-27,"Karlsruhe","Braunschweig",2,0,"H",1,0,"H",1.76,4.3,4.36,"1-0","2-0",22,9,9,0,1,1,0,1,6,4,11,4,2,10,15,"6-4","Y","N","N",2,1,4
"879","D2",2023-08-27,"Nurnberg","Wehen",2,1,"H",0,0,"D",2.09,3.68,3.59,"0-0","2-1",13,4,15,2,2,6,1,2,10,6,12,17,3,16,29,"10-6","Y","Y","N",8,3,4
"880","D2",2023-08-27,"St Pauli","Magdeburg",0,0,"D",0,0,"D",1.96,3.96,3.76,"0-0","0-0",26,12,5,2,2,3,0,0,11,3,9,9,0,14,18,"11-3","N","N","N",5,0,4
"881","D2",2023-09-01,"Braunschweig","St Pauli",1,1,"D",0,0,"D",4.04,3.76,1.94,"0-0","1-1",9,1,19,5,2,3,0,0,3,5,11,11,2,8,22,"3-5","Y","N","N",5,0,5
"882","D2",2023-09-01,"Fortuna Dusseldorf","Karlsruhe",3,1,"H",1,1,"D",2.25,3.89,3.06,"1-1","3-1",19,5,10,8,1,3,0,0,7,7,8,10,4,14,18,"7-7","Y","Y","Y",4,0,5
"883","D2",2023-09-02,"Holstein Kiel","Paderborn",2,1,"H",1,1,"D",2.32,4.18,2.8,"1-1","2-1",19,6,13,2,3,3,0,0,6,8,9,9,3,14,18,"6-8","Y","Y","N",6,0,5
"884","D2",2023-09-02,"Magdeburg","Hertha",6,4,"H",2,3,"A",2.31,4,2.9,"2-3","6-4",23,12,12,7,2,3,0,0,4,3,6,9,10,7,15,"4-3","Y","Y","Y",5,0,5
"885","D2",2023-09-02,"Wehen","Schalke 04",1,1,"D",0,0,"D",3.32,3.88,2.13,"0-0","1-1",14,3,15,5,4,2,0,0,3,7,17,10,2,10,27,"3-7","Y","N","N",6,0,5
"886","D2",2023-09-02,"Kaiserslautern","Nurnberg",3,1,"H",3,1,"H",2.24,3.73,3.19,"3-1","3-1",12,4,18,4,1,2,0,1,4,7,12,14,4,11,26,"4-7","Y","Y","Y",3,1,5
"887","D2",2023-09-03,"Greuther Furth","Hannover",1,3,"A",0,2,"A",2.04,4.12,3.38,"0-2","1-3",19,5,6,5,1,2,0,0,9,2,11,11,4,11,22,"9-2","Y","Y","Y",3,0,5
"888","D2",2023-09-03,"Hamburg","Hansa Rostock",2,0,"H",1,0,"H",1.52,4.94,5.86,"1-0","2-0",17,11,7,3,2,5,0,0,3,5,14,15,2,8,29,"3-5","Y","N","N",7,0,5
"889","D2",2023-09-03,"Osnabruck","Elversberg",0,1,"A",0,0,"D",2.44,3.98,2.73,"0-0","0-1",9,4,10,2,1,2,0,0,6,2,16,13,1,8,29,"6-2","N","N","N",3,0,5
"890","D2",2023-09-15,"Nurnberg","Greuther Furth",1,1,"D",1,1,"D",2.7,3.62,2.62,"1-1","1-1",18,4,9,2,2,3,0,0,6,5,14,17,2,11,31,"6-5","Y","N","N",5,0,6
"891","D2",2023-09-15,"Paderborn","Wehen",2,1,"H",0,1,"A",1.77,4.21,4.39,"0-1","2-1",17,7,12,5,3,2,0,0,5,1,14,12,3,6,26,"5-1","Y","Y","N",5,0,6
"892","D2",2023-09-16,"Elversberg","Hamburg",2,1,"H",1,0,"H",4.2,4.49,1.76,"1-0","2-1",16,7,13,6,3,2,0,0,7,6,12,9,3,13,21,"7-6","Y","Y","N",5,0,6
"893","D2",2023-09-16,"Hansa Rostock","Fortuna Dusseldorf",1,3,"A",1,2,"A",3.36,3.51,2.25,"1-2","1-3",23,4,20,5,2,2,0,0,10,8,11,9,4,18,20,"10-8","Y","Y","Y",4,0,6
"894","D2",2023-09-16,"Karlsruhe","Kaiserslautern",1,1,"D",1,1,"D",2.08,3.8,3.51,"1-1","1-1",19,6,14,7,0,1,0,0,9,3,10,14,2,12,24,"9-3","Y","N","N",1,0,6
"895","D2",2023-09-16,"Schalke 04","Magdeburg",4,3,"H",1,2,"A",2.21,3.95,3.1,"1-2","4-3",19,9,12,6,4,4,0,1,9,4,22,12,7,13,34,"9-4","Y","Y","Y",8,1,6
"896","D2",2023-09-17,"Hannover","Osnabruck",7,0,"H",2,0,"H",1.88,4.02,4.03,"2-0","7-0",24,15,6,3,0,2,0,1,5,3,13,9,7,8,22,"5-3","Y","Y","Y",2,1,6
"897","D2",2023-09-17,"Hertha","Braunschweig",3,0,"H",2,0,"H",1.63,4.45,5.15,"2-0","3-0",15,8,14,4,2,0,0,0,4,9,11,11,3,13,22,"4-9","Y","Y","N",2,0,6
"898","D2",2023-09-17,"St Pauli","Holstein Kiel",5,1,"H",3,0,"H",1.89,3.91,4.08,"3-0","5-1",18,7,13,4,3,3,0,0,3,1,13,16,6,4,29,"3-1","Y","Y","Y",6,0,6
"899","D2",2023-09-22,"Magdeburg","Paderborn",1,1,"D",0,1,"A",2.21,4.05,3.04,"0-1","1-1",11,3,14,4,4,1,0,0,2,6,14,12,2,8,26,"2-6","Y","N","N",5,0,7
"900","D2",2023-09-22,"Osnabruck","Hamburg",2,1,"H",2,1,"H",4.5,4.74,1.67,"2-1","2-1",18,9,8,3,5,6,0,0,13,7,10,15,3,20,25,"13-7","Y","Y","N",11,0,7
"901","D2",2023-09-23,"Braunschweig","Nurnberg",2,2,"D",1,2,"A",2.94,3.68,2.41,"1-2","2-2",14,5,11,5,2,2,0,0,2,3,17,15,4,5,32,"2-3","Y","Y","Y",4,0,7
"902","D2",2023-09-23,"Greuther Furth","Karlsruhe",4,3,"H",3,3,"D",2.27,3.89,3.03,"3-3","4-3",9,6,17,5,3,5,1,0,9,4,10,12,7,13,22,"9-4","Y","Y","Y",8,1,7
"903","D2",2023-09-23,"Wehen","Elversberg",0,2,"A",0,1,"A",2.67,3.82,2.55,"0-1","0-2",16,3,13,5,4,4,0,0,7,3,13,17,2,10,30,"7-3","Y","N","N",8,0,7
"904","D2",2023-09-23,"St Pauli","Schalke 04",3,1,"H",1,1,"D",1.89,3.73,4.28,"1-1","3-1",19,8,10,3,1,4,0,0,4,2,3,19,4,6,22,"4-2","Y","Y","Y",5,0,7
"905","D2",2023-09-24,"Fortuna Dusseldorf","Hannover",1,1,"D",0,1,"A",1.93,4.12,3.7,"0-1","1-1",17,5,6,2,2,3,0,0,5,2,7,10,2,7,17,"5-2","Y","N","N",5,0,7
"906","D2",2023-09-24,"Holstein Kiel","Hertha",2,3,"A",0,2,"A",2.75,3.68,2.55,"0-2","2-3",16,5,11,7,4,3,1,0,2,4,19,13,5,6,32,"2-4","Y","Y","Y",7,1,7
"907","D2",2023-09-24,"Kaiserslautern","Hansa Rostock",3,1,"H",2,1,"H",2.11,3.39,3.83,"2-1","3-1",22,11,18,2,2,2,0,0,6,10,9,15,4,16,24,"6-10","Y","Y","Y",4,0,7
"908","D2",2023-09-29,"Hamburg","Fortuna Dusseldorf",1,0,"H",0,0,"D",2.11,4.16,3.18,"0-0","1-0",10,4,8,2,3,6,0,1,8,3,10,14,1,11,24,"8-3","N","N","N",9,1,8
"909","D2",2023-09-29,"Paderborn","Schalke 04",3,1,"H",1,0,"H",2.28,3.85,3.04,"1-0","3-1",11,6,13,2,1,3,0,0,2,10,10,9,4,12,19,"2-10","Y","Y","Y",4,0,8
"910","D2",2023-09-30,"Hannover","Wehen",2,0,"H",1,0,"H",1.71,4.35,4.6,"1-0","2-0",17,5,12,3,0,2,0,0,4,6,13,15,2,10,28,"4-6","Y","N","N",2,0,8
"911","D2",2023-09-30,"Hansa Rostock","Braunschweig",1,0,"H",0,0,"D",2.03,3.73,3.75,"0-0","1-0",19,6,20,0,3,1,0,0,7,5,20,10,1,12,30,"7-5","N","N","N",4,0,8
"912","D2",2023-09-30,"Karlsruhe","Holstein Kiel",0,2,"A",0,2,"A",2.1,4.04,3.29,"0-2","0-2",14,4,12,5,0,4,0,0,7,9,4,16,2,16,20,"7-9","Y","N","N",4,0,8
"913","D2",2023-09-30,"Hertha","St Pauli",1,2,"A",0,1,"A",2.71,3.68,2.59,"0-1","1-2",8,3,24,5,2,0,0,0,7,3,11,5,3,10,16,"7-3","Y","Y","N",2,0,8
"914","D2",2023-10-01,"Elversberg","Greuther Furth",1,1,"D",1,1,"D",2.48,3.94,2.7,"1-1","1-1",11,4,15,5,1,1,0,0,2,8,13,19,2,10,32,"2-8","Y","N","N",2,0,8
"915","D2",2023-10-01,"Nurnberg","Magdeburg",1,0,"H",0,0,"D",2.67,3.78,2.57,"0-0","1-0",16,6,13,1,6,5,0,0,7,3,14,21,1,10,35,"7-3","N","N","N",11,0,8
"916","D2",2023-10-01,"Osnabruck","Kaiserslautern",2,2,"D",2,1,"H",2.77,3.67,2.54,"2-1","2-2",9,4,32,13,4,3,0,0,4,13,15,13,4,17,28,"4-13","Y","Y","Y",7,0,8
"1","E0",2023-08-11,"Burnley","Man City",0,3,"A",0,2,"A",8.58,5.51,1.37,"0-2","0-3",6,1,17,8,0,0,1,0,6,5,11,8,3,11,19,"6-5","Y","Y","N",0,1,1
"2","E0",2023-08-12,"Arsenal","Nottm Forest",2,1,"H",2,0,"H",1.18,7.86,15.67,"2-0","2-1",15,7,6,2,2,2,0,0,8,3,12,12,3,11,24,"8-3","Y","Y","N",4,0,1
"3","E0",2023-08-12,"Bournemouth","West Ham",1,1,"D",0,0,"D",2.7,3.47,2.71,"0-0","1-1",14,5,16,3,1,4,0,0,10,4,9,14,2,14,23,"10-4","Y","N","N",5,0,1
"4","E0",2023-08-12,"Brighton","Luton",4,1,"H",1,0,"H",1.33,5.65,9.61,"1-0","4-1",27,12,9,3,2,2,0,0,6,7,11,12,5,13,23,"6-7","Y","Y","Y",4,0,1
"5","E0",2023-08-12,"Everton","Fulham",0,1,"A",0,0,"D",2.27,3.45,3.35,"0-0","0-1",19,9,9,2,0,2,0,0,10,4,12,6,1,14,18,"10-4","N","N","N",2,0,1
"6","E0",2023-08-12,"Sheffield United","Crystal Palace",0,1,"A",0,0,"D",3.28,3.22,2.43,"0-0","0-1",8,1,24,8,3,0,0,0,5,5,18,11,1,10,29,"5-5","N","N","N",3,0,1
"7","E0",2023-08-12,"Newcastle","Aston Villa",5,1,"H",2,1,"H",1.77,3.92,4.77,"2-1","5-1",17,13,16,6,4,4,0,0,6,5,12,17,6,11,29,"6-5","Y","Y","Y",8,0,1
"8","E0",2023-08-13,"Brentford","Tottenham",2,2,"D",2,2,"D",2.76,3.65,2.55,"2-2","2-2",11,6,18,6,1,4,0,0,3,6,12,13,4,9,25,"3-6","Y","Y","Y",5,0,1
"9","E0",2023-08-13,"Chelsea","Liverpool",1,1,"D",1,1,"D",2.97,3.64,2.4,"1-1","1-1",10,4,13,1,3,3,0,0,4,4,5,12,2,8,17,"4-4","Y","N","N",6,0,1
"10","E0",2023-08-14,"Man United","Wolves",1,0,"H",0,0,"D",1.32,5.79,9.66,"0-0","1-0",15,3,23,6,2,3,0,0,8,7,14,10,1,15,24,"8-7","N","N","N",5,0,1
"11","E0",2023-08-18,"Nottm Forest","Sheffield United",2,1,"H",1,0,"H",1.97,3.48,4.37,"1-0","2-1",16,4,7,3,2,3,0,0,6,7,5,9,3,13,14,"6-7","Y","Y","N",5,0,2
"12","E0",2023-08-19,"Fulham","Brentford",0,3,"A",0,1,"A",2.76,3.43,2.67,"0-1","0-3",10,2,17,8,2,2,1,0,5,5,13,12,3,10,25,"5-5","Y","Y","N",4,1,2
"13","E0",2023-08-19,"Liverpool","Bournemouth",3,1,"H",2,1,"H",1.23,7.14,11.46,"2-1","3-1",26,10,13,5,1,3,1,0,10,2,11,13,4,12,24,"10-2","Y","Y","Y",4,1,2
"14","E0",2023-08-19,"Wolves","Brighton",1,4,"A",0,1,"A",4.12,3.92,1.88,"0-1","1-4",16,5,16,8,3,6,1,0,5,3,14,11,5,8,25,"5-3","Y","Y","Y",9,1,2
"15","E0",2023-08-19,"Tottenham","Man United",2,0,"H",0,0,"D",2.85,3.82,2.41,"0-0","2-0",17,6,22,6,1,3,0,0,5,6,9,8,2,11,17,"5-6","Y","N","N",4,0,2
"16","E0",2023-08-19,"Man City","Newcastle",1,0,"H",1,0,"H",1.73,4.1,4.8,"1-0","1-0",14,4,7,1,1,5,0,0,3,0,12,11,1,3,23,"3-0","N","N","N",6,0,2
"17","E0",2023-08-20,"Aston Villa","Everton",4,0,"H",2,0,"H",1.72,3.99,5.06,"2-0","4-0",13,7,9,2,3,4,0,0,7,6,8,12,4,13,20,"7-6","Y","Y","Y",7,0,2
"18","E0",2023-08-20,"West Ham","Chelsea",3,1,"H",1,1,"D",3.68,3.57,2.1,"1-1","3-1",12,6,17,4,2,3,1,0,3,9,12,9,4,12,21,"3-9","Y","Y","Y",5,1,2
"19","E0",2023-08-21,"Crystal Palace","Arsenal",0,1,"A",0,0,"D",5.73,4.12,1.63,"0-0","0-1",14,2,14,3,2,1,0,1,1,8,14,10,1,9,24,"1-8","N","N","N",3,1,2
"20","E0",2023-08-25,"Chelsea","Luton",3,0,"H",1,0,"H",1.3,6.08,10.68,"1-0","3-0",19,8,11,1,2,3,0,0,6,4,15,12,3,10,27,"6-4","Y","Y","N",5,0,2
"21","E0",2023-08-26,"Bournemouth","Tottenham",0,2,"A",0,1,"A",3.72,4.04,1.95,"0-1","0-2",11,3,17,6,1,3,0,0,6,2,18,11,2,8,29,"6-2","Y","N","N",4,0,3
"22","E0",2023-08-26,"Arsenal","Fulham",2,2,"D",0,1,"A",1.24,6.07,15.25,"0-1","2-2",19,11,8,3,0,3,0,1,8,3,6,5,4,11,11,"8-3","Y","Y","Y",3,1,3
"23","E0",2023-08-26,"Brentford","Crystal Palace",1,1,"D",1,0,"H",2.17,3.43,3.62,"1-0","1-1",12,1,15,5,0,0,0,0,8,6,9,15,2,14,24,"8-6","Y","N","N",0,0,3
"24","E0",2023-08-26,"Everton","Wolves",0,1,"A",0,0,"D",2.34,3.32,3.34,"0-0","0-1",15,7,11,2,3,4,0,0,7,0,10,14,1,7,24,"7-0","N","N","N",7,0,3
"25","E0",2023-08-26,"Man United","Nottm Forest",3,2,"H",1,2,"A",1.32,5.98,9.11,"1-2","3-2",18,9,9,4,4,4,0,1,11,3,13,11,5,14,24,"11-3","Y","Y","Y",8,1,3
"26","E0",2023-08-26,"Brighton","West Ham",1,3,"A",0,1,"A",1.54,4.74,5.81,"0-1","1-3",25,10,12,3,1,3,0,0,17,4,10,9,4,21,19,"17-4","Y","Y","Y",4,0,3
"27","E0",2023-08-27,"Burnley","Aston Villa",1,3,"A",0,2,"A",3.39,3.65,2.18,"0-2","1-3",9,2,16,6,2,0,0,0,4,6,12,11,4,10,23,"4-6","Y","Y","Y",2,0,3
"28","E0",2023-08-27,"Sheffield United","Man City",1,2,"A",0,0,"D",16.72,7.73,1.18,"0-0","1-2",6,2,30,9,3,0,0,0,1,12,11,2,3,13,13,"1-12","Y","Y","N",3,0,3
"29","E0",2023-08-27,"Newcastle","Liverpool",1,2,"A",1,0,"H",2.2,3.95,3.13,"1-0","1-2",23,8,9,4,1,2,0,1,5,9,16,10,3,14,26,"5-9","Y","Y","N",3,1,3
"30","E0",2023-09-01,"Luton","West Ham",1,2,"A",0,1,"A",4.82,4.04,1.75,"0-1","1-2",16,1,9,3,1,1,0,0,9,6,8,13,3,15,21,"9-6","Y","Y","N",2,0,3
"31","E0",2023-09-02,"Sheffield United","Everton",2,2,"D",2,1,"H",3.06,3.27,2.53,"2-1","2-2",13,8,16,6,1,2,0,0,4,6,11,13,4,10,24,"4-6","Y","Y","Y",3,0,4
"32","E0",2023-09-02,"Brentford","Bournemouth",2,2,"D",1,1,"D",1.75,4.14,4.62,"1-1","2-2",21,7,12,5,1,2,0,0,5,2,6,13,4,7,19,"5-2","Y","Y","Y",3,0,4
"33","E0",2023-09-02,"Burnley","Tottenham",2,5,"A",1,2,"A",3.97,4.04,1.88,"1-2","2-5",16,4,20,10,4,3,0,0,7,4,15,9,7,11,24,"7-4","Y","Y","Y",7,0,4
"34","E0",2023-09-02,"Chelsea","Nottm Forest",0,1,"A",0,0,"D",1.39,5.1,8.62,"0-0","0-1",21,2,7,3,3,4,0,0,8,0,10,9,1,8,19,"8-0","N","N","N",7,0,4
"35","E0",2023-09-02,"Man City","Fulham",5,1,"H",2,1,"H",1.15,8.93,18.11,"2-1","5-1",7,5,6,4,2,4,0,0,4,5,12,12,6,9,24,"4-5","Y","Y","Y",6,0,4
"36","E0",2023-09-02,"Brighton","Newcastle",3,1,"H",1,0,"H",2.59,3.94,2.58,"1-0","3-1",15,6,9,2,4,4,0,0,5,3,14,17,4,8,31,"5-3","Y","Y","Y",8,0,4
"37","E0",2023-09-03,"Crystal Palace","Wolves",3,2,"H",0,0,"D",1.97,3.5,4.25,"0-0","3-2",16,11,12,4,1,3,0,0,4,2,12,12,5,6,24,"4-2","Y","Y","Y",4,0,4
"38","E0",2023-09-03,"Liverpool","Aston Villa",3,0,"H",2,0,"H",1.68,4.61,4.6,"2-0","3-0",17,4,9,3,0,1,0,0,7,3,12,7,3,10,19,"7-3","Y","Y","N",1,0,4
"39","E0",2023-09-03,"Arsenal","Man United",3,1,"H",1,1,"D",1.77,4.08,4.55,"1-1","3-1",17,5,10,2,2,3,0,0,12,3,8,7,4,15,15,"12-3","Y","Y","Y",5,0,4
"40","E0",2023-09-16,"Wolves","Liverpool",1,3,"A",1,0,"H",6.66,4.98,1.47,"1-0","1-3",11,2,16,6,1,3,0,0,4,4,10,4,4,8,14,"4-4","Y","Y","Y",4,0,4
"41","E0",2023-09-16,"Aston Villa","Crystal Palace",3,1,"H",0,0,"D",1.93,3.76,4.1,"0-0","3-1",16,5,6,3,5,3,0,0,4,2,13,9,4,6,22,"4-2","Y","Y","Y",8,0,5
"42","E0",2023-09-16,"Fulham","Luton",1,0,"H",0,0,"D",1.68,4.03,5.31,"0-0","1-0",13,2,7,2,2,2,0,0,6,2,6,14,1,8,20,"6-2","N","N","N",4,0,5
"43","E0",2023-09-16,"Man United","Brighton",1,3,"A",0,1,"A",2.25,4.02,2.99,"0-1","1-3",14,4,10,8,2,2,0,0,8,1,8,9,4,9,17,"8-1","Y","Y","Y",4,0,5
"44","E0",2023-09-16,"Tottenham","Sheffield United",2,1,"H",0,0,"D",1.29,6.08,10.21,"0-0","2-1",28,10,7,5,6,5,0,1,15,2,13,14,3,17,27,"15-2","Y","Y","N",11,1,5
"45","E0",2023-09-16,"West Ham","Man City",1,3,"A",1,0,"H",6.58,4.7,1.5,"1-0","1-3",6,3,29,15,3,2,0,0,4,11,7,11,4,15,18,"4-11","Y","Y","Y",5,0,5
"46","E0",2023-09-16,"Newcastle","Brentford",1,0,"H",0,0,"D",1.54,4.47,6.3,"0-0","1-0",9,2,11,2,3,5,0,0,8,3,8,12,1,11,20,"8-3","N","N","N",8,0,5
"47","E0",2023-09-17,"Bournemouth","Chelsea",0,0,"D",0,0,"D",4.39,4.05,1.8,"0-0","0-0",13,4,14,6,1,5,0,0,1,7,15,20,0,8,35,"1-7","N","N","N",6,0,5
"48","E0",2023-09-17,"Everton","Arsenal",0,1,"A",0,0,"D",6.3,4.54,1.53,"0-0","0-1",8,1,13,4,1,1,0,0,1,11,12,10,1,12,22,"1-11","N","N","N",2,0,5
"49","E0",2023-09-18,"Nottm Forest","Burnley",1,1,"D",0,1,"A",2.23,3.58,3.33,"0-1","1-1",14,4,10,3,2,3,0,1,5,4,16,10,2,9,26,"5-4","Y","N","N",5,1,5
"50","E0",2023-09-23,"Crystal Palace","Fulham",0,0,"D",0,0,"D",1.99,3.54,4.11,"0-0","0-0",7,3,10,5,3,2,0,0,3,2,10,15,0,5,25,"3-2","N","N","N",5,0,5
"51","E0",2023-09-23,"Luton","Wolves",1,1,"D",0,0,"D",3.26,3.47,2.31,"0-0","1-1",20,4,3,3,0,2,0,1,10,1,12,17,2,11,29,"10-1","Y","N","N",2,1,6
"52","E0",2023-09-23,"Man City","Nottm Forest",2,0,"H",2,0,"H",1.15,9.04,17.91,"2-0","2-0",7,4,10,3,3,7,1,0,6,6,5,17,2,12,22,"6-6","Y","N","N",10,1,6
"53","E0",2023-09-23,"Brentford","Everton",1,3,"A",1,1,"D",1.81,3.8,4.67,"1-1","1-3",12,2,18,6,2,2,0,0,1,4,9,12,4,5,21,"1-4","Y","Y","Y",4,0,6
"54","E0",2023-09-23,"Burnley","Man United",0,1,"A",0,1,"A",4.28,4.31,1.77,"0-1","0-1",12,4,11,4,1,2,0,0,9,5,6,12,1,14,18,"9-5","N","N","N",3,0,6
"55","E0",2023-09-24,"Arsenal","Tottenham",2,2,"D",1,1,"D",1.68,4.45,4.69,"1-1","2-2",13,6,13,5,3,4,0,0,11,4,12,19,4,15,31,"11-4","Y","Y","Y",7,0,6
"56","E0",2023-09-24,"Brighton","Bournemouth",3,1,"H",1,1,"D",1.41,5.08,7.9,"1-1","3-1",13,4,12,4,3,3,0,0,4,4,12,17,4,8,29,"4-4","Y","Y","Y",6,0,6
"57","E0",2023-09-24,"Chelsea","Aston Villa",0,1,"A",0,0,"D",1.93,3.9,3.93,"0-0","0-1",10,4,15,7,2,3,0,0,5,11,9,11,1,16,20,"5-11","N","N","N",5,0,6
"58","E0",2023-09-24,"Liverpool","West Ham",3,1,"H",1,1,"D",1.4,5.67,7.21,"1-1","3-1",22,7,11,4,0,2,0,0,7,4,12,13,4,11,25,"7-4","Y","Y","Y",2,0,6
"59","E0",2023-09-24,"Sheffield United","Newcastle",0,8,"A",0,3,"A",7.05,4.98,1.45,"0-3","0-8",9,1,22,15,3,0,0,0,2,6,12,8,8,8,20,"2-6","Y","Y","Y",3,0,6
"60","E0",2023-09-30,"Aston Villa","Brighton",6,1,"H",3,0,"H",2.58,3.96,2.58,"3-0","6-1",19,9,11,3,4,4,0,0,1,3,19,21,7,4,40,"1-3","Y","Y","Y",8,0,6
"61","E0",2023-09-30,"Bournemouth","Arsenal",0,4,"A",0,2,"A",5.59,4.77,1.56,"0-2","0-4",8,1,15,8,0,1,0,0,6,6,11,10,4,12,21,"6-6","Y","Y","Y",1,0,7
"62","E0",2023-09-30,"Everton","Luton",1,2,"A",1,2,"A",1.62,3.94,6.24,"1-2","1-2",23,5,9,2,0,1,0,0,3,6,8,10,3,9,18,"3-6","Y","Y","N",1,0,7
"63","E0",2023-09-30,"Man United","Crystal Palace",0,1,"A",0,1,"A",1.57,4.36,5.96,"0-1","0-1",19,4,8,2,3,2,0,0,10,4,10,8,1,14,18,"10-4","N","N","N",5,0,7
"64","E0",2023-09-30,"Newcastle","Burnley",2,0,"H",1,0,"H",1.34,5.67,9.15,"1-0","2-0",20,8,8,2,1,3,0,0,5,3,7,15,2,8,22,"5-3","Y","N","N",4,0,7
"65","E0",2023-09-30,"West Ham","Sheffield United",2,0,"H",2,0,"H",1.44,4.94,7.44,"2-0","2-0",20,9,16,2,1,1,0,0,7,4,6,9,2,11,15,"7-4","Y","N","N",2,0,7
"66","E0",2023-09-30,"Wolves","Man City",2,1,"H",1,0,"H",9.61,5.75,1.33,"1-0","2-1",3,1,23,8,5,4,0,0,0,6,18,12,3,6,30,"0-6","Y","Y","N",9,0,7
"67","E0",2023-09-30,"Tottenham","Liverpool",2,1,"H",1,1,"D",2.98,4.12,2.23,"1-1","2-1",24,8,12,4,5,4,0,2,12,5,11,17,3,17,28,"12-5","Y","Y","N",9,2,7
"68","E0",2023-10-01,"Nottm Forest","Brentford",1,1,"D",0,0,"D",2.84,3.29,2.69,"0-0","1-1",6,1,18,5,1,2,1,0,1,11,6,10,2,12,16,"1-11","Y","N","N",3,1,7
"69","E0",2023-10-02,"Fulham","Chelsea",0,2,"A",0,2,"A",3.93,3.45,2.06,"0-2","0-2",10,3,11,4,1,4,0,0,8,1,15,12,2,9,27,"8-1","Y","N","N",5,0,7
"70","E0",2023-10-03,"Luton","Burnley",1,2,"A",0,1,"A",2.94,3.23,2.65,"0-1","1-2",18,3,14,4,4,2,0,0,7,6,14,6,3,13,20,"7-6","Y","Y","N",6,0,7
"71","E1",2023-08-04,"Sheffield Weds","Southampton",1,2,"A",0,1,"A",3.3,3.44,2.3,"0-1","1-2",8,1,23,7,4,4,0,0,3,6,12,10,3,9,22,"3-6","Y","Y","N",8,0,1
"72","E1",2023-08-05,"Blackburn","West Brom",2,1,"H",2,0,"H",2.92,3.24,2.65,"2-0","2-1",12,3,14,4,4,3,0,0,6,5,11,11,3,11,22,"6-5","Y","Y","N",7,0,1
"73","E1",2023-08-05,"Bristol City","Preston",1,1,"D",0,0,"D",2.13,3.45,3.72,"0-0","1-1",5,2,11,3,0,1,0,0,2,4,10,11,2,6,21,"2-4","Y","N","N",1,0,1
"74","E1",2023-08-05,"Middlesbrough","Millwall",0,1,"A",0,0,"D",2.05,3.48,3.96,"0-0","0-1",16,2,12,2,1,3,0,0,12,6,3,8,1,18,11,"12-6","N","N","N",4,0,1
"75","E1",2023-08-05,"Norwich","Hull",2,1,"H",1,1,"D",1.8,3.71,4.87,"1-1","2-1",28,5,8,3,2,5,0,0,9,4,14,12,3,13,26,"9-4","Y","Y","N",7,0,1
"76","E1",2023-08-05,"Plymouth","Huddersfield",3,1,"H",1,1,"D",2.19,3.46,3.55,"1-1","3-1",14,7,15,3,1,0,0,0,2,9,9,15,4,11,24,"2-9","Y","Y","Y",1,0,1
"77","E1",2023-08-05,"Stoke","Rotherham",4,1,"H",3,0,"H",1.65,4,5.74,"3-0","4-1",15,6,6,3,5,3,0,1,10,2,12,10,5,12,22,"10-2","Y","Y","Y",8,1,1
"78","E1",2023-08-05,"Swansea","Birmingham",1,1,"D",0,1,"A",1.9,3.65,4.37,"0-1","1-1",11,6,11,5,1,4,0,0,5,5,9,12,2,10,21,"5-5","Y","N","N",5,0,1
"79","E1",2023-08-05,"Watford","QPR",4,0,"H",4,0,"H",1.88,3.69,4.39,"4-0","4-0",23,12,4,1,1,2,0,0,8,2,8,15,4,10,23,"8-2","Y","Y","Y",3,0,1
"80","E1",2023-08-06,"Leicester","Coventry",2,1,"H",0,0,"D",1.6,4.24,5.9,"0-0","2-1",20,7,20,6,3,2,0,0,6,8,11,13,3,14,24,"6-8","Y","Y","N",5,0,1
"81","E1",2023-08-06,"Leeds","Cardiff",2,2,"D",0,2,"A",1.47,4.76,7.04,"0-2","2-2",25,6,7,2,2,1,0,0,10,0,8,10,4,10,18,"10-0","Y","Y","Y",3,0,1
"82","E1",2023-08-06,"Sunderland","Ipswich",1,2,"A",0,1,"A",2.53,3.36,2.99,"0-1","1-2",20,4,13,5,1,3,1,0,11,4,10,13,3,15,23,"11-4","Y","Y","N",4,1,1
"83","E1",2023-08-12,"Coventry","Middlesbrough",3,0,"H",1,0,"H",2.45,3.45,3.04,"1-0","3-0",12,5,14,2,1,1,0,0,7,7,5,8,3,14,13,"7-7","Y","Y","N",2,0,2
"84","E1",2023-08-12,"Birmingham","Leeds",1,0,"H",0,0,"D",3.43,3.59,2.19,"0-0","1-0",10,2,7,1,1,2,0,0,7,4,13,10,1,11,23,"7-4","N","N","N",3,0,2
"85","E1",2023-08-12,"Cardiff","QPR",1,2,"A",0,1,"A",2,3.58,4.01,"0-1","1-2",15,4,7,3,2,2,0,0,13,7,8,13,3,20,21,"13-7","Y","Y","N",4,0,2
"86","E1",2023-08-12,"Huddersfield","Leicester",0,1,"A",0,0,"D",4.66,3.93,1.78,"0-0","0-1",13,3,17,6,1,4,0,0,5,4,15,8,1,9,23,"5-4","N","N","N",5,0,2
"87","E1",2023-08-12,"Hull","Sheffield Weds",4,2,"H",1,1,"D",2.37,3.42,3.19,"1-1","4-2",16,7,6,2,1,3,0,0,9,1,7,22,6,10,29,"9-1","Y","Y","Y",4,0,2
"88","E1",2023-08-12,"Ipswich","Stoke",2,0,"H",1,0,"H",2.16,3.6,3.47,"1-0","2-0",22,10,9,2,3,1,0,0,7,3,12,17,2,10,29,"7-3","Y","N","N",4,0,2
"89","E1",2023-08-12,"Millwall","Bristol City",0,1,"A",0,0,"D",1.91,3.66,4.32,"0-0","0-1",10,2,13,1,1,3,0,0,1,5,13,11,1,6,24,"1-5","N","N","N",4,0,2
"90","E1",2023-08-12,"Preston","Sunderland",2,1,"H",1,1,"D",2.81,3.41,2.64,"1-1","2-1",11,2,13,4,3,1,0,0,5,12,17,8,3,17,25,"5-12","Y","Y","N",4,0,2
"91","E1",2023-08-12,"Rotherham","Blackburn",2,2,"D",1,0,"H",3.09,3.4,2.44,"1-0","2-2",9,3,21,6,3,1,1,0,5,9,9,8,4,14,17,"5-9","Y","Y","Y",4,1,2
"92","E1",2023-08-12,"Southampton","Norwich",4,4,"D",2,3,"A",1.87,3.77,4.35,"2-3","4-4",31,11,15,6,7,4,0,0,13,4,12,13,8,17,25,"13-4","Y","Y","Y",11,0,2
"93","E1",2023-08-12,"Watford","Plymouth",0,0,"D",0,0,"D",1.72,4.01,4.96,"0-0","0-0",20,3,13,5,0,2,0,0,12,3,16,10,0,15,26,"12-3","N","N","N",2,0,2
"94","E1",2023-08-12,"West Brom","Swansea",3,2,"H",1,0,"H",2.1,3.57,3.68,"1-0","3-2",11,3,13,4,3,4,0,0,4,8,10,10,5,12,20,"4-8","Y","Y","Y",7,0,2
"95","E1",2023-08-18,"Leeds","West Brom",1,1,"D",0,0,"D",2.16,3.56,3.52,"0-0","1-1",16,4,4,2,4,5,0,0,4,3,10,9,2,7,19,"4-3","Y","N","N",9,0,3
"96","E1",2023-08-19,"Plymouth","Southampton",1,2,"A",0,0,"D",3.88,3.98,1.93,"0-0","1-2",15,2,19,9,2,4,0,0,5,10,11,15,3,15,26,"5-10","Y","Y","N",6,0,3
"97","E1",2023-08-19,"Blackburn","Hull",1,2,"A",0,0,"D",1.93,3.77,4.04,"0-0","1-2",14,3,19,5,1,3,1,0,2,8,12,7,3,10,19,"2-8","Y","Y","N",4,1,3
"98","E1",2023-08-19,"Bristol City","Birmingham",0,2,"A",0,1,"A",2.29,3.27,3.5,"0-1","0-2",19,0,16,6,0,2,1,0,8,4,12,10,2,12,22,"8-4","Y","N","N",2,1,3
"99","E1",2023-08-19,"Leicester","Cardiff",2,1,"H",1,1,"D",1.54,4.49,6.29,"1-1","2-1",15,6,10,4,1,4,0,1,10,4,11,10,3,14,21,"10-4","Y","Y","N",5,1,3
"100","E1",2023-08-19,"Middlesbrough","Huddersfield",1,1,"D",0,0,"D",1.78,4.01,4.61,"0-0","1-1",17,7,16,2,1,3,0,0,7,8,10,10,2,15,20,"7-8","Y","N","N",4,0,3
"101","E1",2023-08-19,"QPR","Ipswich",0,1,"A",0,0,"D",4.51,3.63,1.88,"0-0","0-1",10,4,16,3,4,1,0,0,5,4,15,10,1,9,25,"5-4","N","N","N",5,0,3
"102","E1",2023-08-19,"Sheffield Weds","Preston",0,1,"A",0,0,"D",2.61,3.24,2.99,"0-0","0-1",8,3,5,2,1,1,0,0,0,4,14,16,1,4,30,"0-4","N","N","N",2,0,3
"103","E1",2023-08-19,"Stoke","Watford",1,0,"H",0,0,"D",2.25,3.53,3.34,"0-0","1-0",13,2,10,3,4,1,0,0,7,2,21,10,1,9,31,"7-2","N","N","N",5,0,3
"104","E1",2023-08-19,"Sunderland","Rotherham",2,1,"H",1,1,"D",1.66,4.18,5.32,"1-1","2-1",11,4,4,1,2,1,0,0,5,0,11,10,3,5,21,"5-0","Y","Y","N",3,0,3
"105","E1",2023-08-19,"Swansea","Coventry",1,1,"D",1,1,"D",2.43,3.53,3.01,"1-1","1-1",7,3,11,2,2,1,0,0,3,8,12,10,2,11,22,"3-8","Y","N","N",3,0,3
"106","E1",2023-08-20,"Norwich","Millwall",3,1,"H",1,0,"H",2.12,3.56,3.62,"1-0","3-1",20,5,10,2,2,1,0,0,6,3,3,13,4,9,16,"6-3","Y","Y","Y",3,0,3
"107","E1",2023-08-25,"Hull","Bristol City",1,1,"D",1,0,"H",2.41,3.41,3.13,"1-0","1-1",13,9,19,5,1,2,0,0,4,5,5,13,2,9,18,"4-5","Y","N","N",3,0,4
"108","E1",2023-08-26,"Birmingham","Plymouth",2,1,"H",1,0,"H",1.88,3.66,4.46,"1-0","2-1",13,4,16,8,2,1,0,0,10,10,17,5,3,20,22,"10-10","Y","Y","N",3,0,4
"109","E1",2023-08-26,"Cardiff","Sheffield Weds",2,1,"H",0,0,"D",2.13,3.44,3.74,"0-0","2-1",12,4,11,2,0,5,0,0,5,10,6,20,3,15,26,"5-10","Y","Y","N",5,0,4
"110","E1",2023-08-26,"Coventry","Sunderland",0,0,"D",0,0,"D",2.15,3.54,3.57,"0-0","0-0",17,6,15,2,1,4,0,0,4,7,11,7,0,11,18,"4-7","N","N","N",5,0,4
"111","E1",2023-08-26,"Huddersfield","Norwich",0,4,"A",0,2,"A",3.37,3.74,2.15,"0-2","0-4",18,5,9,5,3,1,0,0,5,3,10,8,4,8,18,"5-3","Y","Y","Y",4,0,4
"112","E1",2023-08-26,"Ipswich","Leeds",3,4,"A",2,3,"A",2.39,3.37,3.2,"2-3","3-4",21,6,14,9,3,2,0,0,8,4,12,8,7,12,20,"8-4","Y","Y","Y",5,0,4
"113","E1",2023-08-26,"Millwall","Stoke",1,0,"H",1,0,"H",2.43,3.27,3.22,"1-0","1-0",17,7,20,2,1,5,0,0,6,7,15,7,1,13,22,"6-7","N","N","N",6,0,4
"114","E1",2023-08-26,"Preston","Swansea",2,1,"H",0,1,"A",2.66,3.35,2.84,"0-1","2-1",11,3,10,1,2,1,0,0,6,4,12,7,3,10,19,"6-4","Y","Y","N",3,0,4
"115","E1",2023-08-26,"Rotherham","Leicester",1,2,"A",0,1,"A",5.53,4.21,1.63,"0-1","1-2",8,1,15,7,2,2,0,0,5,4,15,10,3,9,25,"5-4","Y","Y","N",4,0,4
"116","E1",2023-08-26,"Southampton","QPR",2,1,"H",1,1,"D",1.37,5.47,8.46,"1-1","2-1",7,3,11,5,4,2,0,0,4,3,8,14,3,7,22,"4-3","Y","Y","N",6,0,4
"117","E1",2023-08-26,"West Brom","Middlesbrough",4,2,"H",2,1,"H",2.3,3.52,3.24,"2-1","4-2",7,4,15,5,2,1,0,1,4,2,10,9,6,6,19,"4-2","Y","Y","Y",3,1,4
"118","E1",2023-08-27,"Watford","Blackburn",0,1,"A",0,0,"D",2.12,3.65,3.55,"0-0","0-1",24,4,5,3,3,2,0,0,8,4,8,5,1,12,13,"8-4","N","N","N",5,0,4
"119","E1",2023-09-02,"Birmingham","Millwall",1,1,"D",0,1,"A",2.46,3.21,3.23,"0-1","1-1",17,4,9,3,1,2,0,0,1,3,9,18,2,4,27,"1-3","Y","N","N",3,0,5
"120","E1",2023-09-02,"Sunderland","Southampton",5,0,"H",3,0,"H",2.84,3.65,2.49,"3-0","5-0",18,10,13,2,2,2,0,0,5,8,20,10,5,13,30,"5-8","Y","Y","Y",4,0,5
"121","E1",2023-09-02,"Swansea","Bristol City",1,2,"A",1,0,"H",2.17,3.64,3.42,"1-0","1-2",12,4,16,4,3,2,0,0,4,8,13,17,3,12,30,"4-8","Y","Y","N",5,0,5
"122","E1",2023-09-02,"Coventry","Watford",3,3,"D",1,1,"D",2.17,3.62,3.44,"1-1","3-3",16,7,14,5,3,3,0,0,9,6,10,16,6,15,26,"9-6","Y","Y","Y",6,0,5
"123","E1",2023-09-02,"Ipswich","Cardiff",3,2,"H",0,1,"A",1.67,4.16,5.25,"0-1","3-2",19,7,13,5,4,3,0,0,6,3,7,14,5,9,21,"6-3","Y","Y","Y",7,0,5
"124","E1",2023-09-02,"Leeds","Sheffield Weds",0,0,"D",0,0,"D",1.45,5.05,6.95,"0-0","0-0",16,4,10,5,1,2,0,0,5,3,8,9,0,8,17,"5-3","N","N","N",3,0,5
"125","E1",2023-09-02,"Leicester","Hull",0,1,"A",0,1,"A",1.54,4.67,5.95,"0-1","0-1",21,1,7,4,3,5,0,0,8,3,16,12,1,11,28,"8-3","N","N","N",8,0,5
"126","E1",2023-09-02,"Middlesbrough","QPR",0,2,"A",0,1,"A",1.6,4.43,5.61,"0-1","0-2",16,9,11,3,1,2,0,0,7,5,9,11,2,12,20,"7-5","Y","N","N",3,0,5
"127","E1",2023-09-02,"Plymouth","Blackburn",3,0,"H",1,0,"H",2.72,3.79,2.52,"1-0","3-0",23,9,20,4,2,1,0,0,9,9,5,6,3,18,11,"9-9","Y","Y","N",3,0,5
"128","E1",2023-09-02,"Rotherham","Norwich",2,1,"H",2,0,"H",4.85,4,1.74,"2-0","2-1",9,3,17,5,2,1,0,0,2,6,12,10,3,8,22,"2-6","Y","Y","N",3,0,5
"129","E1",2023-09-02,"Stoke","Preston",0,2,"A",0,0,"D",1.96,3.5,4.28,"0-0","0-2",18,1,7,3,3,4,0,0,9,0,15,17,2,9,32,"9-0","Y","N","N",7,0,5
"130","E1",2023-09-02,"West Brom","Huddersfield",1,2,"A",0,1,"A",1.72,4.08,4.89,"0-1","1-2",10,5,14,4,1,1,0,0,4,9,9,9,3,13,18,"4-9","Y","Y","N",2,0,5
"131","E1",2023-09-15,"Hull","Coventry",1,1,"D",0,1,"A",2.88,3.48,2.54,"0-1","1-1",18,4,8,2,2,5,0,0,9,3,7,21,2,12,28,"9-3","Y","N","N",7,0,6
"132","E1",2023-09-15,"Southampton","Leicester",1,4,"A",1,3,"A",2.52,3.6,2.83,"1-3","1-4",19,8,15,8,2,4,1,0,9,3,11,12,5,12,23,"9-3","Y","Y","Y",6,1,6
"133","E1",2023-09-16,"Blackburn","Middlesbrough",2,1,"H",1,0,"H",2.55,3.66,2.77,"1-0","2-1",15,8,21,6,1,2,0,0,5,9,11,10,3,14,21,"5-9","Y","Y","N",3,0,6
"134","E1",2023-09-16,"Bristol City","West Brom",0,0,"D",0,0,"D",2.47,3.43,3.01,"0-0","0-0",14,3,14,0,2,2,0,0,7,7,10,5,0,14,15,"7-7","N","N","N",4,0,6
"135","E1",2023-09-16,"Huddersfield","Rotherham",2,0,"H",1,0,"H",1.87,3.7,4.44,"1-0","2-0",15,5,7,3,1,1,0,0,2,5,10,17,2,7,27,"2-5","Y","N","N",2,0,6
"136","E1",2023-09-16,"Norwich","Stoke",1,0,"H",1,0,"H",1.92,3.83,4.04,"1-0","1-0",13,5,13,2,2,2,0,0,5,3,7,14,1,8,21,"5-3","N","N","N",4,0,6
"137","E1",2023-09-16,"Preston","Plymouth",2,1,"H",2,0,"H",2,3.71,3.84,"2-0","2-1",9,5,18,7,3,1,0,0,4,14,14,11,3,18,25,"4-14","Y","Y","N",4,0,6
"138","E1",2023-09-16,"QPR","Sunderland",1,3,"A",1,1,"D",3.33,3.56,2.24,"1-1","1-3",5,3,22,8,2,0,1,0,0,8,12,3,4,8,15,"0-8","Y","Y","Y",2,1,6
"139","E1",2023-09-16,"Sheffield Weds","Ipswich",0,1,"A",0,1,"A",3.89,3.53,2.05,"0-1","0-1",6,0,13,6,3,4,0,0,7,1,17,13,1,8,30,"7-1","N","N","N",7,0,6
"140","E1",2023-09-16,"Watford","Birmingham",2,0,"H",0,0,"D",2.04,3.48,3.98,"0-0","2-0",12,4,8,3,1,5,0,1,8,1,16,17,2,9,33,"8-1","Y","N","N",6,1,6
"141","E1",2023-09-16,"Cardiff","Swansea",2,0,"H",0,0,"D",2.63,3.39,2.85,"0-0","2-0",13,7,9,3,1,1,0,0,2,2,13,11,2,4,24,"2-2","Y","N","N",2,0,6
"142","E1",2023-09-17,"Millwall","Leeds",0,3,"A",0,1,"A",3.13,3.4,2.42,"0-1","0-3",12,3,14,3,0,0,0,0,8,9,13,9,3,17,22,"8-9","Y","Y","N",0,0,6
"143","E1",2023-09-19,"Bristol City","Plymouth",4,1,"H",3,1,"H",1.78,4.15,4.44,"3-1","4-1",17,6,6,2,3,0,0,0,7,1,9,13,5,8,22,"7-1","Y","Y","Y",3,0,7
"144","E1",2023-09-19,"Cardiff","Coventry",3,2,"H",1,1,"D",2.75,3.4,2.7,"1-1","3-2",8,3,7,3,2,3,0,0,3,5,7,8,5,8,15,"3-5","Y","Y","Y",5,0,7
"145","E1",2023-09-19,"Preston","Birmingham",2,1,"H",0,0,"D",2.4,3.2,3.35,"0-0","2-1",10,3,16,4,2,1,0,0,5,2,11,13,3,7,24,"5-2","Y","Y","N",3,0,7
"146","E1",2023-09-19,"QPR","Swansea",1,1,"D",0,1,"A",2.75,3.44,2.68,"0-1","1-1",11,3,8,3,1,1,0,1,4,6,12,17,2,10,29,"4-6","Y","N","N",2,1,7
"147","E1",2023-09-19,"Southampton","Ipswich",0,1,"A",0,1,"A",2.32,3.74,3.05,"0-1","0-1",13,3,11,3,2,2,0,0,9,3,9,13,1,12,22,"9-3","N","N","N",4,0,7
"148","E1",2023-09-19,"Sheffield Weds","Middlesbrough",1,1,"D",1,0,"H",3.46,3.6,2.17,"1-0","1-1",9,2,10,3,2,1,0,0,3,4,13,8,2,7,21,"3-4","Y","N","N",3,0,7
"149","E1",2023-09-20,"Blackburn","Sunderland",1,3,"A",1,2,"A",2.32,3.76,3.02,"1-2","1-3",22,6,13,4,5,3,0,0,8,4,14,11,4,12,25,"8-4","Y","Y","Y",8,0,7
"150","E1",2023-09-20,"Huddersfield","Stoke",2,2,"D",1,1,"D",2.83,3.45,2.6,"1-1","2-2",10,6,18,3,2,2,0,0,5,8,10,6,4,13,16,"5-8","Y","Y","Y",4,0,7
"151","E1",2023-09-20,"Hull","Leeds",0,0,"D",0,0,"D",3.9,3.73,1.98,"0-0","0-0",9,0,17,4,3,2,0,1,5,6,7,15,0,11,22,"5-6","N","N","N",5,1,7
"152","E1",2023-09-20,"Millwall","Rotherham",3,0,"H",1,0,"H",1.73,3.86,5.17,"1-0","3-0",20,8,5,1,1,1,0,0,6,1,12,16,3,7,28,"6-1","Y","Y","N",2,0,7
"153","E1",2023-09-20,"Watford","West Brom",2,2,"D",2,2,"D",2.22,3.49,3.45,"2-2","2-2",12,4,7,5,2,1,0,0,3,2,8,9,4,5,17,"3-2","Y","Y","Y",3,0,7
"154","E1",2023-09-20,"Norwich","Leicester",0,2,"A",0,1,"A",2.67,3.73,2.6,"0-1","0-2",15,2,10,3,3,4,0,0,10,1,14,15,2,11,29,"10-1","Y","N","N",7,0,7
"155","E1",2023-09-22,"Birmingham","QPR",0,0,"D",0,0,"D",1.86,3.61,4.65,"0-0","0-0",12,4,8,4,3,2,0,0,6,7,13,13,0,13,26,"6-7","N","N","N",5,0,8
"156","E1",2023-09-23,"Ipswich","Blackburn",4,3,"H",3,1,"H",1.7,4.26,4.77,"3-1","4-3",29,11,10,5,3,4,0,0,10,5,10,13,7,15,23,"10-5","Y","Y","Y",7,0,8
"157","E1",2023-09-23,"Leeds","Watford",3,0,"H",0,0,"D",1.75,4.09,4.64,"0-0","3-0",17,10,4,1,1,3,0,0,8,1,13,15,3,9,28,"8-1","Y","Y","N",4,0,8
"158","E1",2023-09-23,"Leicester","Bristol City",1,0,"H",0,0,"D",1.74,4.17,4.68,"0-0","1-0",19,7,6,1,1,2,0,0,9,0,11,10,1,9,21,"9-0","N","N","N",3,0,8
"159","E1",2023-09-23,"Middlesbrough","Southampton",2,1,"H",1,1,"D",2.5,3.62,2.85,"1-1","2-1",14,5,15,5,3,0,0,0,5,7,16,7,3,12,23,"5-7","Y","Y","N",3,0,8
"160","E1",2023-09-23,"Plymouth","Norwich",6,2,"H",4,0,"H",3.44,3.88,2.08,"4-0","6-2",16,10,11,6,1,0,0,0,3,6,9,6,8,9,15,"3-6","Y","Y","Y",1,0,8
"161","E1",2023-09-23,"Rotherham","Preston",1,1,"D",1,1,"D",3.44,3.28,2.31,"1-1","1-1",3,1,14,6,3,2,0,0,2,10,7,6,2,12,13,"2-10","Y","N","N",5,0,8
"162","E1",2023-09-23,"Swansea","Sheffield Weds",3,0,"H",1,0,"H",1.97,3.54,4.17,"1-0","3-0",12,4,10,1,2,2,0,0,2,5,12,16,3,7,28,"2-5","Y","Y","N",4,0,8
"163","E1",2023-09-23,"West Brom","Millwall",0,0,"D",0,0,"D",2.16,3.42,3.67,"0-0","0-0",16,3,7,2,0,2,0,0,6,8,8,12,0,14,20,"6-8","N","N","N",2,0,8
"164","E1",2023-09-24,"Stoke","Hull",1,3,"A",0,2,"A",1.95,3.78,3.97,"0-2","1-3",10,6,13,5,2,3,0,0,11,6,18,9,4,17,27,"11-6","Y","Y","Y",5,0,8
"165","E1",2023-09-24,"Sunderland","Cardiff",0,1,"A",0,0,"D",1.96,3.74,3.98,"0-0","0-1",16,6,7,2,2,2,0,0,4,4,6,14,1,8,20,"4-4","N","N","N",4,0,8
"166","E1",2023-09-25,"Coventry","Huddersfield",1,1,"D",1,0,"H",1.84,3.76,4.53,"1-0","1-1",11,3,10,4,2,3,0,0,10,4,12,14,2,14,26,"10-4","Y","N","N",5,0,8
"167","E1",2023-09-29,"Sheffield Weds","Sunderland",0,3,"A",0,3,"A",3.27,3.49,2.29,"0-3","0-3",8,2,12,6,2,0,0,0,2,5,14,5,3,7,19,"2-5","Y","Y","N",2,0,9
"168","E1",2023-09-30,"Southampton","Leeds",3,1,"H",3,0,"H",2.97,3.7,2.38,"3-0","3-1",10,5,15,5,4,1,0,0,5,6,14,13,4,11,27,"5-6","Y","Y","Y",5,0,9
"169","E1",2023-09-30,"Bristol City","Stoke",2,3,"A",2,1,"H",2.37,3.37,3.23,"2-1","2-3",13,5,6,4,1,1,0,0,11,3,9,13,5,14,22,"11-3","Y","Y","Y",2,0,9
"170","E1",2023-09-30,"Cardiff","Rotherham",2,0,"H",0,0,"D",1.71,3.94,5.2,"0-0","2-0",12,5,7,0,2,0,0,0,6,5,4,11,2,11,15,"6-5","Y","N","N",2,0,9
"171","E1",2023-09-30,"Huddersfield","Ipswich",1,1,"D",0,0,"D",3.88,3.89,1.94,"0-0","1-1",12,6,20,6,3,3,0,0,5,6,10,11,2,11,21,"5-6","Y","N","N",6,0,9
"172","E1",2023-09-30,"Hull","Plymouth",1,1,"D",1,1,"D",1.92,3.92,3.96,"1-1","1-1",21,5,11,5,2,2,0,0,12,4,9,10,2,16,19,"12-4","Y","N","N",4,0,9
"173","E1",2023-09-30,"Millwall","Swansea",0,3,"A",0,1,"A",2.1,3.43,3.85,"0-1","0-3",22,5,7,5,2,2,0,0,6,0,18,10,3,6,28,"6-0","Y","Y","N",4,0,9
"174","E1",2023-09-30,"Norwich","Birmingham",2,0,"H",0,0,"D",1.93,3.68,4.21,"0-0","2-0",16,4,12,2,1,1,0,0,4,4,9,10,2,8,19,"4-4","Y","N","N",2,0,9
"175","E1",2023-09-30,"Preston","West Brom",0,4,"A",0,2,"A",2.5,3.27,3.11,"0-2","0-4",5,1,19,6,3,1,0,0,2,6,12,5,4,8,17,"2-6","Y","Y","Y",4,0,9
"176","E1",2023-09-30,"QPR","Coventry",1,3,"A",0,0,"D",3.25,3.39,2.35,"0-0","1-3",12,3,15,6,4,2,0,0,4,5,11,14,4,9,25,"4-5","Y","Y","Y",6,0,9
"177","E1",2023-09-30,"Watford","Middlesbrough",2,3,"A",1,2,"A",2.46,3.53,2.96,"1-2","2-3",17,4,9,3,2,0,0,0,9,3,10,15,5,12,25,"9-3","Y","Y","Y",2,0,9
"178","E1",2023-10-01,"Blackburn","Leicester",1,4,"A",1,2,"A",3.53,3.82,2.07,"1-2","1-4",15,4,11,4,2,3,0,0,5,6,8,14,5,11,22,"5-6","Y","Y","Y",5,0,9
"179","E1",2023-10-03,"Birmingham","Huddersfield",4,1,"H",2,0,"H",2.3,3.34,3.4,"2-0","4-1",12,6,17,6,3,1,0,0,3,5,14,13,5,8,27,"3-5","Y","Y","Y",4,0,10
"180","E1",2023-10-03,"Ipswich","Hull",3,0,"H",2,0,"H",1.76,3.99,4.74,"2-0","3-0",14,6,13,6,0,0,0,0,6,5,16,11,3,11,27,"6-5","Y","Y","N",0,0,10
"181","E1",2023-10-03,"Middlesbrough","Cardiff",2,0,"H",0,0,"D",1.91,3.84,4.09,"0-0","2-0",11,6,6,3,1,3,0,0,8,2,10,10,2,10,20,"8-2","Y","N","N",4,0,10
"182","E1",2023-10-03,"Plymouth","Millwall",0,2,"A",0,0,"D",2.49,3.58,2.89,"0-0","0-2",22,6,9,3,2,6,0,0,8,1,5,14,2,9,19,"8-1","Y","N","N",8,0,10
"183","E1",2023-10-03,"Stoke","Southampton",0,1,"A",0,1,"A",2.78,3.46,2.64,"0-1","0-1",15,2,9,4,4,1,0,0,8,6,17,2,1,14,19,"8-6","N","N","N",5,0,10
"184","E1",2023-10-03,"West Brom","Sheffield Weds",1,0,"H",1,0,"H",1.61,3.94,6.36,"1-0","1-0",17,3,4,2,0,1,0,0,10,4,2,12,1,14,14,"10-4","N","N","N",1,0,10
"185","E1",2023-10-04,"Coventry","Blackburn",1,0,"H",0,0,"D",2.11,3.73,3.5,"0-0","1-0",14,3,14,4,2,1,0,0,7,8,18,13,1,15,31,"7-8","N","N","N",3,0,10
"186","E1",2023-10-04,"Leeds","QPR",1,0,"H",1,0,"H",1.36,5.53,8.65,"1-0","1-0",16,3,5,2,0,2,0,1,8,0,9,12,1,8,21,"8-0","N","N","N",2,1,10
"187","E1",2023-10-04,"Leicester","Preston",3,0,"H",0,0,"D",1.49,4.52,7.13,"0-0","3-0",9,4,6,1,0,2,0,0,4,4,3,8,3,8,11,"4-4","Y","Y","N",2,0,10
"188","E1",2023-10-04,"Sunderland","Watford",2,0,"H",1,0,"H",1.93,3.71,4.16,"1-0","2-0",9,4,11,4,1,5,0,1,5,2,9,19,2,7,28,"5-2","Y","N","N",6,1,10
"189","E1",2023-10-04,"Swansea","Norwich",2,1,"H",1,1,"D",2.94,3.47,2.51,"1-1","2-1",23,7,14,5,4,2,0,0,8,7,12,12,3,15,24,"8-7","Y","Y","N",6,0,10
"190","E1",2023-10-04,"Rotherham","Bristol City",1,2,"A",0,0,"D",4.01,3.37,2.07,"0-0","1-2",8,1,9,5,1,1,0,0,4,4,3,7,3,8,10,"4-4","Y","Y","N",2,0,10
"191","E2",2023-08-05,"Barnsley","Port Vale",7,0,"H",2,0,"H",1.8,3.72,4.72,"2-0","7-0",12,8,13,4,6,2,0,0,3,6,15,14,7,9,29,"3-6","Y","Y","Y",8,0,1
"192","E2",2023-08-05,"Blackpool","Burton",2,0,"H",2,0,"H",1.61,4.33,5.45,"2-0","2-0",15,4,9,3,4,1,0,0,7,4,10,12,2,11,22,"7-4","Y","N","N",5,0,1
"193","E2",2023-08-05,"Bolton","Lincoln",3,0,"H",1,0,"H",1.66,3.74,5.02,"1-0","3-0",16,4,6,0,3,3,0,0,10,1,19,16,3,11,35,"10-1","Y","Y","N",6,0,1
"194","E2",2023-08-05,"Cambridge","Oxford",2,0,"H",2,0,"H",3.25,3.34,2.31,"2-0","2-0",10,6,10,3,4,1,0,0,2,10,9,10,2,12,19,"2-10","Y","N","N",5,0,1
"195","E2",2023-08-05,"Carlisle","Fleetwood Town",1,1,"D",1,1,"D",2.27,3.41,3.33,"1-1","1-1",15,6,13,5,2,3,0,0,5,2,8,18,2,7,26,"5-2","Y","N","N",5,0,1
"196","E2",2023-08-05,"Charlton","Leyton Orient",1,0,"H",1,0,"H",2.18,3.48,3.49,"1-0","1-0",13,5,8,3,3,2,0,0,2,3,9,14,1,5,23,"2-3","N","N","N",5,0,1
"197","E2",2023-08-05,"Derby","Wigan",1,2,"A",0,1,"A",1.68,3.97,5.27,"0-1","1-2",21,5,7,3,2,2,0,0,11,4,11,6,3,15,17,"11-4","Y","Y","N",4,0,1
"198","E2",2023-08-05,"Northampton","Stevenage",0,1,"A",0,0,"D",2.68,3.17,2.9,"0-0","0-1",8,0,14,5,2,3,0,0,7,4,13,12,1,11,25,"7-4","N","N","N",5,0,1
"199","E2",2023-08-05,"Portsmouth","Bristol Rvs",1,1,"D",0,1,"A",1.92,3.71,4.09,"0-1","1-1",21,5,10,6,4,3,0,0,11,3,14,13,2,14,27,"11-3","Y","N","N",7,0,1
"200","E2",2023-08-05,"Reading","Peterboro",0,1,"A",0,1,"A",3.15,3.5,2.33,"0-1","0-1",15,4,13,6,6,4,0,0,6,6,12,9,1,12,21,"6-6","N","N","N",10,0,1
"201","E2",2023-08-05,"Shrewsbury","Cheltenham",1,0,"H",0,0,"D",2.34,3.28,3.31,"0-0","1-0",12,3,16,4,3,2,0,0,5,4,10,7,1,9,17,"5-4","N","N","N",5,0,1
"202","E2",2023-08-05,"Wycombe","Exeter",0,3,"A",0,2,"A",1.93,3.68,4.07,"0-2","0-3",10,1,11,7,2,2,0,0,4,5,11,12,3,9,23,"4-5","Y","Y","N",4,0,1
"203","E2",2023-08-12,"Bristol Rvs","Barnsley",1,1,"D",0,1,"A",3.18,3.47,2.32,"0-1","1-1",15,4,9,3,0,3,0,0,7,2,13,10,2,9,23,"7-2","Y","N","N",3,0,2
"204","E2",2023-08-12,"Burton","Derby",0,3,"A",0,1,"A",4.22,3.84,1.85,"0-1","0-3",14,2,8,5,1,3,0,0,6,2,12,7,3,8,19,"6-2","Y","Y","N",4,0,2
"205","E2",2023-08-12,"Cheltenham","Bolton",0,3,"A",0,3,"A",4.17,3.51,1.96,"0-3","0-3",5,2,16,7,2,1,0,0,3,9,7,9,3,12,16,"3-9","Y","Y","N",3,0,2
"206","E2",2023-08-12,"Exeter","Blackpool",0,0,"D",0,0,"D",2.96,3.32,2.54,"0-0","0-0",11,1,4,3,2,1,0,0,6,7,6,7,0,13,13,"6-7","N","N","N",3,0,2
"207","E2",2023-08-12,"Fleetwood Town","Cambridge",0,2,"A",0,1,"A",2.21,3.33,3.56,"0-1","0-2",13,2,16,7,3,3,0,0,9,6,16,14,2,15,30,"9-6","Y","N","N",6,0,2
"208","E2",2023-08-12,"Leyton Orient","Portsmouth",0,4,"A",0,2,"A",2.77,3.51,2.53,"0-2","0-4",11,3,10,4,2,2,0,0,3,3,10,8,4,6,18,"3-3","Y","Y","Y",4,0,2
"209","E2",2023-08-12,"Lincoln","Wycombe",3,0,"H",0,0,"D",2.52,3.27,3.03,"0-0","3-0",14,8,7,4,2,2,0,0,3,6,11,12,3,9,23,"3-6","Y","Y","N",4,0,2
"210","E2",2023-08-12,"Oxford","Carlisle",1,0,"H",0,0,"D",1.79,3.81,4.68,"0-0","1-0",14,3,8,0,0,4,0,0,5,4,9,17,1,9,26,"5-4","N","N","N",4,0,2
"211","E2",2023-08-12,"Peterboro","Charlton",1,0,"H",1,0,"H",1.96,3.78,3.83,"1-0","1-0",14,3,12,2,5,5,0,0,7,5,15,12,1,12,27,"7-5","N","N","N",10,0,2
"212","E2",2023-08-12,"Port Vale","Reading",1,0,"H",0,0,"D",2.7,3.45,2.68,"0-0","1-0",17,3,9,1,0,2,0,0,5,2,7,11,1,7,18,"5-2","N","N","N",2,0,2
"213","E2",2023-08-12,"Stevenage","Shrewsbury",2,0,"H",0,0,"D",2.18,3.27,3.72,"0-0","2-0",14,6,2,1,0,3,0,0,13,3,7,12,2,16,19,"13-3","Y","N","N",3,0,2
"214","E2",2023-08-12,"Wigan","Northampton",2,1,"H",0,1,"A",2.02,3.63,3.78,"0-1","2-1",24,5,17,3,4,4,0,0,8,5,10,14,3,13,24,"8-5","Y","Y","N",8,0,2
"215","E2",2023-08-15,"Barnsley","Peterboro",1,3,"A",0,0,"D",2.26,3.48,3.3,"0-0","1-3",13,7,18,9,0,1,0,0,10,5,7,7,4,15,14,"10-5","Y","Y","Y",1,0,3
"216","E2",2023-08-15,"Blackpool","Port Vale",0,0,"D",0,0,"D",1.85,3.7,4.47,"0-0","0-0",14,4,8,1,1,1,0,0,4,2,5,9,0,6,14,"4-2","N","N","N",2,0,3
"217","E2",2023-08-15,"Bolton","Fleetwood Town",3,1,"H",3,0,"H",1.6,4.27,5.58,"3-0","3-1",8,5,10,7,2,4,1,0,5,12,11,12,4,17,23,"5-12","Y","Y","Y",6,1,3
"218","E2",2023-08-15,"Cambridge","Stevenage",1,2,"A",0,1,"A",2.76,3.28,2.74,"0-1","1-2",11,3,11,6,0,3,0,0,6,3,11,17,3,9,28,"6-3","Y","Y","N",3,0,3
"219","E2",2023-08-15,"Carlisle","Wigan",1,1,"D",0,1,"A",2.82,3.24,2.71,"0-1","1-1",11,2,14,4,4,2,0,0,3,5,15,6,2,8,21,"3-5","Y","N","N",6,0,3
"220","E2",2023-08-15,"Charlton","Bristol Rvs",1,2,"A",0,0,"D",2.29,3.46,3.24,"0-0","1-2",18,5,14,7,1,2,0,0,7,5,12,6,3,12,18,"7-5","Y","Y","N",3,0,3
"221","E2",2023-08-15,"Derby","Oxford",1,2,"A",0,1,"A",1.93,3.55,4.28,"0-1","1-2",11,4,14,4,5,2,0,0,15,4,17,13,3,19,30,"15-4","Y","Y","N",7,0,3
"222","E2",2023-08-15,"Northampton","Lincoln",2,2,"D",0,1,"A",2.85,3.14,2.74,"0-1","2-2",19,9,6,3,1,0,0,0,3,1,9,7,4,4,16,"3-1","Y","Y","Y",1,0,3
"223","E2",2023-08-15,"Shrewsbury","Burton",2,1,"H",2,0,"H",2.36,3.45,3.12,"2-0","2-1",9,3,12,4,1,4,0,0,4,3,7,14,3,7,21,"4-3","Y","Y","N",5,0,3
"224","E2",2023-08-15,"Wycombe","Leyton Orient",3,2,"H",1,1,"D",2.14,3.41,3.66,"1-1","3-2",15,6,15,6,1,3,0,1,3,7,4,8,5,10,12,"3-7","Y","Y","Y",4,1,3
"225","E2",2023-08-15,"Portsmouth","Exeter",1,0,"H",0,0,"D",1.89,3.67,4.24,"0-0","1-0",13,7,9,5,5,1,0,0,8,6,14,11,1,14,25,"8-6","N","N","N",6,0,3
"226","E2",2023-08-15,"Reading","Cheltenham",1,0,"H",1,0,"H",1.84,3.56,4.76,"1-0","1-0",11,4,10,3,2,2,0,0,7,7,11,7,1,14,18,"7-7","N","N","N",4,0,3
"227","E2",2023-08-19,"Bolton","Wigan",0,4,"A",0,3,"A",1.79,3.81,4.63,"0-3","0-4",20,4,11,5,2,3,0,0,4,2,18,11,4,6,29,"4-2","Y","Y","Y",5,0,4
"228","E2",2023-08-19,"Barnsley","Oxford",1,3,"A",0,1,"A",2.13,3.54,3.56,"0-1","1-3",14,6,14,8,3,2,0,0,9,8,10,5,4,17,15,"9-8","Y","Y","Y",5,0,4
"229","E2",2023-08-19,"Blackpool","Leyton Orient",0,0,"D",0,0,"D",1.65,4.18,5.28,"0-0","0-0",15,5,9,2,0,4,0,0,8,1,8,8,0,9,16,"8-1","N","N","N",4,0,4
"230","E2",2023-08-19,"Cambridge","Bristol Rvs",2,0,"H",0,0,"D",2.82,3.45,2.53,"0-0","2-0",12,4,7,5,1,3,0,0,6,4,16,10,2,10,26,"6-4","Y","N","N",4,0,4
"231","E2",2023-08-19,"Carlisle","Exeter",0,2,"A",0,0,"D",2.72,3.31,2.75,"0-0","0-2",13,6,11,3,0,1,0,0,11,3,5,10,2,14,15,"11-3","Y","N","N",1,0,4
"232","E2",2023-08-19,"Charlton","Port Vale",2,3,"A",1,0,"H",1.98,3.71,3.86,"1-0","2-3",17,7,15,5,4,3,0,0,9,4,15,13,5,13,28,"9-4","Y","Y","Y",7,0,4
"233","E2",2023-08-19,"Derby","Fleetwood Town",1,0,"H",1,0,"H",1.57,4.3,5.9,"1-0","1-0",14,3,8,2,3,3,0,0,7,9,11,13,1,16,24,"7-9","N","N","N",6,0,4
"234","E2",2023-08-19,"Northampton","Peterboro",1,0,"H",0,0,"D",3.46,3.7,2.11,"0-0","1-0",9,2,17,1,1,2,0,0,4,5,7,9,1,9,16,"4-5","N","N","N",3,0,4
"235","E2",2023-08-19,"Portsmouth","Cheltenham",0,0,"D",0,0,"D",1.49,4.38,7.18,"0-0","0-0",15,5,12,1,0,3,0,0,5,5,9,14,0,10,23,"5-5","N","N","N",3,0,4
"236","E2",2023-08-19,"Reading","Stevenage",2,0,"H",1,0,"H",2.66,3.28,2.85,"1-0","2-0",20,7,6,4,0,3,0,1,7,0,12,8,2,7,20,"7-0","Y","N","N",3,1,4
"237","E2",2023-08-19,"Shrewsbury","Lincoln",0,1,"A",0,0,"D",2.67,3.16,2.93,"0-0","0-1",11,2,7,3,2,4,0,0,6,1,9,13,1,7,22,"6-1","N","N","N",6,0,4
"238","E2",2023-08-19,"Wycombe","Burton",0,0,"D",0,0,"D",1.91,3.66,4.19,"0-0","0-0",14,8,7,3,2,2,0,0,6,2,10,10,0,8,20,"6-2","N","N","N",4,0,4
"239","E2",2023-08-26,"Bristol Rvs","Wycombe",1,2,"A",0,1,"A",2.13,3.58,3.52,"0-1","1-2",12,1,12,5,3,0,0,0,7,3,12,6,3,10,18,"7-3","Y","Y","N",3,0,5
"240","E2",2023-08-26,"Burton","Bolton",1,1,"D",0,0,"D",3.83,3.61,1.98,"0-0","1-1",13,3,17,6,6,2,0,0,4,8,13,12,2,12,25,"4-8","Y","N","N",8,0,5
"241","E2",2023-08-26,"Cheltenham","Northampton",0,1,"A",0,0,"D",2.6,3.46,2.78,"0-0","0-1",8,2,15,2,1,2,0,0,1,8,8,8,1,9,16,"1-8","N","N","N",3,0,5
"242","E2",2023-08-26,"Exeter","Reading",2,1,"H",1,1,"D",2.03,3.56,3.73,"1-1","2-1",20,4,12,3,3,4,0,0,7,7,10,9,3,14,19,"7-7","Y","Y","N",7,0,5
"243","E2",2023-08-26,"Fleetwood Town","Shrewsbury",0,1,"A",0,1,"A",2.02,3.41,3.95,"0-1","0-1",9,1,5,2,1,3,2,0,9,1,14,12,1,10,26,"9-1","N","N","N",4,2,5
"244","E2",2023-08-26,"Leyton Orient","Cambridge",2,0,"H",1,0,"H",2.45,3.48,2.96,"1-0","2-0",16,3,10,3,4,4,0,0,5,7,15,14,2,12,29,"5-7","Y","N","N",8,0,5
"245","E2",2023-08-26,"Lincoln","Blackpool",3,0,"H",2,0,"H",2.72,3.18,2.85,"2-0","3-0",11,5,14,3,1,0,0,1,1,2,13,13,3,3,26,"1-2","Y","Y","N",1,1,5
"246","E2",2023-08-26,"Oxford","Charlton",2,1,"H",1,0,"H",1.92,3.82,3.97,"1-0","2-1",16,5,9,3,3,6,0,0,7,1,11,16,3,8,27,"7-1","Y","Y","N",9,0,5
"247","E2",2023-08-26,"Peterboro","Derby",2,4,"A",1,4,"A",2.47,3.41,2.92,"1-4","2-4",16,6,14,5,2,1,0,0,8,9,6,12,6,17,18,"8-9","Y","Y","Y",3,0,5
"248","E2",2023-08-26,"Port Vale","Carlisle",1,0,"H",0,0,"D",1.92,3.71,4.08,"0-0","1-0",17,5,10,2,0,0,0,0,8,8,6,9,1,16,15,"8-8","N","N","N",0,0,5
"249","E2",2023-08-26,"Stevenage","Portsmouth",0,0,"D",0,0,"D",2.75,3.36,2.69,"0-0","0-0",12,3,13,2,4,3,1,1,4,7,12,13,0,11,25,"4-7","N","N","N",7,2,5
"250","E2",2023-08-26,"Wigan","Barnsley",0,2,"A",0,1,"A",2.38,3.53,3.02,"0-1","0-2",9,1,19,8,1,3,1,0,4,5,7,14,2,9,21,"4-5","Y","N","N",4,1,5
"251","E2",2023-09-02,"Blackpool","Wigan",2,1,"H",1,0,"H",2.26,3.46,3.31,"1-0","2-1",14,7,6,3,3,3,0,0,4,3,14,7,3,7,21,"4-3","Y","Y","N",6,0,6
"252","E2",2023-09-02,"Bolton","Derby",2,1,"H",1,1,"D",2.2,3.49,3.42,"1-1","2-1",17,4,10,1,3,2,0,1,7,6,11,9,3,13,20,"7-6","Y","Y","N",5,1,6
"253","E2",2023-09-02,"Bristol Rvs","Lincoln",1,1,"D",0,0,"D",2.39,3.59,2.98,"0-0","1-1",11,3,12,5,2,3,0,0,7,5,9,8,2,12,17,"7-5","Y","N","N",5,0,6
"254","E2",2023-09-02,"Burton","Exeter",0,1,"A",0,0,"D",2.9,3.43,2.52,"0-0","0-1",9,5,16,4,2,1,1,0,3,5,14,8,1,8,22,"3-5","N","N","N",3,1,6
"255","E2",2023-09-02,"Carlisle","Shrewsbury",2,0,"H",0,0,"D",2.38,3.33,3.2,"0-0","2-0",11,2,9,2,2,4,0,0,8,6,11,8,2,14,19,"8-6","Y","N","N",6,0,6
"256","E2",2023-09-02,"Charlton","Fleetwood Town",2,1,"H",1,1,"D",2.12,3.8,3.35,"1-1","2-1",17,4,11,3,4,3,0,0,13,4,12,12,3,17,24,"13-4","Y","Y","N",7,0,6
"257","E2",2023-09-02,"Cheltenham","Barnsley",0,2,"A",0,0,"D",4.26,3.76,1.87,"0-0","0-2",17,5,19,5,3,3,0,0,7,4,9,11,2,11,20,"7-4","Y","N","N",6,0,6
"258","E2",2023-09-02,"Leyton Orient","Stevenage",0,3,"A",0,2,"A",2.81,3.36,2.64,"0-2","0-3",8,2,10,4,2,1,0,0,9,6,13,9,3,15,22,"9-6","Y","Y","N",3,0,6
"259","E2",2023-09-02,"Northampton","Wycombe",0,1,"A",0,1,"A",2.45,3.43,2.99,"0-1","0-1",20,6,7,1,0,2,0,0,5,3,12,9,1,8,21,"5-3","N","N","N",2,0,6
"260","E2",2023-09-02,"Oxford","Port Vale",1,2,"A",0,0,"D",1.71,3.87,5.2,"0-0","1-2",13,6,8,5,1,2,2,0,5,3,8,14,3,8,22,"5-3","Y","Y","N",3,2,6
"261","E2",2023-09-02,"Portsmouth","Peterboro",3,1,"H",2,1,"H",2.26,3.58,3.22,"2-1","3-1",18,7,16,4,1,3,1,0,10,9,10,12,4,19,22,"10-9","Y","Y","Y",4,1,6
"262","E2",2023-09-04,"Cambridge","Reading",1,0,"H",0,0,"D",2.27,3.35,3.26,"0-0","1-0",17,3,13,4,1,4,0,0,9,5,8,15,1,14,23,"9-5","N","N","N",5,0,6
"263","E2",2023-09-09,"Exeter","Leyton Orient",1,2,"A",0,0,"D",1.75,3.87,4.85,"0-0","1-2",5,2,19,7,3,3,0,0,4,10,12,10,3,14,22,"4-10","Y","Y","N",6,0,7
"264","E2",2023-09-09,"Stevenage","Carlisle",2,2,"D",1,1,"D",1.79,3.67,4.86,"1-1","2-2",16,8,4,2,2,2,0,0,11,2,13,10,4,13,23,"11-2","Y","Y","Y",4,0,7
"265","E2",2023-09-16,"Barnsley","Burton",2,0,"H",1,0,"H",1.67,4.12,5.1,"1-0","2-0",8,3,8,1,0,0,0,0,0,2,5,10,2,2,15,"0-2","Y","N","N",0,0,7
"266","E2",2023-09-16,"Derby","Portsmouth",1,1,"D",0,0,"D",2.16,3.54,3.47,"0-0","1-1",8,1,14,5,2,3,0,0,4,8,16,9,2,12,25,"4-8","Y","N","N",5,0,7
"267","E2",2023-09-16,"Exeter","Cheltenham",1,0,"H",0,0,"D",1.71,3.78,5.3,"0-0","1-0",20,7,9,2,3,2,0,0,8,2,11,9,1,10,20,"8-2","N","N","N",5,0,7
"268","E2",2023-09-16,"Fleetwood Town","Oxford",0,3,"A",0,2,"A",3.22,3.59,2.25,"0-2","0-3",11,0,10,5,2,0,0,0,9,4,12,7,3,13,19,"9-4","Y","Y","N",2,0,7
"269","E2",2023-09-16,"Lincoln","Carlisle",1,1,"D",0,1,"A",1.88,3.53,4.55,"0-1","1-1",12,4,14,6,1,5,0,0,2,1,9,13,2,3,22,"2-1","Y","N","N",6,0,7
"270","E2",2023-09-16,"Peterboro","Leyton Orient",1,1,"D",1,1,"D",1.85,4.04,4.04,"1-1","1-1",7,5,6,2,2,3,0,0,6,3,8,17,2,9,25,"6-3","Y","N","N",5,0,7
"271","E2",2023-09-16,"Port Vale","Northampton",1,0,"H",0,0,"D",2,3.62,3.88,"0-0","1-0",13,4,5,1,1,0,0,0,5,3,7,6,1,8,13,"5-3","N","N","N",1,0,7
"272","E2",2023-09-16,"Reading","Bolton",2,1,"H",0,1,"A",3.6,3.7,2.06,"0-1","2-1",18,7,10,5,3,4,0,1,6,4,17,15,3,10,32,"6-4","Y","Y","N",7,1,7
"273","E2",2023-09-16,"Shrewsbury","Bristol Rvs",0,2,"A",0,0,"D",3.02,3.34,2.48,"0-0","0-2",12,4,9,4,2,3,0,0,5,6,14,10,2,11,24,"5-6","Y","N","N",5,0,7
"274","E2",2023-09-16,"Stevenage","Charlton",1,1,"D",1,0,"H",2.01,3.68,3.78,"1-0","1-1",9,3,12,1,3,3,0,0,5,4,10,16,2,9,26,"5-4","Y","N","N",6,0,7
"275","E2",2023-09-16,"Wigan","Cambridge",2,1,"H",0,0,"D",2.15,3.71,3.35,"0-0","2-1",6,3,18,3,2,0,0,0,3,2,13,10,3,5,23,"3-2","Y","Y","N",2,0,8
"276","E2",2023-09-16,"Wycombe","Blackpool",2,0,"H",1,0,"H",2.81,3.43,2.59,"1-0","2-0",10,4,11,2,3,1,0,0,0,5,14,11,2,5,25,"0-5","Y","N","N",4,0,8
"277","E2",2023-09-19,"Barnsley","Portsmouth",2,3,"A",0,3,"A",2.49,3.47,2.91,"0-3","2-3",15,3,16,6,0,1,0,0,3,5,13,8,5,8,21,"3-5","Y","Y","Y",1,0,8
"278","E2",2023-09-19,"Peterboro","Cheltenham",3,0,"H",0,0,"D",1.45,4.76,7.19,"0-0","3-0",24,5,2,0,0,0,0,2,15,1,7,6,3,16,13,"15-1","Y","Y","N",0,2,8
"279","E2",2023-09-19,"Port Vale","Burton",2,3,"A",1,1,"D",1.94,3.52,4.23,"1-1","2-3",19,9,8,3,2,3,0,0,7,1,11,12,5,8,23,"7-1","Y","Y","Y",5,0,8
"280","E2",2023-09-23,"Blackpool","Reading",4,1,"H",3,0,"H",1.89,3.65,4.3,"3-0","4-1",17,6,5,4,0,1,0,0,10,3,7,12,5,13,19,"10-3","Y","Y","Y",1,0,8
"281","E2",2023-09-23,"Bolton","Peterboro",1,1,"D",1,1,"D",2.07,3.57,3.69,"1-1","1-1",7,3,25,6,4,2,1,0,8,10,11,14,2,18,25,"8-10","Y","N","N",6,1,8
"282","E2",2023-09-23,"Bristol Rvs","Wigan",4,1,"H",2,1,"H",2.24,3.6,3.23,"2-1","4-1",15,6,9,3,3,2,0,0,3,5,12,15,5,8,27,"3-5","Y","Y","Y",5,0,8
"283","E2",2023-09-23,"Burton","Fleetwood Town",1,1,"D",1,1,"D",2.64,3.49,2.72,"1-1","1-1",13,2,13,4,2,0,0,0,4,5,9,9,2,9,18,"4-5","Y","N","N",2,0,8
"284","E2",2023-09-23,"Cambridge","Port Vale",1,1,"D",0,1,"A",2.33,3.29,3.34,"0-1","1-1",12,5,8,2,0,4,0,0,7,7,9,14,2,14,23,"7-7","Y","N","N",4,0,8
"285","E2",2023-09-23,"Carlisle","Derby",0,2,"A",0,1,"A",3.43,3.54,2.14,"0-1","0-2",9,4,9,2,1,1,0,0,8,2,8,13,2,10,21,"8-2","Y","N","N",2,0,8
"286","E2",2023-09-23,"Charlton","Wycombe",3,1,"H",1,0,"H",2.23,3.6,3.24,"1-0","3-1",9,6,12,1,3,2,0,0,7,6,15,10,4,13,25,"7-6","Y","Y","Y",5,0,8
"287","E2",2023-09-23,"Cheltenham","Stevenage",0,3,"A",0,1,"A",4.39,3.59,1.89,"0-1","0-3",9,2,21,9,1,1,0,0,5,4,4,14,3,9,18,"5-4","Y","Y","N",2,0,9
"288","E2",2023-09-23,"Leyton Orient","Shrewsbury",1,0,"H",1,0,"H",1.94,3.47,4.31,"1-0","1-0",9,1,12,5,4,1,0,0,7,7,12,9,1,14,21,"7-7","N","N","N",5,0,9
"289","E2",2023-09-23,"Northampton","Barnsley",1,2,"A",0,1,"A",3.17,3.61,2.27,"0-1","1-2",12,5,9,4,0,4,0,0,10,2,9,13,3,12,22,"10-2","Y","Y","N",4,0,9
"290","E2",2023-09-23,"Oxford","Exeter",3,0,"H",1,0,"H",1.81,3.83,4.51,"1-0","3-0",9,4,14,5,1,1,0,0,3,4,11,13,3,7,24,"3-4","Y","Y","N",2,0,9
"291","E2",2023-09-23,"Portsmouth","Lincoln",2,1,"H",2,1,"H",1.68,3.86,5.55,"2-1","2-1",11,3,10,4,3,2,0,0,3,1,7,11,3,4,18,"3-1","Y","Y","N",5,0,9
"292","E2",2023-09-30,"Barnsley","Blackpool",0,1,"A",0,1,"A",2.26,3.6,3.19,"0-1","0-1",13,0,6,3,1,7,0,0,5,2,10,13,1,7,23,"5-2","N","N","N",8,0,9
"293","E2",2023-09-30,"Derby","Cambridge",0,0,"D",0,0,"D",1.67,4.17,5.03,"0-0","0-0",12,2,4,1,2,2,0,0,9,3,11,12,0,12,23,"9-3","N","N","N",4,0,9
"294","E2",2023-09-30,"Exeter","Northampton",0,2,"A",0,1,"A",2.07,3.51,3.75,"0-1","0-2",10,2,11,7,1,5,0,0,6,2,11,14,2,8,25,"6-2","Y","N","N",6,0,9
"295","E2",2023-09-30,"Fleetwood Town","Leyton Orient",1,0,"H",0,0,"D",2.45,3.39,3.02,"0-0","1-0",14,3,15,5,1,3,1,1,6,6,10,10,1,12,20,"6-6","N","N","N",4,2,9
"296","E2",2023-09-30,"Lincoln","Cheltenham",2,0,"H",2,0,"H",1.66,4.01,5.36,"2-0","2-0",9,3,10,1,4,1,0,0,2,5,14,10,2,7,24,"2-5","Y","N","N",5,0,9
"297","E2",2023-09-30,"Peterboro","Bristol Rvs",2,0,"H",1,0,"H",1.89,3.73,4.2,"1-0","2-0",15,7,16,2,5,2,0,0,9,9,9,14,2,18,23,"9-9","Y","N","N",7,0,9
"298","E2",2023-09-30,"Port Vale","Bolton",0,1,"A",0,1,"A",3.03,3.45,2.38,"0-1","0-1",15,6,13,5,2,3,0,0,8,5,6,14,1,13,20,"8-5","N","N","N",5,0,9
"299","E2",2023-09-30,"Reading","Burton",0,0,"D",0,0,"D",1.96,3.66,3.96,"0-0","0-0",20,7,3,1,1,4,0,0,5,2,7,11,0,7,18,"5-2","N","N","N",5,0,10
"300","E2",2023-09-30,"Shrewsbury","Charlton",0,0,"D",0,0,"D",3.07,3.43,2.4,"0-0","0-0",15,8,14,6,1,4,0,0,7,7,6,9,0,14,15,"7-7","N","N","N",5,0,10
"301","E2",2023-09-30,"Stevenage","Oxford",1,3,"A",1,1,"D",2.4,3.38,3.12,"1-1","1-3",11,3,15,4,1,2,0,0,9,8,10,9,4,17,19,"9-8","Y","Y","Y",3,0,10
"302","E2",2023-09-30,"Wigan","Portsmouth",1,2,"A",1,2,"A",3.15,3.52,2.31,"1-2","1-2",7,1,16,5,3,2,1,0,1,9,17,16,3,10,33,"1-9","Y","Y","N",5,1,10
"303","E2",2023-09-30,"Wycombe","Carlisle",2,0,"H",1,0,"H",1.88,3.68,4.32,"1-0","2-0",19,6,12,1,2,1,0,1,8,2,12,10,2,10,22,"8-2","Y","N","N",3,1,10
"304","E2",2023-10-03,"Blackpool","Derby",1,3,"A",0,0,"D",2.35,3.38,3.2,"0-0","1-3",10,4,9,5,1,1,0,0,9,3,6,11,4,12,17,"9-3","Y","Y","Y",2,0,10
"305","E2",2023-10-03,"Bolton","Stevenage",3,2,"H",1,1,"D",2.1,3.51,3.65,"1-1","3-2",9,4,11,3,3,2,0,0,4,5,13,13,5,9,26,"4-5","Y","Y","Y",5,0,10
"306","E2",2023-10-03,"Bristol Rvs","Port Vale",3,0,"H",2,0,"H",2.07,3.55,3.7,"2-0","3-0",10,7,6,2,1,1,0,1,8,3,11,13,3,11,24,"8-3","Y","Y","N",2,1,10
"307","E2",2023-10-03,"Burton","Wigan",2,1,"H",0,1,"A",2.74,3.37,2.7,"0-1","2-1",15,5,12,1,2,3,1,0,3,4,14,16,3,7,30,"3-4","Y","Y","N",5,1,10
"308","E2",2023-10-03,"Cambridge","Barnsley",0,4,"A",0,2,"A",2.96,3.55,2.42,"0-2","0-4",17,8,12,7,2,2,0,0,6,6,7,12,4,12,19,"6-6","Y","Y","Y",4,0,10
"309","E2",2023-10-03,"Carlisle","Peterboro",1,1,"D",0,0,"D",3.76,3.61,2.04,"0-0","1-1",8,1,15,6,2,0,0,0,3,8,8,14,2,11,22,"3-8","Y","N","N",2,0,10
"310","E2",2023-10-03,"Charlton","Exeter",4,1,"H",1,1,"D",2.08,3.65,3.57,"1-1","4-1",21,10,12,3,1,0,0,1,9,5,12,10,5,14,22,"9-5","Y","Y","Y",1,1,10
"311","E2",2023-10-03,"Cheltenham","Fleetwood Town",0,2,"A",0,1,"A",3.23,3.43,2.31,"0-1","0-2",7,2,20,5,2,5,1,0,0,3,16,11,2,3,27,"0-3","Y","N","N",7,1,11
"312","E2",2023-10-03,"Northampton","Reading",3,1,"H",2,0,"H",2.41,3.53,2.99,"2-0","3-1",12,5,7,4,1,3,0,0,4,1,5,14,4,5,19,"4-1","Y","Y","Y",4,0,11
"313","E2",2023-10-03,"Oxford","Shrewsbury",3,0,"H",1,0,"H",1.57,4.12,6.29,"1-0","3-0",14,5,4,1,3,0,0,1,4,4,12,12,3,8,24,"4-4","Y","Y","N",3,1,11
"314","E2",2023-10-03,"Portsmouth","Wycombe",2,1,"H",0,1,"A",1.75,3.89,4.82,"0-1","2-1",11,3,8,1,2,4,0,0,14,2,8,13,3,16,21,"14-2","Y","Y","N",6,0,11
"315","E3",2023-08-05,"Accrington","Newport County",3,0,"H",1,0,"H",2.49,3.27,3.07,"1-0","3-0",16,8,17,2,2,0,0,0,7,4,11,13,3,11,24,"7-4","Y","Y","N",2,0,1
"316","E3",2023-08-05,"Crawley Town","Bradford",1,0,"H",1,0,"H",4.1,3.5,1.98,"1-0","1-0",21,3,14,7,6,3,0,1,2,4,14,14,1,6,28,"2-4","N","N","N",9,1,1
"317","E3",2023-08-05,"Crewe","Mansfield",2,2,"D",1,2,"A",4.15,3.75,1.87,"1-2","2-2",13,3,21,9,2,4,0,1,10,5,8,16,4,15,24,"10-5","Y","Y","Y",6,1,1
"318","E3",2023-08-05,"Doncaster","Harrogate",0,1,"A",0,0,"D",2.26,3.42,3.35,"0-0","0-1",12,3,7,6,1,4,0,0,6,5,7,20,1,11,27,"6-5","N","N","N",5,0,1
"319","E3",2023-08-05,"Forest Green","Salford",0,2,"A",0,0,"D",3.55,3.53,2.13,"0-0","0-2",19,4,7,3,3,3,0,0,10,4,17,9,2,14,26,"10-4","Y","N","N",6,0,1
"320","E3",2023-08-05,"Grimsby","AFC Wimbledon",0,0,"D",0,0,"D",2.06,3.45,3.87,"0-0","0-0",15,5,10,4,4,3,0,0,8,5,10,12,0,13,22,"8-5","N","N","N",7,0,1
"321","E3",2023-08-05,"Morecambe","Walsall",2,1,"H",1,1,"D",2.7,3.26,2.82,"1-1","2-1",7,5,11,1,6,4,0,0,5,3,12,7,3,8,19,"5-3","Y","Y","N",10,0,1
"322","E3",2023-08-05,"Stockport","Gillingham",0,1,"A",0,0,"D",1.79,3.57,5.1,"0-0","0-1",16,3,6,3,0,5,0,0,6,1,11,11,1,7,22,"6-1","N","N","N",5,0,1
"323","E3",2023-08-05,"Sutton","Notts County",5,1,"H",2,0,"H",4.71,4.13,1.72,"2-0","5-1",12,6,14,3,3,3,0,1,4,5,16,8,6,9,24,"4-5","Y","Y","Y",6,1,1
"324","E3",2023-08-05,"Tranmere","Barrow",1,2,"A",0,1,"A",2.45,3.17,3.23,"0-1","1-2",17,3,7,3,2,2,0,0,7,4,9,8,3,11,17,"7-4","Y","Y","N",4,0,1
"325","E3",2023-08-05,"Wrexham","Milton Keynes Dons",3,5,"A",1,2,"A",1.69,3.98,5.13,"1-2","3-5",23,5,8,6,2,3,0,0,5,4,15,9,8,9,24,"5-4","Y","Y","Y",5,0,1
"326","E3",2023-08-12,"AFC Wimbledon","Wrexham",1,1,"D",0,1,"A",3.61,3.62,2.08,"0-1","1-1",13,3,10,6,3,2,0,0,6,4,12,12,2,10,24,"6-4","Y","N","N",5,0,1
"327","E3",2023-08-12,"Barrow","Sutton",2,1,"H",0,1,"A",2.45,3.13,3.28,"0-1","2-1",17,7,9,3,0,1,0,1,9,1,8,7,3,10,15,"9-1","Y","Y","N",1,1,2
"328","E3",2023-08-12,"Bradford","Colchester",2,1,"H",1,1,"D",1.92,3.57,4.15,"1-1","2-1",19,7,11,2,2,2,0,0,4,11,3,9,3,15,12,"4-11","Y","Y","N",4,0,2
"329","E3",2023-08-12,"Gillingham","Accrington",1,0,"H",1,0,"H",2.08,3.31,3.99,"1-0","1-0",17,4,9,1,3,2,0,0,9,1,14,13,1,10,27,"9-1","N","N","N",5,0,2
"330","E3",2023-08-12,"Harrogate","Forest Green",0,1,"A",0,0,"D",2.4,3.46,3.06,"0-0","0-1",10,3,15,2,1,3,0,0,8,5,7,11,1,13,18,"8-5","N","N","N",4,0,2
"331","E3",2023-08-12,"Mansfield","Morecambe",3,0,"H",1,0,"H",1.56,4.48,5.82,"1-0","3-0",27,6,5,0,2,2,0,0,5,4,9,11,3,9,20,"5-4","Y","Y","N",4,0,2
"332","E3",2023-08-12,"Milton Keynes Dons","Tranmere",1,0,"H",1,0,"H",1.79,3.69,4.83,"1-0","1-0",7,2,16,3,2,1,0,0,3,11,8,12,1,14,20,"3-11","N","N","N",3,0,2
"333","E3",2023-08-12,"Newport County","Doncaster",4,0,"H",3,0,"H",2.25,3.47,3.33,"3-0","4-0",14,6,8,2,4,6,0,0,2,5,10,18,4,7,28,"2-5","Y","Y","Y",10,0,2
"334","E3",2023-08-12,"Notts County","Grimsby",3,2,"H",1,2,"A",1.78,4.16,4.32,"1-2","3-2",12,8,10,3,4,4,0,0,7,6,6,16,5,13,22,"7-6","Y","Y","Y",8,0,2
"335","E3",2023-08-12,"Salford","Crawley Town",1,1,"D",0,1,"A",1.48,4.67,6.68,"0-1","1-1",7,3,16,2,1,4,0,0,2,3,13,10,2,5,23,"2-3","Y","N","N",5,0,2
"336","E3",2023-08-12,"Swindon","Crewe",2,2,"D",1,0,"H",1.86,3.6,4.54,"1-0","2-2",20,6,16,5,4,6,0,0,7,2,13,13,4,9,26,"7-2","Y","Y","Y",10,0,2
"337","E3",2023-08-12,"Walsall","Stockport",2,1,"H",1,0,"H",4.13,3.32,2.04,"1-0","2-1",9,2,18,3,3,5,0,0,4,11,8,9,3,15,17,"4-11","Y","Y","N",8,0,2
"338","E3",2023-08-15,"Accrington","Barrow",1,1,"D",1,0,"H",2.61,3.19,2.97,"1-0","1-1",7,2,13,1,2,1,0,0,1,10,10,5,2,11,15,"1-10","Y","N","N",3,0,2
"339","E3",2023-08-15,"Colchester","AFC Wimbledon",0,2,"A",0,0,"D",2.37,3.21,3.34,"0-0","0-2",9,4,21,7,3,3,0,0,7,9,8,12,2,16,20,"7-9","Y","N","N",6,0,3
"340","E3",2023-08-15,"Crawley Town","Milton Keynes Dons",2,1,"H",1,1,"D",3.06,3.44,2.41,"1-1","2-1",14,5,8,2,1,2,0,0,7,5,8,11,3,12,19,"7-5","Y","Y","N",3,0,3
"341","E3",2023-08-15,"Crewe","Newport County",4,2,"H",1,1,"D",3.21,3.42,2.33,"1-1","4-2",10,6,14,7,0,2,0,0,1,5,4,12,6,6,16,"1-5","Y","Y","Y",2,0,3
"342","E3",2023-08-15,"Doncaster","Mansfield",2,2,"D",1,1,"D",4.3,3.71,1.88,"1-1","2-2",11,5,21,8,1,3,0,0,3,7,8,10,4,10,18,"3-7","Y","Y","Y",4,0,3
"343","E3",2023-08-15,"Forest Green","Swindon",1,2,"A",1,0,"H",2.75,3.4,2.66,"1-0","1-2",13,5,21,8,4,3,1,0,6,5,12,11,3,11,23,"6-5","Y","Y","N",7,1,3
"344","E3",2023-08-15,"Grimsby","Salford",2,0,"H",1,0,"H",2.7,3.3,2.78,"1-0","2-0",10,2,7,1,0,3,0,1,2,7,16,16,2,9,32,"2-7","Y","N","N",3,1,3
"345","E3",2023-08-15,"Morecambe","Notts County",0,0,"D",0,0,"D",4.3,4.03,1.8,"0-0","0-0",13,1,9,1,1,1,0,0,4,5,7,4,0,9,11,"4-5","N","N","N",2,0,3
"346","E3",2023-08-15,"Stockport","Bradford",1,1,"D",0,0,"D",1.85,3.46,4.84,"0-0","1-1",15,5,10,6,2,3,0,0,7,4,8,16,2,11,24,"7-4","Y","N","N",5,0,3
"347","E3",2023-08-15,"Sutton","Gillingham",0,1,"A",0,1,"A",2.68,3.18,2.91,"0-1","0-1",6,2,5,1,2,1,0,0,2,9,6,10,1,11,16,"2-9","N","N","N",3,0,3
"348","E3",2023-08-15,"Tranmere","Harrogate",3,0,"H",2,0,"H",2.14,3.4,3.67,"2-0","3-0",11,5,11,2,2,1,0,0,6,3,10,17,3,9,27,"6-3","Y","Y","N",3,0,3
"349","E3",2023-08-15,"Wrexham","Walsall",4,2,"H",2,1,"H",1.62,4.28,5.36,"2-1","4-2",20,11,12,5,1,3,0,0,6,3,3,9,6,9,12,"6-3","Y","Y","Y",4,0,3
"350","E3",2023-08-19,"Accrington","Harrogate",2,1,"H",1,0,"H",2.13,3.46,3.53,"1-0","2-1",23,7,11,2,4,4,1,0,5,3,14,15,3,8,29,"5-3","Y","Y","N",8,1,3
"351","E3",2023-08-19,"Colchester","Milton Keynes Dons",2,3,"A",2,1,"H",2.86,3.28,2.64,"2-1","2-3",12,4,18,6,5,4,0,0,3,6,16,8,5,9,24,"3-6","Y","Y","Y",9,0,4
"352","E3",2023-08-19,"Crawley Town","Gillingham",0,1,"A",0,1,"A",3.13,3.1,2.52,"0-1","0-1",17,7,7,2,3,3,0,0,9,4,8,10,1,13,18,"9-4","N","N","N",6,0,4
"353","E3",2023-08-19,"Crewe","Walsall",2,2,"D",0,2,"A",2.71,3.41,2.7,"0-2","2-2",11,3,19,7,1,1,0,0,8,5,6,10,4,13,16,"8-5","Y","Y","Y",2,0,4
"354","E3",2023-08-19,"Doncaster","Notts County",1,3,"A",0,1,"A",4.23,3.75,1.88,"0-1","1-3",10,6,8,5,0,3,0,0,4,3,10,8,4,7,18,"4-3","Y","Y","Y",3,0,4
"355","E3",2023-08-19,"Forest Green","Newport County",0,3,"A",0,2,"A",2.55,3.47,2.83,"0-2","0-3",12,1,10,7,2,0,1,0,7,4,6,7,3,11,13,"7-4","Y","Y","N",2,1,4
"356","E3",2023-08-19,"Grimsby","Mansfield",1,1,"D",1,0,"H",3.23,3.46,2.3,"1-0","1-1",8,3,20,4,0,0,0,0,4,6,7,11,2,10,18,"4-6","Y","N","N",0,0,4
"357","E3",2023-08-19,"Morecambe","Bradford",3,0,"H",1,0,"H",3.53,3.45,2.17,"1-0","3-0",11,3,12,5,3,3,0,0,6,3,15,11,3,9,26,"6-3","Y","Y","N",6,0,4
"358","E3",2023-08-19,"Stockport","Barrow",1,0,"H",0,0,"D",1.72,3.87,5.08,"0-0","1-0",11,5,10,3,2,1,0,0,4,3,10,5,1,7,15,"4-3","N","N","N",3,0,4
"359","E3",2023-08-19,"Sutton","AFC Wimbledon",0,3,"A",0,0,"D",2.46,3.27,3.13,"0-0","0-3",10,4,15,5,2,1,0,0,4,5,7,18,3,9,25,"4-5","Y","Y","N",3,0,4
"360","E3",2023-08-19,"Tranmere","Salford",3,4,"A",2,1,"H",2.86,3.36,2.59,"2-1","3-4",13,6,15,6,1,2,0,0,4,5,14,10,7,9,24,"4-5","Y","Y","Y",3,0,4
"361","E3",2023-08-19,"Wrexham","Swindon",5,5,"D",1,4,"A",1.62,4.31,5.37,"1-4","5-5",28,12,8,6,1,3,0,0,9,2,12,17,10,11,29,"9-2","Y","Y","Y",4,0,4
"362","E3",2023-08-26,"AFC Wimbledon","Forest Green",1,1,"D",1,0,"H",1.82,3.7,4.64,"1-0","1-1",22,6,8,3,2,1,0,0,9,2,12,4,2,11,16,"9-2","Y","N","N",3,0,4
"363","E3",2023-08-26,"Barrow","Wrexham",1,1,"D",0,1,"A",3.37,3.54,2.2,"0-1","1-1",5,2,12,4,3,2,0,0,3,10,9,9,2,13,18,"3-10","Y","N","N",5,0,5
"364","E3",2023-08-26,"Bradford","Crewe",1,0,"H",1,0,"H",1.65,4.24,5.13,"1-0","1-0",12,2,10,3,2,0,0,0,4,11,10,8,1,15,18,"4-11","N","N","N",2,0,5
"365","E3",2023-08-26,"Gillingham","Colchester",0,3,"A",0,0,"D",1.83,3.44,5.02,"0-0","0-3",10,4,12,5,2,4,1,0,3,4,14,18,3,7,32,"3-4","Y","Y","N",6,1,5
"366","E3",2023-08-26,"Harrogate","Morecambe",2,0,"H",1,0,"H",2.39,3.51,3.03,"1-0","2-0",16,6,9,1,3,3,0,1,1,4,13,11,2,5,24,"1-4","Y","N","N",6,1,5
"367","E3",2023-08-26,"Mansfield","Stockport",3,2,"H",1,2,"A",2.36,3.36,3.22,"1-2","3-2",28,11,10,3,1,0,0,0,11,1,5,7,5,12,12,"11-1","Y","Y","Y",1,0,5
"368","E3",2023-08-26,"Milton Keynes Dons","Doncaster",2,1,"H",2,0,"H",1.7,3.96,5.11,"2-0","2-1",9,5,17,6,1,1,0,0,2,8,8,17,3,10,25,"2-8","Y","Y","N",2,0,5
"369","E3",2023-08-26,"Newport County","Sutton",3,1,"H",0,0,"D",1.99,3.54,3.99,"0-0","3-1",13,5,15,5,1,3,0,0,1,6,8,10,4,7,18,"1-6","Y","Y","Y",4,0,5
"370","E3",2023-08-26,"Notts County","Tranmere",2,1,"H",1,0,"H",1.6,4.43,5.35,"1-0","2-1",17,6,12,4,3,3,0,0,11,3,6,8,3,14,14,"11-3","Y","Y","N",6,0,5
"371","E3",2023-08-26,"Salford","Accrington",1,2,"A",0,2,"A",1.77,3.84,4.59,"0-2","1-2",16,2,16,6,3,3,0,0,1,6,20,10,3,7,30,"1-6","Y","Y","N",6,0,5
"372","E3",2023-08-26,"Swindon","Crawley Town",6,0,"H",1,0,"H",2.08,3.78,3.46,"1-0","6-0",17,10,14,3,0,1,0,0,5,6,10,10,6,11,20,"5-6","Y","Y","Y",1,0,5
"373","E3",2023-08-26,"Walsall","Grimsby",1,1,"D",0,0,"D",2.46,3.35,3.05,"0-0","1-1",16,6,11,2,2,3,1,0,8,10,13,11,2,18,24,"8-10","Y","N","N",5,1,5
"374","E3",2023-09-02,"Tranmere","Wrexham",0,1,"A",0,0,"D",3.58,3.91,2,"0-0","0-1",11,2,23,5,1,1,0,0,7,17,7,11,1,24,18,"7-17","N","N","N",2,0,5
"375","E3",2023-09-02,"Crewe","Milton Keynes Dons",3,1,"H",0,1,"A",3.03,3.57,2.36,"0-1","3-1",15,7,12,4,4,1,0,0,8,2,12,8,4,10,20,"8-2","Y","Y","Y",5,0,6
"376","E3",2023-09-02,"Doncaster","Swindon",0,0,"D",0,0,"D",2.88,3.46,2.52,"0-0","0-0",6,3,13,2,4,4,1,0,1,11,9,15,0,12,24,"1-11","N","N","N",8,1,6
"377","E3",2023-09-02,"Grimsby","Gillingham",2,0,"H",2,0,"H",2.52,3.3,3.01,"2-0","2-0",12,4,6,3,1,0,0,0,6,4,6,12,2,10,18,"6-4","Y","N","N",1,0,6
"378","E3",2023-09-02,"Harrogate","Barrow",0,1,"A",0,1,"A",2.6,3.3,2.9,"0-1","0-1",12,5,10,2,2,2,0,0,8,6,11,10,1,14,21,"8-6","N","N","N",4,0,6
"379","E3",2023-09-02,"Mansfield","Bradford",0,0,"D",0,0,"D",1.82,3.78,4.51,"0-0","0-0",11,1,9,2,2,4,0,0,8,2,10,12,0,10,22,"8-2","N","N","N",6,0,6
"380","E3",2023-09-02,"Morecambe","Salford",1,0,"H",1,0,"H",2.94,3.54,2.44,"1-0","1-0",11,5,7,2,0,0,0,1,9,3,14,11,1,12,25,"9-3","N","N","N",0,1,6
"381","E3",2023-09-02,"Newport County","AFC Wimbledon",2,2,"D",1,2,"A",2.61,3.34,2.86,"1-2","2-2",11,4,14,4,1,1,0,0,6,3,6,8,4,9,14,"6-3","Y","Y","Y",2,0,6
"382","E3",2023-09-02,"Notts County","Accrington",3,1,"H",1,1,"D",1.59,4.51,5.32,"1-1","3-1",10,5,16,6,4,2,0,0,2,7,11,11,4,9,22,"2-7","Y","Y","Y",6,0,6
"383","E3",2023-09-02,"Stockport","Crawley Town",3,3,"D",2,1,"H",1.56,4.35,6.01,"2-1","3-3",17,5,8,5,1,5,0,0,2,3,7,12,6,5,19,"2-3","Y","Y","Y",6,0,6
"384","E3",2023-09-02,"Sutton","Forest Green",0,1,"A",0,0,"D",2.09,3.45,3.76,"0-0","0-1",12,2,17,6,1,2,0,0,7,3,13,14,1,10,27,"7-3","N","N","N",3,0,6
"385","E3",2023-09-02,"Walsall","Colchester",1,0,"H",0,0,"D",2.14,3.46,3.6,"0-0","1-0",16,7,10,3,4,1,0,0,6,4,17,9,1,10,26,"6-4","N","N","N",5,0,6
"386","E3",2023-09-09,"Bradford","Grimsby",1,1,"D",0,1,"A",2.06,3.45,3.87,"0-1","1-1",9,1,7,3,2,4,0,0,7,2,10,10,2,9,20,"7-2","Y","N","N",6,0,6
"387","E3",2023-09-09,"Accrington","Mansfield",0,3,"A",0,2,"A",3.56,3.57,2.11,"0-2","0-3",13,2,12,5,1,1,0,0,5,4,13,17,3,9,30,"5-4","Y","Y","N",2,0,7
"388","E3",2023-09-09,"AFC Wimbledon","Stockport",1,2,"A",1,0,"H",2.81,3.34,2.65,"1-0","1-2",9,4,12,3,2,2,0,0,3,5,13,7,3,8,20,"3-5","Y","Y","N",4,0,7
"389","E3",2023-09-09,"Colchester","Tranmere",2,0,"H",1,0,"H",2.32,3.5,3.16,"1-0","2-0",27,12,10,4,2,4,0,0,11,5,10,8,2,16,18,"11-5","Y","N","N",6,0,7
"390","E3",2023-09-09,"Crawley Town","Newport County",4,1,"H",1,1,"D",3.07,3.49,2.38,"1-1","4-1",13,8,9,5,2,1,0,0,4,0,8,9,5,4,17,"4-0","Y","Y","Y",3,0,7
"391","E3",2023-09-09,"Forest Green","Crewe",1,4,"A",1,0,"H",2.18,3.52,3.44,"1-0","1-4",9,4,18,5,4,3,0,0,3,7,12,10,5,10,22,"3-7","Y","Y","Y",7,0,7
"392","E3",2023-09-09,"Gillingham","Harrogate",1,0,"H",0,0,"D",1.85,3.57,4.69,"0-0","1-0",15,4,5,2,3,1,0,0,10,2,12,7,1,12,19,"10-2","N","N","N",4,0,7
"393","E3",2023-09-09,"Milton Keynes Dons","Notts County",1,1,"D",0,0,"D",2.89,3.86,2.33,"0-0","1-1",11,3,9,3,1,0,0,0,3,6,12,5,2,9,17,"3-6","Y","N","N",1,0,7
"394","E3",2023-09-09,"Salford","Walsall",1,2,"A",1,0,"H",2.1,3.68,3.49,"1-0","1-2",20,7,10,5,2,1,0,0,12,1,12,12,3,13,24,"12-1","Y","Y","N",3,0,7
"395","E3",2023-09-09,"Swindon","Sutton",5,3,"H",3,2,"H",1.83,3.85,4.34,"3-2","5-3",15,7,13,5,1,2,0,0,5,3,4,6,8,8,10,"5-3","Y","Y","Y",3,0,7
"396","E3",2023-09-09,"Wrexham","Doncaster",2,1,"H",1,0,"H",1.43,5.03,7.21,"1-0","2-1",16,8,8,2,2,3,0,0,6,4,9,13,3,10,22,"6-4","Y","Y","N",5,0,7
"397","E3",2023-09-15,"Salford","Notts County",0,2,"A",0,1,"A",3.05,3.9,2.23,"0-1","0-2",12,2,14,4,3,2,1,1,1,8,11,11,2,9,22,"1-8","Y","N","N",5,2,7
"398","E3",2023-09-16,"Accrington","Sutton",4,1,"H",1,0,"H",2.09,3.63,3.57,"1-0","4-1",15,5,12,1,3,1,0,0,2,3,10,12,5,5,22,"2-3","Y","Y","Y",4,0,7
"399","E3",2023-09-16,"AFC Wimbledon","Crewe",2,2,"D",2,0,"H",1.8,3.96,4.41,"2-0","2-2",21,6,9,4,2,2,0,0,13,7,11,9,4,20,20,"13-7","Y","Y","Y",4,0,8
"400","E3",2023-09-16,"Bradford","Harrogate",1,1,"D",0,0,"D",1.76,3.74,4.95,"0-0","1-1",9,3,8,1,0,2,0,0,3,5,8,10,2,8,18,"3-5","Y","N","N",2,0,8
"401","E3",2023-09-16,"Colchester","Mansfield",1,1,"D",1,0,"H",3.64,3.83,2,"1-0","1-1",12,4,10,5,4,3,0,0,3,4,9,4,2,7,13,"3-4","Y","N","N",7,0,8
"402","E3",2023-09-16,"Crawley Town","Tranmere",3,2,"H",0,1,"A",2.22,3.59,3.28,"0-1","3-2",16,7,7,4,4,5,0,0,9,0,7,9,5,9,16,"9-0","Y","Y","Y",9,0,8
"403","E3",2023-09-16,"Forest Green","Doncaster",1,2,"A",0,1,"A",2.21,3.59,3.3,"0-1","1-2",28,3,15,7,4,2,0,0,10,12,8,10,3,22,18,"10-12","Y","Y","N",6,0,8
"404","E3",2023-09-16,"Gillingham","Morecambe",2,1,"H",2,1,"H",1.79,3.7,4.81,"2-1","2-1",11,5,5,3,2,3,0,1,4,3,8,16,3,7,24,"4-3","Y","Y","N",5,1,8
"405","E3",2023-09-16,"Milton Keynes Dons","Stockport",1,2,"A",1,2,"A",3.03,3.61,2.35,"1-2","1-2",20,3,10,5,4,2,0,0,9,4,11,10,3,13,21,"9-4","Y","Y","N",6,0,8
"406","E3",2023-09-16,"Newport County","Barrow",1,1,"D",1,0,"H",2.09,3.44,3.77,"1-0","1-1",8,2,6,3,2,2,1,0,3,10,13,17,2,13,30,"3-10","Y","N","N",4,1,8
"407","E3",2023-09-16,"Swindon","Walsall",2,0,"H",1,0,"H",1.97,3.81,3.76,"1-0","2-0",12,6,7,2,2,2,0,1,4,2,5,10,2,6,15,"4-2","Y","N","N",4,1,8
"408","E3",2023-09-16,"Wrexham","Grimsby",3,0,"H",2,0,"H",1.66,4.19,5.1,"2-0","3-0",17,9,9,1,2,2,0,0,3,1,7,6,3,4,13,"3-1","Y","Y","N",4,0,8
"409","E3",2023-09-23,"Crewe","Colchester",2,1,"H",2,0,"H",2.48,3.65,2.8,"2-0","2-1",10,3,21,6,1,0,0,0,6,10,15,11,3,16,26,"6-10","Y","Y","N",1,0,8
"410","E3",2023-09-23,"Doncaster","Gillingham",2,1,"H",1,1,"D",3.26,3.17,2.43,"1-1","2-1",13,6,15,5,2,2,0,0,7,6,9,10,3,13,19,"7-6","Y","Y","N",4,0,8
"411","E3",2023-09-23,"Grimsby","Crawley Town",2,3,"A",2,2,"D",2.07,3.62,3.64,"2-2","2-3",18,7,13,3,1,1,0,0,5,5,14,8,5,10,22,"5-5","Y","Y","Y",2,0,9
"412","E3",2023-09-23,"Harrogate","Salford",3,2,"H",2,1,"H",2.95,3.45,2.47,"2-1","3-2",16,7,18,5,2,2,0,0,7,5,6,10,5,12,16,"7-5","Y","Y","Y",4,0,9
"413","E3",2023-09-23,"Mansfield","Barrow",1,0,"H",0,0,"D",1.66,3.95,5.56,"0-0","1-0",14,2,9,2,2,1,0,1,6,2,9,11,1,8,20,"6-2","N","N","N",3,1,9
"414","E3",2023-09-23,"Morecambe","Swindon",2,2,"D",1,1,"D",3.39,3.77,2.11,"1-1","2-2",16,4,13,5,1,2,1,0,9,4,11,6,4,13,17,"9-4","Y","Y","Y",3,1,9
"415","E3",2023-09-23,"Newport County","Bradford",1,4,"A",1,3,"A",2.4,3.32,3.16,"1-3","1-4",7,1,17,7,2,1,0,0,6,7,9,8,5,13,17,"6-7","Y","Y","Y",3,0,9
"416","E3",2023-09-23,"Notts County","Forest Green",4,3,"H",2,0,"H",1.51,4.79,5.96,"2-0","4-3",11,6,14,4,3,5,0,0,7,10,10,11,7,17,21,"7-10","Y","Y","Y",8,0,9
"417","E3",2023-09-23,"Stockport","Wrexham",5,0,"H",3,0,"H",2.52,3.73,2.72,"3-0","5-0",10,5,20,5,1,1,0,0,1,5,10,13,5,6,23,"1-5","Y","Y","Y",2,0,9
"418","E3",2023-09-23,"Sutton","Milton Keynes Dons",1,1,"D",1,0,"H",2.66,3.42,2.74,"1-0","1-1",10,5,12,2,0,1,0,0,7,10,10,13,2,17,23,"7-10","Y","N","N",1,0,9
"419","E3",2023-09-23,"Tranmere","Accrington",2,0,"H",1,0,"H",2.74,3.49,2.62,"1-0","2-0",17,7,9,3,0,3,0,1,8,6,11,16,2,14,27,"8-6","Y","N","N",3,1,9
"420","E3",2023-09-23,"Walsall","AFC Wimbledon",1,3,"A",0,1,"A",2.64,3.43,2.76,"0-1","1-3",5,1,15,6,0,2,1,0,0,5,9,13,4,5,22,"0-5","Y","Y","Y",2,1,9
"421","E3",2023-09-30,"Accrington","Stockport",1,3,"A",0,2,"A",3.68,3.77,2.01,"0-2","1-3",14,4,6,4,1,1,0,0,9,4,16,10,4,13,26,"9-4","Y","Y","Y",2,0,9
"422","E3",2023-09-30,"AFC Wimbledon","Tranmere",4,1,"H",2,1,"H",1.72,3.93,4.97,"2-1","4-1",19,8,8,2,1,2,0,1,4,4,9,10,5,8,19,"4-4","Y","Y","Y",3,1,9
"423","E3",2023-09-30,"Barrow","Doncaster",3,2,"H",1,0,"H",1.94,3.64,4.07,"1-0","3-2",7,4,12,4,4,3,0,0,1,8,12,16,5,9,28,"1-8","Y","Y","Y",7,0,10
"424","E3",2023-09-30,"Bradford","Walsall",1,3,"A",1,2,"A",1.82,3.65,4.53,"1-2","1-3",10,2,7,4,1,4,0,0,10,5,8,9,4,15,17,"10-5","Y","Y","Y",5,0,10
"425","E3",2023-09-30,"Colchester","Notts County",5,4,"H",3,1,"H",3.6,3.87,2.01,"3-1","5-4",15,8,21,7,3,3,1,0,3,8,8,9,9,11,17,"3-8","Y","Y","Y",6,1,10
"426","E3",2023-09-30,"Crawley Town","Sutton",3,0,"H",1,0,"H",2.02,3.72,3.68,"1-0","3-0",18,7,7,2,1,3,0,0,5,4,8,12,3,9,20,"5-4","Y","Y","N",4,0,10
"427","E3",2023-09-30,"Forest Green","Morecambe",1,2,"A",0,1,"A",1.98,3.69,3.88,"0-1","1-2",13,2,14,11,3,2,0,0,7,7,8,6,3,14,14,"7-7","Y","Y","N",5,0,10
"428","E3",2023-09-30,"Gillingham","Mansfield",1,1,"D",1,1,"D",3.15,3.28,2.43,"1-1","1-1",20,4,17,3,4,2,0,0,5,11,11,13,2,16,24,"5-11","Y","N","N",6,0,10
"429","E3",2023-09-30,"Milton Keynes Dons","Harrogate",0,1,"A",0,1,"A",1.85,3.81,4.3,"0-1","0-1",27,4,3,3,3,1,0,0,11,3,12,5,1,14,17,"11-3","N","N","N",4,0,10
"430","E3",2023-09-30,"Salford","Newport County",2,1,"H",2,1,"H",2.28,3.66,3.11,"2-1","2-1",10,2,15,4,1,3,0,0,2,6,11,12,3,8,23,"2-6","Y","Y","N",4,0,10
"431","E3",2023-09-30,"Swindon","Grimsby",2,1,"H",1,0,"H",1.86,3.91,4.12,"1-0","2-1",8,3,13,4,2,2,0,0,9,7,5,10,3,16,15,"9-7","Y","Y","N",4,0,10
"432","E3",2023-09-30,"Wrexham","Crewe",3,3,"D",1,2,"A",1.42,5.24,7.06,"1-2","3-3",12,6,11,7,4,4,1,0,7,6,12,12,6,13,24,"7-6","Y","Y","Y",8,1,10
"433","E3",2023-10-03,"Crewe","Gillingham",2,0,"H",1,0,"H",2.78,3.44,2.61,"1-0","2-0",9,4,13,5,1,0,0,0,6,4,7,9,2,10,16,"6-4","Y","N","N",1,0,10
"434","E3",2023-10-03,"Doncaster","Crawley Town",2,0,"H",1,0,"H",2.68,3.67,2.58,"1-0","2-0",17,8,15,4,3,3,0,0,5,5,15,12,2,10,27,"5-5","Y","N","N",6,0,10
"435","E3",2023-10-03,"Grimsby","Barrow",2,1,"H",1,0,"H",2.17,3.33,3.68,"1-0","2-1",9,6,24,7,1,1,0,0,4,7,13,11,3,11,24,"4-7","Y","Y","N",2,0,11
"436","E3",2023-10-03,"Harrogate","AFC Wimbledon",0,1,"A",0,1,"A",3.6,3.39,2.17,"0-1","0-1",4,2,16,4,2,2,0,0,2,4,10,15,1,6,25,"2-4","N","N","N",4,0,11
"437","E3",2023-10-03,"Mansfield","Wrexham",0,0,"D",0,0,"D",2.28,3.74,3.06,"0-0","0-0",19,5,7,1,2,1,0,0,10,6,10,5,0,16,15,"10-6","N","N","N",3,0,11
"438","E3",2023-10-03,"Morecambe","Accrington",1,1,"D",0,0,"D",2.58,3.47,2.8,"0-0","1-1",15,6,15,3,3,3,0,0,4,9,17,9,2,13,26,"4-9","Y","N","N",6,0,11
"439","E3",2023-10-03,"Newport County","Colchester",2,1,"H",1,1,"D",2.3,3.61,3.12,"1-1","2-1",18,7,14,4,2,2,0,1,8,5,12,11,3,13,23,"8-5","Y","Y","N",4,1,11
"440","E3",2023-10-03,"Notts County","Swindon",3,1,"H",3,0,"H",1.86,4.36,3.71,"3-0","3-1",10,6,19,4,3,2,0,0,3,5,13,14,4,8,27,"3-5","Y","Y","Y",5,0,11
"441","E3",2023-10-03,"Stockport","Forest Green",2,0,"H",2,0,"H",1.43,4.75,7.79,"2-0","2-0",15,6,6,1,1,0,0,1,4,3,8,15,2,7,23,"4-3","Y","N","N",1,1,11
"442","E3",2023-10-03,"Sutton","Salford",0,2,"A",0,0,"D",2.56,3.59,2.75,"0-0","0-2",8,2,11,5,1,3,0,0,4,3,15,10,2,7,25,"4-3","Y","N","N",4,0,11
"443","E3",2023-10-03,"Tranmere","Bradford",2,1,"H",1,0,"H",3.36,3.34,2.29,"1-0","2-1",9,5,10,5,3,3,0,0,5,6,6,15,3,11,21,"5-6","Y","Y","N",6,0,11
"444","E3",2023-10-03,"Walsall","Milton Keynes Dons",0,0,"D",0,0,"D",2.74,3.4,2.67,"0-0","0-0",12,4,18,5,3,3,0,0,5,3,17,8,0,8,25,"5-3","N","N","N",6,0,11
"445","EC",2023-08-05,"Aldershot","Oxford City",5,2,"H",3,1,"H",1.99,3.68,3.69,"3-1","5-2",0,0,0,0,2,1,0,0,0,0,0,0,7,0,0,"0-0","Y","Y","Y",3,0,1
"446","EC",2023-08-05,"Altrincham","Dag and Red",1,1,"D",0,0,"D",2.25,3.43,3.23,"0-0","1-1",0,0,0,0,2,2,0,0,0,0,0,0,2,0,0,"0-0","Y","N","N",4,0,1
"447","EC",2023-08-05,"Barnet","Hartlepool",3,2,"H",1,0,"H",2.09,3.65,3.35,"1-0","3-2",0,0,0,0,1,3,0,0,0,0,0,0,5,0,0,"0-0","Y","Y","Y",4,0,1
"448","EC",2023-08-05,"Chesterfield","Dorking",4,3,"H",1,1,"D",1.25,6.07,10.66,"1-1","4-3",0,0,0,0,2,3,0,1,0,0,0,0,7,0,0,"0-0","Y","Y","Y",5,1,1
"449","EC",2023-08-05,"Gateshead","Boreham Wood",2,2,"D",2,0,"H",2.12,3.37,3.63,"2-0","2-2",0,0,0,0,1,3,0,1,0,0,0,0,4,0,0,"0-0","Y","Y","Y",4,1,1
"450","EC",2023-08-05,"Halifax","Bromley",2,0,"H",0,0,"D",2.79,3.24,2.61,"0-0","2-0",0,0,0,0,3,2,0,0,0,0,0,0,2,0,0,"0-0","Y","N","N",5,0,1
"451","EC",2023-08-05,"Kidderminster","Woking",0,0,"D",0,0,"D",2.96,3.29,2.49,"0-0","0-0",0,0,0,0,3,2,0,0,0,0,0,0,0,0,0,"0-0","N","N","N",5,0,1
"452","EC",2023-08-05,"Maidenhead","Fylde",2,2,"D",2,1,"H",2.46,3.33,2.9,"2-1","2-2",0,0,0,0,3,1,0,1,0,0,0,0,4,0,0,"0-0","Y","Y","Y",4,1,1
"453","EC",2023-08-05,"Solihull","Eastleigh",1,1,"D",0,0,"D",2.6,3.76,2.53,"0-0","1-1",0,0,0,0,1,2,1,0,0,0,0,0,2,0,0,"0-0","Y","N","N",3,1,1
"454","EC",2023-08-05,"Southend","Oldham",4,0,"H",1,0,"H",3.1,3.37,2.35,"1-0","4-0",0,0,0,0,2,5,0,1,0,0,0,0,4,0,0,"0-0","Y","Y","Y",7,1,1
"455","EC",2023-08-05,"Wealdstone","York",2,1,"H",0,1,"A",2.68,3.54,2.58,"0-1","2-1",0,0,0,0,3,1,0,1,0,0,0,0,3,0,0,"0-0","Y","Y","N",4,1,1
"456","EC",2023-08-05,"Rochdale","Ebbsfleet",0,1,"A",0,1,"A",1.69,4.25,4.37,"0-1","0-1",0,0,0,0,2,5,0,0,0,0,0,0,1,0,0,"0-0","N","N","N",7,0,1
"457","EC",2023-08-12,"Boreham Wood","Halifax",2,0,"H",0,0,"D",2.23,3.13,3.63,"0-0","2-0",0,0,0,0,1,2,0,0,0,0,0,0,2,0,0,"0-0","Y","N","N",3,0,2
"458","EC",2023-08-12,"Dag and Red","Southend",0,2,"A",0,1,"A",2.68,3.47,2.61,"0-1","0-2",0,0,0,0,3,1,0,0,0,0,0,0,2,0,0,"0-0","Y","N","N",4,0,2
"459","EC",2023-08-12,"Dorking","Maidenhead",0,2,"A",0,0,"D",2.05,3.69,3.49,"0-0","0-2",0,0,0,0,5,1,0,1,0,0,0,0,2,0,0,"0-0","Y","N","N",6,1,2
"460","EC",2023-08-12,"Eastleigh","Wealdstone",0,0,"D",0,0,"D",1.7,3.93,4.68,"0-0","0-0",0,0,0,0,5,3,0,0,0,0,0,0,0,0,0,"0-0","N","N","N",8,0,2
"461","EC",2023-08-12,"Ebbsfleet","Solihull",1,2,"A",0,1,"A",2.17,3.51,3.34,"0-1","1-2",0,0,0,0,3,5,0,0,0,0,0,0,3,0,0,"0-0","Y","Y","N",8,0,2
"462","EC",2023-08-12,"Fylde","Chesterfield",2,4,"A",0,3,"A",3.94,3.92,1.86,"0-3","2-4",0,0,0,0,3,3,1,0,0,0,0,0,6,0,0,"0-0","Y","Y","Y",6,1,2
"463","EC",2023-08-12,"Hartlepool","Gateshead",2,1,"H",1,0,"H",2.54,3.6,2.69,"1-0","2-1",0,0,0,0,2,2,1,0,0,0,0,0,3,0,0,"0-0","Y","Y","N",4,1,2
"464","EC",2023-08-12,"Oldham","Aldershot",5,1,"H",3,0,"H",2.07,3.41,3.7,"3-0","5-1",0,0,0,0,2,1,0,1,0,0,0,0,6,0,0,"0-0","Y","Y","Y",3,1,2
"465","EC",2023-08-12,"Oxford City","Rochdale",0,1,"A",0,0,"D",3.15,3.64,2.21,"0-0","0-1",0,0,0,0,2,1,0,0,0,0,0,0,1,0,0,"0-0","N","N","N",3,0,2
"466","EC",2023-08-12,"Woking","Altrincham",2,3,"A",2,2,"D",1.59,4.37,5.24,"2-2","2-3",0,0,0,0,1,4,0,0,0,0,0,0,5,0,0,"0-0","Y","Y","Y",5,0,2
"467","EC",2023-08-12,"York","Kidderminster",0,1,"A",0,0,"D",1.94,3.57,3.97,"0-0","0-1",0,0,0,0,2,2,0,0,0,0,0,0,1,0,0,"0-0","N","N","N",4,0,2
"468","EC",2023-08-12,"Bromley","Barnet",0,2,"A",0,1,"A",2.25,3.74,3.01,"0-1","0-2",0,0,0,0,2,0,0,0,0,0,0,0,2,0,0,"0-0","Y","N","N",2,0,2
"469","EC",2023-08-15,"Bromley","Wealdstone",1,1,"D",0,1,"A",1.71,4.01,4.63,"0-1","1-1",0,0,0,0,5,2,0,0,0,0,0,0,2,0,0,"0-0","Y","N","N",7,0,3
"470","EC",2023-08-15,"Dag and Red","Gateshead",2,4,"A",0,1,"A",3.64,3.73,1.99,"0-1","2-4",0,0,0,0,4,3,0,0,0,0,0,0,6,0,0,"0-0","Y","Y","Y",7,0,3
"471","EC",2023-08-15,"Dorking","Southend",2,1,"H",1,1,"D",4.21,3.82,1.83,"1-1","2-1",0,0,0,0,1,1,0,0,0,0,0,0,3,0,0,"0-0","Y","Y","N",2,0,3
"472","EC",2023-08-15,"Eastleigh","Barnet",3,3,"D",1,3,"A",2.58,3.55,2.67,"1-3","3-3",0,0,0,0,3,3,0,0,0,0,0,0,6,0,0,"0-0","Y","Y","Y",6,0,3
"473","EC",2023-08-15,"Ebbsfleet","Aldershot",2,0,"H",1,0,"H",1.99,3.66,3.71,"1-0","2-0",0,0,0,0,3,3,0,0,0,0,0,0,2,0,0,"0-0","Y","N","N",6,0,3
"474","EC",2023-08-15,"Fylde","Kidderminster",2,1,"H",0,0,"D",2.18,3.53,3.31,"0-0","2-1",0,0,0,0,3,2,0,0,0,0,0,0,3,0,0,"0-0","Y","Y","N",5,0,3
"475","EC",2023-08-15,"Hartlepool","Maidenhead",3,1,"H",0,0,"D",1.85,3.79,4.14,"0-0","3-1",0,0,0,0,4,2,0,0,0,0,0,0,4,0,0,"0-0","Y","Y","Y",6,0,3
"476","EC",2023-08-15,"Oldham","Halifax",1,2,"A",1,1,"D",1.93,3.27,4.48,"1-1","1-2",0,0,0,0,4,3,0,0,0,0,0,0,3,0,0,"0-0","Y","Y","N",7,0,3
"477","EC",2023-08-15,"Oxford City","Chesterfield",1,2,"A",0,1,"A",6.35,5.09,1.43,"0-1","1-2",0,0,0,0,2,1,0,0,0,0,0,0,3,0,0,"0-0","Y","Y","N",3,0,3
"478","EC",2023-08-15,"Woking","Rochdale",3,2,"H",0,1,"A",2.04,3.54,3.67,"0-1","3-2",0,0,0,0,5,4,0,0,0,0,0,0,5,0,0,"0-0","Y","Y","Y",9,0,3
"479","EC",2023-08-15,"York","Altrincham",2,2,"D",2,1,"H",2.16,3.77,3.16,"2-1","2-2",0,0,0,0,5,3,0,0,0,0,0,0,4,0,0,"0-0","Y","Y","Y",8,0,3
"480","EC",2023-08-16,"Boreham Wood","Solihull",1,2,"A",0,1,"A",2,3.33,4.06,"0-1","1-2",0,0,0,0,2,1,0,0,0,0,0,0,3,0,0,"0-0","Y","Y","N",3,0,3
"481","EC",2023-08-19,"Chesterfield","Oldham",1,1,"D",0,0,"D",1.6,4.29,5.27,"0-0","1-1",0,0,0,0,0,3,0,0,0,0,0,0,2,0,0,"0-0","Y","N","N",3,0,4
"482","EC",2023-08-19,"Aldershot","York",1,1,"D",1,0,"H",2.47,3.5,2.83,"1-0","1-1",0,0,0,0,4,2,0,0,0,0,0,0,2,0,0,"0-0","Y","N","N",6,0,4
"483","EC",2023-08-19,"Altrincham","Boreham Wood",1,1,"D",1,0,"H",2.44,3.45,2.91,"1-0","1-1",0,0,0,0,3,2,0,0,0,0,0,0,2,0,0,"0-0","Y","N","N",5,0,4
"484","EC",2023-08-19,"Barnet","Woking",2,0,"H",1,0,"H",2.35,3.48,3.02,"1-0","2-0",0,0,0,0,1,1,0,0,0,0,0,0,2,0,0,"0-0","Y","N","N",2,0,4
"485","EC",2023-08-19,"Gateshead","Ebbsfleet",4,1,"H",1,1,"D",1.9,3.91,3.78,"1-1","4-1",0,0,0,0,3,3,0,0,0,0,0,0,5,0,0,"0-0","Y","Y","Y",6,0,4
"486","EC",2023-08-19,"Halifax","Oxford City",1,1,"D",1,0,"H",1.66,3.91,5.22,"1-0","1-1",0,0,0,0,2,1,0,0,0,0,0,0,2,0,0,"0-0","Y","N","N",3,0,4
"487","EC",2023-08-19,"Kidderminster","Bromley",0,0,"D",0,0,"D",2.3,3.34,3.22,"0-0","0-0",0,0,0,0,1,2,1,1,0,0,0,0,0,0,0,"0-0","N","N","N",3,2,4
"488","EC",2023-08-19,"Maidenhead","Dag and Red",1,0,"H",0,0,"D",2.45,3.32,2.98,"0-0","1-0",0,0,0,0,1,1,0,0,0,0,0,0,1,0,0,"0-0","N","N","N",2,0,4
"489","EC",2023-08-19,"Rochdale","Eastleigh",2,0,"H",2,0,"H",2.03,3.69,3.54,"2-0","2-0",0,0,0,0,2,5,0,0,0,0,0,0,2,0,0,"0-0","Y","N","N",7,0,4
"490","EC",2023-08-19,"Solihull","Dorking",3,0,"H",2,0,"H",1.76,4.16,4.16,"2-0","3-0",0,0,0,0,0,3,0,1,0,0,0,0,3,0,0,"0-0","Y","Y","N",3,1,4
"491","EC",2023-08-19,"Southend","Hartlepool",2,3,"A",1,1,"D",1.99,3.6,3.75,"1-1","2-3",0,0,0,0,0,0,0,0,0,0,0,0,5,0,0,"0-0","Y","Y","Y",0,0,4
"492","EC",2023-08-19,"Wealdstone","Fylde",3,2,"H",1,1,"D",2.66,3.73,2.5,"1-1","3-2",0,0,0,0,1,2,0,1,0,0,0,0,5,0,0,"0-0","Y","Y","Y",3,1,4
"493","EC",2023-08-25,"Rochdale","Bromley",2,2,"D",1,1,"D",1.88,3.64,4.14,"1-1","2-2",0,0,0,0,0,1,1,1,0,0,0,0,4,0,0,"0-0","Y","Y","Y",1,2,5
"494","EC",2023-08-25,"Solihull","Halifax",1,1,"D",1,0,"H",2.34,3.34,3.15,"1-0","1-1",0,0,0,0,1,1,0,0,0,0,0,0,2,0,0,"0-0","Y","N","N",2,0,5
"495","EC",2023-08-25,"Southend","Eastleigh",2,0,"H",2,0,"H",1.84,3.79,4.18,"2-0","2-0",0,0,0,0,1,1,0,0,0,0,0,0,2,0,0,"0-0","Y","N","N",2,0,5
"496","EC",2023-08-26,"Aldershot","Wealdstone",3,1,"H",1,0,"H",2.32,3.82,2.85,"1-0","3-1",0,0,0,0,3,2,0,0,0,0,0,0,4,0,0,"0-0","Y","Y","Y",5,0,5
"497","EC",2023-08-26,"Altrincham","Chesterfield",2,1,"H",0,1,"A",4.03,4.25,1.78,"0-1","2-1",0,0,0,0,1,4,0,0,0,0,0,0,3,0,0,"0-0","Y","Y","N",5,0,5
"498","EC",2023-08-26,"Boreham Wood","Oldham",0,0,"D",0,0,"D",2.62,3.37,2.73,"0-0","0-0",0,0,0,0,2,0,0,0,0,0,0,0,0,0,0,"0-0","N","N","N",2,0,5
"499","EC",2023-08-26,"Dag and Red","Barnet",1,0,"H",0,0,"D",3.83,3.83,1.91,"0-0","1-0",0,0,0,0,4,0,0,0,0,0,0,0,1,0,0,"0-0","N","N","N",4,0,5
"500","EC",2023-08-26,"Dorking","York",2,2,"D",1,0,"H",3.09,3.64,2.24,"1-0","2-2",0,0,0,0,1,1,0,1,0,0,0,0,4,0,0,"0-0","Y","Y","Y",2,1,5
"501","EC",2023-08-26,"Ebbsfleet","Kidderminster",3,0,"H",3,0,"H",2.57,3.53,2.69,"3-0","3-0",0,0,0,0,1,0,0,1,0,0,0,0,3,0,0,"0-0","Y","Y","N",1,1,5
"502","EC",2023-08-26,"Gateshead","Woking",1,3,"A",1,0,"H",2.08,3.61,3.48,"1-0","1-3",0,0,0,0,1,4,0,0,0,0,0,0,4,0,0,"0-0","Y","Y","Y",5,0,5
"503","EC",2023-08-26,"Maidenhead","Oxford City",0,0,"D",0,0,"D",2.2,3.79,3.06,"0-0","0-0",0,0,0,0,3,2,0,0,0,0,0,0,0,0,0,"0-0","N","N","N",5,0,5
"504","EC",2023-08-26,"Hartlepool","Fylde",3,1,"H",2,1,"H",2.12,3.67,3.33,"2-1","3-1",0,0,0,0,2,1,0,0,0,0,0,0,4,0,0,"0-0","Y","Y","Y",3,0,5
"505","EC",2023-08-28,"Barnet","Ebbsfleet",3,2,"H",1,1,"D",2.01,3.81,3.5,"1-1","3-2",0,0,0,0,2,3,0,0,0,0,0,0,5,0,0,"0-0","Y","Y","Y",5,0,6
"506","EC",2023-08-28,"Bromley","Southend",2,1,"H",1,0,"H",3.75,3.48,2.03,"1-0","2-1",0,0,0,0,3,1,0,0,0,0,0,0,3,0,0,"0-0","Y","Y","N",4,0,6
"507","EC",2023-08-28,"Chesterfield","Hartlepool",3,2,"H",1,2,"A",1.76,4.22,4.1,"1-2","3-2",0,0,0,0,3,4,0,0,0,0,0,0,5,0,0,"0-0","Y","Y","Y",7,0,6
"508","EC",2023-08-28,"Eastleigh","Aldershot",3,0,"H",1,0,"H",2.47,3.51,2.82,"1-0","3-0",0,0,0,0,0,1,0,1,0,0,0,0,3,0,0,"0-0","Y","Y","N",1,1,6
"509","EC",2023-08-28,"Fylde","Altrincham",3,3,"D",0,2,"A",2.45,3.73,2.72,"0-2","3-3",0,0,0,0,4,1,0,0,0,0,0,0,6,0,0,"0-0","Y","Y","Y",5,0,6
"510","EC",2023-08-28,"Halifax","Gateshead",0,0,"D",0,0,"D",2.79,3.51,2.49,"0-0","0-0",0,0,0,0,4,3,0,1,0,0,0,0,0,0,0,"0-0","N","N","N",7,1,6
"511","EC",2023-08-28,"Kidderminster","Maidenhead",0,0,"D",0,0,"D",1.98,3.5,3.93,"0-0","0-0",0,0,0,0,2,2,0,0,0,0,0,0,0,0,0,"0-0","N","N","N",4,0,6
"512","EC",2023-08-28,"Oldham","Solihull",0,2,"A",0,0,"D",1.9,3.98,3.72,"0-0","0-2",0,0,0,0,4,0,1,0,0,0,0,0,2,0,0,"0-0","Y","N","N",4,1,6
"513","EC",2023-08-28,"Oxford City","Boreham Wood",4,0,"H",0,0,"D",3.48,3.47,2.13,"0-0","4-0",0,0,0,0,2,2,0,0,0,0,0,0,4,0,0,"0-0","Y","Y","Y",4,0,6
"514","EC",2023-08-28,"Wealdstone","Dag and Red",0,2,"A",0,0,"D",2.25,3.77,2.98,"0-0","0-2",0,0,0,0,1,0,0,0,0,0,0,0,2,0,0,"0-0","Y","N","N",1,0,6
"515","EC",2023-08-28,"Woking","Dorking",2,0,"H",1,0,"H",1.58,4.38,5.25,"1-0","2-0",0,0,0,0,2,0,0,0,0,0,0,0,2,0,0,"0-0","Y","N","N",2,0,6
"516","EC",2023-08-28,"York","Rochdale",1,3,"A",1,1,"D",2.67,3.41,2.66,"1-1","1-3",0,0,0,0,5,4,1,0,0,0,0,0,4,0,0,"0-0","Y","Y","Y",9,1,6
"517","EC",2023-09-02,"Aldershot","Chesterfield",3,4,"A",1,1,"D",4.25,3.97,1.79,"1-1","3-4",0,0,0,0,1,3,1,0,0,0,0,0,7,0,0,"0-0","Y","Y","Y",4,1,7
"518","EC",2023-09-02,"Altrincham","Bromley",1,2,"A",1,1,"D",1.74,4,4.35,"1-1","1-2",0,0,0,0,2,1,0,0,0,0,0,0,3,0,0,"0-0","Y","Y","N",3,0,7
"519","EC",2023-09-02,"Boreham Wood","Barnet",0,1,"A",0,0,"D",2.67,3.42,2.65,"0-0","0-1",0,0,0,0,3,2,0,0,0,0,0,0,1,0,0,"0-0","N","N","N",5,0,7
"520","EC",2023-09-02,"Dag and Red","Fylde",3,1,"H",2,1,"H",2.55,3.49,2.69,"2-1","3-1",0,0,0,0,1,3,0,0,0,0,0,0,4,0,0,"0-0","Y","Y","Y",4,0,7
"521","EC",2023-09-02,"Dorking","Eastleigh",0,0,"D",0,0,"D",3.03,3.64,2.27,"0-0","0-0",0,0,0,0,1,2,0,0,0,0,0,0,0,0,0,"0-0","N","N","N",3,0,7
"522","EC",2023-09-02,"Ebbsfleet","York",4,1,"H",2,1,"H",2.06,3.64,3.49,"2-1","4-1",0,0,0,0,1,3,0,0,0,0,0,0,5,0,0,"0-0","Y","Y","Y",4,0,7
"523","EC",2023-09-02,"Hartlepool","Wealdstone",2,1,"H",1,0,"H",1.7,4.12,4.57,"1-0","2-1",0,0,0,0,1,0,0,0,0,0,0,0,3,0,0,"0-0","Y","Y","N",1,0,7
"524","EC",2023-09-02,"Maidenhead","Woking",0,0,"D",0,0,"D",3.79,3.37,2.06,"0-0","0-0",0,0,0,0,1,2,0,0,0,0,0,0,0,0,0,"0-0","N","N","N",3,0,7
"525","EC",2023-09-02,"Rochdale","Halifax",0,1,"A",0,1,"A",1.96,3.53,3.96,"0-1","0-1",0,0,0,0,4,1,0,0,0,0,0,0,1,0,0,"0-0","N","N","N",5,0,7
"526","EC",2023-09-02,"Solihull","Oxford City",3,3,"D",2,1,"H",1.8,4.06,4.06,"2-1","3-3",0,0,0,0,0,3,0,0,0,0,0,0,6,0,0,"0-0","Y","Y","Y",3,0,7
"527","EC",2023-09-02,"Southend","Kidderminster",2,1,"H",0,0,"D",1.88,3.41,4.53,"0-0","2-1",0,0,0,0,1,2,0,0,0,0,0,0,3,0,0,"0-0","Y","Y","N",3,0,7
"528","EC",2023-09-02,"Gateshead","Oldham",2,2,"D",0,1,"A",1.88,3.89,3.86,"0-1","2-2",0,0,0,0,2,4,0,1,0,0,0,0,4,0,0,"0-0","Y","Y","Y",6,1,7
"529","EC",2023-09-09,"Halifax","Southend",1,1,"D",0,0,"D",2.66,3.25,2.78,"0-0","1-1",0,0,0,0,2,2,1,0,0,0,0,0,2,0,0,"0-0","Y","N","N",4,1,8
"530","EC",2023-09-09,"Barnet","Altrincham",3,0,"H",1,0,"H",1.92,3.81,3.81,"1-0","3-0",0,0,0,0,2,3,0,0,0,0,0,0,3,0,0,"0-0","Y","Y","N",5,0,8
"531","EC",2023-09-09,"Bromley","Maidenhead",4,1,"H",3,0,"H",2.2,3.49,3.3,"3-0","4-1",0,0,0,0,1,0,0,0,0,0,0,0,5,0,0,"0-0","Y","Y","Y",1,0,8
"532","EC",2023-09-09,"Chesterfield","Dag and Red",3,1,"H",0,1,"A",1.47,4.78,6.23,"0-1","3-1",0,0,0,0,0,2,0,1,0,0,0,0,4,0,0,"0-0","Y","Y","Y",2,1,8
"533","EC",2023-09-09,"Eastleigh","Gateshead",0,6,"A",0,4,"A",2.95,3.45,2.37,"0-4","0-6",0,0,0,0,4,3,0,0,0,0,0,0,6,0,0,"0-0","Y","Y","Y",7,0,8
"534","EC",2023-09-09,"Fylde","Aldershot",0,2,"A",0,0,"D",1.95,4.06,3.46,"0-0","0-2",0,0,0,0,1,1,0,0,0,0,0,0,2,0,0,"0-0","Y","N","N",2,0,8
"535","EC",2023-09-09,"Kidderminster","Rochdale",1,1,"D",1,0,"H",2.59,3.14,2.94,"1-0","1-1",0,0,0,0,4,1,0,0,0,0,0,0,2,0,0,"0-0","Y","N","N",5,0,8
"536","EC",2023-09-09,"Oldham","Dorking",0,0,"D",0,0,"D",1.58,4.35,5.14,"0-0","0-0",0,0,0,0,2,2,0,0,0,0,0,0,0,0,0,"0-0","N","N","N",4,0,8
"537","EC",2023-09-09,"Oxford City","Hartlepool",5,2,"H",1,2,"A",3.71,3.93,1.92,"1-2","5-2",0,0,0,0,4,0,0,0,0,0,0,0,7,0,0,"0-0","Y","Y","Y",4,0,8
"538","EC",2023-09-09,"Wealdstone","Ebbsfleet",2,1,"H",0,0,"D",2.79,3.89,2.29,"0-0","2-1",0,0,0,0,4,5,1,1,0,0,0,0,3,0,0,"0-0","Y","Y","N",9,2,8
"539","EC",2023-09-09,"Woking","Solihull",1,1,"D",0,1,"A",1.68,4.08,4.62,"0-1","1-1",0,0,0,0,4,3,0,0,0,0,0,0,2,0,0,"0-0","Y","N","N",7,0,8
"540","EC",2023-09-09,"York","Boreham Wood",2,2,"D",1,0,"H",2.58,3.34,2.81,"1-0","2-2",0,0,0,0,1,4,0,0,0,0,0,0,4,0,0,"0-0","Y","Y","Y",5,0,8
"541","EC",2023-09-16,"Aldershot","Gateshead",1,1,"D",0,0,"D",3.28,3.85,2.05,"0-0","1-1",0,0,0,0,2,0,0,0,0,0,0,0,2,0,0,"0-0","Y","N","N",2,0,9
"542","EC",2023-09-16,"Bromley","Oldham",3,0,"H",2,0,"H",2.92,3.69,2.32,"2-0","3-0",0,0,0,0,1,1,0,0,0,0,0,0,3,0,0,"0-0","Y","Y","N",2,0,9
"543","EC",2023-09-16,"Ebbsfleet","Chesterfield",0,1,"A",0,0,"D",3.26,4.09,2.02,"0-0","0-1",0,0,0,0,4,3,0,1,0,0,0,0,1,0,0,"0-0","N","N","N",7,1,9
"544","EC",2023-09-16,"Fylde","Eastleigh",1,2,"A",0,1,"A",2.09,3.68,3.39,"0-1","1-2",0,0,0,0,1,2,1,0,0,0,0,0,3,0,0,"0-0","Y","Y","N",3,1,9
"545","EC",2023-09-16,"Halifax","Dorking",0,1,"A",0,1,"A",1.71,4.04,4.47,"0-1","0-1",0,0,0,0,1,4,0,0,0,0,0,0,1,0,0,"0-0","N","N","N",5,0,9
"546","EC",2023-09-16,"Hartlepool","Woking",0,2,"A",0,0,"D",2.28,3.53,3.11,"0-0","0-2",0,0,0,0,1,1,0,0,0,0,0,0,2,0,0,"0-0","Y","N","N",2,0,9
"547","EC",2023-09-16,"Maidenhead","Boreham Wood",0,1,"A",0,0,"D",2.95,3.21,2.5,"0-0","0-1",0,0,0,0,0,3,0,0,0,0,0,0,1,0,0,"0-0","N","N","N",3,0,9
"548","EC",2023-09-16,"Oxford City","Dag and Red",0,0,"D",0,0,"D",2.52,3.5,2.72,"0-0","0-0",0,0,0,0,2,1,0,0,0,0,0,0,0,0,0,"0-0","N","N","N",3,0,9
"549","EC",2023-09-16,"Rochdale","Barnet",4,2,"H",2,1,"H",2.9,3.49,2.43,"2-1","4-2",0,0,0,0,2,1,0,0,0,0,0,0,6,0,0,"0-0","Y","Y","Y",3,0,9
"550","EC",2023-09-16,"Wealdstone","Altrincham",0,0,"D",0,0,"D",2.66,3.8,2.47,"0-0","0-0",0,0,0,0,1,1,0,0,0,0,0,0,0,0,0,"0-0","N","N","N",2,0,9
"551","EC",2023-09-16,"York","Southend",3,0,"H",1,0,"H",3.57,3.69,2.02,"1-0","3-0",0,0,0,0,2,2,0,2,0,0,0,0,3,0,0,"0-0","Y","Y","N",4,2,9
"552","EC",2023-09-16,"Kidderminster","Solihull",0,1,"A",0,1,"A",2.22,3.45,3.28,"0-1","0-1",0,0,0,0,1,2,0,0,0,0,0,0,1,0,0,"0-0","N","N","N",3,0,9
"553","EC",2023-09-19,"Altrincham","Hartlepool",2,2,"D",2,1,"H",2.9,3.76,2.3,"2-1","2-2",0,0,0,0,2,5,0,0,0,0,0,0,4,0,0,"0-0","Y","Y","Y",7,0,10
"554","EC",2023-09-19,"Barnet","Aldershot",2,1,"H",1,0,"H",1.58,4.4,5.25,"1-0","2-1",0,0,0,0,3,3,0,0,0,0,0,0,3,0,0,"0-0","Y","Y","N",6,0,10
"555","EC",2023-09-19,"Boreham Wood","Rochdale",1,1,"D",0,0,"D",2.65,3.18,2.84,"0-0","1-1",0,0,0,0,1,0,0,0,0,0,0,0,2,0,0,"0-0","Y","N","N",1,0,10
"556","EC",2023-09-19,"Chesterfield","Halifax",3,2,"H",2,1,"H",1.46,4.46,7.03,"2-1","3-2",0,0,0,0,4,3,1,1,0,0,0,0,5,0,0,"0-0","Y","Y","Y",7,2,10
"557","EC",2023-09-19,"Dag and Red","Bromley",0,1,"A",0,0,"D",2.66,3.11,2.89,"0-0","0-1",0,0,0,0,2,2,0,0,0,0,0,0,1,0,0,"0-0","N","N","N",4,0,10
"558","EC",2023-09-19,"Dorking","Wealdstone",3,1,"H",3,0,"H",3.27,3.85,2.08,"3-0","3-1",0,0,0,0,3,2,0,0,0,0,0,0,4,0,0,"0-0","Y","Y","Y",5,0,10
"559","EC",2023-09-19,"Eastleigh","Oxford City",2,2,"D",1,0,"H",2.16,3.78,3.15,"1-0","2-2",0,0,0,0,1,2,0,0,0,0,0,0,4,0,0,"0-0","Y","Y","Y",3,0,10
"560","EC",2023-09-19,"Gateshead","Kidderminster",3,0,"H",2,0,"H",1.76,3.96,4.37,"2-0","3-0",0,0,0,0,0,1,0,0,0,0,0,0,3,0,0,"0-0","Y","Y","N",1,0,10
"561","EC",2023-09-19,"Oldham","York",2,0,"H",1,0,"H",2.01,3.84,3.47,"1-0","2-0",0,0,0,0,3,1,0,0,0,0,0,0,2,0,0,"0-0","Y","N","N",4,0,10
"562","EC",2023-09-19,"Solihull","Fylde",2,1,"H",2,1,"H",2.4,3.76,2.76,"2-1","2-1",0,0,0,0,2,3,0,0,0,0,0,0,3,0,0,"0-0","Y","Y","N",5,0,10
"563","EC",2023-09-19,"Southend","Maidenhead",2,0,"H",0,0,"D",2.15,3.32,3.59,"0-0","2-0",0,0,0,0,1,1,0,0,0,0,0,0,2,0,0,"0-0","Y","N","N",2,0,10
"564","EC",2023-09-19,"Woking","Ebbsfleet",1,1,"D",1,0,"H",1.72,3.89,4.76,"1-0","1-1",0,0,0,0,3,1,0,0,0,0,0,0,2,0,0,"0-0","Y","N","N",4,0,10
"565","EC",2023-09-23,"Woking","York",1,2,"A",0,1,"A",1.82,3.82,4.24,"0-1","1-2",0,0,0,0,1,1,0,0,0,0,0,0,3,0,0,"0-0","Y","Y","N",2,0,11
"566","EC",2023-09-23,"Altrincham","Ebbsfleet",6,1,"H",4,1,"H",2.1,3.49,3.55,"4-1","6-1",0,0,0,0,2,1,0,0,0,0,0,0,7,0,0,"0-0","Y","Y","Y",3,0,11
"567","EC",2023-09-23,"Barnet","Halifax",0,0,"D",0,0,"D",1.79,3.5,4.92,"0-0","0-0",0,0,0,0,3,1,0,0,0,0,0,0,0,0,0,"0-0","N","N","N",4,0,11
"568","EC",2023-09-23,"Boreham Wood","Aldershot",1,2,"A",0,1,"A",1.9,3.69,3.91,"0-1","1-2",0,0,0,0,2,0,0,0,0,0,0,0,3,0,0,"0-0","Y","Y","N",2,0,11
"569","EC",2023-09-23,"Chesterfield","Wealdstone",3,2,"H",0,1,"A",1.42,5.39,6.12,"0-1","3-2",0,0,0,0,2,5,0,0,0,0,0,0,5,0,0,"0-0","Y","Y","Y",7,0,11
"570","EC",2023-09-23,"Dag and Red","Hartlepool",0,1,"A",0,1,"A",3.19,3.57,2.22,"0-1","0-1",0,0,0,0,1,3,0,0,0,0,0,0,1,0,0,"0-0","N","N","N",4,0,11
"571","EC",2023-09-23,"Dorking","Rochdale",1,2,"A",0,0,"D",3.81,3.82,1.88,"0-0","1-2",0,0,0,0,3,1,1,0,0,0,0,0,3,0,0,"0-0","Y","Y","N",4,1,11
"572","EC",2023-09-23,"Eastleigh","Kidderminster",2,1,"H",2,1,"H",2.51,3.36,2.87,"2-1","2-1",0,0,0,0,2,1,0,0,0,0,0,0,3,0,0,"0-0","Y","Y","N",3,0,11
"573","EC",2023-09-23,"Gateshead","Maidenhead",3,0,"H",0,0,"D",1.47,4.64,6.53,"0-0","3-0",0,0,0,0,0,1,0,0,0,0,0,0,3,0,0,"0-0","Y","Y","N",1,0,11
"574","EC",2023-09-23,"Oldham","Oxford City",4,0,"H",2,0,"H",1.66,4.09,4.94,"2-0","4-0",0,0,0,0,1,2,0,0,0,0,0,0,4,0,0,"0-0","Y","Y","Y",3,0,11
"575","EC",2023-09-23,"Solihull","Bromley",1,1,"D",0,0,"D",2.13,3.75,3.24,"0-0","1-1",0,0,0,0,1,2,0,0,0,0,0,0,2,0,0,"0-0","Y","N","N",3,0,11
"576","EC",2023-09-23,"Southend","Fylde",1,2,"A",0,1,"A",1.83,3.81,4.21,"0-1","1-2",0,0,0,0,0,1,0,0,0,0,0,0,3,0,0,"0-0","Y","Y","N",1,0,11
"577","EC",2023-09-26,"Aldershot","Southend",1,1,"D",1,0,"H",2.96,3.56,2.35,"1-0","1-1",0,0,0,0,2,3,0,0,0,0,0,0,2,0,0,"0-0","Y","N","N",5,0,12
"578","EC",2023-09-26,"Bromley","Eastleigh",1,0,"H",1,0,"H",2.18,3.49,3.34,"1-0","1-0",0,0,0,0,1,2,0,0,0,0,0,0,1,0,0,"0-0","N","N","N",3,0,12
"579","EC",2023-09-26,"Ebbsfleet","Dorking",0,1,"A",0,0,"D",1.63,4.38,4.79,"0-0","0-1",0,0,0,0,0,4,0,0,0,0,0,0,1,0,0,"0-0","N","N","N",4,0,12
"580","EC",2023-09-26,"Fylde","Boreham Wood",2,2,"D",1,1,"D",2.43,3.44,2.93,"1-1","2-2",0,0,0,0,1,2,0,0,0,0,0,0,4,0,0,"0-0","Y","Y","Y",3,0,12
"581","EC",2023-09-26,"Halifax","Dag and Red",0,0,"D",0,0,"D",2.14,3.25,3.68,"0-0","0-0",0,0,0,0,3,4,0,0,0,0,0,0,0,0,0,"0-0","N","N","N",7,0,12
"582","EC",2023-09-26,"Hartlepool","Solihull",0,2,"A",0,2,"A",2.01,3.78,3.52,"0-2","0-2",0,0,0,0,3,3,0,0,0,0,0,0,2,0,0,"0-0","Y","N","N",6,0,12
"583","EC",2023-09-26,"Kidderminster","Oldham",1,2,"A",0,1,"A",2.98,3.31,2.46,"0-1","1-2",0,0,0,0,1,1,0,0,0,0,0,0,3,0,0,"0-0","Y","Y","N",2,0,12
"584","EC",2023-09-26,"Maidenhead","Altrincham",0,1,"A",0,0,"D",3.11,3.52,2.28,"0-0","0-1",0,0,0,0,2,1,0,0,0,0,0,0,1,0,0,"0-0","N","N","N",3,0,12
"585","EC",2023-09-26,"Oxford City","Gateshead",0,4,"A",0,1,"A",4.94,4.43,1.61,"0-1","0-4",0,0,0,0,1,3,0,0,0,0,0,0,4,0,0,"0-0","Y","Y","Y",4,0,12
"586","EC",2023-09-26,"Wealdstone","Woking",1,0,"H",1,0,"H",3.26,3.85,2.09,"1-0","1-0",0,0,0,0,2,0,0,0,0,0,0,0,1,0,0,"0-0","N","N","N",2,0,12
"587","EC",2023-09-26,"York","Barnet",2,4,"A",1,1,"D",3.1,3.61,2.25,"1-1","2-4",0,0,0,0,0,2,0,0,0,0,0,0,6,0,0,"0-0","Y","Y","Y",2,0,12
"588","EC",2023-09-26,"Rochdale","Chesterfield",1,2,"A",1,2,"A",3.46,3.73,2.05,"1-2","1-2",0,0,0,0,3,3,0,0,0,0,0,0,3,0,0,"0-0","Y","Y","N",6,0,12
"589","EC",2023-09-30,"Aldershot","Dag and Red",3,2,"H",1,1,"D",2.33,3.6,2.97,"1-1","3-2",0,0,0,0,1,5,0,1,0,0,0,0,5,0,0,"0-0","Y","Y","Y",6,1,13
"590","EC",2023-09-30,"Bromley","Gateshead",3,1,"H",0,0,"D",3.72,3.57,2.01,"0-0","3-1",0,0,0,0,4,2,1,0,0,0,0,0,4,0,0,"0-0","Y","Y","Y",6,1,13
"591","EC",2023-09-30,"Ebbsfleet","Boreham Wood",3,1,"H",2,1,"H",2.56,3.65,2.63,"2-1","3-1",0,0,0,0,2,6,0,1,0,0,0,0,4,0,0,"0-0","Y","Y","Y",8,1,13
"592","EC",2023-09-30,"Fylde","Woking",0,2,"A",0,1,"A",2.86,3.55,2.42,"0-1","0-2",0,0,0,0,1,3,0,0,0,0,0,0,2,0,0,"0-0","Y","N","N",4,0,13
"593","EC",2023-09-30,"Halifax","Eastleigh",2,3,"A",0,1,"A",1.99,3.44,3.95,"0-1","2-3",0,0,0,0,1,2,0,0,0,0,0,0,5,0,0,"0-0","Y","Y","Y",3,0,13
"594","EC",2023-09-30,"Hartlepool","Dorking",0,2,"A",0,0,"D",1.56,4.6,5.22,"0-0","0-2",0,0,0,0,1,1,0,0,0,0,0,0,2,0,0,"0-0","Y","N","N",2,0,13
"595","EC",2023-09-30,"Kidderminster","Barnet",1,2,"A",0,2,"A",3.2,3.61,2.16,"0-2","1-2",0,0,0,0,2,3,0,0,0,0,0,0,3,0,0,"0-0","Y","Y","N",5,0,13
"596","EC",2023-09-30,"Maidenhead","Chesterfield",1,1,"D",1,0,"H",6.46,4.21,1.52,"1-0","1-1",0,0,0,0,3,3,0,0,0,0,0,0,2,0,0,"0-0","Y","N","N",6,0,13
"597","EC",2023-09-30,"Rochdale","Southend",2,2,"D",2,1,"H",2.36,3.39,3,"2-1","2-2",0,0,0,0,0,4,0,0,0,0,0,0,4,0,0,"0-0","Y","Y","Y",4,0,13
"598","EC",2023-09-30,"Wealdstone","Oldham",1,1,"D",1,1,"D",3.3,3.7,2.08,"1-1","1-1",0,0,0,0,1,1,0,0,0,0,0,0,2,0,0,"0-0","Y","N","N",2,0,13
"599","EC",2023-09-30,"York","Solihull",2,2,"D",1,0,"H",2.44,3.69,2.7,"1-0","2-2",0,0,0,0,2,1,0,0,0,0,0,0,4,0,0,"0-0","Y","Y","Y",3,0,13
"600","EC",2023-09-30,"Oxford City","Altrincham",1,2,"A",0,1,"A",3.21,3.86,2.11,"0-1","1-2",0,0,0,0,1,0,0,0,0,0,0,0,3,0,0,"0-0","Y","Y","N",1,0,13
"601","EC",2023-10-03,"Altrincham","Aldershot",2,1,"H",1,0,"H",1.81,3.96,4.1,"1-0","2-1",0,0,0,0,2,2,0,0,0,0,0,0,3,0,0,"0-0","Y","Y","N",4,0,14
"602","EC",2023-10-03,"Barnet","Fylde",2,1,"H",0,1,"A",1.51,4.56,6.01,"0-1","2-1",0,0,0,0,1,6,0,1,0,0,0,0,3,0,0,"0-0","Y","Y","N",7,1,14
"603","EC",2023-10-03,"Chesterfield","Bromley",2,0,"H",0,0,"D",1.41,5.02,7.1,"0-0","2-0",0,0,0,0,2,2,0,0,0,0,0,0,2,0,0,"0-0","Y","N","N",4,0,14
"604","EC",2023-10-03,"Dag and Red","York",1,2,"A",0,0,"D",2.5,3.13,3.08,"0-0","1-2",0,0,0,0,2,1,0,0,0,0,0,0,3,0,0,"0-0","Y","Y","N",3,0,14
"605","EC",2023-10-03,"Dorking","Kidderminster",0,1,"A",0,1,"A",2.63,3.52,2.63,"0-1","0-1",0,0,0,0,2,1,0,0,0,0,0,0,1,0,0,"0-0","N","N","N",3,0,14
"606","EC",2023-10-03,"Eastleigh","Ebbsfleet",5,2,"H",2,1,"H",2.1,3.88,3.21,"2-1","5-2",0,0,0,0,4,3,0,1,0,0,0,0,7,0,0,"0-0","Y","Y","Y",7,1,14
"607","EC",2023-10-03,"Gateshead","Wealdstone",2,1,"H",0,0,"D",1.44,4.92,6.53,"0-0","2-1",0,0,0,0,1,2,0,0,0,0,0,0,3,0,0,"0-0","Y","Y","N",3,0,14
"608","EC",2023-10-03,"Oldham","Maidenhead",1,1,"D",1,0,"H",1.62,4.22,5.11,"1-0","1-1",0,0,0,0,2,2,0,0,0,0,0,0,2,0,0,"0-0","Y","N","N",4,0,14
"609","EC",2023-10-03,"Solihull","Rochdale",2,0,"H",0,0,"D",2.46,3.44,2.89,"0-0","2-0",0,0,0,0,0,3,0,0,0,0,0,0,2,0,0,"0-0","Y","N","N",3,0,14
"610","EC",2023-10-03,"Southend","Oxford City",2,0,"H",2,0,"H",1.52,4.39,6.12,"2-0","2-0",0,0,0,0,2,1,0,0,0,0,0,0,2,0,0,"0-0","Y","N","N",3,0,14
"611","EC",2023-10-03,"Woking","Halifax",1,2,"A",1,0,"H",1.88,3.47,4.39,"1-0","1-2",0,0,0,0,4,0,0,0,0,0,0,0,3,0,0,"0-0","Y","Y","N",4,0,14
"612","EC",2023-10-04,"Boreham Wood","Hartlepool",1,0,"H",0,0,"D",2.56,3.45,2.75,"0-0","1-0",0,0,0,0,2,1,0,0,0,0,0,0,1,0,0,"0-0","N","N","N",3,0,14
"917","F1",2023-08-11,"Nice","Lille",1,1,"D",1,0,"H",2.63,3.47,2.83,"1-0","1-1",8,3,12,5,3,2,0,0,3,3,13,9,2,6,22,"3-3","Y","N","N",5,0,1
"918","F1",2023-08-12,"Marseille","Reims",2,1,"H",1,1,"D",1.73,4.04,4.89,"1-1","2-1",14,4,11,4,1,3,0,0,10,10,7,16,3,20,23,"10-10","Y","Y","N",4,0,1
"919","F1",2023-08-12,"Paris SG","Lorient",0,0,"D",0,0,"D",1.35,5.73,8.38,"0-0","0-0",20,4,4,0,0,0,0,0,9,2,8,6,0,11,14,"9-2","N","N","N",0,0,1
"920","F1",2023-08-13,"Brest","Lens",3,2,"H",1,2,"A",4.01,3.62,1.99,"1-2","3-2",15,8,10,2,2,3,0,1,6,8,13,15,5,14,28,"6-8","Y","Y","Y",5,1,1
"921","F1",2023-08-13,"Clermont","Monaco",2,4,"A",1,2,"A",3.69,3.8,2.02,"1-2","2-4",15,7,14,8,0,4,0,0,6,2,7,16,6,8,23,"6-2","Y","Y","Y",4,0,1
"922","F1",2023-08-13,"Montpellier","Le Havre",2,2,"D",0,1,"A",2.04,3.47,3.99,"0-1","2-2",15,5,12,4,1,2,0,0,5,2,8,12,4,7,20,"5-2","Y","Y","Y",3,0,1
"923","F1",2023-08-13,"Nantes","Toulouse",1,2,"A",1,0,"H",2.66,3.36,2.82,"1-0","1-2",9,4,9,5,2,2,0,0,7,5,14,14,3,12,28,"7-5","Y","Y","N",4,0,1
"924","F1",2023-08-13,"Rennes","Metz",5,1,"H",1,1,"D",1.42,5.07,7.64,"1-1","5-1",29,14,9,3,0,2,0,0,5,4,7,10,6,9,17,"5-4","Y","Y","Y",2,0,1
"925","F1",2023-08-13,"Strasbourg","Lyon",2,1,"H",0,0,"D",2.61,3.55,2.76,"0-0","2-1",8,2,23,7,2,2,0,0,1,6,8,11,3,7,19,"1-6","Y","Y","N",4,0,1
"926","F1",2023-08-18,"Metz","Marseille",2,2,"D",0,1,"A",4.96,4.13,1.72,"0-1","2-2",10,5,22,5,3,2,1,0,4,9,15,9,4,13,24,"4-9","Y","Y","Y",5,1,2
"927","F1",2023-08-19,"Lyon","Montpellier",1,4,"A",0,2,"A",1.72,4.25,4.67,"0-2","1-4",7,3,14,8,4,1,1,0,6,2,20,10,5,8,30,"6-2","Y","Y","Y",5,1,2
"928","F1",2023-08-19,"Toulouse","Paris SG",1,1,"D",0,0,"D",5.01,4.25,1.68,"0-0","1-1",8,2,16,3,0,3,0,0,5,5,8,11,2,10,19,"5-5","Y","N","N",3,0,2
"929","F1",2023-08-20,"Lille","Nantes",2,0,"H",0,0,"D",1.43,4.96,7.54,"0-0","2-0",18,8,14,4,0,2,1,0,7,5,8,15,2,12,23,"7-5","Y","N","N",2,1,2
"930","F1",2023-08-20,"Le Havre","Brest",1,2,"A",0,1,"A",2.82,3.22,2.76,"0-1","1-2",18,7,10,5,0,2,0,0,5,3,18,15,3,8,33,"5-3","Y","Y","N",2,0,2
"931","F1",2023-08-20,"Lorient","Nice",1,1,"D",0,0,"D",3.49,3.52,2.19,"0-0","1-1",9,2,21,8,1,1,0,0,0,9,8,10,2,9,18,"0-9","Y","N","N",2,0,2
"932","F1",2023-08-20,"Reims","Clermont",2,0,"H",1,0,"H",1.93,3.72,4.1,"1-0","2-0",8,4,11,4,0,0,0,0,3,10,9,6,2,13,15,"3-10","Y","N","N",0,0,2
"933","F1",2023-08-20,"Monaco","Strasbourg",3,0,"H",2,0,"H",1.84,4.1,4.13,"2-0","3-0",9,4,4,1,2,1,0,0,4,3,19,16,3,7,35,"4-3","Y","Y","N",3,0,2
"934","F1",2023-08-20,"Lens","Rennes",1,1,"D",1,0,"H",2.42,3.78,2.86,"1-0","1-1",15,4,10,5,2,1,0,0,11,0,15,10,2,11,25,"11-0","Y","N","N",3,0,2
"935","F1",2023-08-25,"Nantes","Monaco",3,3,"D",2,1,"H",4.87,3.81,1.79,"2-1","3-3",3,3,27,10,2,2,0,0,1,10,8,7,6,11,15,"1-10","Y","Y","Y",4,0,3
"936","F1",2023-08-26,"Marseille","Brest",2,0,"H",1,0,"H",1.53,4.48,6.43,"1-0","2-0",15,6,18,7,0,1,0,0,3,10,4,8,2,13,12,"3-10","Y","N","N",1,0,3
"937","F1",2023-08-26,"Paris SG","Lens",3,1,"H",1,0,"H",1.63,4.27,5.45,"1-0","3-1",17,7,12,4,0,5,0,0,5,5,8,16,4,10,24,"5-5","Y","Y","Y",5,0,3
"938","F1",2023-08-27,"Rennes","Le Havre",2,2,"D",2,1,"H",1.44,4.76,7.86,"2-1","2-2",22,8,7,3,1,2,0,1,5,2,5,7,4,7,12,"5-2","Y","Y","Y",3,1,3
"939","F1",2023-08-27,"Clermont","Metz",0,1,"A",0,0,"D",1.93,3.83,3.99,"0-0","0-1",16,4,10,5,1,1,0,0,10,2,8,10,1,12,18,"10-2","N","N","N",2,0,3
"940","F1",2023-08-27,"Montpellier","Reims",1,3,"A",1,2,"A",2.41,3.54,3.02,"1-2","1-3",19,3,12,6,1,1,0,0,5,3,9,19,4,8,28,"5-3","Y","Y","Y",2,0,3
"941","F1",2023-08-27,"Strasbourg","Toulouse",2,0,"H",0,0,"D",2.17,3.75,3.32,"0-0","2-0",11,3,7,1,1,3,0,0,3,3,16,17,2,6,33,"3-3","Y","N","N",4,0,3
"942","F1",2023-08-27,"Lorient","Lille",4,1,"H",2,0,"H",3.83,3.75,1.99,"2-0","4-1",9,6,18,7,2,4,0,0,5,8,22,12,5,13,34,"5-8","Y","Y","Y",6,0,3
"943","F1",2023-08-27,"Nice","Lyon",0,0,"D",0,0,"D",2.11,3.79,3.44,"0-0","0-0",21,4,6,1,1,4,0,0,7,2,8,14,0,9,22,"7-2","N","N","N",5,0,3
"944","F1",2023-09-01,"Nantes","Marseille",1,1,"D",1,1,"D",4.97,4.02,1.73,"1-1","1-1",10,2,26,9,0,2,1,0,2,7,7,13,2,9,20,"2-7","Y","N","N",2,1,4
"945","F1",2023-09-02,"Brest","Rennes",0,0,"D",0,0,"D",3.37,3.68,2.18,"0-0","0-0",13,2,6,3,3,1,0,0,7,5,12,12,0,12,24,"7-5","N","N","N",4,0,4
"946","F1",2023-09-02,"Monaco","Lens",3,0,"H",2,0,"H",2.11,3.93,3.33,"2-0","3-0",11,6,12,1,4,2,0,0,5,2,21,16,3,7,37,"5-2","Y","Y","N",6,0,4
"947","F1",2023-09-03,"Toulouse","Clermont",2,2,"D",2,1,"H",2.02,3.69,3.82,"2-1","2-2",9,5,15,3,1,3,0,0,0,8,19,17,4,8,36,"0-8","Y","Y","Y",4,0,4
"948","F1",2023-09-03,"Le Havre","Lorient",3,0,"H",0,0,"D",2.87,3.12,2.79,"0-0","3-0",17,6,9,2,0,0,0,0,5,4,10,7,3,9,17,"5-4","Y","Y","N",0,0,4
"949","F1",2023-09-03,"Lille","Montpellier",1,0,"H",1,0,"H",1.83,4.25,4.05,"1-0","1-0",15,6,9,5,2,1,0,0,5,5,15,14,1,10,29,"5-5","N","N","N",3,0,4
"950","F1",2023-09-03,"Metz","Reims",2,2,"D",1,1,"D",4.09,3.72,1.93,"1-1","2-2",12,4,12,2,0,4,0,0,4,1,10,17,4,5,27,"4-1","Y","Y","Y",4,0,4
"951","F1",2023-09-03,"Nice","Strasbourg",2,0,"H",1,0,"H",1.98,3.58,4.06,"1-0","2-0",16,6,4,0,2,1,0,0,5,2,7,12,2,7,19,"5-2","Y","N","N",3,0,4
"952","F1",2023-09-03,"Lyon","Paris SG",1,4,"A",0,4,"A",5.79,5.01,1.52,"0-4","1-4",19,8,22,8,2,2,0,0,5,2,9,5,5,7,14,"5-2","Y","Y","Y",4,0,4
"953","F1",2023-09-15,"Paris SG","Nice",2,3,"A",1,1,"D",1.56,4.6,5.86,"1-1","2-3",12,3,14,8,2,5,0,0,4,3,8,17,5,7,25,"4-3","Y","Y","Y",7,0,5
"954","F1",2023-09-16,"Rennes","Lille",2,2,"D",0,1,"A",2.17,3.69,3.37,"0-1","2-2",7,4,10,6,1,4,0,0,5,2,11,16,4,7,27,"5-2","Y","Y","Y",5,0,5
"955","F1",2023-09-16,"Lens","Metz",0,1,"A",0,1,"A",1.52,4.62,6.36,"0-1","0-1",31,10,2,2,1,2,0,0,9,1,12,12,1,10,24,"9-1","N","N","N",3,0,5
"956","F1",2023-09-17,"Lorient","Monaco",2,2,"D",1,1,"D",4.12,3.98,1.87,"1-1","2-2",10,3,20,7,0,1,0,0,8,6,13,14,4,14,27,"8-6","Y","Y","Y",1,0,5
"957","F1",2023-09-17,"Clermont","Nantes",0,1,"A",0,0,"D",2.04,3.6,3.85,"0-0","0-1",16,3,8,5,2,2,0,0,6,3,16,16,1,9,32,"6-3","N","N","N",4,0,5
"958","F1",2023-09-17,"Reims","Brest",1,2,"A",1,0,"H",1.9,3.6,4.43,"1-0","1-2",13,7,18,7,2,4,0,0,8,8,7,11,3,16,18,"8-8","Y","Y","N",6,0,5
"959","F1",2023-09-17,"Strasbourg","Montpellier",2,2,"D",0,2,"A",2.39,3.61,3.01,"0-2","2-2",14,7,11,4,4,6,0,0,2,4,17,17,4,6,34,"2-4","Y","Y","Y",10,0,5
"960","F1",2023-09-17,"Marseille","Toulouse",0,0,"D",0,0,"D",1.5,4.87,6.33,"0-0","0-0",24,6,10,3,2,5,0,0,6,1,9,11,0,7,20,"6-1","N","N","N",7,0,5
"961","F1",2023-09-17,"Lyon","Le Havre",0,0,"D",0,0,"D",1.7,4.23,4.82,"0-0","0-0",23,7,7,0,3,2,0,0,6,1,13,12,0,7,25,"6-1","N","N","N",5,0,5
"962","F1",2023-09-22,"Monaco","Nice",0,1,"A",0,0,"D",2.25,3.61,3.27,"0-0","0-1",9,3,13,7,1,1,0,0,5,2,13,15,1,7,28,"5-2","N","N","N",2,0,6
"963","F1",2023-09-23,"Nantes","Lorient",5,3,"H",1,1,"D",2.46,3.45,3.02,"1-1","5-3",19,9,10,7,1,3,0,0,4,2,8,17,8,6,25,"4-2","Y","Y","Y",4,0,6
"964","F1",2023-09-23,"Brest","Lyon",1,0,"H",0,0,"D",2.57,3.67,2.73,"0-0","1-0",27,11,6,3,3,1,0,0,10,1,17,16,1,11,33,"10-1","N","N","N",4,0,6
"965","F1",2023-09-24,"Metz","Strasbourg",0,1,"A",0,0,"D",3.01,3.23,2.59,"0-0","0-1",13,1,4,1,2,0,0,0,1,1,16,15,1,2,31,"1-1","N","N","N",2,0,6
"966","F1",2023-09-24,"Le Havre","Clermont",2,1,"H",2,1,"H",2.48,3.26,3.15,"2-1","2-1",9,3,11,4,2,3,0,0,1,3,15,17,3,4,32,"1-3","Y","Y","N",5,0,6
"967","F1",2023-09-24,"Lens","Toulouse",2,1,"H",1,1,"D",1.72,4.05,4.93,"1-1","2-1",27,7,7,2,2,1,0,0,9,4,16,15,3,13,31,"9-4","Y","Y","N",3,0,6
"968","F1",2023-09-24,"Montpellier","Rennes",0,0,"D",0,0,"D",2.7,3.56,2.65,"0-0","0-0",13,4,18,6,2,1,0,0,3,6,10,15,0,9,25,"3-6","N","N","N",3,0,6
"969","F1",2023-09-24,"Paris SG","Marseille",4,0,"H",2,0,"H",1.64,4.41,5.15,"2-0","4-0",15,5,6,0,0,3,0,0,8,3,11,14,4,11,25,"8-3","Y","Y","Y",3,0,6
"970","F1",2023-09-26,"Lille","Reims",1,2,"A",0,2,"A",1.96,3.79,3.95,"0-2","1-2",14,3,4,4,1,2,0,0,4,2,4,19,3,6,23,"4-2","Y","Y","N",3,0,6
"971","F1",2023-09-29,"Strasbourg","Lens",0,1,"A",0,1,"A",3.69,3.48,2.13,"0-1","0-1",8,2,9,2,2,4,0,0,2,3,16,15,1,5,31,"2-3","N","N","N",6,0,7
"972","F1",2023-09-30,"Clermont","Paris SG",0,0,"D",0,0,"D",7.03,4.81,1.47,"0-0","0-0",12,3,21,10,2,3,0,0,6,9,11,16,0,15,27,"6-9","N","N","N",5,0,7
"973","F1",2023-09-30,"Monaco","Marseille",3,2,"H",2,2,"D",2.21,3.88,3.14,"2-2","3-2",10,7,8,4,4,4,0,0,2,6,17,15,5,8,32,"2-6","Y","Y","Y",8,0,7
"974","F1",2023-10-01,"Reims","Lyon",2,0,"H",1,0,"H",2.1,3.81,3.45,"1-0","2-0",8,3,11,6,2,2,0,0,1,5,19,14,2,6,33,"1-5","Y","N","N",4,0,7
"975","F1",2023-10-01,"Le Havre","Lille",0,2,"A",0,1,"A",4.08,3.44,2.03,"0-1","0-2",5,0,16,6,0,0,0,0,6,6,18,6,2,12,24,"6-6","Y","N","N",0,0,7
"976","F1",2023-10-01,"Nice","Brest",0,0,"D",0,0,"D",1.8,3.84,4.69,"0-0","0-0",12,1,7,2,1,3,0,0,6,4,13,9,0,10,22,"6-4","N","N","N",4,0,7
"977","F1",2023-10-01,"Toulouse","Metz",3,0,"H",2,0,"H",2.13,3.47,3.7,"2-0","3-0",15,10,8,3,3,0,0,0,4,6,10,7,3,10,17,"4-6","Y","Y","N",3,0,7
"978","F1",2023-10-01,"Lorient","Montpellier",0,3,"A",0,1,"A",2.95,3.59,2.44,"0-1","0-3",14,3,14,8,2,1,0,0,8,3,13,6,3,11,19,"8-3","Y","Y","N",3,0,7
"979","F1",2023-10-01,"Rennes","Nantes",3,1,"H",1,1,"D",1.53,4.58,6.18,"1-1","3-1",16,5,10,3,3,6,0,1,6,4,11,17,4,10,28,"6-4","Y","Y","Y",9,1,7
"980","F2",2023-08-05,"St Etienne","Grenoble",0,1,"A",0,0,"D",1.65,3.78,6.05,"0-0","0-1",17,4,13,5,2,1,0,0,6,1,14,12,1,7,26,"6-1","N","N","N",3,0,1
"981","F2",2023-08-05,"Ajaccio","Rodez",1,1,"D",1,1,"D",1.96,3.22,4.69,"1-1","1-1",19,6,8,3,1,3,0,0,7,4,9,12,2,11,21,"7-4","Y","N","N",4,0,1
"982","F2",2023-08-05,"Amiens","Quevilly Rouen",1,0,"H",0,0,"D",2.59,3.46,2.79,"0-0","1-0",5,2,6,2,1,1,0,0,9,2,12,17,1,11,29,"9-2","N","N","N",2,0,1
"983","F2",2023-08-05,"Annecy","Guingamp",1,4,"A",1,0,"H",3.6,3.41,2.16,"1-0","1-4",11,4,15,8,2,0,0,0,3,2,13,12,5,5,25,"3-2","Y","Y","Y",2,0,1
"984","F2",2023-08-05,"Concarneau","Bastia",0,0,"D",0,0,"D",3.11,3.22,2.49,"0-0","0-0",13,3,8,1,0,3,0,0,5,6,7,17,0,11,24,"5-6","N","N","N",3,0,1
"985","F2",2023-08-05,"Dunkerque","Troyes",2,2,"D",1,2,"A",2.82,3.14,2.78,"1-2","2-2",16,5,14,7,2,1,0,0,4,4,16,6,4,8,22,"4-4","Y","Y","Y",3,0,1
"986","F2",2023-08-05,"Laval","Angers",1,0,"H",0,0,"D",2.67,3.29,2.82,"0-0","1-0",13,5,6,2,1,3,0,0,3,4,7,11,1,7,18,"3-4","N","N","N",4,0,1
"987","F2",2023-08-05,"Paris FC","Caen",0,2,"A",0,1,"A",2.91,3.2,2.66,"0-1","0-2",2,0,12,5,2,2,1,0,2,6,12,13,2,8,25,"2-6","Y","N","N",4,1,1
"988","F2",2023-08-05,"Valenciennes","Auxerre",1,4,"A",1,1,"D",3.97,3.4,2.05,"1-1","1-4",12,5,19,6,1,1,0,0,6,7,10,15,5,13,25,"6-7","Y","Y","Y",2,0,1
"989","F2",2023-08-07,"Pau FC","Bordeaux",3,0,"H",2,0,"H",3.83,3.51,2,"2-0","3-0",7,4,15,6,2,0,0,0,2,8,21,8,3,10,29,"2-8","Y","Y","N",2,0,1
"990","F2",2023-08-12,"Rodez","St Etienne",2,1,"H",1,0,"H",3.78,3.7,1.97,"1-0","2-1",21,7,15,8,0,2,0,0,10,2,7,11,3,12,18,"10-2","Y","Y","N",2,0,2
"991","F2",2023-08-12,"Angers","Annecy",0,0,"D",0,0,"D",1.72,3.76,5.29,"0-0","0-0",12,1,5,2,2,2,0,0,8,3,17,13,0,11,30,"8-3","N","N","N",4,0,2
"992","F2",2023-08-12,"Auxerre","Amiens",0,1,"A",0,0,"D",1.7,3.77,5.44,"0-0","0-1",15,0,7,1,0,1,0,0,6,5,8,11,1,11,19,"6-5","N","N","N",1,0,2
"993","F2",2023-08-12,"Bastia","Valenciennes",3,0,"H",1,0,"H",1.81,3.56,4.95,"1-0","3-0",15,7,3,1,0,2,0,0,5,5,12,13,3,10,25,"5-5","Y","Y","N",2,0,2
"994","F2",2023-08-12,"Caen","Pau FC",2,0,"H",2,0,"H",1.7,3.74,5.54,"2-0","2-0",23,5,7,2,0,2,0,1,8,3,10,16,2,11,26,"8-3","Y","N","N",2,1,2
"995","F2",2023-08-12,"Grenoble","Paris FC",2,0,"H",0,0,"D",2.45,3.21,3.19,"0-0","2-0",11,7,3,3,1,2,0,1,5,6,9,10,2,11,19,"5-6","Y","N","N",3,1,2
"996","F2",2023-08-12,"Guingamp","Dunkerque",0,1,"A",0,0,"D",1.93,3.56,4.21,"0-0","0-1",16,3,9,5,4,3,0,0,7,1,13,18,1,8,31,"7-1","N","N","N",7,0,2
"997","F2",2023-08-12,"Quevilly Rouen","Ajaccio",0,1,"A",0,1,"A",2.57,3.08,3.14,"0-1","0-1",4,2,3,3,2,1,0,0,3,0,19,13,1,3,32,"3-0","N","N","N",3,0,2
"998","F2",2023-08-12,"Troyes","Laval",3,1,"H",2,0,"H",2.09,3.55,3.64,"2-0","3-1",9,6,19,3,1,1,0,0,5,7,5,20,4,12,25,"5-7","Y","Y","Y",2,0,2
"999","F2",2023-08-14,"Bordeaux","Concarneau",1,0,"H",0,0,"D",1.67,4.09,4.86,"0-0","1-0",16,5,10,4,2,1,0,0,8,5,16,10,1,13,26,"8-5","N","N","N",3,0,2
"1000","F2",2023-08-19,"Angers","Auxerre",2,2,"D",1,1,"D",2.8,3.39,2.63,"1-1","2-2",12,5,13,5,3,0,0,1,3,3,22,8,4,6,30,"3-3","Y","Y","Y",3,1,3
"1001","F2",2023-08-19,"Amiens","Bastia",2,1,"H",1,1,"D",2.6,3.16,3.02,"1-1","2-1",17,6,11,4,3,2,0,1,12,2,9,17,3,14,26,"12-2","Y","Y","N",5,1,3
"1002","F2",2023-08-19,"Annecy","Dunkerque",3,0,"H",0,0,"D",2.82,3.23,2.71,"0-0","3-0",11,4,4,2,3,1,0,0,4,3,11,9,3,7,20,"4-3","Y","Y","N",4,0,3
"1003","F2",2023-08-19,"Concarneau","Caen",0,2,"A",0,0,"D",3.4,3.45,2.23,"0-0","0-2",14,4,11,3,1,1,0,0,2,2,15,8,2,4,23,"2-2","Y","N","N",2,0,3
"1004","F2",2023-08-19,"Grenoble","Troyes",0,0,"D",0,0,"D",2.48,3.31,3.06,"0-0","0-0",18,7,6,1,1,1,0,1,14,5,13,13,0,19,26,"14-5","N","N","N",2,1,3
"1005","F2",2023-08-19,"Laval","Rodez",1,0,"H",0,0,"D",2.07,3.4,3.87,"0-0","1-0",9,4,7,1,2,0,0,0,2,3,11,13,1,5,24,"2-3","N","N","N",2,0,3
"1006","F2",2023-08-19,"Pau FC","Paris FC",2,0,"H",1,0,"H",2.52,3.27,3.02,"1-0","2-0",9,3,14,5,2,1,0,0,1,2,13,10,2,3,23,"1-2","Y","N","N",3,0,3
"1007","F2",2023-08-19,"St Etienne","Quevilly Rouen",2,1,"H",2,0,"H",1.75,3.93,4.8,"2-0","2-1",5,2,10,1,0,3,0,0,3,5,8,18,3,8,26,"3-5","Y","Y","N",3,0,3
"1008","F2",2023-08-19,"Valenciennes","Guingamp",0,0,"D",0,0,"D",3.43,3.33,2.26,"0-0","0-0",9,3,6,3,3,2,0,0,3,7,12,15,0,10,27,"3-7","N","N","N",5,0,3
"1009","F2",2023-08-21,"Ajaccio","Bordeaux",0,0,"D",0,0,"D",2.8,3.11,2.74,"0-0","0-0",9,2,15,4,4,3,1,0,1,4,11,8,0,5,19,"1-4","N","N","N",7,1,3
"1010","F2",2023-08-26,"Bordeaux","Amiens",2,0,"H",0,0,"D",1.81,3.79,4.55,"0-0","2-0",17,7,12,2,5,1,0,0,6,5,12,7,2,11,19,"6-5","Y","N","N",6,0,4
"1011","F2",2023-08-26,"Auxerre","Grenoble",0,0,"D",0,0,"D",1.86,3.66,4.43,"0-0","0-0",15,2,7,4,2,2,0,0,4,3,11,16,0,7,27,"4-3","N","N","N",4,0,4
"1012","F2",2023-08-26,"Bastia","Troyes",3,2,"H",0,2,"A",2,3.61,3.87,"0-2","3-2",24,6,9,6,2,1,1,1,6,2,18,15,5,8,33,"6-2","Y","Y","Y",3,2,4
"1013","F2",2023-08-26,"Caen","Ajaccio",3,0,"H",2,0,"H",1.85,3.35,5.02,"2-0","3-0",10,4,5,2,1,2,0,0,7,4,5,10,3,11,15,"7-4","Y","Y","N",3,0,4
"1014","F2",2023-08-26,"Dunkerque","Angers",0,1,"A",0,0,"D",2.83,3.35,2.62,"0-0","0-1",14,9,7,3,3,2,0,0,3,4,10,13,1,7,23,"3-4","N","N","N",5,0,4
"1015","F2",2023-08-26,"Guingamp","Pau FC",4,0,"H",2,0,"H",1.93,3.46,4.42,"2-0","4-0",23,9,13,6,3,2,0,0,6,2,17,14,4,8,31,"6-2","Y","Y","Y",5,0,4
"1016","F2",2023-08-26,"Paris FC","Concarneau",3,0,"H",1,0,"H",2.46,3.31,3.08,"1-0","3-0",13,6,13,4,1,0,0,0,3,8,14,14,3,11,28,"3-8","Y","Y","N",1,0,4
"1017","F2",2023-08-26,"Quevilly Rouen","Laval",0,0,"D",0,0,"D",2.31,3.27,3.39,"0-0","0-0",7,2,11,2,1,1,0,0,4,6,15,16,0,10,31,"4-6","N","N","N",2,0,4
"1018","F2",2023-08-26,"Rodez","Valenciennes",0,1,"A",0,1,"A",1.99,3.2,4.57,"0-1","0-1",19,7,10,4,2,3,0,0,7,1,8,18,1,8,26,"7-1","N","N","N",5,0,4
"1019","F2",2023-08-28,"Annecy","St Etienne",1,1,"D",1,0,"H",3.58,3.55,2.06,"1-0","1-1",17,5,10,4,2,2,0,0,3,3,15,13,2,6,28,"3-3","Y","N","N",4,0,4
"1020","F2",2023-09-02,"Bordeaux","Auxerre",2,4,"A",1,2,"A",2.07,3.66,3.6,"1-2","2-4",20,9,15,6,2,2,0,0,3,11,8,17,6,14,25,"3-11","Y","Y","Y",4,0,5
"1021","F2",2023-09-02,"Ajaccio","Dunkerque",2,2,"D",0,1,"A",1.91,3.41,4.58,"0-1","2-2",10,3,10,4,3,1,1,0,2,5,14,20,4,7,34,"2-5","Y","Y","Y",4,1,5
"1022","F2",2023-09-02,"Amiens","Guingamp",4,1,"H",1,1,"D",2.4,3.28,3.22,"1-1","4-1",11,7,12,4,1,4,0,0,2,4,16,15,5,6,31,"2-4","Y","Y","Y",5,0,5
"1023","F2",2023-09-02,"Angers","Paris FC",2,0,"H",1,0,"H",2.04,3.4,3.88,"1-0","2-0",11,4,9,3,1,2,0,0,5,4,12,14,2,9,26,"5-4","Y","N","N",3,0,5
"1024","F2",2023-09-02,"Concarneau","Annecy",1,1,"D",0,1,"A",2.26,3.36,3.33,"0-1","1-1",10,2,17,7,5,4,0,1,4,1,10,21,2,5,31,"4-1","Y","N","N",9,1,5
"1025","F2",2023-09-02,"Grenoble","Bastia",0,0,"D",0,0,"D",2.33,3.25,3.38,"0-0","0-0",22,3,11,1,0,1,0,0,8,3,6,14,0,11,20,"8-3","N","N","N",1,0,5
"1026","F2",2023-09-02,"Laval","Caen",2,1,"H",0,0,"D",3.63,3.17,2.26,"0-0","2-1",9,3,5,2,2,3,0,0,3,2,13,9,3,5,22,"3-2","Y","Y","N",5,0,5
"1027","F2",2023-09-02,"Pau FC","Rodez",2,2,"D",2,0,"H",2.84,3.34,2.62,"2-0","2-2",10,3,17,8,4,3,0,0,4,5,17,15,4,9,32,"4-5","Y","Y","Y",7,0,5
"1028","F2",2023-09-02,"St Etienne","Valenciennes",0,0,"D",0,0,"D",1.6,4.22,5.76,"0-0","0-0",11,1,9,3,7,3,0,0,4,4,11,13,0,8,24,"4-4","N","N","N",10,0,5
"1029","F2",2023-09-02,"Troyes","Quevilly Rouen",2,2,"D",0,2,"A",2.33,3.25,3.37,"0-2","2-2",10,4,10,3,2,1,0,0,5,7,14,9,4,12,23,"5-7","Y","Y","Y",3,0,5
"1030","F2",2023-09-16,"Caen","St Etienne",1,2,"A",0,1,"A",1.93,3.78,3.98,"0-1","1-2",14,6,8,3,3,1,0,0,3,1,12,10,3,4,22,"3-1","Y","Y","N",4,0,6
"1031","F2",2023-09-16,"Annecy","Troyes",0,0,"D",0,0,"D",2.45,3.46,2.98,"0-0","0-0",15,0,7,3,1,0,0,0,10,4,9,11,0,14,20,"10-4","N","N","N",1,0,6
"1032","F2",2023-09-16,"Auxerre","Pau FC",2,2,"D",1,1,"D",1.5,4.47,6.8,"1-1","2-2",24,6,6,4,2,3,0,0,13,4,10,3,4,17,13,"13-4","Y","Y","Y",5,0,6
"1033","F2",2023-09-16,"Bastia","Laval",0,3,"A",0,1,"A",2.19,3.35,3.6,"0-1","0-3",8,3,9,4,2,2,0,0,5,6,14,12,3,11,26,"5-6","Y","Y","N",4,0,6
"1034","F2",2023-09-16,"Dunkerque","Grenoble",0,0,"D",0,0,"D",2.81,3.23,2.72,"0-0","0-0",5,4,18,5,2,2,1,0,3,6,13,9,0,9,22,"3-6","N","N","N",4,1,6
"1035","F2",2023-09-16,"Paris FC","Amiens",3,0,"H",2,0,"H",2.78,3.31,2.7,"2-0","3-0",12,3,13,3,2,2,0,0,3,8,11,17,3,11,28,"3-8","Y","Y","N",4,0,6
"1036","F2",2023-09-16,"Quevilly Rouen","Concarneau",2,3,"A",0,3,"A",1.94,3.46,4.18,"0-3","2-3",23,8,9,6,1,1,0,0,7,1,18,12,5,8,30,"7-1","Y","Y","Y",2,0,6
"1037","F2",2023-09-16,"Rodez","Angers",4,1,"H",0,1,"A",2.96,3.19,2.62,"0-1","4-1",13,5,9,3,2,2,0,0,3,4,12,13,5,7,25,"3-4","Y","Y","Y",4,0,6
"1038","F2",2023-09-16,"Valenciennes","Bordeaux",1,2,"A",0,1,"A",4.26,3.66,1.89,"0-1","1-2",11,3,13,5,3,2,0,0,3,5,7,17,3,8,24,"3-5","Y","Y","N",5,0,6
"1039","F2",2023-09-18,"Guingamp","Ajaccio",3,0,"H",2,0,"H",2.27,3.19,3.45,"2-0","3-0",12,5,15,4,0,1,0,0,3,6,15,9,3,9,24,"3-6","Y","Y","N",1,0,6
"1040","F2",2023-09-23,"Troyes","Auxerre",1,2,"A",0,1,"A",3.45,3.74,2.1,"0-1","1-2",10,4,19,5,2,2,0,0,3,14,20,12,3,17,32,"3-14","Y","Y","N",4,0,7
"1041","F2",2023-09-23,"Ajaccio","Paris FC",2,1,"H",0,0,"D",1.97,3.41,4.26,"0-0","2-1",11,4,6,1,2,2,0,0,4,4,14,11,3,8,25,"4-4","Y","Y","N",4,0,7
"1042","F2",2023-09-23,"Amiens","Valenciennes",0,0,"D",0,0,"D",1.7,3.79,5.38,"0-0","0-0",12,4,8,3,3,3,0,0,4,5,21,19,0,9,40,"4-5","N","N","N",6,0,7
"1043","F2",2023-09-23,"Angers","Bastia",2,0,"H",1,0,"H",1.98,3.48,3.99,"1-0","2-0",10,7,9,3,1,3,0,1,9,3,13,10,2,12,23,"9-3","Y","N","N",4,1,7
"1044","F2",2023-09-23,"Concarneau","St Etienne",0,1,"A",0,0,"D",3.2,3.47,2.31,"0-0","0-1",9,3,16,4,1,1,0,0,5,9,13,11,1,14,24,"5-9","N","N","N",2,0,7
"1045","F2",2023-09-23,"Dunkerque","Rodez",1,2,"A",0,1,"A",2.56,3,3.17,"0-1","1-2",15,3,14,5,1,2,0,0,6,2,10,12,3,8,22,"6-2","Y","Y","N",3,0,7
"1046","F2",2023-09-23,"Grenoble","Quevilly Rouen",2,1,"H",1,1,"D",2.49,3.28,3.07,"1-1","2-1",10,4,11,5,1,2,0,0,4,1,9,11,3,5,20,"4-1","Y","Y","N",3,0,7
"1047","F2",2023-09-23,"Laval","Guingamp",2,1,"H",0,0,"D",2.62,3.09,3.06,"0-0","2-1",15,6,13,6,1,2,0,0,6,3,19,13,3,9,32,"6-3","Y","Y","N",3,0,7
"1048","F2",2023-09-23,"Pau FC","Annecy",0,3,"A",0,2,"A",2.9,3.21,2.65,"0-2","0-3",12,4,9,5,5,1,0,0,7,4,17,16,3,11,33,"7-4","Y","Y","N",6,0,7
"1049","F2",2023-09-26,"Amiens","Ajaccio",0,0,"D",0,0,"D",2.11,3.24,4,"0-0","0-0",7,0,6,2,2,5,0,0,3,3,16,27,0,6,43,"3-3","N","N","N",7,0,7
"1050","F2",2023-09-26,"Auxerre","Annecy",4,0,"H",2,0,"H",1.57,4.17,6.13,"2-0","4-0",11,5,5,1,0,1,0,0,3,5,7,15,4,8,22,"3-5","Y","Y","Y",1,0,8
"1051","F2",2023-09-26,"Bastia","Pau FC",1,4,"A",0,1,"A",1.72,3.87,5.08,"0-1","1-4",10,2,17,10,2,3,1,0,10,3,7,12,5,13,19,"10-3","Y","Y","Y",5,1,8
"1052","F2",2023-09-26,"Caen","Grenoble",1,2,"A",1,0,"H",1.94,3.47,4.33,"1-0","1-2",10,1,10,4,0,3,0,0,3,3,10,17,3,6,27,"3-3","Y","Y","N",3,0,8
"1053","F2",2023-09-26,"Guingamp","Bordeaux",0,0,"D",0,0,"D",2.91,3.19,2.66,"0-0","0-0",11,2,14,3,1,1,0,0,2,4,12,16,0,6,28,"2-4","N","N","N",2,0,8
"1054","F2",2023-09-26,"Paris FC","Laval",0,1,"A",0,0,"D",2.89,3.02,2.82,"0-0","0-1",15,4,11,2,1,1,0,0,9,3,13,11,1,12,24,"9-3","N","N","N",2,0,8
"1055","F2",2023-09-26,"Quevilly Rouen","Angers",0,1,"A",0,1,"A",2.84,3.13,2.77,"0-1","0-1",12,1,6,3,3,4,1,0,2,5,15,17,1,7,32,"2-5","N","N","N",7,1,8
"1056","F2",2023-09-26,"Rodez","Troyes",2,1,"H",0,0,"D",1.96,3.78,3.83,"0-0","2-1",19,5,7,3,1,2,0,0,8,3,11,11,3,11,22,"8-3","Y","Y","N",3,0,8
"1057","F2",2023-09-26,"Valenciennes","Concarneau",0,1,"A",0,1,"A",2.44,3.15,3.26,"0-1","0-1",19,2,9,3,3,4,0,0,4,8,22,20,1,12,42,"4-8","N","N","N",7,0,8
"1058","F2",2023-09-30,"Troyes","St Etienne",0,1,"A",0,0,"D",3.51,3.68,2.09,"0-0","0-1",20,4,11,5,1,1,0,0,11,4,9,6,1,15,15,"11-4","N","N","N",2,0,8
"1059","F2",2023-09-30,"Angers","Concarneau",2,0,"H",0,0,"D",1.74,3.62,5.41,"0-0","2-0",14,7,11,6,1,2,0,0,12,5,12,9,2,17,21,"12-5","Y","N","N",3,0,8
"1060","F2",2023-09-30,"Annecy","Paris FC",2,2,"D",1,0,"H",2.38,3.16,3.36,"1-0","2-2",9,5,11,2,4,2,0,0,7,6,15,7,4,13,22,"7-6","Y","Y","Y",6,0,9
"1061","F2",2023-09-30,"Auxerre","Rodez",3,1,"H",1,0,"H",1.57,4.36,5.76,"1-0","3-1",15,4,7,1,1,3,0,0,5,7,12,9,4,12,21,"5-7","Y","Y","Y",4,0,9
"1062","F2",2023-09-30,"Caen","Guingamp",0,1,"A",0,0,"D",2.03,3.4,4.04,"0-0","0-1",7,1,14,7,1,2,0,0,6,5,17,21,1,11,38,"6-5","N","N","N",3,0,9
"1063","F2",2023-09-30,"Dunkerque","Quevilly Rouen",0,1,"A",0,0,"D",2.48,3.23,3.12,"0-0","0-1",11,3,16,6,0,0,0,0,9,12,8,14,1,21,22,"9-12","N","N","N",0,0,9
"1064","F2",2023-09-30,"Grenoble","Bordeaux",2,0,"H",1,0,"H",2.73,3.17,2.84,"1-0","2-0",10,8,15,4,2,2,0,0,2,8,16,10,2,10,26,"2-8","Y","N","N",4,0,9
"1065","F2",2023-09-30,"Laval","Valenciennes",1,0,"H",0,0,"D",1.78,3.56,5.18,"0-0","1-0",17,8,7,2,1,1,0,0,4,4,19,14,1,8,33,"4-4","N","N","N",2,0,9
"1066","F2",2023-09-30,"Pau FC","Amiens",1,0,"H",1,0,"H",2.96,3.37,2.51,"1-0","1-0",15,6,14,7,2,0,0,0,4,3,14,15,1,7,29,"4-3","N","N","N",2,0,9
"1067","F2",2023-10-02,"Ajaccio","Bastia",2,0,"H",0,0,"D",2.33,3.08,3.44,"0-0","2-0",11,3,7,2,0,1,0,1,4,3,8,11,2,7,19,"4-3","Y","N","N",1,1,9
"1068","F2",2023-10-03,"Bordeaux","Caen",1,1,"D",1,1,"D",2.14,3.5,3.56,"1-1","1-1",19,8,7,2,3,1,0,0,4,4,17,16,2,8,33,"4-4","Y","N","N",4,0,9
"1069","F2",2023-10-04,"St Etienne","Dunkerque",2,0,"H",0,0,"D",1.68,4.12,5.02,"0-0","2-0",20,4,15,4,1,3,0,0,9,6,10,17,2,15,27,"9-6","Y","N","N",4,0,9
"1479","G1",2023-08-18,"Volos NFC","Lamia",2,2,"D",0,0,"D",2.5,3.01,3.2,"0-0","2-2",8,4,13,8,3,2,0,0,7,0,13,16,4,7,29,"7-0","Y","Y","Y",5,0,1
"1480","G1",2023-08-20,"Giannina","Kifisias",3,0,"H",1,0,"H",2.26,2.88,3.93,"1-0","3-0",10,7,4,0,3,4,1,0,7,2,16,19,3,9,35,"7-2","Y","Y","N",7,1,1
"1481","G1",2023-08-20,"OFI Crete","Aris",3,2,"H",2,1,"H",2.45,3.17,3.02,"2-1","3-2",13,4,16,7,5,3,0,0,3,4,25,13,5,7,38,"3-4","Y","Y","Y",8,0,1
"1482","G1",2023-08-20,"PAOK","Asteras Tripolis",3,0,"H",1,0,"H",1.27,5.32,11.14,"1-0","3-0",13,6,9,2,2,1,0,0,3,1,5,12,3,4,17,"3-1","Y","Y","N",3,0,1
"1483","G1",2023-08-20,"Olympiakos","Panserraikos",2,0,"H",0,0,"D",1.17,7.06,14.52,"0-0","2-0",29,3,5,2,3,0,0,1,8,3,19,7,2,11,26,"8-3","Y","N","N",3,1,1
"1484","G1",2023-08-25,"Panetolikos","Giannina",0,0,"D",0,0,"D",2.54,2.92,3.26,"0-0","0-0",17,7,8,2,1,4,0,0,2,3,16,19,0,5,35,"2-3","N","N","N",5,0,1
"1485","G1",2023-08-26,"Asteras Tripolis","OFI Crete",3,0,"H",2,0,"H",2.28,3.29,3.3,"2-0","3-0",12,4,16,6,1,3,0,0,3,4,16,16,3,7,32,"3-4","Y","Y","N",4,0,1
"1486","G1",2023-08-26,"Panathinaikos","Volos NFC",3,0,"H",2,0,"H",1.29,5.92,9.42,"2-0","3-0",14,8,5,3,1,3,0,0,6,1,16,19,3,7,35,"6-1","Y","Y","N",4,0,2
"1487","G1",2023-08-26,"AEK","Panserraikos",1,1,"D",0,1,"A",1.14,7.98,20.36,"0-1","1-1",29,10,7,4,1,6,0,0,12,1,6,20,2,13,26,"12-1","Y","N","N",7,0,2
"1488","G1",2023-08-27,"Lamia","Aris",1,0,"H",1,0,"H",3.4,3.3,2.18,"1-0","1-0",7,4,7,3,4,4,1,0,2,2,22,16,1,4,38,"2-2","N","N","N",8,1,2
"1489","G1",2023-08-27,"PAOK","Kifisias",2,1,"H",1,0,"H",1.17,6.66,16.16,"1-0","2-1",19,8,6,3,1,5,0,0,8,5,12,14,3,13,26,"8-5","Y","Y","N",6,0,2
"1490","G1",2023-08-27,"Olympiakos","Atromitos",4,0,"H",2,0,"H",1.28,5.51,10.05,"2-0","4-0",24,9,3,1,1,5,0,1,5,2,9,9,4,7,18,"5-2","Y","Y","Y",6,1,2
"1491","G1",2023-09-01,"Kifisias","Atromitos",2,1,"H",1,0,"H",2.64,3.18,2.86,"1-0","2-1",14,7,13,9,3,1,0,1,5,8,14,12,3,13,26,"5-8","Y","Y","N",4,1,2
"1492","G1",2023-09-02,"Panserraikos","Panetolikos",1,1,"D",1,0,"H",2.31,3.22,3.25,"1-0","1-1",14,3,8,4,3,1,0,0,4,6,14,15,2,10,29,"4-6","Y","N","N",4,0,2
"1493","G1",2023-09-03,"Aris","Asteras Tripolis",3,2,"H",1,1,"D",1.52,3.88,6.81,"1-1","3-2",10,6,4,4,1,3,0,0,3,5,14,13,5,8,27,"3-5","Y","Y","Y",4,0,3
"1494","G1",2023-09-03,"OFI Crete","PAOK",1,0,"H",0,0,"D",5.24,3.85,1.64,"0-0","1-0",7,2,12,4,4,5,0,0,1,5,20,17,1,6,37,"1-5","N","N","N",9,0,3
"1495","G1",2023-09-03,"Olympiakos","Lamia",4,0,"H",2,0,"H",1.25,5.66,11.44,"2-0","4-0",17,8,8,3,2,3,0,0,5,2,14,14,4,7,28,"5-2","Y","Y","Y",5,0,3
"1496","G1",2023-09-03,"Volos NFC","AEK",2,3,"A",1,2,"A",11.46,6.13,1.22,"1-2","2-3",7,5,11,7,4,1,0,1,3,8,18,17,5,11,35,"3-8","Y","Y","Y",5,1,3
"1497","G1",2023-09-03,"Giannina","Panathinaikos",0,1,"A",0,0,"D",6.17,3.66,1.6,"0-0","0-1",11,4,11,2,6,2,0,0,2,8,11,19,1,10,30,"2-8","N","N","N",8,0,3
"1498","G1",2023-09-16,"Lamia","OFI Crete",2,2,"D",0,1,"A",2.72,3.17,2.73,"0-1","2-2",7,2,12,4,1,3,0,0,6,7,7,16,4,13,23,"6-7","Y","Y","Y",4,0,3
"1499","G1",2023-09-16,"Panetolikos","Panathinaikos",0,5,"A",0,2,"A",7.6,4.07,1.49,"0-2","0-5",11,4,18,10,2,1,0,0,3,6,10,13,5,9,23,"3-6","Y","Y","Y",3,0,3
"1500","G1",2023-09-17,"Asteras Tripolis","Giannina",2,2,"D",2,2,"D",2.13,3.07,3.82,"2-2","2-2",10,4,7,6,2,3,0,0,8,1,15,9,4,9,24,"8-1","Y","Y","Y",5,0,4
"1501","G1",2023-09-17,"Kifisias","Panserraikos",4,4,"D",0,3,"A",2.04,3.41,3.66,"0-3","4-4",19,6,9,4,3,5,0,1,3,3,16,22,8,6,38,"3-3","Y","Y","Y",8,1,4
"1502","G1",2023-09-17,"PAOK","Aris",0,0,"D",0,0,"D",1.55,4.01,5.99,"0-0","0-0",10,3,8,4,4,3,0,0,7,1,17,13,0,8,30,"7-1","N","N","N",7,0,4
"1503","G1",2023-09-17,"AEK","Olympiakos",1,1,"D",1,1,"D",2.19,3.35,3.32,"1-1","1-1",9,4,7,3,2,4,0,0,5,5,15,21,2,10,36,"5-5","Y","N","N",6,0,4
"1504","G1",2023-09-18,"Atromitos","Volos NFC",1,1,"D",1,0,"H",1.79,3.83,4.16,"1-0","1-1",8,1,10,1,3,2,0,0,4,1,13,19,2,5,32,"4-1","Y","N","N",5,0,4
"1505","G1",2023-09-23,"OFI Crete","Atromitos",1,1,"D",1,0,"H",2.08,3.41,3.59,"1-0","1-1",16,5,9,4,3,4,0,0,8,4,13,18,2,12,31,"8-4","Y","N","N",7,0,4
"1506","G1",2023-09-23,"Panserraikos","Lamia",2,0,"H",0,0,"D",2.3,3.22,3.33,"0-0","2-0",14,7,4,1,1,2,0,0,3,1,14,19,2,4,33,"3-1","Y","N","N",3,0,4
"1507","G1",2023-09-24,"Olympiakos","Kifisias",4,0,"H",2,0,"H",1.15,7.58,16.14,"2-0","4-0",13,7,8,2,1,2,0,0,7,1,18,11,4,8,29,"7-1","Y","Y","Y",3,0,5
"1508","G1",2023-09-24,"Aris","Panetolikos",3,0,"H",1,0,"H",1.5,4.06,6.79,"1-0","3-0",14,6,5,3,0,2,0,0,6,5,10,8,3,11,18,"6-5","Y","Y","N",2,0,5
"1509","G1",2023-09-24,"Volos NFC","Asteras Tripolis",1,2,"A",0,2,"A",2.63,3.14,2.81,"0-2","1-2",13,7,16,6,4,3,0,0,1,5,18,18,3,6,36,"1-5","Y","Y","N",7,0,5
"1510","G1",2023-09-24,"Giannina","PAOK",1,3,"A",1,2,"A",5.4,3.87,1.62,"1-2","1-3",10,3,10,5,4,2,0,0,8,6,10,9,4,14,19,"8-6","Y","Y","Y",6,0,5
"1511","G1",2023-09-25,"Panathinaikos","AEK",1,2,"A",1,1,"D",2.37,3.09,3.23,"1-1","1-2",10,5,15,4,3,4,0,0,6,6,13,21,3,12,34,"6-6","Y","Y","N",7,0,5
"1512","G1",2023-09-27,"Panetolikos","OFI Crete",1,1,"D",1,1,"D",2.88,3.37,2.38,"1-1","1-1",18,6,21,10,2,2,0,0,3,7,7,13,2,10,20,"3-7","Y","N","N",4,0,5
"1513","G1",2023-09-27,"Kifisias","Lamia",1,1,"D",0,0,"D",2.3,3.33,3.24,"0-0","1-1",17,4,8,4,4,3,1,0,6,8,14,12,2,14,26,"6-8","Y","N","N",7,1,5
"1514","G1",2023-09-27,"Olympiakos","Aris",4,1,"H",1,0,"H",1.36,4.85,9.26,"1-0","4-1",20,5,7,1,2,0,0,0,8,1,17,7,5,9,24,"8-1","Y","Y","Y",2,0,6
"1515","G1",2023-09-27,"PAOK","Volos NFC",3,0,"H",2,0,"H",1.18,7.46,14.45,"2-0","3-0",17,10,5,2,0,1,0,0,5,3,14,13,3,8,27,"5-3","Y","Y","N",1,0,6
"1516","G1",2023-09-28,"Panserraikos","Giannina",3,2,"H",2,1,"H",2.28,3.07,3.45,"2-1","3-2",12,6,6,3,5,3,0,1,4,4,10,11,5,8,21,"4-4","Y","Y","Y",8,1,6
"1517","G1",2023-09-28,"Asteras Tripolis","Panathinaikos",1,4,"A",1,2,"A",5.4,3.6,1.67,"1-2","1-4",9,4,9,7,3,1,0,0,2,4,7,9,5,6,16,"2-4","Y","Y","Y",4,0,6
"1518","G1",2023-09-28,"AEK","Atromitos",2,1,"H",1,0,"H",1.17,7.15,14.76,"1-0","2-1",18,8,5,2,2,4,1,0,6,1,9,10,3,7,19,"6-1","Y","Y","N",6,1,6
"1519","G1",2023-10-01,"Lamia","Panetolikos",1,0,"H",1,0,"H",1.88,3.33,4.41,"1-0","1-0",7,3,13,1,2,4,0,0,2,5,16,18,1,7,34,"2-5","N","N","N",6,0,6
"1520","G1",2023-10-01,"Aris","Kifisias",1,1,"D",1,0,"H",1.41,4.43,7.69,"1-0","1-1",12,6,10,4,2,7,0,0,5,3,13,20,2,8,33,"5-3","Y","N","N",9,0,6
"1521","G1",2023-10-01,"Panathinaikos","PAOK",2,2,"D",1,1,"D",1.9,3.33,4.33,"1-1","2-2",22,13,5,2,2,4,0,0,7,2,10,13,4,9,23,"7-2","Y","Y","Y",6,0,7
"1522","G1",2023-10-01,"Giannina","Olympiakos",0,3,"A",0,2,"A",7.93,4.46,1.4,"0-2","0-3",5,0,25,9,3,2,0,0,2,6,10,14,3,8,24,"2-6","Y","Y","N",5,0,7
"1523","G1",2023-10-02,"Atromitos","Asteras Tripolis",0,0,"D",0,0,"D",2.16,3.17,3.69,"0-0","0-0",8,1,8,4,1,5,1,0,4,5,8,22,0,9,30,"4-5","N","N","N",6,1,7
"1524","G1",2023-10-02,"OFI Crete","AEK",2,0,"H",1,0,"H",6.48,4.38,1.47,"1-0","2-0",7,5,14,4,4,3,0,0,2,4,10,17,2,6,27,"2-4","Y","N","N",7,0,7
"1070","I1",2023-08-19,"Empoli","Verona",0,1,"A",0,0,"D",2.3,3.3,3.44,"0-0","0-1",10,4,10,4,2,2,0,0,2,4,17,18,1,6,35,"2-4","N","N","N",4,0,1
"1071","I1",2023-08-19,"Frosinone","Napoli",1,3,"A",1,2,"A",8.85,5.25,1.37,"1-2","1-3",4,1,19,8,3,3,0,0,4,6,14,17,4,10,31,"4-6","Y","Y","Y",6,0,1
"1072","I1",2023-08-19,"Genoa","Fiorentina",1,4,"A",0,3,"A",3.54,3.36,2.23,"0-3","1-4",4,2,9,5,2,3,0,0,3,4,14,13,5,7,27,"3-4","Y","Y","Y",5,0,1
"1073","I1",2023-08-19,"Inter","Monza",2,0,"H",1,0,"H",1.39,5.1,8.76,"1-0","2-0",22,3,12,2,1,1,0,0,8,3,8,13,2,11,21,"8-3","Y","N","N",2,0,1
"1074","I1",2023-08-20,"Roma","Salernitana",2,2,"D",1,1,"D",1.53,4.18,7.16,"1-1","2-2",13,3,3,2,0,4,0,0,9,1,12,9,4,10,21,"9-1","Y","Y","Y",4,0,1
"1075","I1",2023-08-20,"Sassuolo","Atalanta",0,2,"A",0,0,"D",3.39,3.63,2.18,"0-0","0-2",11,3,16,6,0,0,0,0,7,7,9,13,2,14,22,"7-7","Y","N","N",0,0,1
"1076","I1",2023-08-20,"Lecce","Lazio",2,1,"H",0,1,"A",3.87,3.31,2.14,"0-1","2-1",23,7,10,4,3,2,0,0,5,2,12,16,3,7,28,"5-2","Y","Y","N",5,0,1
"1077","I1",2023-08-20,"Udinese","Juventus",0,3,"A",0,3,"A",4.64,3.66,1.85,"0-3","0-3",18,5,9,4,1,3,0,0,7,3,12,10,3,10,22,"7-3","Y","Y","N",4,0,1
"1078","I1",2023-08-21,"Torino","Cagliari",0,0,"D",0,0,"D",1.67,3.86,5.78,"0-0","0-0",11,2,8,2,1,1,0,0,8,3,8,12,0,11,20,"8-3","N","N","N",2,0,1
"1079","I1",2023-08-21,"Bologna","Milan",0,2,"A",0,2,"A",4.02,3.52,2.01,"0-2","0-2",17,5,10,6,2,2,0,0,3,6,10,4,2,9,14,"3-6","Y","N","N",4,0,1
"1080","I1",2023-08-26,"Frosinone","Atalanta",2,1,"H",2,0,"H",5.04,4.16,1.69,"2-0","2-1",13,5,18,6,1,2,0,0,3,7,10,10,3,10,20,"3-7","Y","Y","N",3,0,2
"1081","I1",2023-08-26,"Monza","Empoli",2,0,"H",1,0,"H",1.95,3.59,4.18,"1-0","2-0",20,5,18,6,1,2,0,0,6,5,14,7,2,11,21,"6-5","Y","N","N",3,0,2
"1082","I1",2023-08-26,"Milan","Torino",4,1,"H",3,1,"H",1.69,3.8,5.71,"3-1","4-1",17,7,8,1,2,3,0,0,2,1,13,16,5,3,29,"2-1","Y","Y","Y",5,0,2
"1083","I1",2023-08-26,"Verona","Roma",2,1,"H",2,0,"H",4.83,3.49,1.87,"2-0","2-1",5,3,23,7,1,3,1,0,1,12,17,12,3,13,29,"1-12","Y","Y","N",4,1,2
"1084","I1",2023-08-27,"Fiorentina","Lecce",2,2,"D",2,0,"H",1.64,4,5.86,"2-0","2-2",9,4,6,2,1,3,0,0,3,3,13,12,4,6,25,"3-3","Y","Y","Y",4,0,2
"1085","I1",2023-08-27,"Juventus","Bologna",1,1,"D",0,1,"A",1.51,4.42,7.08,"0-1","1-1",14,3,9,4,2,1,0,0,5,1,14,13,2,6,27,"5-1","Y","N","N",3,0,2
"1086","I1",2023-08-27,"Lazio","Genoa",0,1,"A",0,1,"A",1.61,4.23,5.75,"0-1","0-1",16,2,5,3,4,2,0,0,15,1,9,16,1,16,25,"15-1","N","N","N",6,0,2
"1087","I1",2023-08-27,"Napoli","Sassuolo",2,0,"H",1,0,"H",1.34,5.87,8.45,"1-0","2-0",25,5,6,1,0,1,0,1,12,4,9,10,2,16,19,"12-4","Y","N","N",1,1,2
"1088","I1",2023-08-28,"Salernitana","Udinese",1,1,"D",0,0,"D",2.8,3.34,2.69,"0-0","1-1",9,4,14,6,4,4,0,0,7,5,12,19,2,12,31,"7-5","Y","N","N",8,0,2
"1089","I1",2023-08-28,"Cagliari","Inter",0,2,"A",0,2,"A",6.7,5.01,1.47,"0-2","0-2",12,2,17,3,1,1,0,0,4,7,9,10,2,11,19,"4-7","Y","N","N",2,0,2
"1090","I1",2023-09-01,"Sassuolo","Verona",3,1,"H",1,0,"H",2.04,3.66,3.84,"1-0","3-1",16,7,11,3,1,3,0,0,10,1,8,13,4,11,21,"10-1","Y","Y","Y",4,0,3
"1091","I1",2023-09-01,"Roma","Milan",1,2,"A",0,1,"A",2.88,3.2,2.76,"0-1","1-2",13,2,9,4,2,4,0,1,3,5,14,15,3,8,29,"3-5","Y","Y","N",6,1,3
"1092","I1",2023-09-02,"Bologna","Cagliari",2,1,"H",0,1,"A",1.75,3.63,5.47,"0-1","2-1",16,7,7,1,1,2,0,0,5,2,9,13,3,7,22,"5-2","Y","Y","N",3,0,3
"1093","I1",2023-09-02,"Udinese","Frosinone",0,0,"D",0,0,"D",1.82,3.72,4.74,"0-0","0-0",12,6,12,2,2,2,0,0,3,5,14,9,0,8,23,"3-5","N","N","N",4,0,3
"1094","I1",2023-09-02,"Atalanta","Monza",3,0,"H",2,0,"H",1.64,4.27,5.32,"2-0","3-0",18,8,8,2,0,3,0,0,7,3,11,9,3,10,20,"7-3","Y","Y","N",3,0,3
"1095","I1",2023-09-02,"Napoli","Lazio",1,2,"A",1,1,"D",1.62,4.19,5.73,"1-1","1-2",22,4,6,2,1,2,0,0,7,2,8,9,3,9,17,"7-2","Y","Y","N",3,0,3
"1096","I1",2023-09-03,"Inter","Fiorentina",4,0,"H",1,0,"H",1.66,4.16,5.29,"1-0","4-0",21,11,6,2,1,1,0,0,1,1,13,12,4,2,25,"1-1","Y","Y","Y",2,0,3
"1097","I1",2023-09-03,"Torino","Genoa",1,0,"H",0,0,"D",2.09,3.31,4.03,"0-0","1-0",10,3,7,2,2,5,0,0,4,0,13,7,1,4,20,"4-0","N","N","N",7,0,3
"1098","I1",2023-09-03,"Empoli","Juventus",0,2,"A",0,1,"A",5.43,3.98,1.68,"0-1","0-2",7,0,18,5,3,3,0,0,3,7,14,13,2,10,27,"3-7","Y","N","N",6,0,3
"1099","I1",2023-09-03,"Lecce","Salernitana",2,0,"H",1,0,"H",2.06,3.4,4,"1-0","2-0",20,6,11,4,3,3,0,0,6,5,17,15,2,11,32,"6-5","Y","N","N",6,0,3
"1100","I1",2023-09-16,"Juventus","Lazio",3,1,"H",2,0,"H",1.94,3.47,4.41,"2-0","3-1",17,7,16,5,5,1,0,0,7,9,13,13,4,16,26,"7-9","Y","Y","Y",6,0,4
"1101","I1",2023-09-16,"Inter","Milan",5,1,"H",2,0,"H",2.15,3.57,3.53,"2-0","5-1",14,7,9,2,2,2,0,0,5,0,16,13,6,5,29,"5-0","Y","Y","Y",4,0,4
"1102","I1",2023-09-16,"Genoa","Napoli",2,2,"D",1,0,"H",5.41,4.1,1.66,"1-0","2-2",8,3,12,4,3,2,0,0,3,1,14,8,4,4,22,"3-1","Y","Y","Y",5,0,4
"1103","I1",2023-09-17,"Cagliari","Udinese",0,0,"D",0,0,"D",2.9,3.27,2.65,"0-0","0-0",10,1,11,1,2,1,1,0,4,6,12,11,0,10,23,"4-6","N","N","N",3,1,4
"1104","I1",2023-09-17,"Frosinone","Sassuolo",4,2,"H",1,2,"A",2.83,3.52,2.57,"1-2","4-2",16,6,18,7,4,2,0,0,5,6,10,9,6,11,19,"5-6","Y","Y","Y",6,0,4
"1105","I1",2023-09-17,"Monza","Lecce",1,1,"D",1,1,"D",2.13,3.5,3.66,"1-1","1-1",25,6,4,3,6,1,1,1,10,1,17,11,2,11,28,"10-1","Y","N","N",7,2,4
"1106","I1",2023-09-17,"Fiorentina","Atalanta",3,2,"H",2,1,"H",2.54,3.55,2.84,"2-1","3-2",15,8,11,4,1,2,0,0,3,4,8,14,5,7,22,"3-4","Y","Y","Y",3,0,4
"1107","I1",2023-09-17,"Roma","Empoli",7,0,"H",3,0,"H",1.43,4.66,8.61,"3-0","7-0",14,9,8,2,2,2,0,0,2,6,15,5,7,8,20,"2-6","Y","Y","Y",4,0,4
"1108","I1",2023-09-18,"Salernitana","Torino",0,3,"A",0,2,"A",3.73,3.27,2.2,"0-2","0-3",14,4,11,3,2,2,0,0,1,2,12,16,3,3,28,"1-2","Y","Y","N",4,0,4
"1109","I1",2023-09-18,"Verona","Bologna",0,0,"D",0,0,"D",3.15,3.39,2.41,"0-0","0-0",9,1,11,4,4,2,0,0,3,4,18,10,0,7,28,"3-4","N","N","N",6,0,4
"1110","I1",2023-09-22,"Salernitana","Frosinone",1,1,"D",0,1,"A",2.59,3.3,3.01,"0-1","1-1",19,6,9,3,2,2,0,0,8,6,12,12,2,14,24,"8-6","Y","N","N",4,0,5
"1111","I1",2023-09-22,"Lecce","Genoa",1,0,"H",0,0,"D",2.49,3.22,3.23,"0-0","1-0",18,3,8,1,1,3,0,1,4,3,12,10,1,7,22,"4-3","N","N","N",4,1,5
"1112","I1",2023-09-23,"Milan","Verona",1,0,"H",1,0,"H",1.39,4.95,9.16,"1-0","1-0",9,4,10,2,4,2,0,0,2,3,13,9,1,5,22,"2-3","N","N","N",6,0,5
"1113","I1",2023-09-23,"Sassuolo","Juventus",4,2,"H",2,1,"H",4.35,4.03,1.81,"2-1","4-2",18,7,15,2,4,2,0,0,6,3,13,8,6,9,21,"6-3","Y","Y","Y",6,0,5
"1114","I1",2023-09-23,"Lazio","Monza",1,1,"D",1,1,"D",1.8,3.94,4.52,"1-1","1-1",8,1,16,4,2,2,0,0,1,3,13,7,2,4,20,"1-3","Y","N","N",4,0,5
"1115","I1",2023-09-24,"Empoli","Inter",0,1,"A",0,0,"D",9.73,5.6,1.33,"0-0","0-1",7,1,23,6,2,2,0,0,3,6,15,11,1,9,26,"3-6","N","N","N",4,0,5
"1116","I1",2023-09-24,"Atalanta","Cagliari",2,0,"H",1,0,"H",1.41,5.11,7.79,"1-0","2-0",10,6,11,1,1,2,0,0,7,7,6,11,2,14,17,"7-7","Y","N","N",3,0,5
"1117","I1",2023-09-24,"Udinese","Fiorentina",0,2,"A",0,1,"A",3.17,3.45,2.37,"0-1","0-2",20,8,6,2,0,1,0,0,10,3,13,11,2,13,24,"10-3","Y","N","N",1,0,5
"1118","I1",2023-09-24,"Bologna","Napoli",0,0,"D",0,0,"D",3.72,3.66,2.06,"0-0","0-0",5,2,12,4,4,5,0,0,5,5,16,12,0,10,28,"5-5","N","N","N",9,0,5
"1119","I1",2023-09-24,"Torino","Roma",1,1,"D",0,0,"D",3.09,3.1,2.62,"0-0","1-1",13,4,11,3,0,2,0,0,7,1,4,5,2,8,9,"7-1","Y","N","N",2,0,5
"1120","I1",2023-09-26,"Juventus","Lecce",1,0,"H",0,0,"D",1.52,4.31,7.27,"0-0","1-0",14,5,2,0,2,5,0,1,5,1,14,15,1,6,29,"5-1","N","N","N",7,1,6
"1121","I1",2023-09-27,"Cagliari","Milan",1,3,"A",1,2,"A",5.46,3.96,1.68,"1-2","1-3",16,6,17,6,3,1,0,0,3,5,13,6,4,8,19,"3-5","Y","Y","Y",4,0,6
"1122","I1",2023-09-27,"Empoli","Salernitana",1,0,"H",1,0,"H",2.41,3.22,3.31,"1-0","1-0",13,6,14,2,2,1,0,0,10,2,18,13,1,12,31,"10-2","N","N","N",3,0,6
"1123","I1",2023-09-27,"Verona","Atalanta",0,1,"A",0,1,"A",4.63,3.78,1.82,"0-1","0-1",11,2,8,2,2,3,0,0,4,1,10,25,1,5,35,"4-1","N","N","N",5,0,6
"1124","I1",2023-09-27,"Inter","Sassuolo",1,2,"A",1,0,"H",1.32,5.99,9.3,"1-0","1-2",13,3,13,6,0,1,0,0,8,6,10,8,3,14,18,"8-6","Y","Y","N",1,0,6
"1125","I1",2023-09-27,"Lazio","Torino",2,0,"H",0,0,"D",2.17,3.37,3.7,"0-0","2-0",6,3,7,2,1,4,0,0,4,2,12,13,2,6,25,"4-2","Y","N","N",5,0,6
"1126","I1",2023-09-27,"Napoli","Udinese",4,1,"H",2,0,"H",1.39,5.16,8.46,"2-0","4-1",23,10,13,3,1,1,0,0,8,4,11,10,5,12,21,"8-4","Y","Y","Y",2,0,6
"1127","I1",2023-09-28,"Frosinone","Fiorentina",1,1,"D",0,1,"A",3.78,3.67,2.03,"0-1","1-1",11,3,19,6,3,3,0,0,8,10,6,11,2,18,17,"8-10","Y","N","N",6,0,6
"1128","I1",2023-09-28,"Monza","Bologna",0,0,"D",0,0,"D",2.49,3.35,3.06,"0-0","0-0",12,3,7,5,5,3,0,1,7,5,9,13,0,12,22,"7-5","N","N","N",8,1,6
"1129","I1",2023-09-28,"Genoa","Roma",4,1,"H",2,1,"H",3.85,3.31,2.14,"2-1","4-1",8,4,13,3,4,3,0,0,1,7,7,12,5,8,19,"1-7","Y","Y","Y",7,0,6
"1130","I1",2023-09-30,"Lecce","Napoli",0,4,"A",0,1,"A",4.84,3.9,1.76,"0-1","0-4",9,4,15,6,3,2,0,0,3,7,11,11,4,10,22,"3-7","Y","Y","Y",5,0,7
"1131","I1",2023-09-30,"Milan","Lazio",2,0,"H",0,0,"D",1.78,3.72,5.04,"0-0","2-0",14,7,13,4,3,2,0,0,7,1,15,5,2,8,20,"7-1","Y","N","N",5,0,7
"1132","I1",2023-09-30,"Salernitana","Inter",0,4,"A",0,0,"D",8.16,4.81,1.43,"0-0","0-4",12,3,16,6,2,1,0,0,3,3,12,10,4,6,22,"3-3","Y","Y","Y",3,0,7
"1133","I1",2023-10-01,"Bologna","Empoli",3,0,"H",1,0,"H",1.66,3.97,5.17,"1-0","3-0",21,9,12,4,2,4,0,0,2,6,11,16,3,8,27,"2-6","Y","Y","N",6,0,7
"1134","I1",2023-10-01,"Udinese","Genoa",2,2,"D",1,2,"A",2.38,3.07,3.35,"1-2","2-2",11,2,8,4,2,2,1,0,5,0,12,12,4,5,24,"5-0","Y","Y","Y",4,1,7
"1135","I1",2023-10-01,"Atalanta","Juventus",0,0,"D",0,0,"D",2.53,3.48,2.77,"0-0","0-0",15,2,5,3,1,2,0,0,5,2,13,7,0,7,20,"5-2","N","N","N",3,0,7
"1136","I1",2023-10-01,"Roma","Frosinone",2,0,"H",1,0,"H",1.45,4.36,7.55,"1-0","2-0",11,5,8,0,1,2,0,0,7,3,12,11,2,10,23,"7-3","Y","N","N",3,0,7
"1137","I1",2023-10-02,"Sassuolo","Monza",0,1,"A",0,0,"D",2.16,3.87,3.04,"0-0","0-1",19,7,13,4,0,0,0,0,7,4,8,10,1,11,18,"7-4","N","N","N",0,0,7
"1138","I1",2023-10-02,"Torino","Verona",0,0,"D",0,0,"D",1.83,3.37,4.73,"0-0","0-0",8,2,5,2,1,1,0,0,10,1,6,11,0,11,17,"10-1","N","N","N",2,0,7
"1139","I1",2023-10-02,"Fiorentina","Cagliari",3,0,"H",2,0,"H",1.48,4.17,6.98,"2-0","3-0",14,2,6,4,1,1,0,0,4,2,10,10,3,6,20,"4-2","Y","Y","N",2,0,7
"1140","I2",2023-08-18,"Bari","Palermo",0,0,"D",0,0,"D",2.83,3.12,2.83,"0-0","0-0",11,3,16,2,7,4,2,0,3,5,13,15,0,8,28,"3-5","N","N","N",11,2,1
"1141","I2",2023-08-19,"Cosenza","Ascoli",3,0,"H",1,0,"H",2.84,2.96,2.97,"1-0","3-0",22,6,4,0,1,4,0,3,7,0,11,12,3,7,23,"7-0","Y","Y","N",5,3,1
"1142","I2",2023-08-19,"Cremonese","Catanzaro",0,0,"D",0,0,"D",1.98,3.37,4.41,"0-0","0-0",17,3,6,2,3,1,0,0,6,2,7,18,0,8,25,"6-2","N","N","N",4,0,1
"1143","I2",2023-08-19,"Ternana","Sampdoria",1,2,"A",0,1,"A",3.3,3.55,2.26,"0-1","1-2",14,3,13,6,4,1,0,0,5,4,11,10,3,9,21,"5-4","Y","Y","N",5,0,1
"1144","I2",2023-08-20,"Sudtirol","Spezia",3,3,"D",1,2,"A",3.75,3.07,2.3,"1-2","3-3",10,4,17,5,3,3,0,0,2,1,17,20,6,3,37,"2-1","Y","Y","Y",6,0,1
"1145","I2",2023-08-20,"Cittadella","Reggiana",1,0,"H",1,0,"H",2.15,3.28,3.87,"1-0","1-0",13,3,8,1,3,3,0,0,6,2,20,17,1,8,37,"6-2","N","N","N",6,0,1
"1146","I2",2023-08-20,"Parma","FeralpiSalo",2,0,"H",1,0,"H",1.54,4.06,7.38,"1-0","2-0",15,4,13,2,1,4,0,0,7,7,11,11,2,14,22,"7-7","Y","N","N",5,0,1
"1147","I2",2023-08-20,"Venezia","Como",3,0,"H",2,0,"H",2.1,3.41,3.87,"2-0","3-0",18,6,12,3,0,0,0,0,9,3,17,9,3,12,26,"9-3","Y","Y","N",0,0,1
"1148","I2",2023-08-25,"Sampdoria","Pisa",0,2,"A",0,1,"A",1.97,3.35,4.47,"0-1","0-2",12,2,8,3,1,4,0,0,5,3,16,16,2,8,32,"5-3","Y","N","N",5,0,1
"1149","I2",2023-08-26,"Venezia","Cosenza",1,1,"D",0,1,"A",1.78,3.64,5.16,"0-1","1-1",20,4,4,1,1,1,0,0,8,2,6,9,2,10,15,"8-2","Y","N","N",2,0,1
"1150","I2",2023-08-26,"Como","Reggiana",2,2,"D",1,0,"H",2.09,3.46,3.82,"1-0","2-2",10,4,12,5,3,2,0,0,3,4,18,14,4,7,32,"3-4","Y","Y","Y",5,0,2
"1151","I2",2023-08-26,"Cremonese","Bari",0,1,"A",0,1,"A",2.04,3.41,4.08,"0-1","0-1",25,5,7,1,1,3,0,0,5,4,9,10,1,9,19,"5-4","N","N","N",4,0,2
"1152","I2",2023-08-26,"FeralpiSalo","Sudtirol",0,2,"A",0,1,"A",2.71,3.07,3,"0-1","0-2",7,1,9,4,2,3,0,0,6,1,16,12,2,7,28,"6-1","Y","N","N",5,0,2
"1153","I2",2023-08-26,"Modena","Ascoli",1,0,"H",0,0,"D",1.95,3.25,4.78,"0-0","1-0",13,3,8,5,1,1,0,1,9,1,12,17,1,10,29,"9-1","N","N","N",2,1,2
"1154","I2",2023-08-26,"Parma","Cittadella",2,0,"H",1,0,"H",1.89,3.42,4.77,"1-0","2-0",10,3,19,0,1,2,0,0,2,11,16,14,2,13,30,"2-11","Y","N","N",3,0,2
"1155","I2",2023-08-27,"Catanzaro","Ternana",2,1,"H",1,1,"D",2.31,3.34,3.38,"1-1","2-1",15,5,25,7,1,2,0,0,4,7,16,9,3,11,25,"4-7","Y","Y","N",3,0,2
"1156","I2",2023-08-29,"Ascoli","FeralpiSalo",3,0,"H",2,0,"H",1.95,3.53,4.28,"2-0","3-0",19,5,5,4,0,3,0,0,7,3,12,14,3,10,26,"7-3","Y","Y","N",3,0,2
"1157","I2",2023-08-29,"Cosenza","Modena",1,2,"A",1,1,"D",2.55,3.24,3.06,"1-1","1-2",12,2,10,5,4,2,0,0,6,4,12,10,3,10,22,"6-4","Y","Y","N",6,0,2
"1158","I2",2023-08-29,"Pisa","Parma",1,2,"A",0,1,"A",2.6,2.98,3.25,"0-1","1-2",16,2,9,2,1,3,1,1,7,4,11,15,3,11,26,"7-4","Y","Y","N",4,2,2
"1159","I2",2023-08-29,"Reggiana","Palermo",1,3,"A",0,1,"A",3.22,3.29,2.42,"0-1","1-3",15,2,18,9,3,0,1,0,7,3,18,9,4,10,27,"7-3","Y","Y","Y",3,1,2
"1160","I2",2023-08-30,"Bari","Cittadella",1,1,"D",1,0,"H",2.37,3.13,3.51,"1-0","1-1",14,4,17,5,1,1,0,0,1,8,12,12,2,9,24,"1-8","Y","N","N",2,0,3
"1161","I2",2023-08-30,"Catanzaro","Spezia",3,0,"H",0,0,"D",3.09,3.4,2.44,"0-0","3-0",10,5,8,2,2,3,1,0,6,5,21,14,3,11,35,"6-5","Y","Y","N",5,1,3
"1162","I2",2023-08-30,"Sampdoria","Venezia",1,2,"A",0,0,"D",2.21,3.55,3.39,"0-0","1-2",17,5,13,5,5,0,0,0,7,4,7,10,3,11,17,"7-4","Y","Y","N",5,0,3
"1163","I2",2023-08-30,"Ternana","Cremonese",0,1,"A",0,0,"D",3.36,3.28,2.35,"0-0","0-1",10,4,17,4,2,3,0,1,8,5,10,8,1,13,18,"8-5","N","N","N",5,1,3
"1164","I2",2023-09-02,"Modena","Pisa",2,0,"H",1,0,"H",2.53,2.95,3.41,"1-0","2-0",14,4,6,2,2,2,0,1,7,7,10,13,2,14,23,"7-7","Y","N","N",4,1,3
"1165","I2",2023-09-02,"Palermo","FeralpiSalo",3,0,"H",1,0,"H",1.67,3.91,5.68,"1-0","3-0",16,6,8,0,1,1,0,0,5,6,8,14,3,11,22,"5-6","Y","Y","N",2,0,3
"1166","I2",2023-09-02,"Parma","Reggiana",0,0,"D",0,0,"D",1.7,3.77,5.59,"0-0","0-0",18,4,8,1,2,2,0,0,6,2,7,15,0,8,22,"6-2","N","N","N",4,0,3
"1167","I2",2023-09-02,"Sudtirol","Ascoli",3,1,"H",0,1,"A",2.33,2.9,3.95,"0-1","3-1",7,4,14,4,2,4,0,0,0,8,11,16,4,8,27,"0-8","Y","Y","Y",6,0,3
"1168","I2",2023-09-03,"Brescia","Cosenza",1,0,"H",0,0,"D",2.17,3.28,3.8,"0-0","1-0",7,1,13,1,4,2,0,1,5,7,18,18,1,12,36,"5-7","N","N","N",6,1,3
"1169","I2",2023-09-03,"Cremonese","Sampdoria",1,1,"D",1,0,"H",2.07,3.43,3.88,"1-0","1-1",19,11,8,4,2,4,0,0,3,2,12,14,2,5,26,"3-2","Y","N","N",6,0,3
"1170","I2",2023-09-03,"Lecco","Catanzaro",3,4,"A",0,1,"A",NA,NA,NA,"0-1","3-4",17,7,20,8,2,1,0,0,3,6,10,7,7,9,17,"3-6","Y","Y","Y",3,0,4
"1171","I2",2023-09-03,"Spezia","Como",0,1,"A",0,1,"A",1.81,3.42,5.44,"0-1","0-1",9,1,12,5,5,4,0,0,6,6,19,14,1,12,33,"6-6","N","N","N",9,0,4
"1172","I2",2023-09-03,"Ternana","Bari",0,0,"D",0,0,"D",2.76,3.1,2.92,"0-0","0-0",13,2,10,1,3,2,0,0,3,3,14,16,0,6,30,"3-3","N","N","N",5,0,4
"1173","I2",2023-09-03,"Cittadella","Venezia",0,0,"D",0,0,"D",2.57,3.15,3.12,"0-0","0-0",8,4,10,3,3,2,0,0,5,5,13,12,0,10,25,"5-5","N","N","N",5,0,4
"1174","I2",2023-09-15,"Venezia","Spezia",1,0,"H",0,0,"D",2.2,3.51,3.48,"0-0","1-0",9,3,23,7,2,3,0,0,3,5,17,15,1,8,32,"3-5","N","N","N",5,0,4
"1175","I2",2023-09-16,"Ascoli","Palermo",0,1,"A",0,0,"D",3.56,3.3,2.25,"0-0","0-1",16,1,11,4,0,2,0,0,8,10,21,7,1,18,28,"8-10","N","N","N",2,0,4
"1176","I2",2023-09-16,"Cosenza","Sudtirol",2,2,"D",1,0,"H",2.33,3.08,3.66,"1-0","2-2",12,5,6,2,4,1,0,0,5,2,10,13,4,7,23,"5-2","Y","Y","Y",5,0,4
"1177","I2",2023-09-16,"FeralpiSalo","Modena",1,1,"D",1,1,"D",3.59,3.28,2.25,"1-1","1-1",10,1,17,6,4,4,1,0,4,7,15,7,2,11,22,"4-7","Y","N","N",8,1,4
"1178","I2",2023-09-16,"Lecco","Brescia",0,2,"A",0,1,"A",2.91,3.23,2.67,"0-1","0-2",24,7,11,5,3,2,0,0,7,5,16,19,2,12,35,"7-5","Y","N","N",5,0,4
"1179","I2",2023-09-16,"Pisa","Bari",1,1,"D",1,0,"H",2.17,3.23,3.87,"1-0","1-1",7,1,10,3,4,2,1,0,3,5,10,17,2,8,27,"3-5","Y","N","N",6,1,4
"1180","I2",2023-09-16,"Reggiana","Cremonese",2,2,"D",2,0,"H",3.35,3.22,2.39,"2-0","2-2",7,5,37,8,0,1,0,0,0,14,10,5,4,14,15,"0-14","Y","Y","Y",1,0,5
"1181","I2",2023-09-17,"Catanzaro","Parma",0,5,"A",0,3,"A",2.25,3.39,3.47,"0-3","0-5",12,2,10,7,1,4,0,0,8,3,13,5,5,11,18,"8-3","Y","Y","Y",5,0,5
"1182","I2",2023-09-17,"Como","Ternana",2,1,"H",0,0,"D",2.1,3.45,3.76,"0-0","2-1",19,5,10,4,2,2,0,0,1,3,13,16,3,4,29,"1-3","Y","Y","N",4,0,5
"1183","I2",2023-09-18,"Sampdoria","Cittadella",1,2,"A",1,0,"H",2.33,3.33,3.29,"1-0","1-2",12,5,11,6,3,3,0,0,2,4,22,13,3,6,35,"2-4","Y","Y","N",6,0,5
"1184","I2",2023-09-22,"Palermo","Cosenza",0,1,"A",0,0,"D",1.77,3.6,5.36,"0-0","0-1",19,6,14,4,1,3,0,0,4,2,11,11,1,6,22,"4-2","N","N","N",4,0,5
"1185","I2",2023-09-23,"Brescia","Venezia",0,0,"D",0,0,"D",3.31,3.1,2.48,"0-0","0-0",11,3,15,0,3,2,0,0,3,8,12,7,0,11,19,"3-8","N","N","N",5,0,5
"1186","I2",2023-09-23,"Cremonese","Ascoli",2,2,"D",1,1,"D",1.7,3.82,5.54,"1-1","2-2",13,4,17,8,3,4,1,1,6,5,16,11,4,11,27,"6-5","Y","Y","Y",7,2,5
"1187","I2",2023-09-23,"FeralpiSalo","Pisa",0,1,"A",0,0,"D",3.29,3.16,2.46,"0-0","0-1",12,3,16,4,3,4,0,0,4,4,19,11,1,8,30,"4-4","N","N","N",7,0,5
"1188","I2",2023-09-23,"Modena","Lecco",0,0,"D",0,0,"D",1.6,3.86,6.89,"0-0","0-0",17,5,14,4,3,1,0,0,8,8,15,7,0,16,22,"8-8","N","N","N",4,0,5
"1189","I2",2023-09-23,"Ternana","Sudtirol",1,1,"D",1,0,"H",2.19,3.22,3.83,"1-0","1-1",10,3,10,3,3,1,0,0,5,7,10,17,2,12,27,"5-7","Y","N","N",4,0,5
"1190","I2",2023-09-23,"Spezia","Reggiana",1,2,"A",0,0,"D",1.93,3.56,4.38,"0-0","1-2",15,3,11,4,3,5,0,0,7,5,13,16,3,12,29,"7-5","Y","Y","N",8,0,6
"1191","I2",2023-09-24,"Bari","Catanzaro",2,2,"D",1,2,"A",2.45,3.14,3.32,"1-2","2-2",12,4,11,5,1,4,0,1,2,4,13,17,4,6,30,"2-4","Y","Y","Y",5,1,6
"1192","I2",2023-09-24,"Cittadella","Como",0,3,"A",0,2,"A",2.12,3.31,3.95,"0-2","0-3",12,3,9,4,1,2,0,0,5,2,21,13,3,7,34,"5-2","Y","Y","N",3,0,6
"1193","I2",2023-09-24,"Parma","Sampdoria",1,1,"D",0,1,"A",2.15,3.45,3.66,"0-1","1-1",12,7,8,3,3,5,0,0,9,1,11,15,2,10,26,"9-1","Y","N","N",8,0,6
"1194","I2",2023-09-26,"Cosenza","Cremonese",1,2,"A",0,0,"D",3.31,3.24,2.4,"0-0","1-2",9,4,20,4,2,1,0,0,4,7,9,15,3,11,24,"4-7","Y","Y","N",3,0,6
"1195","I2",2023-09-26,"Lecco","FeralpiSalo",1,2,"A",0,0,"D",2.56,3.12,3.17,"0-0","1-2",13,3,12,4,2,3,0,0,4,1,10,13,3,5,23,"4-1","Y","Y","N",5,0,6
"1196","I2",2023-09-26,"Ascoli","Ternana",2,0,"H",1,0,"H",2.4,3.22,3.34,"1-0","2-0",13,5,17,3,2,3,0,0,2,8,20,13,2,10,33,"2-8","Y","N","N",5,0,6
"1197","I2",2023-09-26,"Reggiana","Pisa",0,0,"D",0,0,"D",2.61,3.13,3.08,"0-0","0-0",13,2,12,5,4,4,0,0,3,2,16,12,0,5,28,"3-2","N","N","N",8,0,6
"1198","I2",2023-09-26,"Spezia","Brescia",0,0,"D",0,0,"D",1.84,3.68,4.65,"0-0","0-0",12,5,11,3,1,2,0,0,7,5,8,16,0,12,24,"7-5","N","N","N",3,0,6
"1199","I2",2023-09-26,"Sudtirol","Modena",0,0,"D",0,0,"D",3.11,2.83,2.83,"0-0","0-0",7,1,25,2,1,2,0,0,5,3,13,6,0,8,19,"5-3","N","N","N",3,0,6
"1200","I2",2023-09-26,"Venezia","Palermo",1,3,"A",1,1,"D",2.49,3.27,3.13,"1-1","1-3",17,1,7,4,1,2,0,0,8,1,10,10,4,9,20,"8-1","Y","Y","Y",3,0,7
"1201","I2",2023-09-27,"Catanzaro","Cittadella",1,1,"D",1,1,"D",2.34,3.13,3.54,"1-1","1-1",14,8,10,3,0,3,0,0,5,2,12,14,2,7,26,"5-2","Y","N","N",3,0,7
"1202","I2",2023-09-27,"Como","Sampdoria",1,0,"H",0,0,"D",2.43,3.4,3.1,"0-0","1-0",8,4,13,5,2,5,0,0,2,5,17,15,1,7,32,"2-5","N","N","N",7,0,7
"1203","I2",2023-09-27,"Parma","Bari",2,1,"H",1,0,"H",1.94,3.45,4.44,"1-0","2-1",12,5,14,4,1,3,0,0,5,3,16,12,3,8,28,"5-3","Y","Y","N",4,0,7
"1204","I2",2023-09-30,"Brescia","Ascoli",1,1,"D",0,1,"A",2.23,3.28,3.63,"0-1","1-1",21,3,9,3,2,3,0,0,7,2,13,11,2,9,24,"7-2","Y","N","N",5,0,7
"1205","I2",2023-09-30,"FeralpiSalo","Spezia",1,2,"A",0,2,"A",3.53,3.27,2.28,"0-2","1-2",9,3,13,5,1,6,0,0,2,5,16,17,3,7,33,"2-5","Y","Y","N",7,0,7
"1206","I2",2023-09-30,"Modena","Venezia",1,3,"A",0,0,"D",2.53,3.32,3.02,"0-0","1-3",14,4,9,4,2,2,0,0,7,3,9,5,4,10,14,"7-3","Y","Y","Y",4,0,7
"1207","I2",2023-09-30,"Pisa","Cosenza",1,2,"A",0,1,"A",1.88,3.63,4.45,"0-1","1-2",8,6,15,5,3,6,1,0,2,3,13,13,3,5,26,"2-3","Y","Y","N",9,1,7
"1208","I2",2023-09-30,"Ternana","Reggiana",3,0,"H",2,0,"H",2.17,3.37,3.7,"2-0","3-0",13,7,10,3,6,3,0,0,3,2,13,9,3,5,22,"3-2","Y","Y","N",9,0,7
"1209","I2",2023-10-01,"Bari","Como",1,1,"D",0,0,"D",2.44,3.2,3.28,"0-0","1-1",18,5,9,6,3,4,0,1,6,4,18,16,2,10,34,"6-4","Y","N","N",7,1,7
"1210","I2",2023-10-01,"Cittadella","Lecco",2,1,"H",0,1,"A",1.66,4.02,5.52,"0-1","2-1",15,5,16,6,4,4,0,0,4,5,26,10,3,9,36,"4-5","Y","Y","N",8,0,8
"1211","I2",2023-10-01,"Palermo","Sudtirol",2,1,"H",0,1,"A",1.64,3.91,5.96,"0-1","2-1",24,6,8,2,5,3,0,0,13,1,15,17,3,14,32,"13-1","Y","Y","N",8,0,8
"1212","I2",2023-10-01,"Sampdoria","Catanzaro",1,2,"A",1,2,"A",2.19,3.55,3.46,"1-2","1-2",17,6,4,3,1,4,0,0,11,2,12,23,3,13,35,"11-2","Y","Y","N",5,0,8
"1213","I2",2023-10-01,"Cremonese","Parma",1,2,"A",0,0,"D",2.19,3.4,3.61,"0-0","1-2",15,3,9,3,1,1,0,0,2,4,12,13,3,6,25,"2-4","Y","Y","N",2,0,8
"1277","N1",2023-08-11,"Volendam","Vitesse",1,2,"A",1,0,"H",3.47,3.88,2.07,"1-0","1-2",4,4,13,9,3,1,1,0,3,7,12,10,3,10,22,"3-7","Y","Y","N",4,1,1
"1278","N1",2023-08-12,"PSV Eindhoven","Utrecht",2,0,"H",1,0,"H",1.37,5.75,7.93,"1-0","2-0",23,8,7,1,2,1,0,0,4,2,15,14,2,6,29,"4-2","Y","N","N",3,0,1
"1279","N1",2023-08-12,"Heerenveen","Waalwijk",3,1,"H",3,0,"H",1.78,4.1,4.46,"3-0","3-1",19,9,13,5,0,1,0,0,7,2,9,8,4,9,17,"7-2","Y","Y","Y",1,0,1
"1280","N1",2023-08-12,"Ajax","Heracles",4,1,"H",1,1,"D",1.19,8.58,12.96,"1-1","4-1",31,13,7,2,2,5,0,0,13,4,11,14,5,17,25,"13-4","Y","Y","Y",7,0,1
"1281","N1",2023-08-12,"Zwolle","Sparta Rotterdam",1,2,"A",0,1,"A",2.51,3.51,2.91,"0-1","1-2",20,7,9,4,2,4,0,0,7,1,8,15,3,8,23,"7-1","Y","Y","N",6,0,1
"1282","N1",2023-08-13,"Nijmegen","Excelsior",3,4,"A",2,1,"H",1.53,4.76,6,"2-1","3-4",8,6,6,6,1,2,0,0,2,7,4,10,7,9,14,"2-7","Y","Y","Y",3,0,1
"1283","N1",2023-08-13,"AZ Alkmaar","Go Ahead Eagles",5,1,"H",2,0,"H",1.35,5.34,9.01,"2-0","5-1",13,8,9,4,2,3,0,0,5,4,8,13,6,9,21,"5-4","Y","Y","Y",5,0,1
"1284","N1",2023-08-13,"Feyenoord","For Sittard",0,0,"D",0,0,"D",1.17,8.25,16.82,"0-0","0-0",22,6,14,5,0,6,1,0,8,3,4,21,0,11,25,"8-3","N","N","N",6,1,1
"1285","N1",2023-08-13,"Almere City","Twente",1,4,"A",0,0,"D",5.67,4.35,1.6,"0-0","1-4",12,4,20,8,4,0,1,0,2,11,15,10,5,13,25,"2-11","Y","Y","Y",4,1,1
"1286","N1",2023-08-18,"Heracles","Nijmegen",2,1,"H",0,1,"A",2.5,3.68,2.81,"0-1","2-1",16,7,17,4,2,2,0,0,5,9,10,10,3,14,20,"5-9","Y","Y","N",4,0,2
"1287","N1",2023-08-19,"Excelsior","Ajax",2,2,"D",1,1,"D",10.04,6.56,1.27,"1-1","2-2",13,2,15,8,0,0,0,0,4,10,7,7,4,14,14,"4-10","Y","Y","Y",0,0,2
"1288","N1",2023-08-19,"Vitesse","PSV Eindhoven",1,3,"A",1,0,"H",5.98,4.62,1.54,"1-0","1-3",12,2,19,7,0,1,0,0,4,7,7,2,4,11,9,"4-7","Y","Y","Y",1,0,2
"1289","N1",2023-08-19,"For Sittard","Almere City",2,1,"H",2,1,"H",1.97,3.97,3.72,"2-1","2-1",21,7,8,5,3,2,0,0,5,6,8,13,3,11,21,"5-6","Y","Y","N",5,0,2
"1290","N1",2023-08-19,"Go Ahead Eagles","Volendam",4,1,"H",3,0,"H",1.65,4.48,4.94,"3-0","4-1",8,6,19,5,1,3,1,0,4,12,3,8,5,16,11,"4-12","Y","Y","Y",4,1,2
"1291","N1",2023-08-20,"Utrecht","Heerenveen",0,2,"A",0,0,"D",1.83,3.83,4.47,"0-0","0-2",12,6,12,6,0,1,0,0,9,2,11,10,2,11,21,"9-2","Y","N","N",1,0,2
"1292","N1",2023-08-20,"Sparta Rotterdam","Feyenoord",2,2,"D",1,0,"H",5.17,4.61,1.61,"1-0","2-2",10,5,24,8,2,0,0,0,3,12,9,5,4,15,14,"3-12","Y","Y","Y",2,0,2
"1293","N1",2023-08-20,"Twente","Zwolle",3,1,"H",1,1,"D",1.36,5.61,8.29,"1-1","3-1",18,3,9,4,2,5,0,0,8,3,6,15,4,11,21,"8-3","Y","Y","Y",7,0,2
"1294","N1",2023-08-20,"Waalwijk","AZ Alkmaar",1,3,"A",1,0,"H",5.06,4.39,1.65,"1-0","1-3",7,5,15,7,2,1,0,0,1,10,9,12,4,11,21,"1-10","Y","Y","Y",3,0,2
"1295","N1",2023-08-26,"Nijmegen","Waalwijk",3,0,"H",1,0,"H",1.79,4.3,4.19,"1-0","3-0",13,10,10,1,1,2,0,0,2,4,10,9,3,6,19,"2-4","Y","Y","N",3,0,3
"1296","N1",2023-08-26,"Excelsior","For Sittard",2,2,"D",1,0,"H",2.46,3.75,2.82,"1-0","2-2",9,6,13,5,1,1,0,0,0,6,5,9,4,6,14,"0-6","Y","Y","Y",2,0,3
"1297","N1",2023-08-27,"Zwolle","Utrecht",1,0,"H",0,0,"D",2.86,3.83,2.4,"0-0","1-0",9,2,10,1,2,3,0,0,2,8,13,8,1,10,21,"2-8","N","N","N",5,0,3
"1298","N1",2023-08-27,"Feyenoord","Almere City",6,1,"H",3,0,"H",1.16,9.16,16.46,"3-0","6-1",31,18,6,1,0,1,0,0,8,2,8,15,7,10,23,"8-2","Y","Y","Y",1,0,3
"1299","N1",2023-08-27,"Heerenveen","Sparta Rotterdam",1,3,"A",0,1,"A",2.35,3.79,2.95,"0-1","1-3",19,6,16,7,0,0,1,0,6,7,4,8,4,13,12,"6-7","Y","Y","Y",0,1,3
"1300","N1",2023-09-01,"Sparta Rotterdam","Nijmegen",1,1,"D",0,0,"D",1.9,3.83,4.11,"0-0","1-1",15,6,13,6,1,4,0,0,10,1,11,10,2,11,21,"10-1","Y","N","N",5,0,3
"1301","N1",2023-09-02,"Almere City","Zwolle",1,2,"A",0,1,"A",3.26,3.66,2.23,"0-1","1-2",10,3,13,6,3,4,0,1,7,4,12,10,3,11,22,"7-4","Y","Y","N",7,1,3
"1302","N1",2023-09-02,"Go Ahead Eagles","Heerenveen",3,2,"H",2,1,"H",2.21,3.76,3.24,"2-1","3-2",21,7,13,3,3,0,0,1,9,8,10,9,5,17,19,"9-8","Y","Y","Y",3,1,3
"1303","N1",2023-09-02,"Waalwijk","PSV Eindhoven",0,4,"A",0,1,"A",8.33,5.63,1.36,"0-1","0-4",10,3,22,9,0,0,0,0,4,8,1,13,4,12,14,"4-8","Y","Y","Y",0,0,3
"1304","N1",2023-09-02,"Heracles","Excelsior",3,1,"H",0,1,"A",1.84,3.92,4.34,"0-1","3-1",15,5,9,3,1,4,0,1,8,1,6,11,4,9,17,"8-1","Y","Y","Y",5,1,4
"1305","N1",2023-09-03,"Utrecht","Feyenoord",1,5,"A",1,2,"A",4.89,4.55,1.65,"1-2","1-5",5,1,21,11,1,0,0,0,5,8,13,13,6,13,26,"5-8","Y","Y","Y",1,0,4
"1306","N1",2023-09-03,"For Sittard","Ajax",0,0,"D",0,0,"D",7.39,5.51,1.4,"0-0","0-0",12,4,12,4,3,2,0,0,3,7,20,7,0,10,27,"3-7","N","N","N",5,0,4
"1307","N1",2023-09-03,"Volendam","Twente",0,2,"A",0,1,"A",5.22,4.57,1.61,"0-1","0-2",7,2,12,4,1,2,0,0,1,5,10,7,2,6,17,"1-5","Y","N","N",3,0,4
"1308","N1",2023-09-03,"Vitesse","AZ Alkmaar",0,2,"A",0,0,"D",3.62,3.83,2.04,"0-0","0-2",4,2,16,7,3,0,0,0,0,9,12,10,2,9,22,"0-9","Y","N","N",3,0,4
"1309","N1",2023-09-16,"Feyenoord","Heerenveen",6,1,"H",3,1,"H",1.24,6.83,12.31,"3-1","6-1",21,9,7,1,1,0,0,0,6,3,8,9,7,9,17,"6-3","Y","Y","Y",1,0,4
"1310","N1",2023-09-16,"Vitesse","Waalwijk",0,2,"A",0,1,"A",1.53,4.75,5.99,"0-1","0-2",16,2,18,9,1,5,1,0,8,6,9,9,2,14,18,"8-6","Y","N","N",6,1,4
"1311","N1",2023-09-16,"For Sittard","Volendam",3,1,"H",0,1,"A",1.66,4.4,4.99,"0-1","3-1",27,11,7,2,1,0,0,0,15,3,9,6,4,18,15,"15-3","Y","Y","Y",1,0,4
"1312","N1",2023-09-16,"PSV Eindhoven","Nijmegen",4,0,"H",2,0,"H",1.17,8.54,15.69,"2-0","4-0",28,11,3,0,1,2,0,0,8,3,11,11,4,11,22,"8-3","Y","Y","Y",3,0,4
"1313","N1",2023-09-16,"Heracles","Utrecht",1,3,"A",0,2,"A",2.56,3.62,2.78,"0-2","1-3",11,1,11,7,3,3,0,0,4,4,12,13,4,8,25,"4-4","Y","Y","Y",6,0,5
"1314","N1",2023-09-17,"Zwolle","Go Ahead Eagles",1,1,"D",0,0,"D",2.45,3.59,2.93,"0-0","1-1",27,11,9,2,1,4,0,1,11,4,9,6,2,15,15,"11-4","Y","N","N",5,1,5
"1315","N1",2023-09-17,"Excelsior","Almere City",0,0,"D",0,0,"D",2.1,4.05,3.23,"0-0","0-0",14,2,16,3,2,3,0,0,4,5,7,13,0,9,20,"4-5","N","N","N",5,0,5
"1316","N1",2023-09-17,"Twente","Ajax",3,1,"H",2,1,"H",2.58,3.72,2.7,"2-1","3-1",24,9,11,2,1,2,0,0,5,9,13,9,4,14,22,"5-9","Y","Y","Y",3,0,5
"1317","N1",2023-09-17,"AZ Alkmaar","Sparta Rotterdam",2,0,"H",2,0,"H",1.53,4.6,6.13,"2-0","2-0",18,7,10,3,0,3,0,0,9,4,8,5,2,13,13,"9-4","Y","N","N",3,0,5
"1318","N1",2023-09-22,"Go Ahead Eagles","For Sittard",3,0,"H",1,0,"H",2.26,3.7,3.17,"1-0","3-0",20,9,21,2,0,4,0,0,2,5,2,14,3,7,16,"2-5","Y","Y","N",4,0,5
"1319","N1",2023-09-23,"Volendam","Heracles",2,2,"D",0,0,"D",2.86,3.81,2.4,"0-0","2-2",16,6,15,5,1,1,0,0,5,7,14,14,4,12,28,"5-7","Y","Y","Y",2,0,5
"1320","N1",2023-09-23,"Nijmegen","Utrecht",3,0,"H",2,0,"H",2.67,3.67,2.63,"2-0","3-0",9,5,17,4,1,2,0,0,4,4,8,11,3,8,19,"4-4","Y","Y","N",3,0,5
"1321","N1",2023-09-23,"Almere City","PSV Eindhoven",0,4,"A",0,2,"A",13.47,7.38,1.21,"0-2","0-4",9,2,20,9,1,1,0,0,5,8,15,6,4,13,21,"5-8","Y","Y","Y",2,0,5
"1322","N1",2023-09-23,"Heerenveen","Excelsior",0,3,"A",0,2,"A",1.67,4.45,4.82,"0-2","0-3",9,2,7,4,4,2,0,0,3,2,10,11,3,5,21,"3-2","Y","Y","N",6,0,6
"1323","N1",2023-09-24,"Sparta Rotterdam","Vitesse",1,0,"H",1,0,"H",1.91,3.91,3.99,"1-0","1-0",17,5,6,0,1,2,0,0,5,3,13,19,1,8,32,"5-3","N","N","N",3,0,6
"1324","N1",2023-09-24,"Waalwijk","Twente",1,0,"H",0,0,"D",5.91,4.58,1.55,"0-0","1-0",9,3,7,2,1,1,0,0,1,6,12,13,1,7,25,"1-6","N","N","N",2,0,6
"1325","N1",2023-09-24,"Zwolle","AZ Alkmaar",0,3,"A",0,1,"A",4.78,3.99,1.75,"0-1","0-3",7,3,15,5,3,3,0,0,2,6,13,8,3,8,21,"2-6","Y","Y","N",6,0,6
"1326","N1",2023-09-27,"Ajax","Feyenoord",0,4,"A",0,3,"A",2.85,3.86,2.39,"0-3","0-4",9,2,14,7,3,2,0,0,4,0,15,14,4,4,29,"4-0","Y","Y","Y",5,0,6
"1327","N1",2023-09-27,"PSV Eindhoven","Go Ahead Eagles",3,0,"H",1,0,"H",1.17,8.61,14.81,"1-0","3-0",23,11,9,2,0,2,0,0,9,2,10,7,3,11,17,"9-2","Y","Y","N",2,0,6
"1328","N1",2023-09-27,"Twente","Vitesse",1,0,"H",1,0,"H",1.4,5.13,8.1,"1-0","1-0",18,5,10,3,1,4,0,0,5,2,10,15,1,7,25,"5-2","N","N","N",5,0,6
"1329","N1",2023-09-28,"AZ Alkmaar","Heracles",1,1,"D",1,0,"H",1.27,6.44,10.66,"1-0","1-1",21,7,4,2,1,2,0,0,16,0,9,8,2,16,17,"16-0","Y","N","N",3,0,6
"1330","N1",2023-09-30,"Feyenoord","Go Ahead Eagles",3,1,"H",1,0,"H",1.16,9.16,15.85,"1-0","3-1",29,9,7,3,1,2,0,0,11,0,10,11,4,11,21,"11-0","Y","Y","Y",3,0,6
"1331","N1",2023-09-30,"PSV Eindhoven","Volendam",3,1,"H",1,0,"H",1.07,16,31.33,"1-0","3-1",38,17,2,1,1,2,0,1,7,0,11,8,4,7,19,"7-0","Y","Y","Y",3,1,7
"1332","N1",2023-09-30,"Utrecht","Almere City",0,2,"A",0,0,"D",1.56,4.65,5.78,"0-0","0-2",11,2,17,5,4,4,1,0,4,6,18,15,2,10,33,"4-6","Y","N","N",8,1,7
"1333","N1",2023-09-30,"Twente","Heerenveen",1,0,"H",0,0,"D",1.36,5.75,8.23,"0-0","1-0",11,3,5,1,3,1,0,0,8,1,10,12,1,9,22,"8-1","N","N","N",4,0,7
"1334","N1",2023-10-01,"Nijmegen","Vitesse",1,3,"A",1,1,"D",2.19,3.82,3.23,"1-1","1-3",9,5,10,5,2,5,0,0,6,5,9,18,4,11,27,"6-5","Y","Y","Y",7,0,7
"1335","N1",2023-10-01,"Excelsior","Sparta Rotterdam",2,1,"H",0,0,"D",3.59,3.59,2.12,"0-0","2-1",15,7,9,5,4,1,0,0,2,7,9,12,3,9,21,"2-7","Y","Y","N",5,0,7
"1336","N1",2023-10-01,"Heracles","Zwolle",2,1,"H",0,0,"D",2.29,3.82,3.03,"0-0","2-1",13,6,13,5,1,3,0,0,2,2,8,12,3,4,20,"2-2","Y","Y","N",4,0,7
"1337","N1",2023-10-01,"AZ Alkmaar","For Sittard",4,0,"H",1,0,"H",1.39,5.44,7.8,"1-0","4-0",12,7,8,1,1,3,0,0,1,3,14,12,4,4,26,"1-3","Y","Y","Y",4,0,7
"1214","P1",2023-08-11,"Sp Braga","Famalicao",1,2,"A",1,0,"H",1.45,4.86,7.21,"1-0","1-2",13,2,12,4,4,4,0,0,3,4,17,12,3,7,29,"3-4","Y","Y","N",8,0,1
"1215","P1",2023-08-12,"Gil Vicente","Portimonense",5,0,"H",2,0,"H",2.05,3.38,4.07,"2-0","5-0",8,5,9,3,0,0,0,0,1,1,11,14,5,2,25,"1-1","Y","Y","Y",0,0,1
"1216","P1",2023-08-12,"Farense","Casa Pia",0,3,"A",0,1,"A",2.59,3.07,3.17,"0-1","0-3",12,5,14,5,2,4,0,0,5,6,13,13,3,11,26,"5-6","Y","Y","N",6,0,1
"1217","P1",2023-08-12,"Sp Lisbon","Vizela",3,2,"H",2,0,"H",1.18,7.76,16.94,"2-0","3-2",19,6,10,4,4,0,0,0,8,3,16,9,5,11,25,"8-3","Y","Y","Y",4,0,1
"1218","P1",2023-08-13,"Rio Ave","Chaves",2,0,"H",0,0,"D",2.14,3.37,3.79,"0-0","2-0",21,8,6,1,3,4,0,1,14,3,12,20,2,17,32,"14-3","Y","N","N",7,1,1
"1219","P1",2023-08-13,"Estrela","Guimaraes",0,1,"A",0,1,"A",NA,NA,NA,"0-1","0-1",5,0,11,3,3,3,1,0,3,10,13,18,1,13,31,"3-10","N","N","N",6,1,1
"1220","P1",2023-08-13,"Arouca","Estoril",4,3,"H",1,1,"D",2.22,3.13,3.89,"1-1","4-3",11,5,12,8,4,2,1,0,2,6,11,17,7,8,28,"2-6","Y","Y","Y",6,1,1
"1221","P1",2023-08-14,"Moreirense","Porto",1,2,"A",0,0,"D",8.32,5.36,1.37,"0-0","1-2",8,1,18,7,4,7,0,1,5,10,22,15,3,15,37,"5-10","Y","Y","N",11,1,1
"1222","P1",2023-08-14,"Boavista","Benfica",3,2,"H",0,1,"A",11.02,5.89,1.29,"0-1","3-2",11,3,15,5,6,4,1,1,3,3,18,15,5,6,33,"3-3","Y","Y","Y",10,2,1
"1223","P1",2023-08-18,"Casa Pia","Sp Lisbon",1,2,"A",0,1,"A",7.6,4.77,1.45,"0-1","1-2",13,3,17,5,4,1,0,0,4,5,14,11,3,9,25,"4-5","Y","Y","N",5,0,2
"1224","P1",2023-08-19,"Guimaraes","Gil Vicente",2,1,"H",0,0,"D",2.11,3.39,3.86,"0-0","2-1",15,3,11,3,3,3,0,0,6,4,14,14,3,10,28,"6-4","Y","Y","N",6,0,2
"1225","P1",2023-08-19,"Chaves","Sp Braga",2,4,"A",1,1,"D",4.98,4.2,1.69,"1-1","2-4",15,4,13,6,2,2,1,0,5,6,12,12,6,11,24,"5-6","Y","Y","Y",4,1,2
"1226","P1",2023-08-19,"Benfica","Estrela",2,0,"H",0,0,"D",1.09,13.06,27.99,"0-0","2-0",27,10,6,1,3,3,0,0,9,4,8,14,2,13,22,"9-4","Y","N","N",6,0,2
"1227","P1",2023-08-19,"Portimonense","Boavista",1,4,"A",0,3,"A",2.81,3.18,2.8,"0-3","1-4",10,5,9,6,3,2,0,0,11,2,19,13,5,13,32,"11-2","Y","Y","Y",5,0,2
"1228","P1",2023-08-20,"Estoril","Rio Ave",2,0,"H",0,0,"D",2.54,3.24,3.07,"0-0","2-0",5,4,9,3,4,2,0,0,3,3,14,13,2,6,27,"3-3","Y","N","N",6,0,2
"1229","P1",2023-08-20,"Porto","Farense",2,1,"H",1,1,"D",1.13,9.69,19.53,"1-1","2-1",26,8,7,1,2,3,0,0,17,3,9,11,3,20,20,"17-3","Y","Y","N",5,0,2
"1230","P1",2023-08-20,"Vizela","Arouca",2,2,"D",1,1,"D",2.17,3.31,3.78,"1-1","2-2",13,7,9,2,6,6,1,1,6,3,24,11,4,9,35,"6-3","Y","Y","Y",12,2,2
"1231","P1",2023-08-21,"Famalicao","Moreirense",0,0,"D",0,0,"D",1.95,3.55,4.14,"0-0","0-0",4,2,12,3,4,3,1,0,3,6,15,10,0,9,25,"3-6","N","N","N",7,1,2
"1232","P1",2023-08-25,"Estrela","Estoril",2,1,"H",0,0,"D",2.37,3.19,3.43,"0-0","2-1",15,3,11,4,1,1,0,0,8,8,8,6,3,16,14,"8-8","Y","Y","N",2,0,3
"1233","P1",2023-08-26,"Arouca","Portimonense",1,1,"D",0,1,"A",1.66,4,5.64,"0-1","1-1",21,4,5,2,1,2,0,0,16,2,12,19,2,18,31,"16-2","Y","N","N",3,0,3
"1234","P1",2023-08-26,"Farense","Chaves",5,0,"H",4,0,"H",2.36,3.37,3.25,"4-0","5-0",18,10,19,7,2,1,0,0,7,4,24,15,5,11,39,"7-4","Y","Y","Y",3,0,3
"1235","P1",2023-08-26,"Gil Vicente","Benfica",2,3,"A",0,1,"A",9.93,6.01,1.31,"0-1","2-3",11,7,14,7,3,3,0,0,1,5,15,14,5,6,29,"1-5","Y","Y","Y",6,0,3
"1236","P1",2023-08-27,"Boavista","Casa Pia",1,1,"D",0,1,"A",2.3,3.29,3.45,"0-1","1-1",10,5,10,7,1,0,0,0,11,4,18,14,2,15,32,"11-4","Y","N","N",1,0,3
"1237","P1",2023-08-27,"Guimaraes","Vizela",2,0,"H",0,0,"D",1.93,3.58,4.35,"0-0","2-0",6,3,9,4,1,3,1,0,3,4,11,9,2,7,20,"3-4","Y","N","N",4,1,3
"1238","P1",2023-08-27,"Sp Lisbon","Famalicao",1,0,"H",0,0,"D",1.25,6.56,11.91,"0-0","1-0",10,6,7,1,3,2,0,0,8,1,17,13,1,9,30,"8-1","N","N","N",5,0,3
"1239","P1",2023-08-28,"Rio Ave","Porto",1,2,"A",0,0,"D",7.11,4.83,1.45,"0-0","1-2",4,1,9,5,4,3,0,0,1,7,22,17,3,8,39,"1-7","Y","Y","N",7,0,3
"1240","P1",2023-09-01,"Vizela","Gil Vicente",1,0,"H",0,0,"D",2.27,3.4,3.42,"0-0","1-0",13,5,5,1,0,3,0,0,4,3,20,16,1,7,36,"4-3","N","N","N",3,0,3
"1241","P1",2023-09-02,"Casa Pia","Rio Ave",1,1,"D",1,0,"H",2.22,3.39,3.53,"1-0","1-1",10,5,11,5,1,2,0,0,12,0,18,15,2,12,33,"12-0","Y","N","N",3,0,4
"1242","P1",2023-09-02,"Famalicao","Farense",1,0,"H",0,0,"D",1.79,3.72,4.92,"0-0","1-0",21,4,6,1,1,3,0,1,12,4,16,14,1,16,30,"12-4","N","N","N",4,1,4
"1243","P1",2023-09-02,"Portimonense","Estrela",1,1,"D",1,1,"D",2.7,3.22,2.89,"1-1","1-1",15,4,10,1,3,6,0,0,3,7,12,16,2,10,28,"3-7","Y","N","N",9,0,4
"1244","P1",2023-09-02,"Benfica","Guimaraes",4,0,"H",3,0,"H",1.21,7.46,13.1,"3-0","4-0",20,9,7,1,2,4,0,1,11,2,9,14,4,13,23,"11-2","Y","Y","Y",6,1,4
"1245","P1",2023-09-03,"Chaves","Moreirense",1,2,"A",0,1,"A",2.54,3.34,2.99,"0-1","1-2",13,3,9,2,3,4,0,0,3,4,14,21,3,7,35,"3-4","Y","Y","N",7,0,4
"1246","P1",2023-09-03,"Estoril","Boavista",1,2,"A",1,2,"A",2.48,3.37,3.01,"1-2","1-2",13,4,14,8,3,1,0,0,10,5,21,12,3,15,33,"10-5","Y","Y","N",4,0,4
"1247","P1",2023-09-03,"Porto","Arouca",1,1,"D",0,0,"D",1.26,6.43,11.28,"0-0","1-1",12,3,10,2,3,2,0,0,5,2,9,14,2,7,23,"5-2","Y","N","N",5,0,4
"1248","P1",2023-09-03,"Sp Braga","Sp Lisbon",1,1,"D",0,1,"A",3.04,3.63,2.36,"0-1","1-1",6,2,4,2,2,5,0,0,4,2,16,9,2,6,25,"4-2","Y","N","N",7,0,4
"1249","P1",2023-09-09,"Moreirense","Sp Braga",2,3,"A",2,1,"H",4.28,3.97,1.84,"2-1","2-3",11,3,12,5,2,2,0,0,4,5,12,11,5,9,23,"4-5","Y","Y","Y",4,0,4
"1250","P1",2023-09-15,"Estrela","Porto",0,1,"A",0,1,"A",9.42,5.38,1.35,"0-1","0-1",9,1,10,4,3,5,0,0,10,6,12,21,1,16,33,"10-6","N","N","N",8,0,5
"1251","P1",2023-09-16,"Rio Ave","Famalicao",1,1,"D",0,1,"A",2.66,3.15,3,"0-1","1-1",5,0,12,4,1,3,0,0,3,3,15,20,2,6,35,"3-3","Y","N","N",4,0,5
"1252","P1",2023-09-16,"Farense","Sp Braga",3,1,"H",2,0,"H",4.72,4.26,1.71,"2-0","3-1",16,4,17,7,4,5,0,0,7,3,16,10,4,10,26,"7-3","Y","Y","Y",9,0,5
"1253","P1",2023-09-16,"Vizela","Benfica",1,2,"A",0,2,"A",8.67,5.89,1.34,"0-2","1-2",12,2,17,7,2,1,0,0,2,3,15,6,3,5,21,"2-3","Y","Y","N",3,0,5
"1254","P1",2023-09-17,"Arouca","Casa Pia",0,1,"A",0,0,"D",2.46,3.25,3.19,"0-0","0-1",11,5,12,2,2,3,0,0,2,7,12,7,1,9,19,"2-7","N","N","N",5,0,5
"1255","P1",2023-09-17,"Gil Vicente","Estoril",5,3,"H",3,0,"H",2.18,3.55,3.49,"3-0","5-3",12,7,14,6,3,2,0,0,5,8,11,15,8,13,26,"5-8","Y","Y","Y",5,0,5
"1256","P1",2023-09-17,"Guimaraes","Portimonense",1,2,"A",1,0,"H",1.58,4.21,6.2,"1-0","1-2",11,3,9,2,2,4,0,0,10,3,16,13,3,13,29,"10-3","Y","Y","N",6,0,5
"1257","P1",2023-09-17,"Sp Lisbon","Moreirense",3,0,"H",0,0,"D",1.23,7.02,12.49,"0-0","3-0",20,9,7,1,3,3,0,1,8,2,10,16,3,10,26,"8-2","Y","Y","N",6,1,5
"1258","P1",2023-09-18,"Boavista","Chaves",4,1,"H",4,0,"H",1.74,4.1,4.64,"4-0","4-1",7,4,21,10,1,3,0,0,3,12,12,15,5,15,27,"3-12","Y","Y","Y",4,0,5
"1259","P1",2023-09-22,"Famalicao","Arouca",1,0,"H",1,0,"H",2.04,3.4,4.1,"1-0","1-0",7,4,13,6,5,2,1,1,6,8,15,23,1,14,38,"6-8","N","N","N",7,2,6
"1260","P1",2023-09-23,"Estoril","Vizela",2,2,"D",0,0,"D",2.56,3.48,2.87,"0-0","2-2",16,6,11,7,1,2,0,0,5,3,13,15,4,8,28,"5-3","Y","Y","Y",3,0,6
"1261","P1",2023-09-23,"Moreirense","Farense",1,0,"H",1,0,"H",2.23,3.52,3.39,"1-0","1-0",15,3,10,2,1,2,0,0,11,3,10,17,1,14,27,"11-3","N","N","N",3,0,6
"1262","P1",2023-09-23,"Casa Pia","Guimaraes",0,0,"D",0,0,"D",2.43,3.26,3.23,"0-0","0-0",10,2,14,3,3,2,0,0,8,9,16,11,0,17,27,"8-9","N","N","N",5,0,6
"1263","P1",2023-09-23,"Porto","Gil Vicente",2,1,"H",1,1,"D",1.22,7.32,11.96,"1-1","2-1",20,7,12,4,1,3,0,0,6,3,15,12,3,9,27,"6-3","Y","Y","N",4,0,6
"1264","P1",2023-09-24,"Chaves","Estrela",2,2,"D",0,1,"A",2.73,3.55,2.64,"0-1","2-2",17,8,10,3,4,4,0,1,9,5,11,11,4,14,22,"9-5","Y","Y","Y",8,1,6
"1265","P1",2023-09-24,"Portimonense","Benfica",1,3,"A",0,2,"A",11.17,6.7,1.25,"0-2","1-3",9,2,13,7,1,0,0,0,3,4,7,7,4,7,14,"3-4","Y","Y","Y",1,0,6
"1266","P1",2023-09-24,"Sp Braga","Boavista",4,1,"H",2,1,"H",1.55,4.78,5.69,"2-1","4-1",24,9,6,2,2,3,0,1,6,2,8,9,5,8,17,"6-2","Y","Y","Y",5,1,6
"1267","P1",2023-09-25,"Sp Lisbon","Rio Ave",2,0,"H",2,0,"H",1.2,7.3,13.69,"2-0","2-0",10,6,7,2,NA,5,0,0,4,2,14,12,2,6,26,"4-2","Y","N","N",NA,0,6
"1268","P1",2023-09-28,"Estrela","Sp Braga",2,4,"A",0,1,"A",4.72,4.16,1.71,"0-1","2-4",17,9,17,9,1,3,0,0,8,6,9,13,6,14,22,"8-6","Y","Y","Y",4,0,7
"1269","P1",2023-09-29,"Benfica","Porto",1,0,"H",0,0,"D",1.93,3.69,4.14,"0-0","1-0",12,2,6,3,4,5,0,1,9,5,18,10,1,14,28,"9-5","N","N","N",9,1,7
"1270","P1",2023-09-30,"Vizela","Portimonense",2,3,"A",0,2,"A",1.83,3.76,4.62,"0-2","2-3",14,4,9,7,3,3,0,0,13,2,11,16,5,15,27,"13-2","Y","Y","Y",6,0,7
"1271","P1",2023-09-30,"Boavista","Famalicao",2,2,"D",1,1,"D",2.21,3.51,3.44,"1-1","2-2",10,6,7,3,5,4,1,2,2,4,23,21,4,6,44,"2-4","Y","Y","Y",9,3,7
"1272","P1",2023-09-30,"Farense","Sp Lisbon",2,3,"A",1,2,"A",6.17,4.58,1.44,"1-2","2-3",9,4,23,10,5,6,1,0,2,8,13,12,5,10,25,"2-8","Y","Y","Y",11,1,7
"1273","P1",2023-10-01,"Arouca","Chaves",0,2,"A",0,0,"D",1.85,3.76,4.39,"0-0","0-2",11,2,5,3,3,5,1,0,5,3,16,10,2,8,26,"5-3","Y","N","N",8,1,7
"1274","P1",2023-10-01,"Guimaraes","Estoril",3,2,"H",0,2,"A",1.85,3.79,4.45,"0-2","3-2",25,8,10,5,4,4,0,1,11,2,16,13,5,13,29,"11-2","Y","Y","Y",8,1,7
"1275","P1",2023-10-01,"Rio Ave","Moreirense",0,4,"A",0,2,"A",2.38,3.46,3.13,"0-2","0-4",10,4,11,6,3,5,0,0,4,2,13,26,4,6,39,"4-2","Y","Y","Y",8,0,7
"1276","P1",2023-10-02,"Gil Vicente","Casa Pia",2,0,"H",0,0,"D",2.41,3.34,3.14,"0-0","2-0",16,9,8,1,3,3,0,1,5,5,10,15,2,10,25,"5-5","Y","N","N",6,1,7
"1525","SC0",2023-08-05,"Celtic","Ross County",4,2,"H",3,0,"H",1.12,11.1,20.81,"3-0","4-2",18,12,7,2,0,4,0,0,4,8,6,14,6,12,20,"4-8","Y","Y","Y",4,0,1
"1526","SC0",2023-08-05,"Dundee","Motherwell",1,1,"D",0,1,"A",2.65,3.38,2.82,"0-1","1-1",17,2,13,3,0,2,0,0,7,12,12,12,2,19,24,"7-12","Y","N","N",2,0,1
"1527","SC0",2023-08-05,"Livingston","Aberdeen",0,0,"D",0,0,"D",2.99,3.32,2.55,"0-0","0-0",12,2,11,0,3,4,0,0,7,7,22,13,0,14,35,"7-7","N","N","N",7,0,1
"1528","SC0",2023-08-05,"St Johnstone","Hearts",0,2,"A",0,0,"D",3.27,3.68,2.22,"0-0","0-2",9,3,16,9,2,3,0,0,6,9,14,13,2,15,27,"6-9","Y","N","N",5,0,1
"1529","SC0",2023-08-05,"Kilmarnock","Rangers",1,0,"H",0,0,"D",7.25,4.98,1.44,"0-0","1-0",10,3,18,4,0,0,0,0,2,8,7,10,1,10,17,"2-8","N","N","N",0,0,1
"1530","SC0",2023-08-06,"Hibernian","St Mirren",2,3,"A",0,2,"A",1.93,3.65,4.17,"0-2","2-3",14,7,8,4,2,2,0,0,2,7,14,7,5,9,21,"2-7","Y","Y","Y",4,0,1
"1531","SC0",2023-08-12,"Rangers","Livingston",4,0,"H",1,0,"H",1.28,6.16,10.41,"1-0","4-0",21,9,6,2,1,1,0,0,5,4,9,9,4,9,18,"5-4","Y","Y","Y",2,0,2
"1532","SC0",2023-08-12,"Ross County","St Johnstone",2,0,"H",1,0,"H",2.2,3.34,3.64,"1-0","2-0",19,8,12,3,2,2,0,0,6,7,11,14,2,13,25,"6-7","Y","N","N",4,0,2
"1533","SC0",2023-08-12,"St Mirren","Dundee",2,1,"H",2,0,"H",2.09,3.45,3.83,"2-0","2-1",15,2,7,4,2,3,0,0,4,3,8,8,3,7,16,"4-3","Y","Y","N",5,0,2
"1534","SC0",2023-08-13,"Aberdeen","Celtic",1,3,"A",1,2,"A",8.1,5.6,1.37,"1-2","1-3",11,2,15,10,0,2,0,0,9,9,12,11,4,18,23,"9-9","Y","Y","Y",2,0,2
"1535","SC0",2023-08-13,"Hearts","Kilmarnock",0,0,"D",0,0,"D",1.89,3.73,4.31,"0-0","0-0",8,1,15,5,3,4,0,0,6,5,12,15,0,11,27,"6-5","N","N","N",7,0,2
"1536","SC0",2023-08-13,"Motherwell","Hibernian",2,1,"H",0,0,"D",2.69,3.32,2.82,"0-0","2-1",10,3,4,1,1,4,0,0,5,2,14,16,3,7,30,"5-2","Y","Y","N",5,0,2
"1537","SC0",2023-08-26,"Ross County","Rangers",0,2,"A",0,2,"A",8.67,5.53,1.36,"0-2","0-2",8,2,24,9,3,1,0,0,4,8,10,11,2,12,21,"4-8","Y","N","N",4,0,3
"1538","SC0",2023-08-26,"Celtic","St Johnstone",0,0,"D",0,0,"D",1.05,19.42,39.84,"0-0","0-0",19,5,5,2,1,3,0,0,19,1,9,12,0,20,21,"19-1","N","N","N",4,0,3
"1539","SC0",2023-08-26,"Hibernian","Livingston",2,3,"A",0,1,"A",1.88,3.82,4.25,"0-1","2-3",13,3,8,4,2,4,0,0,9,3,12,10,5,12,22,"9-3","Y","Y","Y",6,0,3
"1540","SC0",2023-08-26,"Motherwell","Kilmarnock",2,1,"H",0,1,"A",2.52,3.28,3.07,"0-1","2-1",13,7,12,3,6,3,0,0,1,6,15,19,3,7,34,"1-6","Y","Y","N",9,0,3
"1541","SC0",2023-08-27,"Dundee","Hearts",1,0,"H",0,0,"D",2.93,3.49,2.47,"0-0","1-0",12,4,10,5,1,1,0,0,3,8,16,10,1,11,26,"3-8","N","N","N",2,0,3
"1542","SC0",2023-08-27,"St Mirren","Aberdeen",2,2,"D",0,1,"A",2.35,3.33,3.32,"0-1","2-2",13,6,4,2,2,2,0,0,4,3,9,14,4,7,23,"4-3","Y","Y","Y",4,0,3
"1543","SC0",2023-09-02,"Kilmarnock","Ross County",0,1,"A",0,0,"D",1.93,3.6,4.33,"0-0","0-1",15,4,9,4,0,5,0,0,14,2,9,17,1,16,26,"14-2","N","N","N",5,0,4
"1544","SC0",2023-09-02,"Livingston","St Mirren",1,1,"D",0,0,"D",2.97,3.06,2.75,"0-0","1-1",13,2,8,4,3,1,0,0,6,2,17,13,2,8,30,"6-2","Y","N","N",4,0,4
"1545","SC0",2023-09-02,"St Johnstone","Dundee",2,2,"D",0,1,"A",2.72,3.34,2.77,"0-1","2-2",8,3,12,4,3,0,0,0,4,6,13,11,4,10,24,"4-6","Y","Y","Y",3,0,4
"1546","SC0",2023-09-03,"Rangers","Celtic",0,1,"A",0,1,"A",2.43,3.78,2.84,"0-1","0-1",17,3,7,5,1,1,0,0,6,2,15,15,1,8,30,"6-2","N","N","N",2,0,4
"1547","SC0",2023-09-03,"Aberdeen","Hibernian",0,2,"A",0,0,"D",2.34,3.47,3.19,"0-0","0-2",10,3,15,7,2,4,0,0,7,5,15,11,2,12,26,"7-5","Y","N","N",6,0,4
"1548","SC0",2023-09-03,"Hearts","Motherwell",0,1,"A",0,1,"A",2.01,3.69,3.8,"0-1","0-1",18,1,8,4,1,2,0,1,16,5,10,16,1,21,26,"16-5","N","N","N",3,1,4
"1549","SC0",2023-09-16,"St Johnstone","Rangers",0,2,"A",0,1,"A",12.28,6.42,1.25,"0-1","0-2",3,0,20,6,5,2,0,0,3,5,13,13,2,8,26,"3-5","Y","N","N",7,0,5
"1550","SC0",2023-09-16,"Celtic","Dundee",3,0,"H",0,0,"D",1.13,10.55,19.28,"0-0","3-0",19,7,4,1,0,0,0,0,9,1,6,7,3,10,13,"9-1","Y","Y","N",0,0,5
"1551","SC0",2023-09-16,"Hearts","Aberdeen",2,0,"H",1,0,"H",2.15,3.65,3.45,"1-0","2-0",12,4,11,5,4,2,0,0,9,3,11,12,2,12,23,"9-3","Y","N","N",6,0,5
"1552","SC0",2023-09-16,"Kilmarnock","Hibernian",2,2,"D",0,1,"A",2.65,3.27,2.91,"0-1","2-2",16,5,11,4,5,4,0,0,4,4,16,8,4,8,24,"4-4","Y","Y","Y",9,0,5
"1553","SC0",2023-09-16,"Motherwell","St Mirren",0,1,"A",0,0,"D",2.41,3.19,3.34,"0-0","0-1",20,7,9,3,0,5,0,0,8,3,6,18,1,11,24,"8-3","N","N","N",5,0,5
"1554","SC0",2023-09-16,"Ross County","Livingston",1,1,"D",0,0,"D",2.44,3.34,3.14,"0-0","1-1",16,5,5,2,0,3,0,0,6,2,14,13,2,8,27,"6-2","Y","N","N",3,0,5
"1555","SC0",2023-09-23,"Livingston","Celtic",0,3,"A",0,1,"A",10.91,6.27,1.27,"0-1","0-3",15,4,14,7,5,2,0,1,2,4,17,6,3,6,23,"2-4","Y","Y","N",7,1,6
"1556","SC0",2023-09-23,"Dundee","Kilmarnock",2,2,"D",1,1,"D",2.56,3.29,3.01,"1-1","2-2",10,3,23,3,1,3,1,0,4,7,8,12,4,11,20,"4-7","Y","Y","Y",4,1,6
"1557","SC0",2023-09-23,"Hibernian","St Johnstone",2,0,"H",1,0,"H",1.61,4.29,5.5,"1-0","2-0",17,8,12,1,1,3,0,0,4,4,9,10,2,8,19,"4-4","Y","N","N",4,0,6
"1558","SC0",2023-09-23,"St Mirren","Hearts",1,0,"H",1,0,"H",2.74,3.2,2.86,"1-0","1-0",13,5,11,3,2,1,0,0,4,8,13,12,1,12,25,"4-8","N","N","N",3,0,6
"1559","SC0",2023-09-24,"Aberdeen","Ross County",4,0,"H",2,0,"H",2,3.49,4.04,"2-0","4-0",13,6,11,2,0,4,0,0,5,5,9,10,4,10,19,"5-5","Y","Y","Y",4,0,6
"1560","SC0",2023-09-24,"Rangers","Motherwell",1,0,"H",1,0,"H",1.24,6.72,12.04,"1-0","1-0",17,7,9,4,2,2,0,0,2,2,14,15,1,4,29,"2-2","N","N","N",4,0,6
"1561","SC0",2023-09-30,"Motherwell","Celtic",1,2,"A",0,0,"D",10.22,5.91,1.31,"0-0","1-2",10,4,24,6,3,1,0,0,4,6,12,11,3,10,23,"4-6","Y","Y","N",4,0,7
"1562","SC0",2023-09-30,"Hibernian","Dundee",0,0,"D",0,0,"D",1.79,4.05,4.44,"0-0","0-0",23,9,11,2,1,4,0,0,14,1,7,10,0,15,17,"14-1","N","N","N",5,0,7
"1563","SC0",2023-09-30,"Kilmarnock","St Mirren",1,1,"D",1,1,"D",2.44,3.31,3.17,"1-1","1-1",12,2,8,3,2,3,0,0,7,6,15,16,2,13,31,"7-6","Y","N","N",5,0,7
"1564","SC0",2023-09-30,"Rangers","Aberdeen",1,3,"A",0,1,"A",1.28,6.23,10.73,"0-1","1-3",18,5,14,6,2,1,1,0,5,8,18,4,4,13,22,"5-8","Y","Y","Y",3,1,7
"1565","SC0",2023-09-30,"Ross County","Hearts",0,1,"A",0,0,"D",3.25,3.6,2.26,"0-0","0-1",9,1,17,3,3,2,0,0,5,5,15,10,1,10,25,"5-5","N","N","N",5,0,7
"1566","SC0",2023-09-30,"St Johnstone","Livingston",1,1,"D",1,0,"H",2.71,3.1,2.96,"1-0","1-1",12,2,7,3,2,2,1,0,5,2,14,14,2,7,28,"5-2","Y","N","N",4,1,7
"1567","SC1",2023-08-04,"Arbroath","Dundee United",0,4,"A",0,4,"A",3.88,3.26,2.08,"0-4","0-4",3,1,15,7,2,0,0,0,6,10,13,3,4,16,16,"6-10","Y","Y","Y",2,0,1
"1568","SC1",2023-08-05,"Dunfermline","Airdrie Utd",2,1,"H",1,1,"D",1.96,3.69,3.78,"1-1","2-1",13,5,12,3,1,1,1,0,4,5,11,9,3,9,20,"4-5","Y","Y","N",2,1,1
"1569","SC1",2023-08-05,"Inverness C","Queens Park",1,2,"A",0,1,"A",2.21,3.63,3.16,"0-1","1-2",12,6,12,7,1,3,0,0,5,4,9,10,3,9,19,"5-4","Y","Y","N",4,0,1
"1570","SC1",2023-08-05,"Morton","Ayr",3,1,"H",0,0,"D",2.6,3.29,2.81,"0-0","3-1",19,6,7,4,3,5,0,0,3,4,9,16,4,7,25,"3-4","Y","Y","Y",8,0,1
"1571","SC1",2023-08-05,"Partick","Raith Rvs",2,2,"D",2,0,"H",1.75,3.87,4.59,"2-0","2-2",14,5,14,6,1,2,0,0,7,4,8,9,4,11,17,"7-4","Y","Y","Y",3,0,1
"1572","SC1",2023-08-12,"Airdrie Utd","Partick",2,1,"H",0,1,"A",3,3.61,2.21,"0-1","2-1",11,2,7,2,0,0,0,0,6,4,6,9,3,10,15,"6-4","Y","Y","N",0,0,2
"1573","SC1",2023-08-12,"Ayr","Inverness C",1,0,"H",1,0,"H",2.01,3.63,3.66,"1-0","1-0",7,3,10,4,2,2,0,0,5,3,10,13,1,8,23,"5-3","N","N","N",4,0,2
"1574","SC1",2023-08-12,"Dundee United","Dunfermline",1,1,"D",0,0,"D",1.65,4.24,4.79,"0-0","1-1",16,4,5,2,0,2,0,0,10,4,14,3,2,14,17,"10-4","Y","N","N",2,0,2
"1575","SC1",2023-08-12,"Queens Park","Arbroath",2,1,"H",1,0,"H",1.69,3.99,4.68,"1-0","2-1",14,5,6,1,3,1,0,0,15,2,8,7,3,17,15,"15-2","Y","Y","N",4,0,2
"1576","SC1",2023-08-12,"Raith Rvs","Morton",3,2,"H",2,1,"H",2.52,3.46,2.79,"2-1","3-2",4,4,3,2,5,8,0,0,5,6,8,13,5,11,21,"5-6","Y","Y","Y",13,0,2
"1577","SC1",2023-08-19,"Arbroath","Queens Park",0,1,"A",0,0,"D",3.49,3.44,2.14,"0-0","0-1",12,3,4,3,1,2,0,0,3,6,15,9,1,9,24,"3-6","N","N","N",3,0,3
"1578","SC1",2023-08-26,"Airdrie Utd","Inverness C",2,1,"H",2,0,"H",2.17,3.58,3.28,"2-0","2-1",8,3,19,6,1,3,1,0,1,3,11,15,3,4,26,"1-3","Y","Y","N",4,1,3
"1579","SC1",2023-08-26,"Ayr","Dundee United",0,3,"A",0,0,"D",3.21,3.34,2.31,"0-0","0-3",2,2,13,8,1,2,0,0,4,11,8,9,3,15,17,"4-11","Y","Y","N",3,0,3
"1580","SC1",2023-08-26,"Dunfermline","Raith Rvs",0,1,"A",0,1,"A",2.34,3.41,3.09,"0-1","0-1",5,2,3,2,2,2,0,0,12,2,8,7,1,14,15,"12-2","N","N","N",4,0,3
"1581","SC1",2023-08-26,"Morton","Arbroath",0,3,"A",0,1,"A",1.69,3.7,5.33,"0-1","0-3",17,8,13,6,2,3,0,0,14,6,11,17,3,20,28,"14-6","Y","Y","N",5,0,3
"1582","SC1",2023-08-26,"Partick","Queens Park",3,1,"H",2,1,"H",2.01,3.82,3.5,"2-1","3-1",10,6,14,4,2,1,0,0,1,6,8,10,4,7,18,"1-6","Y","Y","Y",3,0,4
"1583","SC1",2023-09-02,"Arbroath","Ayr",2,1,"H",1,1,"D",2.8,2.96,2.87,"1-1","2-1",11,6,9,3,3,1,0,0,5,7,9,7,3,12,16,"5-7","Y","Y","N",4,0,4
"1584","SC1",2023-09-02,"Dundee United","Airdrie Utd",2,0,"H",1,0,"H",1.64,4,5.26,"1-0","2-0",9,3,9,3,2,2,0,0,5,3,14,8,2,8,22,"5-3","Y","N","N",4,0,4
"1585","SC1",2023-09-02,"Inverness C","Dunfermline",1,1,"D",1,0,"H",2.35,3.39,3.09,"1-0","1-1",7,2,10,4,2,1,0,0,2,7,10,7,2,9,17,"2-7","Y","N","N",3,0,4
"1586","SC1",2023-09-02,"Morton","Partick",1,4,"A",1,1,"D",2.56,3.61,2.66,"1-1","1-4",15,8,13,6,1,0,0,1,2,7,6,6,5,9,12,"2-7","Y","Y","Y",1,1,4
"1587","SC1",2023-09-02,"Raith Rvs","Queens Park",3,2,"H",1,0,"H",2.14,3.68,3.28,"1-0","3-2",8,7,4,2,1,0,0,1,8,1,5,10,5,9,15,"8-1","Y","Y","Y",1,1,5
"1588","SC1",2023-09-15,"Ayr","Partick",0,4,"A",0,1,"A",3.29,3.73,2.12,"0-1","0-4",13,10,11,5,3,1,0,0,9,3,6,7,4,12,13,"9-3","Y","Y","Y",4,0,5
"1589","SC1",2023-09-16,"Arbroath","Airdrie Utd",4,0,"H",2,0,"H",2.43,3.68,2.77,"2-0","4-0",11,6,6,0,0,1,1,1,2,5,13,8,4,7,21,"2-5","Y","Y","Y",1,2,5
"1590","SC1",2023-09-16,"Dundee United","Morton",1,1,"D",1,0,"H",1.67,4.02,4.94,"1-0","1-1",9,1,7,1,1,3,1,0,5,4,15,12,2,9,27,"5-4","Y","N","N",4,1,5
"1591","SC1",2023-09-16,"Queens Park","Dunfermline",0,2,"A",0,0,"D",2.31,3.52,3.05,"0-0","0-2",14,2,15,5,2,3,0,0,8,9,11,7,2,17,18,"8-9","Y","N","N",5,0,5
"1592","SC1",2023-09-16,"Raith Rvs","Inverness C",1,0,"H",0,0,"D",1.88,3.69,3.95,"0-0","1-0",7,2,8,5,2,2,0,0,3,7,9,15,1,10,24,"3-7","N","N","N",4,0,6
"1593","SC1",2023-09-22,"Queens Park","Ayr",2,5,"A",1,4,"A",2.07,3.61,3.49,"1-4","2-5",12,4,10,6,2,0,0,0,4,2,8,7,7,6,15,"4-2","Y","Y","Y",2,0,6
"1594","SC1",2023-09-23,"Airdrie Utd","Raith Rvs",1,0,"H",0,0,"D",2.41,3.57,2.86,"0-0","1-0",7,3,11,6,1,4,0,0,2,1,8,9,1,3,17,"2-1","N","N","N",5,0,6
"1595","SC1",2023-09-23,"Dunfermline","Morton",3,1,"H",2,0,"H",2.07,3.48,3.65,"2-0","3-1",10,5,9,2,0,3,0,0,10,4,8,14,4,14,22,"10-4","Y","Y","Y",3,0,6
"1596","SC1",2023-09-23,"Inverness C","Dundee United",0,1,"A",0,0,"D",3.69,3.48,2.05,"0-0","0-1",8,2,12,4,2,3,0,1,4,2,6,13,1,6,19,"4-2","N","N","N",5,1,6
"1597","SC1",2023-09-23,"Partick","Arbroath",0,3,"A",0,2,"A",1.62,4.17,5.18,"0-2","0-3",8,1,19,7,3,2,0,0,4,6,12,10,3,10,22,"4-6","Y","Y","N",5,0,7
"1598","SC1",2023-09-30,"Arbroath","Inverness C",2,3,"A",0,2,"A",2.19,3.6,3.14,"0-2","2-3",11,3,7,6,1,1,0,0,8,2,14,18,5,10,32,"8-2","Y","Y","Y",2,0,7
"1599","SC1",2023-09-30,"Ayr","Raith Rvs",1,2,"A",0,2,"A",2.78,3.45,2.5,"0-2","1-2",13,4,8,3,2,2,0,0,8,4,10,6,3,12,16,"8-4","Y","Y","N",4,0,7
"1600","SC1",2023-09-30,"Dundee United","Queens Park",4,1,"H",1,1,"D",1.56,4.24,5.82,"1-1","4-1",14,5,8,3,0,2,0,0,4,2,7,7,5,6,14,"4-2","Y","Y","Y",2,0,7
"1601","SC1",2023-09-30,"Morton","Airdrie Utd",0,1,"A",0,1,"A",2.16,3.81,3.13,"0-1","0-1",13,1,8,2,2,3,0,0,6,3,12,13,1,9,25,"6-3","N","N","N",5,0,7
"1602","SC1",2023-09-30,"Partick","Dunfermline",3,0,"H",1,0,"H",1.99,3.78,3.5,"1-0","3-0",23,12,19,4,3,1,0,0,4,9,8,5,3,13,13,"4-9","Y","Y","N",4,0,8
"1603","SC2",2023-08-05,"Falkirk","Annan Athletic",3,0,"H",0,0,"D",NA,NA,NA,"0-0","3-0",17,8,4,0,3,1,0,0,11,1,14,5,3,12,19,"11-1","Y","Y","N",4,0,1
"1604","SC2",2023-08-05,"Hamilton","Cove Rangers",1,0,"H",1,0,"H",NA,NA,NA,"1-0","1-0",9,6,4,0,2,1,0,1,7,5,8,2,1,12,10,"7-5","N","N","N",3,1,1
"1605","SC2",2023-08-05,"Montrose","Kelty Hearts",0,2,"A",0,0,"D",2.26,3.4,2.93,"0-0","0-2",11,4,11,4,3,3,0,0,12,5,17,13,2,17,30,"12-5","Y","N","N",6,0,1
"1606","SC2",2023-08-05,"Queen of Sth","Alloa",3,4,"A",2,4,"A",1.93,3.61,3.68,"2-4","3-4",9,4,10,8,3,2,0,0,8,3,9,18,7,11,27,"8-3","Y","Y","Y",5,0,1
"1607","SC2",2023-08-05,"Stirling","Edinburgh City",1,0,"H",0,0,"D",NA,NA,NA,"0-0","1-0",12,5,5,4,0,3,0,0,10,1,12,10,1,11,22,"10-1","N","N","N",3,0,1
"1608","SC2",2023-08-12,"Alloa","Stirling",0,1,"A",0,0,"D",NA,NA,NA,"0-0","0-1",3,1,4,2,3,2,1,0,3,5,11,10,1,8,21,"3-5","N","N","N",5,1,2
"1609","SC2",2023-08-12,"Annan Athletic","Montrose",1,3,"A",0,3,"A",2.51,3.43,2.67,"0-3","1-3",16,5,4,3,0,2,0,0,4,3,7,11,4,7,18,"4-3","Y","Y","Y",2,0,2
"1610","SC2",2023-08-12,"Cove Rangers","Falkirk",2,2,"D",0,0,"D",NA,NA,NA,"0-0","2-2",7,4,13,7,3,3,0,0,3,8,17,11,4,11,28,"3-8","Y","Y","Y",6,0,2
"1611","SC2",2023-08-12,"Edinburgh City","Queen of Sth",1,2,"A",1,0,"H",NA,NA,NA,"1-0","1-2",8,3,14,8,1,1,0,1,3,10,14,8,3,13,22,"3-10","Y","Y","N",2,1,2
"1612","SC2",2023-08-12,"Kelty Hearts","Hamilton",0,2,"A",0,0,"D",NA,NA,NA,"0-0","0-2",5,1,16,11,0,2,0,0,3,7,6,6,2,10,12,"3-7","Y","N","N",2,0,2
"1613","SC2",2023-08-19,"Edinburgh City","Hamilton",0,3,"A",0,1,"A",3.81,3.77,1.86,"0-1","0-3",9,1,23,9,0,2,1,0,3,8,11,6,3,11,17,"3-8","Y","Y","N",2,1,3
"1614","SC2",2023-08-19,"Kelty Hearts","Alloa",2,1,"H",1,0,"H",2.49,3.25,2.82,"1-0","2-1",7,3,9,3,2,6,0,0,2,2,16,9,3,4,25,"2-2","Y","Y","N",8,0,3
"1615","SC2",2023-08-19,"Montrose","Cove Rangers",0,3,"A",0,2,"A",2.5,3.41,2.7,"0-2","0-3",8,5,19,8,0,0,0,0,6,3,8,9,3,9,17,"6-3","Y","Y","N",0,0,3
"1616","SC2",2023-08-19,"Queen of Sth","Annan Athletic",3,1,"H",0,1,"A",1.58,4.16,5.23,"0-1","3-1",13,4,6,1,2,2,0,0,5,1,14,6,4,6,20,"5-1","Y","Y","Y",4,0,3
"1617","SC2",2023-08-22,"Falkirk","Stirling",3,0,"H",3,0,"H",1.66,3.97,4.46,"3-0","3-0",12,4,3,3,2,2,0,0,10,2,11,11,3,12,22,"10-2","Y","Y","N",4,0,3
"1618","SC2",2023-08-26,"Annan Athletic","Edinburgh City",3,2,"H",1,2,"A",2.11,3.45,3.32,"1-2","3-2",16,8,15,7,3,2,0,0,2,8,7,8,5,10,15,"2-8","Y","Y","Y",5,0,4
"1619","SC2",2023-08-26,"Cove Rangers","Queen of Sth",1,2,"A",0,2,"A",2.07,3.62,3.27,"0-2","1-2",15,3,6,2,1,2,1,1,6,5,12,14,3,11,26,"6-5","Y","Y","N",3,2,4
"1620","SC2",2023-08-26,"Hamilton","Montrose",1,0,"H",1,0,"H",1.43,4.58,6.8,"1-0","1-0",7,4,4,2,2,3,0,0,10,1,13,8,1,11,21,"10-1","N","N","N",5,0,4
"1621","SC2",2023-08-26,"Stirling","Kelty Hearts",1,0,"H",0,0,"D",1.9,3.72,3.71,"0-0","1-0",8,3,7,2,1,1,0,0,9,4,8,5,1,13,13,"9-4","N","N","N",2,0,4
"1622","SC2",2023-08-26,"Alloa","Falkirk",1,4,"A",0,2,"A",3.99,3.88,1.8,"0-2","1-4",6,4,14,7,3,2,0,0,2,9,9,13,5,11,22,"2-9","Y","Y","Y",5,0,4
"1623","SC2",2023-09-02,"Alloa","Cove Rangers",1,0,"H",1,0,"H",2.64,3.33,2.6,"1-0","1-0",10,5,9,3,3,1,0,0,5,3,10,10,1,8,20,"5-3","N","N","N",4,0,5
"1624","SC2",2023-09-02,"Edinburgh City","Falkirk",0,2,"A",0,1,"A",7.01,4.84,1.4,"0-1","0-2",2,0,28,12,4,0,0,0,4,7,12,7,2,11,19,"4-7","Y","N","N",4,0,5
"1625","SC2",2023-09-02,"Kelty Hearts","Annan Athletic",1,1,"D",0,0,"D",1.71,3.87,4.21,"0-0","1-1",6,3,11,2,1,2,0,0,2,3,8,6,2,5,14,"2-3","Y","N","N",3,0,5
"1626","SC2",2023-09-02,"Queen of Sth","Montrose",2,3,"A",0,2,"A",1.79,3.9,3.99,"0-2","2-3",10,6,6,4,1,1,0,0,4,5,6,8,5,9,14,"4-5","Y","Y","Y",2,0,5
"1627","SC2",2023-09-02,"Stirling","Hamilton",2,2,"D",1,2,"A",3.63,3.58,1.96,"1-2","2-2",8,5,17,7,2,0,0,0,1,7,15,7,4,8,22,"1-7","Y","Y","Y",2,0,5
"1628","SC2",2023-09-16,"Annan Athletic","Stirling",3,0,"H",1,0,"H",2.72,3.44,2.47,"1-0","3-0",14,8,11,3,1,3,0,0,4,9,9,14,3,13,23,"4-9","Y","Y","N",4,0,6
"1629","SC2",2023-09-16,"Cove Rangers","Kelty Hearts",2,2,"D",1,2,"A",1.94,3.61,3.65,"1-2","2-2",7,4,5,5,2,3,0,1,4,3,8,8,4,7,16,"4-3","Y","Y","Y",5,1,6
"1630","SC2",2023-09-16,"Falkirk","Queen of Sth",1,0,"H",0,0,"D",1.56,3.88,4.62,"0-0","1-0",11,4,4,0,0,2,0,0,5,1,9,9,1,6,18,"5-1","N","N","N",2,0,6
"1631","SC2",2023-09-16,"Hamilton","Alloa",2,1,"H",0,0,"D",1.56,4.2,5.4,"0-0","2-1",15,8,9,4,2,2,0,0,11,3,9,13,3,14,22,"11-3","Y","Y","N",4,0,6
"1632","SC2",2023-09-16,"Montrose","Edinburgh City",5,2,"H",4,0,"H",1.72,3.92,4.35,"4-0","5-2",15,8,14,7,2,4,0,0,7,5,9,18,7,12,27,"7-5","Y","Y","Y",6,0,6
"1633","SC2",2023-09-23,"Annan Athletic","Alloa",1,1,"D",0,1,"A",2.62,3.45,2.55,"0-1","1-1",15,8,8,2,2,1,0,0,7,0,9,15,2,7,24,"7-0","Y","N","N",3,0,7
"1634","SC2",2023-09-23,"Edinburgh City","Cove Rangers",2,2,"D",1,1,"D",4.34,4.11,1.69,"1-1","2-2",12,5,17,7,1,2,0,0,7,3,8,7,4,10,15,"7-3","Y","Y","Y",3,0,7
"1635","SC2",2023-09-23,"Montrose","Stirling",1,0,"H",0,0,"D",2.5,3.44,2.68,"0-0","1-0",5,3,4,0,3,4,0,0,5,5,11,13,1,10,24,"5-5","N","N","N",7,0,7
"1636","SC2",2023-09-23,"Queen of Sth","Hamilton",1,2,"A",1,1,"D",3.31,3.54,2.09,"1-1","1-2",7,1,16,8,5,1,0,0,1,6,21,11,3,7,32,"1-6","Y","Y","N",6,0,7
"1637","SC2",2023-09-23,"Kelty Hearts","Falkirk",1,5,"A",1,3,"A",4.9,4.02,1.64,"1-3","1-5",2,1,22,14,2,2,0,0,3,6,9,13,6,9,22,"3-6","Y","Y","Y",4,0,7
"1638","SC2",2023-09-29,"Hamilton","Annan Athletic",5,0,"H",1,0,"H",1.34,5.34,7.83,"1-0","5-0",16,6,2,1,1,1,0,0,4,4,13,7,5,8,20,"4-4","Y","Y","Y",2,0,8
"1639","SC2",2023-09-30,"Alloa","Edinburgh City",1,1,"D",0,0,"D",1.67,3.94,4.45,"0-0","1-1",14,6,6,3,2,2,0,0,7,5,11,8,2,12,19,"7-5","Y","N","N",4,0,8
"1640","SC2",2023-09-30,"Falkirk","Montrose",3,2,"H",0,0,"D",1.39,4.65,6.35,"0-0","3-2",21,7,10,3,2,3,0,0,13,5,12,8,5,18,20,"13-5","Y","Y","Y",5,0,8
"1641","SC2",2023-09-30,"Kelty Hearts","Queen of Sth",3,1,"H",1,1,"D",2.77,3.59,2.35,"1-1","3-1",8,3,14,4,3,2,0,0,5,6,18,14,4,11,32,"5-6","Y","Y","Y",5,0,8
"1642","SC2",2023-09-30,"Stirling","Cove Rangers",2,2,"D",1,0,"H",2.5,3.31,2.76,"1-0","2-2",11,7,9,4,2,0,0,1,2,4,8,7,4,6,15,"2-4","Y","Y","Y",2,1,8
"1643","SC3",2023-08-05,"Bonnyrigg Rose","Dumbarton",1,1,"D",0,1,"A",2.53,3.26,2.77,"0-1","1-1",9,4,13,6,3,2,0,0,10,4,13,12,2,14,25,"10-4","Y","N","N",5,0,1
"1644","SC3",2023-08-05,"East Fife","Peterhead",0,3,"A",0,1,"A",1.78,3.66,4.39,"0-1","0-3",5,3,10,6,2,3,0,0,4,4,10,12,3,8,22,"4-4","Y","Y","N",5,0,1
"1645","SC3",2023-08-05,"Elgin","Stranraer",0,1,"A",0,1,"A",2.56,3.38,2.65,"0-1","0-1",10,3,6,2,0,1,0,0,5,6,12,18,1,11,30,"5-6","N","N","N",1,0,1
"1646","SC3",2023-08-05,"Spartans","Clyde",1,1,"D",0,1,"A",1.59,3.64,4.05,"0-1","1-1",6,2,7,3,1,1,0,0,6,2,3,7,2,8,10,"6-2","Y","N","N",2,0,1
"1647","SC3",2023-08-05,"Stenhousemuir","Forfar",0,0,"D",0,0,"D",2.2,3.55,3.04,"0-0","0-0",12,3,9,5,2,2,0,0,6,7,12,10,0,13,22,"6-7","N","N","N",4,0,1
"1648","SC3",2023-08-12,"Clyde","Bonnyrigg Rose",0,2,"A",0,1,"A",NA,NA,NA,"0-1","0-2",6,1,9,5,0,2,0,0,4,5,6,10,2,9,16,"4-5","Y","N","N",2,0,2
"1649","SC3",2023-08-12,"Dumbarton","Spartans",1,1,"D",0,0,"D",NA,NA,NA,"0-0","1-1",3,2,2,1,1,3,0,0,4,7,7,5,2,11,12,"4-7","Y","N","N",4,0,2
"1650","SC3",2023-08-12,"Forfar","Elgin",0,0,"D",0,0,"D",1.79,3.58,4.44,"0-0","0-0",11,3,7,3,1,3,0,0,4,6,15,14,0,10,29,"4-6","N","N","N",4,0,2
"1651","SC3",2023-08-12,"Peterhead","Stenhousemuir",0,0,"D",0,0,"D",NA,NA,NA,"0-0","0-0",9,2,8,1,1,2,1,0,4,6,10,14,0,10,24,"4-6","N","N","N",3,1,2
"1652","SC3",2023-08-12,"Stranraer","East Fife",1,1,"D",0,0,"D",2.44,3.29,2.85,"0-0","1-1",3,3,14,8,2,1,1,0,6,6,8,11,2,12,19,"6-6","Y","N","N",3,1,2
"1653","SC3",2023-08-19,"Bonnyrigg Rose","Stranraer",1,1,"D",1,0,"H",2.55,3.32,2.7,"1-0","1-1",5,3,5,2,2,1,0,0,2,4,12,8,2,6,20,"2-4","Y","N","N",3,0,3
"1654","SC3",2023-08-19,"Clyde","Peterhead",1,2,"A",1,2,"A",2.64,3.55,2.39,"1-2","1-2",3,3,11,5,2,1,1,1,2,1,13,4,3,3,17,"2-1","Y","Y","N",3,2,3
"1655","SC3",2023-08-19,"Dumbarton","Forfar",3,1,"H",0,1,"A",2.66,3.32,2.58,"0-1","3-1",14,4,6,3,0,1,0,0,9,5,7,9,4,14,16,"9-5","Y","Y","Y",1,0,3
"1656","SC3",2023-08-19,"East Fife","Stenhousemuir",0,2,"A",0,1,"A",2.31,3.36,2.77,"0-1","0-2",6,3,6,4,2,3,0,0,6,3,9,14,2,9,23,"6-3","Y","N","N",5,0,3
"1657","SC3",2023-08-19,"Spartans","Elgin",2,1,"H",0,0,"D",1.61,3.93,4.75,"0-0","2-1",11,6,8,3,0,0,0,0,5,3,11,8,3,8,19,"5-3","Y","Y","N",0,0,3
"1658","SC3",2023-08-26,"Elgin","East Fife",1,1,"D",1,0,"H",2.91,3.33,2.38,"1-0","1-1",8,3,10,4,4,2,0,0,2,5,12,7,2,7,19,"2-5","Y","N","N",6,0,4
"1659","SC3",2023-08-26,"Forfar","Bonnyrigg Rose",1,2,"A",0,1,"A",2.21,3.19,3.34,"0-1","1-2",9,4,8,3,2,1,1,0,3,4,21,20,3,7,41,"3-4","Y","Y","N",3,1,4
"1660","SC3",2023-08-26,"Peterhead","Spartans",0,1,"A",0,0,"D",2.29,3.34,3.04,"0-0","0-1",5,2,11,6,4,1,0,0,3,5,10,8,1,8,18,"3-5","N","N","N",5,0,4
"1661","SC3",2023-08-26,"Stenhousemuir","Dumbarton",2,4,"A",0,4,"A",2.46,3.26,2.85,"0-4","2-4",10,5,12,8,4,5,0,1,9,7,9,12,6,16,21,"9-7","Y","Y","Y",9,1,4
"1662","SC3",2023-08-26,"Stranraer","Clyde",1,0,"H",0,0,"D",1.93,3.59,3.76,"0-0","1-0",15,3,9,4,1,1,0,0,7,3,11,9,1,10,20,"7-3","N","N","N",2,0,4
"1663","SC3",2023-09-02,"Bonnyrigg Rose","Elgin",5,1,"H",2,0,"H",1.74,3.65,4.66,"2-0","5-1",13,6,11,3,1,1,0,0,6,3,22,11,6,9,33,"6-3","Y","Y","Y",2,0,5
"1664","SC3",2023-09-02,"Clyde","Forfar",0,0,"D",0,0,"D",2.66,3.25,2.63,"0-0","0-0",7,5,7,1,2,2,0,0,3,2,14,12,0,5,26,"3-2","N","N","N",4,0,5
"1665","SC3",2023-09-02,"Dumbarton","East Fife",1,0,"H",0,0,"D",1.8,3.69,4.19,"0-0","1-0",10,3,7,2,1,2,0,0,3,4,13,15,1,7,28,"3-4","N","N","N",3,0,5
"1666","SC3",2023-09-02,"Spartans","Stenhousemuir",0,1,"A",0,0,"D",1.85,3.82,3.84,"0-0","0-1",7,2,9,4,1,0,0,1,10,3,6,7,1,13,13,"10-3","N","N","N",1,1,5
"1667","SC3",2023-09-02,"Stranraer","Peterhead",2,1,"H",2,0,"H",2.18,3.42,3.19,"2-0","2-1",14,7,11,5,3,3,0,0,6,5,11,18,3,11,29,"6-5","Y","Y","N",6,0,5
"1668","SC3",2023-09-16,"East Fife","Clyde",2,0,"H",1,0,"H",1.9,3.49,3.53,"1-0","2-0",9,4,6,3,2,2,0,0,4,0,10,17,2,4,27,"4-0","Y","N","N",4,0,6
"1669","SC3",2023-09-16,"Elgin","Dumbarton",2,0,"H",1,0,"H",3.56,3.48,2.01,"1-0","2-0",11,4,11,2,1,0,0,0,7,7,9,11,2,14,20,"7-7","Y","N","N",1,0,6
"1670","SC3",2023-09-16,"Forfar","Spartans",2,2,"D",1,2,"A",2.42,3.2,2.73,"1-2","2-2",8,6,12,7,3,2,0,0,5,4,11,8,4,9,19,"5-4","Y","Y","Y",5,0,6
"1671","SC3",2023-09-16,"Peterhead","Bonnyrigg Rose",2,1,"H",0,0,"D",2.58,3.22,2.73,"0-0","2-1",10,4,8,2,5,2,0,0,2,3,21,12,3,5,33,"2-3","Y","Y","N",7,0,6
"1672","SC3",2023-09-16,"Stenhousemuir","Stranraer",5,0,"H",2,0,"H",2.24,3.34,3.13,"2-0","5-0",10,8,3,2,2,3,0,0,8,3,9,10,5,11,19,"8-3","Y","Y","Y",5,0,6
"1673","SC3",2023-09-23,"Bonnyrigg Rose","Stenhousemuir",0,1,"A",0,0,"D",2.37,3.43,2.85,"0-0","0-1",8,3,11,5,5,3,0,0,4,2,13,15,1,6,28,"4-2","N","N","N",8,0,7
"1674","SC3",2023-09-23,"Clyde","Elgin",2,1,"H",2,0,"H",2.35,3.39,2.91,"2-0","2-1",11,4,13,2,2,2,0,0,7,2,7,8,3,9,15,"7-2","Y","Y","N",4,0,7
"1675","SC3",2023-09-23,"Dumbarton","Peterhead",0,1,"A",0,0,"D",2.16,3.42,3.22,"0-0","0-1",11,3,16,5,2,2,1,0,11,7,14,9,1,18,23,"11-7","N","N","N",4,1,7
"1676","SC3",2023-09-23,"Spartans","East Fife",2,2,"D",1,0,"H",1.98,3.36,3.83,"1-0","2-2",7,2,10,8,2,2,0,0,5,2,8,10,4,7,18,"5-2","Y","Y","Y",4,0,7
"1677","SC3",2023-09-23,"Stranraer","Forfar",0,2,"A",0,2,"A",2.3,3.3,3,"0-2","0-2",9,5,11,6,1,2,0,0,9,8,7,18,2,17,25,"9-8","Y","N","N",3,0,7
"1678","SC3",2023-09-30,"Dumbarton","Stranraer",3,1,"H",2,1,"H",1.83,3.62,4.12,"2-1","3-1",10,5,6,1,2,3,0,0,8,3,11,10,4,11,21,"8-3","Y","Y","Y",5,0,8
"1679","SC3",2023-09-30,"East Fife","Forfar",1,1,"D",1,0,"H",2.33,3.26,3.05,"1-0","1-1",2,1,9,3,1,2,0,0,4,3,15,17,2,7,32,"4-3","Y","N","N",3,0,8
"1680","SC3",2023-09-30,"Peterhead","Elgin",6,0,"H",2,0,"H",1.7,3.79,4.68,"2-0","6-0",13,8,4,1,0,5,0,0,4,2,9,15,6,6,24,"4-2","Y","Y","Y",5,0,8
"1681","SC3",2023-09-30,"Spartans","Bonnyrigg Rose",2,2,"D",0,1,"A",2.17,3.37,3.25,"0-1","2-2",7,3,9,4,2,1,0,0,6,4,15,11,4,10,26,"6-4","Y","Y","Y",3,0,8
"1682","SC3",2023-09-30,"Stenhousemuir","Clyde",2,2,"D",1,0,"H",1.6,3.98,5.34,"1-0","2-2",13,8,12,4,2,4,0,0,5,4,7,12,4,9,19,"5-4","Y","Y","Y",6,0,8
"613","SP1",2023-08-11,"Almeria","Vallecano",0,2,"A",0,2,"A",2.62,3.3,2.96,"0-2","0-2",19,5,10,4,1,3,0,0,8,3,16,25,2,11,41,"8-3","Y","N","N",4,0,1
"614","SP1",2023-08-11,"Sevilla","Valencia",1,2,"A",0,0,"D",1.95,3.47,4.48,"0-0","1-2",9,3,10,3,3,2,1,0,8,1,15,17,3,9,32,"8-1","Y","Y","N",5,1,1
"615","SP1",2023-08-12,"Sociedad","Girona",1,1,"D",1,0,"H",1.65,4.05,5.66,"1-0","1-1",15,2,6,1,2,5,0,0,4,1,22,9,2,5,31,"4-1","Y","N","N",7,0,1
"616","SP1",2023-08-12,"Las Palmas","Mallorca",1,1,"D",1,0,"H",2.45,3.02,3.46,"1-0","1-1",5,2,12,2,3,2,0,0,3,6,11,21,2,9,32,"3-6","Y","N","N",5,0,1
"617","SP1",2023-08-12,"Ath Bilbao","Real Madrid",0,2,"A",0,2,"A",3.43,3.58,2.19,"0-2","0-2",7,1,14,8,3,1,0,0,7,5,18,6,2,12,24,"7-5","Y","N","N",4,0,1
"618","SP1",2023-08-13,"Celta","Osasuna",0,2,"A",0,1,"A",2.15,3.19,3.99,"0-1","0-2",11,1,11,5,1,1,0,0,7,2,11,15,2,9,26,"7-2","Y","N","N",2,0,1
"619","SP1",2023-08-13,"Villarreal","Betis",1,2,"A",0,1,"A",1.81,3.98,4.43,"0-1","1-2",18,5,12,5,1,3,0,0,9,4,13,17,3,13,30,"9-4","Y","Y","N",4,0,1
"620","SP1",2023-08-13,"Getafe","Barcelona",0,0,"D",0,0,"D",6.69,4.04,1.57,"0-0","0-0",5,2,14,4,8,2,1,1,3,4,20,11,0,7,31,"3-4","N","N","N",10,2,1
"621","SP1",2023-08-14,"Cadiz","Alaves",1,0,"H",1,0,"H",2.25,3.08,3.86,"1-0","1-0",12,3,10,2,3,2,1,0,2,4,19,15,1,6,34,"2-4","N","N","N",5,1,1
"622","SP1",2023-08-14,"Ath Madrid","Granada",3,1,"H",1,0,"H",1.31,5.76,10.3,"1-0","3-1",14,6,7,4,3,1,0,0,3,3,15,9,4,6,24,"3-3","Y","Y","Y",4,0,1
"623","SP1",2023-08-18,"Mallorca","Villarreal",0,1,"A",0,0,"D",3.04,3.13,2.68,"0-0","0-1",8,1,15,3,2,4,0,0,6,5,12,11,1,11,23,"6-5","N","N","N",6,0,2
"624","SP1",2023-08-18,"Valencia","Las Palmas",1,0,"H",0,0,"D",1.61,4.02,6.49,"0-0","1-0",9,4,7,1,0,0,0,0,6,4,12,6,1,10,18,"6-4","N","N","N",0,0,2
"625","SP1",2023-08-19,"Sociedad","Celta",1,1,"D",1,0,"H",1.76,3.54,5.57,"1-0","1-1",11,2,17,6,2,1,0,0,9,7,12,12,2,16,24,"9-7","Y","N","N",3,0,2
"626","SP1",2023-08-19,"Almeria","Real Madrid",1,3,"A",1,1,"D",8.15,5.11,1.4,"1-1","1-3",20,8,24,9,1,0,0,0,4,5,10,13,4,9,23,"4-5","Y","Y","Y",1,0,2
"627","SP1",2023-08-19,"Osasuna","Ath Bilbao",0,2,"A",0,2,"A",2.89,3.1,2.79,"0-2","0-2",18,7,8,2,1,5,1,1,5,3,9,14,2,8,23,"5-3","Y","N","N",6,2,2
"628","SP1",2023-08-20,"Girona","Getafe",3,0,"H",1,0,"H",2.06,3.22,4.31,"1-0","3-0",7,6,9,2,2,5,0,0,3,2,11,20,3,5,31,"3-2","Y","Y","N",7,0,2
"629","SP1",2023-08-20,"Barcelona","Cadiz",2,0,"H",0,0,"D",1.21,6.9,14.96,"0-0","2-0",23,10,10,1,4,3,0,0,10,2,9,22,2,12,31,"10-2","Y","N","N",7,0,2
"630","SP1",2023-08-20,"Betis","Ath Madrid",0,0,"D",0,0,"D",3.93,3.57,2.02,"0-0","0-0",14,0,5,1,2,1,0,0,2,7,10,8,0,9,18,"2-7","N","N","N",3,0,2
"631","SP1",2023-08-21,"Alaves","Sevilla",4,3,"H",2,2,"D",3.45,3.1,2.41,"2-2","4-3",14,7,12,2,1,2,0,0,4,4,14,13,7,8,27,"4-4","Y","Y","Y",3,0,2
"632","SP1",2023-08-21,"Granada","Vallecano",0,2,"A",0,0,"D",2.68,3.09,3.03,"0-0","0-2",14,7,17,9,2,1,1,0,5,6,14,11,2,11,25,"5-6","Y","N","N",3,1,2
"633","SP1",2023-08-25,"Las Palmas","Sociedad",0,0,"D",0,0,"D",4.23,3.36,2.04,"0-0","0-0",11,5,8,1,1,4,0,0,5,7,7,29,0,12,36,"5-7","N","N","N",5,0,3
"634","SP1",2023-08-25,"Celta","Real Madrid",0,1,"A",0,0,"D",4.93,3.97,1.75,"0-0","0-1",13,4,10,3,2,3,0,0,3,5,19,14,1,8,33,"3-5","N","N","N",5,0,3
"635","SP1",2023-08-26,"Cadiz","Almeria",1,1,"D",0,0,"D",2.24,3.44,3.44,"0-0","1-1",11,3,5,2,0,5,1,1,7,3,16,22,2,10,38,"7-3","Y","N","N",5,2,3
"636","SP1",2023-08-26,"Granada","Mallorca",3,2,"H",1,1,"D",2.71,3.03,3.05,"1-1","3-2",10,4,10,5,2,7,0,0,5,3,11,27,5,8,38,"5-3","Y","Y","Y",9,0,3
"637","SP1",2023-08-26,"Sevilla","Girona",1,2,"A",1,1,"D",2.1,3.52,3.73,"1-1","1-2",21,4,8,3,2,1,0,0,6,6,11,18,3,12,29,"6-6","Y","Y","N",3,0,3
"638","SP1",2023-08-27,"Villarreal","Barcelona",3,4,"A",2,2,"D",3.62,3.76,2.06,"2-2","3-4",13,6,21,11,3,3,0,0,2,6,12,14,7,8,26,"2-6","Y","Y","Y",6,0,3
"639","SP1",2023-08-27,"Valencia","Osasuna",1,2,"A",0,1,"A",1.89,3.56,4.53,"0-1","1-2",16,4,7,2,3,4,0,0,6,3,13,12,3,9,25,"6-3","Y","Y","N",7,0,3
"640","SP1",2023-08-27,"Ath Bilbao","Betis",4,2,"H",3,2,"H",1.96,3.7,4,"3-2","4-2",14,6,7,3,4,2,0,0,5,3,23,11,6,8,34,"5-3","Y","Y","Y",6,0,3
"641","SP1",2023-08-28,"Getafe","Alaves",1,0,"H",0,0,"D",2.36,2.89,3.88,"0-0","1-0",15,4,16,2,1,2,0,0,4,5,13,15,1,9,28,"4-5","N","N","N",3,0,3
"642","SP1",2023-08-28,"Vallecano","Ath Madrid",0,7,"A",0,3,"A",4.16,3.48,2,"0-3","0-7",12,3,17,10,4,3,0,0,8,3,19,17,7,11,36,"8-3","Y","Y","Y",7,0,3
"643","SP1",2023-09-01,"Cadiz","Villarreal",3,1,"H",2,1,"H",3.43,3.59,2.21,"2-1","3-1",18,4,7,3,5,4,0,1,7,3,21,15,4,10,36,"7-3","Y","Y","Y",9,1,4
"644","SP1",2023-09-01,"Almeria","Celta",2,3,"A",0,2,"A",3.04,3.33,2.55,"0-2","2-3",16,5,14,8,1,1,0,0,6,5,9,9,5,11,18,"6-5","Y","Y","Y",2,0,4
"645","SP1",2023-09-02,"Sociedad","Granada",5,3,"H",2,1,"H",1.47,4.63,7.49,"2-1","5-3",15,6,8,5,1,5,0,0,2,5,15,14,8,7,29,"2-5","Y","Y","Y",6,0,4
"646","SP1",2023-09-02,"Real Madrid","Getafe",2,1,"H",0,1,"A",1.34,5.13,10.76,"0-1","2-1",26,12,6,2,2,6,0,0,11,1,12,16,3,12,28,"11-1","Y","Y","N",8,0,4
"647","SP1",2023-09-02,"Alaves","Valencia",1,0,"H",1,0,"H",2.96,2.99,2.82,"1-0","1-0",7,1,9,4,4,2,0,0,1,2,18,9,1,3,27,"1-2","N","N","N",6,0,4
"648","SP1",2023-09-02,"Betis","Vallecano",1,0,"H",0,0,"D",1.98,3.55,4.14,"0-0","1-0",14,5,15,6,3,5,0,0,2,3,22,20,1,5,42,"2-3","N","N","N",8,0,4
"649","SP1",2023-09-03,"Girona","Las Palmas",1,0,"H",0,0,"D",1.69,3.83,5.59,"0-0","1-0",11,6,10,5,3,3,0,0,3,5,15,10,1,8,25,"3-5","N","N","N",6,0,4
"650","SP1",2023-09-03,"Mallorca","Ath Bilbao",0,0,"D",0,0,"D",3.3,3.11,2.49,"0-0","0-0",8,2,11,3,0,1,0,0,3,5,12,17,0,8,29,"3-5","N","N","N",1,0,4
"651","SP1",2023-09-03,"Osasuna","Barcelona",1,2,"A",0,1,"A",5.37,4.17,1.65,"0-1","1-2",11,3,9,4,1,3,1,0,8,5,6,16,3,13,22,"8-5","Y","Y","N",4,1,4
"652","SP1",2023-09-15,"Vallecano","Alaves",2,0,"H",1,0,"H",2.03,3.23,4.52,"1-0","2-0",20,11,9,1,2,3,0,0,5,3,15,14,2,8,29,"5-3","Y","N","N",5,0,4
"653","SP1",2023-09-16,"Ath Bilbao","Cadiz",3,0,"H",0,0,"D",1.56,4.17,6.66,"0-0","3-0",20,9,5,4,1,4,0,0,5,4,10,20,3,9,30,"5-4","Y","Y","N",5,0,5
"654","SP1",2023-09-16,"Valencia","Ath Madrid",3,0,"H",2,0,"H",3.93,3.41,2.08,"2-0","3-0",12,8,11,3,1,5,0,0,5,8,13,17,3,13,30,"5-8","Y","Y","N",6,0,5
"655","SP1",2023-09-16,"Celta","Mallorca",0,1,"A",0,0,"D",2.08,3.13,4.4,"0-0","0-1",16,4,7,4,1,3,0,0,10,1,9,15,1,11,24,"10-1","N","N","N",4,0,5
"656","SP1",2023-09-16,"Barcelona","Betis",5,0,"H",2,0,"H",1.38,5.4,8.04,"2-0","5-0",17,9,11,2,1,2,0,0,9,5,9,10,5,14,19,"9-5","Y","Y","Y",3,0,5
"657","SP1",2023-09-17,"Getafe","Osasuna",3,2,"H",1,1,"D",2.65,2.93,3.24,"1-1","3-2",11,6,8,3,6,2,0,0,6,3,15,11,5,9,26,"6-3","Y","Y","Y",8,0,5
"658","SP1",2023-09-17,"Villarreal","Almeria",2,1,"H",1,1,"D",1.48,4.98,6.38,"1-1","2-1",10,4,17,7,2,3,0,0,7,6,16,6,3,13,22,"7-6","Y","Y","N",5,0,5
"659","SP1",2023-09-17,"Sevilla","Las Palmas",1,0,"H",0,0,"D",1.64,3.93,5.99,"0-0","1-0",26,9,12,2,3,5,0,0,7,3,13,12,1,10,25,"7-3","N","N","N",8,0,5
"660","SP1",2023-09-17,"Real Madrid","Sociedad",2,1,"H",0,1,"A",1.69,3.97,5.31,"0-1","2-1",17,8,15,5,3,2,0,0,4,3,11,14,3,7,25,"4-3","Y","Y","N",5,0,5
"661","SP1",2023-09-18,"Granada","Girona",2,4,"A",0,3,"A",2.78,3.44,2.65,"0-3","2-4",12,5,13,7,3,3,0,0,4,5,13,21,6,9,34,"4-5","Y","Y","Y",6,0,5
"662","SP1",2023-09-22,"Alaves","Ath Bilbao",0,2,"A",0,1,"A",4.27,3.16,2.12,"0-1","0-2",15,5,11,3,2,2,0,0,3,4,13,9,2,7,22,"3-4","Y","N","N",4,0,5
"663","SP1",2023-09-23,"Girona","Mallorca",5,3,"H",4,1,"H",1.94,3.39,4.54,"4-1","5-3",23,10,15,5,1,5,0,0,6,5,10,12,8,11,22,"6-5","Y","Y","Y",6,0,6
"664","SP1",2023-09-23,"Osasuna","Sevilla",0,0,"D",0,0,"D",2.62,3.22,2.99,"0-0","0-0",16,2,15,3,2,3,0,0,7,4,11,7,0,11,18,"7-4","N","N","N",5,0,6
"665","SP1",2023-09-23,"Barcelona","Celta",3,2,"H",0,1,"A",1.29,6.04,10.38,"0-1","3-2",15,6,13,7,2,1,0,0,2,3,10,11,5,5,21,"2-3","Y","Y","Y",3,0,6
"666","SP1",2023-09-23,"Almeria","Valencia",2,2,"D",0,1,"A",3.11,3.53,2.36,"0-1","2-2",17,10,7,5,4,2,0,0,8,3,12,10,4,11,22,"8-3","Y","Y","Y",6,0,6
"667","SP1",2023-09-24,"Sociedad","Getafe",4,3,"H",1,2,"A",1.56,3.82,7.76,"1-2","4-3",10,6,10,7,3,2,0,0,2,1,13,24,7,3,37,"2-1","Y","Y","Y",5,0,6
"668","SP1",2023-09-24,"Vallecano","Villarreal",1,1,"D",1,1,"D",2.56,3.54,2.83,"1-1","1-1",11,6,13,6,2,3,0,1,2,8,20,18,2,10,38,"2-8","Y","N","N",5,1,6
"669","SP1",2023-09-24,"Betis","Cadiz",1,1,"D",0,1,"A",1.86,3.62,4.64,"0-1","1-1",21,7,5,1,2,3,0,0,11,8,10,14,2,19,24,"11-8","Y","N","N",5,0,6
"670","SP1",2023-09-24,"Las Palmas","Granada",1,0,"H",0,0,"D",2.05,3.56,3.87,"0-0","1-0",10,3,2,1,6,4,1,0,6,7,13,19,1,13,32,"6-7","N","N","N",10,1,6
"671","SP1",2023-09-24,"Ath Madrid","Real Madrid",3,1,"H",2,1,"H",2.88,3.37,2.61,"2-1","3-1",10,4,20,5,1,3,0,0,6,11,13,10,4,17,23,"6-11","Y","Y","Y",4,0,6
"672","SP1",2023-09-26,"Sevilla","Almeria",5,1,"H",3,0,"H",1.7,4.1,5.09,"3-0","5-1",18,9,10,1,3,2,0,0,9,4,15,16,6,13,31,"9-4","Y","Y","Y",5,0,6
"673","SP1",2023-09-26,"Mallorca","Barcelona",2,2,"D",2,1,"H",6.98,4.53,1.51,"2-1","2-2",10,5,10,4,4,1,1,0,7,2,19,7,4,9,26,"7-2","Y","Y","Y",5,1,7
"674","SP1",2023-09-27,"Ath Bilbao","Getafe",2,2,"D",1,0,"H",1.64,3.76,6.51,"1-0","2-2",9,4,13,5,5,6,1,0,5,4,9,19,4,9,28,"5-4","Y","Y","Y",11,1,7
"675","SP1",2023-09-27,"Real Madrid","Las Palmas",2,0,"H",1,0,"H",1.21,7.24,13.67,"1-0","2-0",21,9,16,2,0,1,0,0,7,2,7,9,2,9,16,"7-2","Y","N","N",1,0,7
"676","SP1",2023-09-27,"Villarreal","Girona",1,2,"A",0,0,"D",2.22,3.72,3.23,"0-0","1-2",14,3,17,5,3,2,0,0,5,6,9,11,3,11,20,"5-6","Y","Y","N",5,0,7
"677","SP1",2023-09-27,"Cadiz","Vallecano",0,0,"D",0,0,"D",2.64,3.17,3,"0-0","0-0",9,2,9,4,5,6,0,1,1,2,16,13,0,3,29,"1-2","N","N","N",11,1,7
"678","SP1",2023-09-27,"Valencia","Sociedad",0,1,"A",0,1,"A",2.68,3.18,2.94,"0-1","0-1",9,2,2,1,4,7,1,0,0,2,14,17,1,2,31,"0-2","N","N","N",11,1,7
"679","SP1",2023-09-28,"Celta","Alaves",1,1,"D",1,0,"H",1.71,3.59,5.97,"1-0","1-1",8,0,21,11,5,3,1,0,2,8,9,11,2,10,20,"2-8","Y","N","N",8,1,7
"680","SP1",2023-09-28,"Granada","Betis",1,1,"D",0,0,"D",3.11,3.53,2.36,"0-0","1-1",19,7,13,3,2,1,0,0,5,7,14,10,2,12,24,"5-7","Y","N","N",3,0,7
"681","SP1",2023-09-28,"Osasuna","Ath Madrid",0,2,"A",0,1,"A",3.68,3.47,2.14,"0-1","0-2",13,2,4,3,3,3,1,1,7,2,14,4,2,9,18,"7-2","Y","N","N",6,2,7
"682","SP1",2023-09-29,"Barcelona","Sevilla",1,0,"H",0,0,"D",1.39,5.36,7.97,"0-0","1-0",18,5,12,3,2,3,0,0,13,3,11,15,1,16,26,"13-3","N","N","N",5,0,7
"683","SP1",2023-09-30,"Getafe","Villarreal",0,0,"D",0,0,"D",3,3.25,2.59,"0-0","0-0",22,9,3,0,2,4,0,1,6,4,19,11,0,10,30,"6-4","N","N","N",6,1,8
"684","SP1",2023-09-30,"Vallecano","Mallorca",2,2,"D",1,1,"D",2.16,3.16,4.04,"1-1","2-2",19,5,9,4,2,5,0,0,5,0,12,20,4,5,32,"5-0","Y","Y","Y",7,0,8
"685","SP1",2023-09-30,"Girona","Real Madrid",0,3,"A",0,2,"A",3.56,4.02,2,"0-2","0-3",13,3,14,7,2,2,0,1,1,4,13,14,3,5,27,"1-4","Y","Y","N",4,1,8
"686","SP1",2023-09-30,"Sociedad","Ath Bilbao",3,0,"H",1,0,"H",2.26,3.3,3.53,"1-0","3-0",8,5,18,3,2,2,0,0,5,7,20,9,3,12,29,"5-7","Y","Y","N",4,0,8
"687","SP1",2023-10-01,"Almeria","Granada",3,3,"D",3,0,"H",1.92,3.68,3.96,"3-0","3-3",17,5,19,4,2,1,0,0,1,5,18,14,6,6,32,"1-5","Y","Y","Y",3,0,8
"688","SP1",2023-10-01,"Alaves","Osasuna",0,2,"A",0,1,"A",2.76,2.99,2.89,"0-1","0-2",17,3,10,3,2,3,1,0,4,2,13,13,2,6,26,"4-2","Y","N","N",5,1,8
"689","SP1",2023-10-01,"Ath Madrid","Cadiz",3,2,"H",1,2,"A",1.35,4.99,8.91,"1-2","3-2",18,9,8,4,1,3,0,0,5,3,5,10,5,8,15,"5-3","Y","Y","Y",4,0,8
"690","SP1",2023-10-01,"Betis","Valencia",3,0,"H",1,0,"H",2.31,3.29,3.26,"1-0","3-0",15,7,9,2,2,2,0,0,5,3,11,10,3,8,21,"5-3","Y","Y","N",4,0,8
"691","SP1",2023-10-02,"Las Palmas","Celta",2,1,"H",0,0,"D",2.52,3.15,2.99,"0-0","2-1",16,5,11,3,2,1,0,0,4,5,13,14,3,9,27,"4-5","Y","Y","N",3,0,8
"692","SP2",2023-08-11,"Amorebieta","Levante",1,1,"D",0,1,"A",3.32,3.1,2.48,"0-1","1-1",11,3,7,2,0,3,0,0,8,2,20,18,2,10,38,"8-2","Y","N","N",3,0,1
"693","SP2",2023-08-11,"Valladolid","Sp Gijon",2,0,"H",1,0,"H",1.93,3.36,4.67,"1-0","2-0",17,5,11,4,5,5,0,0,8,2,12,15,2,10,27,"8-2","Y","N","N",10,0,1
"694","SP2",2023-08-12,"Santander","Eibar",4,0,"H",3,0,"H",3.05,2.98,2.74,"3-0","4-0",11,8,14,3,2,3,0,0,4,6,10,14,4,10,24,"4-6","Y","Y","Y",5,0,1
"695","SP2",2023-08-12,"Zaragoza","Villarreal B",2,0,"H",0,0,"D",1.71,3.54,6.06,"0-0","2-0",16,7,11,2,2,4,0,0,4,0,9,8,2,4,17,"4-0","Y","N","N",6,0,1
"696","SP2",2023-08-12,"Elche","Ferrol",0,1,"A",0,0,"D",NA,NA,NA,"0-0","0-1",14,1,10,2,0,2,0,0,4,4,13,15,1,8,28,"4-4","N","N","N",2,0,1
"697","SP2",2023-08-13,"Burgos","Huesca",1,1,"D",1,1,"D",2.39,2.94,3.7,"1-1","1-1",19,5,4,2,2,4,0,0,6,5,5,14,2,11,19,"6-5","Y","N","N",6,0,1
"698","SP2",2023-08-13,"Albacete","Espanol",1,1,"D",0,1,"A",3.09,3.26,2.52,"0-1","1-1",17,6,8,3,3,3,0,0,7,4,14,19,2,11,33,"7-4","Y","N","N",6,0,1
"699","SP2",2023-08-13,"Cartagena","Eldense",0,1,"A",0,1,"A",2.2,3.11,3.96,"0-1","0-1",12,2,8,2,1,1,0,0,6,6,9,18,1,12,27,"6-6","N","N","N",2,0,1
"700","SP2",2023-08-13,"Leganes","Andorra",0,1,"A",0,1,"A",2.38,2.97,3.69,"0-1","0-1",12,4,13,3,5,1,0,0,2,2,25,12,1,4,37,"2-2","N","N","N",6,0,1
"701","SP2",2023-08-14,"Mirandes","Alcorcon",4,0,"H",2,0,"H",2.66,2.96,3.13,"2-0","4-0",17,6,18,6,1,1,0,0,2,5,14,6,4,7,20,"2-5","Y","Y","Y",2,0,1
"702","SP2",2023-08-14,"Tenerife","Oviedo",1,0,"H",1,0,"H",2.15,2.99,4.28,"1-0","1-0",10,3,7,0,6,0,0,0,6,4,17,7,1,10,24,"6-4","N","N","N",6,0,1
"703","SP2",2023-08-18,"Andorra","Cartagena",3,2,"H",0,0,"D",1.92,3.42,4.65,"0-0","3-2",17,5,5,3,2,4,0,0,6,0,14,11,5,6,25,"6-0","Y","Y","Y",6,0,2
"704","SP2",2023-08-18,"Zaragoza","Valladolid",1,0,"H",1,0,"H",2.39,3.08,3.51,"1-0","1-0",12,5,11,5,3,2,0,0,5,0,10,14,1,5,24,"5-0","N","N","N",5,0,2
"705","SP2",2023-08-19,"Eibar","Elche",2,1,"H",1,0,"H",2.25,3.06,3.89,"1-0","2-1",11,5,13,3,1,2,0,0,6,4,13,8,3,10,21,"6-4","Y","Y","N",3,0,2
"706","SP2",2023-08-19,"Espanol","Santander",2,0,"H",1,0,"H",1.85,3.35,5.22,"1-0","2-0",20,6,12,2,1,2,0,0,6,7,23,17,2,13,40,"6-7","Y","N","N",3,0,2
"707","SP2",2023-08-19,"Levante","Burgos",3,2,"H",2,1,"H",1.72,3.47,6.13,"2-1","3-2",18,11,16,8,4,3,0,0,4,4,19,7,5,8,26,"4-4","Y","Y","Y",7,0,2
"708","SP2",2023-08-19,"Alcorcon","Leganes",0,2,"A",0,0,"D",2.61,2.92,3.31,"0-0","0-2",15,2,7,4,3,4,0,0,8,5,12,16,2,13,28,"8-5","Y","N","N",7,0,2
"709","SP2",2023-08-20,"Oviedo","Ferrol",1,1,"D",0,1,"A",2.08,2.96,4.75,"0-1","1-1",16,3,5,1,2,1,0,1,6,3,8,12,2,9,20,"6-3","Y","N","N",3,1,2
"710","SP2",2023-08-20,"Sp Gijon","Mirandes",3,0,"H",3,0,"H",1.88,3.37,4.94,"3-0","3-0",12,7,22,11,2,2,0,0,7,11,11,12,3,18,23,"7-11","Y","Y","N",4,0,2
"711","SP2",2023-08-20,"Albacete","Amorebieta",2,2,"D",1,2,"A",1.64,3.56,6.99,"1-2","2-2",18,8,13,3,3,0,0,0,4,7,11,8,4,11,19,"4-7","Y","Y","Y",3,0,2
"712","SP2",2023-08-21,"Villarreal B","Eldense",3,1,"H",2,1,"H",2.31,3.34,3.32,"2-1","3-1",13,6,11,3,2,1,0,0,2,5,17,17,4,7,34,"2-5","Y","Y","Y",3,0,2
"713","SP2",2023-08-21,"Huesca","Tenerife",0,2,"A",0,1,"A",2.96,2.87,2.89,"0-1","0-2",12,4,11,5,0,4,0,0,4,2,7,18,2,6,25,"4-2","Y","N","N",4,0,2
"714","SP2",2023-08-25,"Cartagena","Levante",0,1,"A",0,1,"A",2.98,3.13,2.69,"0-1","0-1",9,3,13,5,4,6,0,0,2,12,14,15,1,14,29,"2-12","N","N","N",10,0,3
"715","SP2",2023-08-26,"Burgos","Oviedo",1,0,"H",1,0,"H",2.74,2.8,3.28,"1-0","1-0",16,5,9,3,4,4,0,1,4,3,13,16,1,7,29,"4-3","N","N","N",8,1,3
"716","SP2",2023-08-26,"Tenerife","Zaragoza",0,1,"A",0,0,"D",2.23,2.89,4.27,"0-0","0-1",14,2,7,4,3,3,1,0,11,3,19,10,1,14,29,"11-3","N","N","N",6,1,3
"717","SP2",2023-08-26,"Elche","Villarreal B",1,0,"H",1,0,"H",1.63,3.86,6.33,"1-0","1-0",19,8,12,3,2,0,0,0,4,4,14,8,1,8,22,"4-4","N","N","N",2,0,3
"718","SP2",2023-08-26,"Valladolid","Alcorcon",0,2,"A",0,1,"A",1.79,3.44,5.49,"0-1","0-2",28,2,12,5,1,4,0,0,10,3,10,20,2,13,30,"10-3","Y","N","N",5,0,3
"719","SP2",2023-08-27,"Ferrol","Sp Gijon",2,0,"H",0,0,"D",2.53,3.04,3.29,"0-0","2-0",13,3,6,1,0,2,0,0,4,4,12,16,2,8,28,"4-4","Y","N","N",2,0,3
"720","SP2",2023-08-27,"Amorebieta","Andorra",3,0,"H",1,0,"H",3.35,3.1,2.46,"1-0","3-0",9,4,15,5,2,1,0,0,3,7,14,8,3,10,22,"3-7","Y","Y","N",3,0,3
"721","SP2",2023-08-27,"Mirandes","Espanol",0,1,"A",0,0,"D",3.58,3.22,2.28,"0-0","0-1",5,1,17,4,4,2,0,0,4,7,12,13,1,11,25,"4-7","N","N","N",6,0,3
"722","SP2",2023-08-27,"Leganes","Albacete",2,0,"H",1,0,"H",2.47,3.12,3.28,"1-0","2-0",11,2,12,3,3,2,0,0,2,5,9,15,2,7,24,"2-5","Y","N","N",5,0,3
"723","SP2",2023-08-28,"Eldense","Eibar",2,1,"H",2,0,"H",2.96,3.04,2.73,"2-0","2-1",7,4,12,2,1,4,0,0,6,4,8,11,3,10,19,"6-4","Y","Y","N",5,0,3
"724","SP2",2023-08-28,"Santander","Huesca",0,0,"D",0,0,"D",2.12,3.13,4.12,"0-0","0-0",10,0,14,0,5,5,0,0,12,6,16,16,0,18,32,"12-6","N","N","N",10,0,3
"725","SP2",2023-09-01,"Alcorcon","Ferrol",1,1,"D",0,0,"D",2.34,2.99,3.77,"0-0","1-1",12,3,7,2,3,1,0,0,3,1,11,9,2,4,20,"3-1","Y","N","N",4,0,4
"726","SP2",2023-09-01,"Albacete","Valladolid",2,0,"H",1,0,"H",2.11,3.31,3.97,"1-0","2-0",9,3,7,1,1,5,0,0,5,4,19,12,2,9,31,"5-4","Y","N","N",6,0,4
"727","SP2",2023-09-02,"Sp Gijon","Burgos",2,1,"H",1,0,"H",2.1,3.12,4.32,"1-0","2-1",17,2,5,2,1,1,0,0,10,2,12,15,3,12,27,"10-2","Y","Y","N",2,0,4
"728","SP2",2023-09-02,"Levante","Oviedo",1,1,"D",0,0,"D",1.86,3.39,5.06,"0-0","1-1",17,4,11,2,3,3,0,1,4,2,18,11,2,6,29,"4-2","Y","N","N",6,1,4
"729","SP2",2023-09-02,"Elche","Santander",1,1,"D",1,0,"H",1.84,3.53,4.82,"1-0","1-1",22,6,12,6,0,3,1,0,8,1,11,16,2,9,27,"8-1","Y","N","N",3,1,4
"730","SP2",2023-09-02,"Villarreal B","Cartagena",1,2,"A",1,0,"H",2.24,3.38,3.5,"1-0","1-2",17,6,12,5,2,3,0,0,3,7,9,14,3,10,23,"3-7","Y","Y","N",5,0,4
"731","SP2",2023-09-03,"Andorra","Tenerife",0,1,"A",0,0,"D",2.29,3.07,3.73,"0-0","0-1",16,2,10,4,0,3,0,0,8,4,7,18,1,12,25,"8-4","N","N","N",3,0,4
"732","SP2",2023-09-03,"Eibar","Leganes",0,1,"A",0,1,"A",2.07,3.15,4.39,"0-1","0-1",20,2,2,1,2,3,0,0,8,1,11,14,1,9,25,"8-1","N","N","N",5,0,4
"733","SP2",2023-09-03,"Espanol","Amorebieta",3,2,"H",0,2,"A",1.62,3.76,6.71,"0-2","3-2",21,7,7,4,3,1,0,0,4,3,6,15,5,7,21,"4-3","Y","Y","Y",4,0,4
"734","SP2",2023-09-03,"Zaragoza","Eldense",2,0,"H",1,0,"H",1.77,3.45,5.68,"1-0","2-0",13,1,8,3,2,1,0,0,1,3,6,13,2,4,19,"1-3","Y","N","N",3,0,4
"735","SP2",2023-09-03,"Huesca","Mirandes",1,1,"D",0,0,"D",2.09,3.28,4.07,"0-0","1-1",15,3,13,3,5,5,1,0,9,5,15,10,2,14,25,"9-5","Y","N","N",10,1,4
"736","SP2",2023-09-08,"Levante","Espanol",1,4,"A",1,2,"A",2.67,3.19,2.95,"1-2","1-4",15,3,17,10,0,0,1,0,5,3,13,13,5,8,26,"5-3","Y","Y","Y",0,1,5
"737","SP2",2023-09-09,"Burgos","Eibar",1,0,"H",0,0,"D",3.13,2.99,2.68,"0-0","1-0",6,3,14,2,2,4,0,1,5,10,10,13,1,15,23,"5-10","N","N","N",6,1,5
"738","SP2",2023-09-09,"Oviedo","Sp Gijon",0,0,"D",0,0,"D",2.36,2.96,3.77,"0-0","0-0",6,0,7,1,2,3,0,0,7,1,12,17,0,8,29,"7-1","N","N","N",5,0,5
"739","SP2",2023-09-09,"Leganes","Huesca",2,0,"H",1,0,"H",2.04,3.09,4.65,"1-0","2-0",11,7,8,3,0,2,0,0,2,3,18,12,2,5,30,"2-3","Y","N","N",2,0,5
"740","SP2",2023-09-09,"Tenerife","Albacete",2,0,"H",2,0,"H",2.18,3.08,4.09,"2-0","2-0",10,4,14,4,2,1,0,0,1,7,19,9,2,8,28,"1-7","Y","N","N",3,0,5
"741","SP2",2023-09-10,"Ferrol","Villarreal B",2,2,"D",0,1,"A",1.97,3.33,4.54,"0-1","2-2",24,8,6,3,3,2,0,0,13,0,11,12,4,13,23,"13-0","Y","Y","Y",5,0,5
"742","SP2",2023-09-10,"Santander","Amorebieta",1,0,"H",1,0,"H",1.85,3.58,4.73,"1-0","1-0",7,4,7,2,4,2,0,0,4,4,12,17,1,8,29,"4-4","N","N","N",6,0,5
"743","SP2",2023-09-10,"Cartagena","Zaragoza",1,3,"A",1,2,"A",3.25,2.93,2.64,"1-2","1-3",19,5,9,5,2,2,0,0,6,4,11,6,4,10,17,"6-4","Y","Y","Y",4,0,5
"744","SP2",2023-09-10,"Mirandes","Andorra",4,3,"H",2,0,"H",3.24,3.21,2.46,"2-0","4-3",17,6,25,7,1,3,0,0,3,3,9,11,7,6,20,"3-3","Y","Y","Y",4,0,5
"745","SP2",2023-09-10,"Valladolid","Elche",1,1,"D",1,0,"H",2.33,3.03,3.71,"1-0","1-1",14,5,8,3,6,2,1,1,7,6,15,13,2,13,28,"7-6","Y","N","N",8,2,5
"746","SP2",2023-09-11,"Eldense","Alcorcon",2,2,"D",0,0,"D",2.4,2.99,3.53,"0-0","2-2",17,3,13,4,0,3,0,1,5,2,14,7,4,7,21,"5-2","Y","Y","Y",3,1,5
"747","SP2",2023-09-15,"Zaragoza","Santander",1,1,"D",1,1,"D",2.06,3.11,4.5,"1-1","1-1",6,2,12,4,2,5,0,0,6,6,21,16,2,12,37,"6-6","Y","N","N",7,0,6
"748","SP2",2023-09-16,"Huesca","Villarreal B",2,2,"D",0,2,"A",2.07,3.23,4.24,"0-2","2-2",8,2,7,3,5,3,0,0,7,0,14,14,4,7,28,"7-0","Y","Y","Y",8,0,6
"749","SP2",2023-09-16,"Alcorcon","Levante",0,2,"A",0,1,"A",2.96,3.08,2.74,"0-1","0-2",10,1,21,5,6,3,1,0,3,6,10,16,2,9,26,"3-6","Y","N","N",9,1,6
"750","SP2",2023-09-16,"Valladolid","Cartagena",1,0,"H",0,0,"D",1.87,3.62,4.58,"0-0","1-0",22,8,9,4,3,1,0,0,9,3,14,14,1,12,28,"9-3","N","N","N",4,0,6
"751","SP2",2023-09-16,"Albacete","Burgos",2,1,"H",1,0,"H",1.81,3.42,5.44,"1-0","2-1",19,5,12,3,1,2,0,0,3,6,16,8,3,9,24,"3-6","Y","Y","N",3,0,6
"752","SP2",2023-09-17,"Amorebieta","Mirandes",2,0,"H",2,0,"H",2.31,3.31,3.41,"2-0","2-0",7,2,10,2,3,2,0,0,9,4,24,10,2,13,34,"9-4","Y","N","N",5,0,6
"753","SP2",2023-09-17,"Eibar","Ferrol",2,0,"H",1,0,"H",1.82,3.42,5.31,"1-0","2-0",13,6,8,1,0,2,0,0,4,6,10,10,2,10,20,"4-6","Y","N","N",2,0,6
"754","SP2",2023-09-17,"Elche","Leganes",1,0,"H",1,0,"H",1.85,3.37,5.22,"1-0","1-0",18,5,9,3,5,3,0,0,8,4,14,10,1,12,24,"8-4","N","N","N",8,0,6
"755","SP2",2023-09-17,"Espanol","Eldense",3,3,"D",0,2,"A",1.49,4.29,7.86,"0-2","3-3",23,5,6,3,3,4,0,1,12,0,14,13,6,12,27,"12-0","Y","Y","Y",7,1,6
"756","SP2",2023-09-17,"Sp Gijon","Tenerife",2,1,"H",1,1,"D",2.81,2.95,3.01,"1-1","2-1",10,4,8,1,2,5,0,0,6,4,12,16,3,10,28,"6-4","Y","Y","N",7,0,6
"757","SP2",2023-09-18,"Andorra","Oviedo",1,0,"H",0,0,"D",2.22,3.08,3.85,"0-0","1-0",5,1,6,2,1,4,1,1,4,3,15,16,1,7,31,"4-3","N","N","N",5,2,6
"758","SP2",2023-09-22,"Cartagena","Eibar",1,2,"A",0,1,"A",3.53,3.19,2.32,"0-1","1-2",7,4,11,5,2,5,1,0,5,6,10,23,3,11,33,"5-6","Y","Y","N",7,1,7
"759","SP2",2023-09-23,"Andorra","Sp Gijon",0,0,"D",0,0,"D",2.27,2.99,3.94,"0-0","0-0",13,5,6,2,0,1,0,0,4,2,10,10,0,6,20,"4-2","N","N","N",1,0,7
"760","SP2",2023-09-23,"Levante","Eldense",2,0,"H",1,0,"H",1.83,3.53,5.02,"1-0","2-0",17,7,10,2,1,2,0,0,5,2,11,15,2,7,26,"5-2","Y","N","N",3,0,7
"761","SP2",2023-09-23,"Burgos","Elche",4,0,"H",2,0,"H",3.15,3.19,2.52,"2-0","4-0",16,9,12,1,3,1,0,0,4,1,11,12,4,5,23,"4-1","Y","Y","Y",4,0,7
"762","SP2",2023-09-23,"Alcorcon","Huesca",0,2,"A",0,2,"A",2.29,3.1,3.72,"0-2","0-2",19,3,6,2,2,1,0,0,4,2,15,7,2,6,22,"4-2","Y","N","N",3,0,7
"763","SP2",2023-09-23,"Santander","Albacete",2,1,"H",2,0,"H",2.36,3.26,3.37,"2-0","2-1",8,3,18,4,2,3,0,0,0,6,13,13,3,6,26,"0-6","Y","Y","N",5,0,7
"764","SP2",2023-09-24,"Villarreal B","Amorebieta",3,1,"H",1,0,"H",2.04,3.56,3.9,"1-0","3-1",19,8,14,4,2,4,0,0,3,6,12,18,4,9,30,"3-6","Y","Y","Y",6,0,7
"765","SP2",2023-09-24,"Oviedo","Valladolid",0,1,"A",0,0,"D",2.68,2.89,3.24,"0-0","0-1",10,3,16,5,1,3,0,0,6,6,14,13,1,12,27,"6-6","N","N","N",4,0,7
"766","SP2",2023-09-24,"Mirandes","Leganes",1,3,"A",1,1,"D",2.78,2.83,3.19,"1-1","1-3",12,6,10,5,1,1,0,0,0,4,11,12,4,4,23,"0-4","Y","Y","Y",2,0,7
"767","SP2",2023-09-25,"Ferrol","Zaragoza",1,0,"H",0,0,"D",2.9,3,2.82,"0-0","1-0",7,3,6,2,1,0,0,0,4,4,7,9,1,8,16,"4-4","N","N","N",1,0,7
"768","SP2",2023-09-25,"Tenerife","Espanol",1,0,"H",1,0,"H",NA,NA,NA,"1-0","1-0",14,6,18,2,3,3,0,0,6,10,22,9,1,16,31,"6-10","N","N","N",6,0,7
"769","SP2",2023-09-29,"Leganes","Santander",2,1,"H",1,0,"H",2.44,2.96,3.57,"1-0","2-1",9,4,16,2,4,3,0,0,4,11,14,5,3,15,19,"4-11","Y","Y","N",7,0,8
"770","SP2",2023-09-30,"Eibar","Tenerife",3,0,"H",0,0,"D",2.06,3.13,4.45,"0-0","3-0",14,5,8,2,3,1,0,0,4,3,16,9,3,7,25,"4-3","Y","Y","N",4,0,8
"771","SP2",2023-09-30,"Elche","Levante",0,0,"D",0,0,"D",2.47,3.31,3.12,"0-0","0-0",28,4,10,2,1,1,0,0,8,7,8,12,0,15,20,"8-7","N","N","N",2,0,8
"772","SP2",2023-09-30,"Albacete","Andorra",3,1,"H",2,0,"H",2.25,3.27,3.62,"2-0","3-1",12,7,11,2,2,2,0,0,4,3,12,15,4,7,27,"4-3","Y","Y","Y",4,0,8
"773","SP2",2023-09-30,"Villarreal B","Alcorcon",2,2,"D",1,2,"A",2.51,3.26,3.1,"1-2","2-2",25,8,10,5,2,3,0,0,7,5,16,13,4,12,29,"7-5","Y","Y","Y",5,0,8
"774","SP2",2023-10-01,"Eldense","Oviedo",1,3,"A",0,3,"A",2.85,2.95,2.97,"0-3","1-3",10,4,10,4,1,0,0,0,6,4,18,10,4,10,28,"6-4","Y","Y","Y",1,0,8
"775","SP2",2023-10-01,"Amorebieta","Cartagena",0,0,"D",0,0,"D",2.37,3.28,3.33,"0-0","0-0",5,2,8,1,2,2,0,0,3,2,14,10,0,5,24,"3-2","N","N","N",4,0,8
"776","SP2",2023-10-01,"Valladolid","Burgos",3,0,"H",2,0,"H",1.79,3.6,5.2,"2-0","3-0",11,6,11,2,2,2,0,0,3,6,14,10,3,9,24,"3-6","Y","Y","N",4,0,8
"777","SP2",2023-10-01,"Zaragoza","Mirandes",0,1,"A",0,0,"D",1.79,3.56,5.19,"0-0","0-1",8,2,8,0,2,4,1,0,6,2,10,11,1,8,21,"6-2","N","N","N",6,1,8
"778","SP2",2023-10-01,"Huesca","Sp Gijon",0,1,"A",0,0,"D",2.35,3.05,3.64,"0-0","0-1",6,2,13,6,6,5,0,0,9,8,11,15,1,17,26,"9-8","N","N","N",11,0,8
"779","SP2",2023-10-02,"Espanol","Ferrol",3,0,"H",1,0,"H",1.63,4.01,5.76,"1-0","3-0",10,3,6,2,2,2,0,1,6,0,22,13,3,6,35,"6-0","Y","Y","N",4,1,8
"780","SP2",2023-10-03,"Alcorcon","Albacete",1,2,"A",0,1,"A",3.16,3.11,2.57,"0-1","1-2",23,6,9,4,0,6,0,0,6,1,10,11,3,7,21,"6-1","Y","Y","N",6,0,9
"781","SP2",2023-10-03,"Levante","Villarreal B",1,1,"D",0,0,"D",1.72,3.99,5.06,"0-0","1-1",15,4,7,1,2,2,0,0,8,2,18,9,2,10,27,"8-2","Y","N","N",4,0,9
"782","SP2",2023-10-03,"Tenerife","Santander",2,0,"H",0,0,"D",1.93,3.34,4.69,"0-0","2-0",21,6,9,3,1,4,0,0,7,4,18,7,2,11,25,"7-4","Y","N","N",5,0,9
"783","SP2",2023-10-04,"Eldense","Valladolid",0,1,"A",0,1,"A",3.17,3.2,2.5,"0-1","0-1",4,0,8,2,1,4,0,0,3,2,16,18,1,5,34,"3-2","N","N","N",5,0,9
"784","SP2",2023-10-04,"Oviedo","Huesca",1,0,"H",0,0,"D",1.99,3.15,4.8,"0-0","1-0",9,6,9,3,2,2,0,0,5,4,14,18,1,9,32,"5-4","N","N","N",4,0,9
"785","SP2",2023-10-04,"Burgos","Leganes",1,0,"H",1,0,"H",2.36,3.01,3.66,"1-0","1-0",5,3,12,2,5,3,0,1,0,8,14,11,1,8,25,"0-8","N","N","N",8,1,9
"786","SP2",2023-10-04,"Sp Gijon","Elche",2,0,"H",2,0,"H",2.54,3.18,3.12,"2-0","2-0",20,8,10,1,0,0,0,0,6,3,9,15,2,9,24,"6-3","Y","N","N",0,0,9
"787","SP2",2023-10-05,"Andorra","Zaragoza",0,1,"A",0,1,"A",2.3,3.13,3.67,"0-1","0-1",5,0,5,3,2,4,1,0,4,0,9,16,1,4,25,"4-0","N","N","N",6,1,9
"788","SP2",2023-10-05,"Mirandes","Eibar",1,3,"A",1,1,"D",3.59,3.1,2.35,"1-1","1-3",7,3,13,3,2,2,0,0,0,6,8,14,4,6,22,"0-6","Y","Y","Y",4,0,9
"789","SP2",2023-10-05,"Cartagena","Espanol",0,2,"A",0,1,"A",3.81,3.63,2.04,"0-1","0-2",10,1,8,4,4,3,0,0,6,2,17,14,2,8,31,"6-2","Y","N","N",7,0,9
"790","SP2",2023-10-05,"Ferrol","Amorebieta",1,0,"H",1,0,"H",1.85,3.5,4.75,"1-0","1-0",11,3,4,2,1,1,0,0,5,3,12,9,1,8,21,"5-3","N","N","N",2,0,9
"1410","T1",2023-08-11,"Trabzonspor","Antalyaspor",1,0,"H",1,0,"H",1.92,3.81,4.06,"1-0","1-0",13,5,11,2,0,1,0,0,6,9,18,11,1,15,29,"6-9","N","N","N",1,0,1
"1411","T1",2023-08-12,"Kasimpasa","Ankaragucu",3,2,"H",1,0,"H",2.36,3.73,2.98,"1-0","3-2",15,5,9,3,1,0,0,0,3,5,8,15,5,8,23,"3-5","Y","Y","Y",1,0,1
"1412","T1",2023-08-12,"Konyaspor","Istanbulspor",1,1,"D",0,1,"A",1.8,3.93,4.55,"0-1","1-1",15,2,4,2,3,5,1,2,10,2,13,10,2,12,23,"10-2","Y","N","N",8,3,1
"1413","T1",2023-08-12,"Kayserispor","Galatasaray",0,0,"D",0,0,"D",5.15,4.41,1.64,"0-0","0-0",12,3,17,3,2,2,0,0,3,9,11,6,0,12,17,"3-9","N","N","N",4,0,1
"1414","T1",2023-08-12,"Pendikspor","Hatayspor",1,5,"A",0,2,"A",2.27,3.48,3.33,"0-2","1-5",6,4,15,9,0,1,0,0,4,2,10,18,6,6,28,"4-2","Y","Y","Y",1,0,1
"1415","T1",2023-08-13,"Sivasspor","Samsunspor",1,1,"D",1,0,"H",2.33,3.6,3.12,"1-0","1-1",6,2,11,3,2,1,0,0,4,5,11,11,2,9,22,"4-5","Y","N","N",3,0,1
"1416","T1",2023-08-13,"Ad. Demirspor","Rizespor",2,1,"H",1,0,"H",1.6,4.61,5.34,"1-0","2-1",9,6,13,4,6,6,0,0,4,5,15,14,3,9,29,"4-5","Y","Y","N",12,0,1
"1417","T1",2023-08-13,"Fenerbahce","Gaziantep",2,1,"H",2,1,"H",1.33,6.04,8.69,"2-1","2-1",21,5,4,1,0,6,0,1,3,1,13,12,3,4,25,"3-1","Y","Y","N",6,1,1
"1418","T1",2023-08-14,"Alanyaspor","Buyuksehyr",2,0,"H",1,0,"H",2.83,3.58,2.49,"1-0","2-0",11,4,8,3,5,4,0,1,4,5,15,14,2,9,29,"4-5","Y","N","N",9,1,1
"1419","T1",2023-08-14,"Karagumruk","Besiktas",0,1,"A",0,0,"D",4.53,4.58,1.67,"0-0","0-1",2,0,9,6,4,1,0,0,4,4,13,14,1,8,27,"4-4","N","N","N",5,0,1
"1420","T1",2023-08-18,"Antalyaspor","Konyaspor",1,1,"D",0,0,"D",2.3,3.61,3.16,"0-0","1-1",14,3,7,3,2,2,0,0,5,5,14,12,2,10,26,"5-5","Y","N","N",4,0,2
"1421","T1",2023-08-18,"Istanbulspor","Kayserispor",1,1,"D",0,0,"D",2.67,3.55,2.69,"0-0","1-1",7,3,9,4,1,0,0,0,4,6,11,11,2,10,22,"4-6","Y","N","N",1,0,2
"1422","T1",2023-08-19,"Rizespor","Alanyaspor",0,0,"D",0,0,"D",2.48,3.61,2.86,"0-0","0-0",10,3,8,2,3,3,0,1,3,3,12,13,0,6,25,"3-3","N","N","N",6,1,2
"1423","T1",2023-08-19,"Galatasaray","Trabzonspor",2,0,"H",1,0,"H",1.64,4.55,4.98,"1-0","2-0",15,5,5,1,4,3,0,0,7,1,21,3,2,8,24,"7-1","Y","N","N",7,0,2
"1424","T1",2023-08-19,"Hatayspor","Kasimpasa",0,0,"D",0,0,"D",2.49,3.6,2.87,"0-0","0-0",8,2,11,2,0,0,0,0,3,1,7,6,0,4,13,"3-1","N","N","N",0,0,2
"1425","T1",2023-08-20,"Buyuksehyr","Karagumruk",0,2,"A",0,2,"A",1.68,4.31,4.95,"0-2","0-2",15,5,9,2,3,4,0,0,5,4,11,14,2,9,25,"5-4","Y","N","N",7,0,2
"1426","T1",2023-08-20,"Besiktas","Pendikspor",1,1,"D",1,0,"H",1.24,6.75,11.71,"1-0","1-1",15,6,11,1,4,2,0,0,6,4,11,9,2,10,20,"6-4","Y","N","N",6,0,2
"1427","T1",2023-08-20,"Gaziantep","Sivasspor",1,3,"A",0,2,"A",2.71,3.73,2.56,"0-2","1-3",11,2,13,7,6,4,0,0,7,4,19,16,4,11,35,"7-4","Y","Y","Y",10,0,2
"1428","T1",2023-08-21,"Ankaragucu","Ad. Demirspor",1,1,"D",1,1,"D",2.72,3.63,2.56,"1-1","1-1",18,5,12,4,1,1,0,0,3,4,9,10,2,7,19,"3-4","Y","N","N",2,0,2
"1429","T1",2023-08-21,"Samsunspor","Fenerbahce",0,2,"A",0,0,"D",5.53,4.5,1.57,"0-0","0-2",5,1,13,6,1,1,0,0,2,5,11,10,2,7,21,"2-5","Y","N","N",2,0,2
"1430","T1",2023-08-25,"Konyaspor","Gaziantep",2,0,"H",0,0,"D",1.8,4.01,4.46,"0-0","2-0",17,8,8,3,1,2,0,0,10,2,9,8,2,12,17,"10-2","Y","N","N",3,0,3
"1431","T1",2023-08-26,"Kasimpasa","Pendikspor",1,1,"D",0,1,"A",1.79,3.85,4.71,"0-1","1-1",7,3,16,6,3,2,0,1,9,2,10,19,2,11,29,"9-2","Y","N","N",5,1,3
"1432","T1",2023-08-26,"Trabzonspor","Rizespor",2,3,"A",0,2,"A",1.51,4.72,6.34,"0-2","2-3",20,7,12,7,1,2,0,0,9,2,10,17,5,11,27,"9-2","Y","Y","Y",3,0,3
"1433","T1",2023-08-26,"Sivasspor","Antalyaspor",1,1,"D",1,1,"D",2.36,3.31,3.31,"1-1","1-1",6,2,8,4,3,3,0,0,3,4,11,15,2,7,26,"3-4","Y","N","N",6,0,3
"1434","T1",2023-08-27,"Karagumruk","Ankaragucu",1,1,"D",1,0,"H",2.38,3.47,3.13,"1-0","1-1",6,2,7,5,1,1,0,0,3,5,15,12,2,8,27,"3-5","Y","N","N",2,0,3
"1435","T1",2023-08-27,"Kayserispor","Samsunspor",2,1,"H",2,1,"H",2.53,3.53,2.87,"2-1","2-1",11,4,6,1,0,0,0,0,3,2,7,8,3,5,15,"3-2","Y","Y","N",0,0,3
"1436","T1",2023-08-27,"Alanyaspor","Hatayspor",0,0,"D",0,0,"D",1.99,3.84,3.77,"0-0","0-0",15,5,5,0,4,3,0,0,9,1,9,17,0,10,26,"9-1","N","N","N",7,0,3
"1437","T1",2023-09-01,"Kasimpasa","Trabzonspor",1,5,"A",0,3,"A",3.03,3.6,2.38,"0-3","1-5",19,6,7,6,3,3,0,0,9,3,10,16,6,12,26,"9-3","Y","Y","Y",6,0,3
"1438","T1",2023-09-01,"Rizespor","Karagumruk",1,0,"H",1,0,"H",1.76,4.1,3.34,"1-0","1-0",13,4,17,3,3,2,0,0,1,6,12,17,1,7,29,"1-6","N","N","N",5,0,3
"1439","T1",2023-09-02,"Buyuksehyr","Konyaspor",0,1,"A",0,0,"D",2.4,3.53,3.05,"0-0","0-1",11,2,13,5,4,2,1,0,2,4,13,13,1,6,26,"2-4","N","N","N",6,1,3
"1440","T1",2023-09-02,"Pendikspor","Alanyaspor",1,1,"D",0,0,"D",2.38,3.63,3.02,"0-0","1-1",10,3,8,4,2,2,0,0,8,4,9,14,2,12,23,"8-4","Y","N","N",4,0,4
"1441","T1",2023-09-02,"Antalyaspor","Kayserispor",1,1,"D",1,1,"D",1.94,3.87,3.91,"1-1","1-1",20,7,7,3,2,3,0,0,9,3,14,11,2,12,25,"9-3","Y","N","N",5,0,4
"1442","T1",2023-09-02,"Gaziantep","Galatasaray",0,3,"A",0,1,"A",7.45,5.13,1.42,"0-1","0-3",15,7,15,4,2,0,0,0,4,7,12,13,3,11,25,"4-7","Y","Y","N",2,0,4
"1443","T1",2023-09-03,"Besiktas","Sivasspor",2,0,"H",2,0,"H",1.45,4.72,7.56,"2-0","2-0",17,8,5,1,2,4,0,0,7,2,17,17,2,9,34,"7-2","Y","N","N",6,0,4
"1444","T1",2023-09-03,"Ankaragucu","Fenerbahce",0,1,"A",0,0,"D",5.03,4.08,1.7,"0-0","0-1",14,2,14,2,2,3,0,1,4,2,15,14,1,6,29,"4-2","N","N","N",5,1,4
"1445","T1",2023-09-03,"Hatayspor","Ad. Demirspor",3,3,"D",0,1,"A",3.45,3.62,2.16,"0-1","3-3",14,7,11,6,6,2,0,0,3,7,19,9,6,10,28,"3-7","Y","Y","Y",8,0,4
"1446","T1",2023-09-16,"Kayserispor","Gaziantep",2,0,"H",1,0,"H",1.89,3.79,4.21,"1-0","2-0",10,4,16,5,0,1,0,0,3,7,11,8,2,10,19,"3-7","Y","N","N",1,0,4
"1447","T1",2023-09-16,"Konyaspor","Rizespor",1,2,"A",1,0,"H",1.99,3.69,3.92,"1-0","1-2",6,4,11,2,2,1,0,0,2,4,12,14,3,6,26,"2-4","Y","Y","N",3,0,4
"1448","T1",2023-09-16,"Ad. Demirspor","Pendikspor",3,0,"H",2,0,"H",1.52,4.93,5.92,"2-0","3-0",18,7,15,5,0,3,0,0,6,6,8,6,3,12,14,"6-6","Y","Y","N",3,0,4
"1449","T1",2023-09-16,"Galatasaray","Samsunspor",4,2,"H",3,0,"H",1.34,5.78,8.87,"3-0","4-2",9,5,9,4,1,3,0,0,2,6,17,15,6,8,32,"2-6","Y","Y","Y",4,0,4
"1450","T1",2023-09-17,"Fenerbahce","Antalyaspor",3,2,"H",1,1,"D",1.4,5.41,7.66,"1-1","3-2",17,10,14,6,3,4,0,0,7,5,13,11,5,12,24,"7-5","Y","Y","Y",7,0,5
"1451","T1",2023-09-17,"Istanbulspor","Buyuksehyr",0,2,"A",0,0,"D",3.34,3.48,2.27,"0-0","0-2",5,0,20,8,4,0,0,0,0,7,15,9,2,7,24,"0-7","Y","N","N",4,0,5
"1452","T1",2023-09-17,"Alanyaspor","Kasimpasa",3,3,"D",2,1,"H",2.09,3.67,3.56,"2-1","3-3",13,6,17,3,0,0,0,0,5,7,9,11,6,12,20,"5-7","Y","Y","Y",0,0,5
"1453","T1",2023-09-17,"Trabzonspor","Besiktas",3,0,"H",2,0,"H",3.12,3.47,2.39,"2-0","3-0",8,5,7,1,4,1,0,0,2,7,15,11,3,9,26,"2-7","Y","Y","N",5,0,5
"1454","T1",2023-09-18,"Karagumruk","Hatayspor",0,0,"D",0,0,"D",1.99,3.63,3.89,"0-0","0-0",5,2,18,5,3,2,0,0,3,3,14,9,0,6,23,"3-3","N","N","N",5,0,5
"1455","T1",2023-09-18,"Sivasspor","Ankaragucu",1,3,"A",1,1,"D",2.42,3.4,3.08,"1-1","1-3",15,9,15,5,3,2,1,0,5,3,7,12,4,8,19,"5-3","Y","Y","Y",5,1,5
"1456","T1",2023-09-22,"Gaziantep","Istanbulspor",2,0,"H",0,0,"D",1.88,3.91,4.12,"0-0","2-0",13,2,5,0,1,5,0,0,8,4,11,13,2,12,24,"8-4","Y","N","N",6,0,5
"1457","T1",2023-09-23,"Pendikspor","Karagumruk",1,1,"D",1,0,"H",2.56,3.44,2.89,"1-0","1-1",8,4,10,4,0,1,0,0,5,4,13,10,2,9,23,"5-4","Y","N","N",1,0,5
"1458","T1",2023-09-23,"Rizespor","Sivasspor",1,1,"D",1,1,"D",2.29,3.39,3.37,"1-1","1-1",14,4,14,4,7,3,0,0,5,4,12,17,2,9,29,"5-4","Y","N","N",10,0,5
"1459","T1",2023-09-23,"Antalyaspor","Samsunspor",2,0,"H",2,0,"H",2.12,3.75,3.46,"2-0","2-0",7,3,9,1,2,1,0,0,1,4,22,11,2,5,33,"1-4","Y","N","N",3,0,5
"1460","T1",2023-09-23,"Buyuksehyr","Galatasaray",1,2,"A",0,1,"A",4.44,3.86,1.83,"0-1","1-2",6,2,17,4,3,2,0,0,2,4,18,15,3,6,33,"2-4","Y","Y","N",5,0,6
"1461","T1",2023-09-24,"Ankaragucu","Konyaspor",1,1,"D",1,1,"D",2.4,3.58,3.01,"1-1","1-1",15,1,7,1,1,1,0,0,4,2,15,8,2,6,23,"4-2","Y","N","N",2,0,6
"1462","T1",2023-09-24,"Besiktas","Kayserispor",2,1,"H",0,0,"D",1.4,5.2,8.13,"0-0","2-1",23,10,5,1,1,0,0,0,7,2,13,10,3,9,23,"7-2","Y","Y","N",1,0,6
"1463","T1",2023-09-24,"Alanyaspor","Fenerbahce",0,1,"A",0,1,"A",5.11,4.35,1.65,"0-1","0-1",2,1,14,7,2,6,0,0,4,5,15,14,1,9,29,"4-5","N","N","N",8,0,6
"1464","T1",2023-09-24,"Kasimpasa","Ad. Demirspor",2,1,"H",1,0,"H",3.2,3.83,2.2,"1-0","2-1",13,7,19,6,4,2,0,3,6,11,21,7,3,17,28,"6-11","Y","Y","N",6,3,6
"1465","T1",2023-09-25,"Hatayspor","Trabzonspor",3,2,"H",0,1,"A",3.05,3.68,2.3,"0-1","3-2",9,3,6,3,6,2,0,0,9,1,22,13,5,10,35,"9-1","Y","Y","Y",8,0,6
"1466","T1",2023-09-26,"Istanbulspor","Galatasaray",0,1,"A",0,1,"A",9.13,5.73,1.34,"0-1","0-1",4,3,17,7,1,2,0,0,3,4,12,16,1,7,28,"3-4","N","N","N",3,0,6
"1467","T1",2023-09-27,"Ad. Demirspor","Besiktas",4,2,"H",2,0,"H",3.37,3.93,2.09,"2-0","4-2",14,7,16,5,2,1,0,0,1,5,16,15,6,6,31,"1-5","Y","Y","Y",3,0,6
"1468","T1",2023-09-28,"Fenerbahce","Buyuksehyr",4,0,"H",3,0,"H",1.44,5.07,7.13,"3-0","4-0",16,8,6,0,4,1,0,0,14,2,22,9,4,16,31,"14-2","Y","Y","Y",5,0,6
"1469","T1",2023-09-29,"Samsunspor","Gaziantep",1,2,"A",0,2,"A",1.93,3.76,4.11,"0-2","1-2",18,2,4,3,2,3,0,0,9,2,13,12,3,11,25,"9-2","Y","Y","N",5,0,6
"1470","T1",2023-09-30,"Sivasspor","Hatayspor",0,0,"D",0,0,"D",2.08,3.57,3.74,"0-0","0-0",12,4,4,1,3,3,0,0,6,7,9,20,0,13,29,"6-7","N","N","N",6,0,7
"1471","T1",2023-09-30,"Istanbulspor","Antalyaspor",1,2,"A",1,0,"H",3.23,3.77,2.21,"1-0","1-2",4,3,17,5,2,3,0,0,4,8,8,17,3,12,25,"4-8","Y","Y","N",5,0,7
"1472","T1",2023-09-30,"Trabzonspor","Pendikspor",2,1,"H",2,1,"H",1.55,4.62,5.91,"2-1","2-1",11,3,9,4,2,1,1,0,4,2,19,8,3,6,27,"4-2","Y","Y","N",3,1,7
"1473","T1",2023-09-30,"Galatasaray","Ankaragucu",2,1,"H",0,0,"D",1.31,6.12,9.34,"0-0","2-1",34,13,7,2,0,3,0,0,12,3,11,10,3,15,21,"12-3","Y","Y","N",3,0,7
"1474","T1",2023-10-01,"Karagumruk","Kasimpasa",2,3,"A",1,3,"A",2.34,3.63,3.08,"1-3","2-3",13,4,4,3,3,3,0,0,8,0,9,14,5,8,23,"8-0","Y","Y","Y",6,0,7
"1475","T1",2023-10-01,"Fenerbahce","Rizespor",5,0,"H",1,0,"H",1.34,5.83,8.54,"1-0","5-0",23,11,5,1,1,3,0,0,8,2,10,15,5,10,25,"8-2","Y","Y","Y",4,0,7
"1476","T1",2023-10-01,"Ad. Demirspor","Alanyaspor",4,0,"H",1,0,"H",1.74,4.3,4.43,"1-0","4-0",15,7,9,1,2,3,0,0,7,3,11,14,4,10,25,"7-3","Y","Y","Y",5,0,7
"1477","T1",2023-10-01,"Konyaspor","Besiktas",0,2,"A",0,1,"A",3.51,3.7,2.11,"0-1","0-2",5,3,6,1,2,3,1,0,2,6,13,20,2,8,33,"2-6","Y","N","N",5,1,7
"1478","T1",2023-10-02,"Kayserispor","Buyuksehyr",0,0,"D",0,0,"D",2.6,3.39,2.83,"0-0","0-0",14,1,8,4,2,2,0,0,10,5,6,15,0,15,21,"10-5","N","N","N",4,0,7
